id,cdep,cmun,cindica,nomind,periodo,edadR,casos,poblacion,tasa,casosh,poblacionh,tasah,casosm,poblacionm,tasam
25233,11,11001,81,"Tasa de exámenes médico legales por presunto delito sexual contra niños, niñas y adolescentes",2018,2,715,607892,117.619577161733,172,312398,55.0579709217088,543,295494,183.760076346728
25234,11,11001,81,"Tasa de exámenes médico legales por presunto delito sexual contra niños, niñas y adolescentes",2018,3,1314,722847,181.7812068114,253,371162,68.1643056131824,1061,351685,301.690433200165
25235,11,11001,81,"Tasa de exámenes médico legales por presunto delito sexual contra niños, niñas y adolescentes",2018,4,1585,734488,215.796582108898,175,374811,46.6901985267241,1410,359677,392.018394281536
25236,11,11001,121,Tasa de exámenes médico legales por presunto delito sexual cuando la víctima está entre 18 y 28 años,2018,5,359,1458269,24.6182288727251,28,737666,3.79575580276168,331,720603,45.9337527043323
25237,11,11001,81,"Tasa de exámenes médico legales por presunto delito sexual contra niños, niñas y adolescentes",2018,1,8,122409,6.53546716336217,3,62875,4.7713717693837,5,59534,8.39856216615715
25238,13,13001,81,"Tasa de exámenes médico legales por presunto delito sexual contra niños, niñas y adolescentes",2018,2,90,81565,110.341445472936,17,41612,40.8535999230991,73,39953,182.714689760469
25239,13,13001,81,"Tasa de exámenes médico legales por presunto delito sexual contra niños, niñas y adolescentes",2018,3,193,102556,188.189866999493,35,52033,67.2650049007361,158,50523,312.728856164519
25240,13,13001,81,"Tasa de exámenes médico legales por presunto delito sexual contra niños, niñas y adolescentes",2018,4,293,109139,268.464985019104,27,54831,49.2422169940362,266,54308,489.798924651985
25241,13,13001,121,Tasa de exámenes médico legales por presunto delito sexual cuando la víctima está entre 18 y 28 años,2018,5,59,197666,29.8483300112311,8,99782,8.01747810226293,51,97884,52.1024886600466
25242,13,13001,81,"Tasa de exámenes médico legales por presunto delito sexual contra niños, niñas y adolescentes",2018,1,1,16120,6.20347394540943,0,8219,0,1,7901,12.6566257435768
25243,13,13006,81,"Tasa de exámenes médico legales por presunto delito sexual contra niños, niñas y adolescentes",2018,4,2,2665,75.046904315197,0,1367,0,2,1298,154.083204930663
25244,13,13030,81,"Tasa de exámenes médico legales por presunto delito sexual contra niños, niñas y adolescentes",2018,3,1,1708,58.5480093676815,1,890,112.359550561798,0,818,0
25245,13,13042,81,"Tasa de exámenes médico legales por presunto delito sexual contra niños, niñas y adolescentes",2018,2,1,2552,39.1849529780564,0,1302,0,1,1250,80
25246,13,13042,81,"Tasa de exámenes médico legales por presunto delito sexual contra niños, niñas y adolescentes",2018,3,2,2706,73.909830007391,0,1391,0,2,1315,152.091254752852
25247,13,13042,81,"Tasa de exámenes médico legales por presunto delito sexual contra niños, niñas y adolescentes",2018,4,2,2577,77.6096235933256,1,1368,73.0994152046784,1,1209,82.7129859387924
25248,13,13052,81,"Tasa de exámenes médico legales por presunto delito sexual contra niños, niñas y adolescentes",2018,2,3,7597,39.4892720810846,2,3883,51.5065670873036,1,3714,26.9251480883145
25249,13,13052,81,"Tasa de exámenes médico legales por presunto delito sexual contra niños, niñas y adolescentes",2018,3,4,9100,43.956043956044,1,4635,21.5749730312837,3,4465,67.1892497200448
25250,13,13052,81,"Tasa de exámenes médico legales por presunto delito sexual contra niños, niñas y adolescentes",2018,4,20,9057,220.82367229767,4,4606,86.8432479374729,16,4451,359.469782071445
25251,13,13052,121,Tasa de exámenes médico legales por presunto delito sexual cuando la víctima está entre 18 y 28 años,2018,5,4,15331,26.0909268801774,1,8066,12.3977188197372,3,7265,41.2938747419133
25252,13,13074,81,"Tasa de exámenes médico legales por presunto delito sexual contra niños, niñas y adolescentes",2018,2,2,2505,79.8403193612774,0,1281,0,2,1224,163.398692810458
25253,13,13074,81,"Tasa de exámenes médico legales por presunto delito sexual contra niños, niñas y adolescentes",2018,3,3,2630,114.068441064639,1,1335,74.9063670411985,2,1295,154.440154440154
25254,13,13074,81,"Tasa de exámenes médico legales por presunto delito sexual contra niños, niñas y adolescentes",2018,4,2,2341,85.4335753951303,0,1190,0,2,1151,173.761946133797
25255,13,13140,81,"Tasa de exámenes médico legales por presunto delito sexual contra niños, niñas y adolescentes",2018,3,1,3024,33.0687830687831,0,1624,0,1,1400,71.4285714285714
25256,13,13140,81,"Tasa de exámenes médico legales por presunto delito sexual contra niños, niñas y adolescentes",2018,4,4,2925,136.752136752137,0,1582,0,4,1343,297.840655249442
25257,13,13140,121,Tasa de exámenes médico legales por presunto delito sexual cuando la víctima está entre 18 y 28 años,2018,5,1,4782,20.9117524048515,0,2543,0,1,2239,44.6627958910228
25258,13,13160,81,"Tasa de exámenes médico legales por presunto delito sexual contra niños, niñas y adolescentes",2018,4,2,1097,182.315405651778,0,561,0,2,536,373.134328358209
25259,13,13188,81,"Tasa de exámenes médico legales por presunto delito sexual contra niños, niñas y adolescentes",2018,3,4,1336,299.40119760479,1,686,145.772594752187,3,650,461.538461538462
25260,13,13188,81,"Tasa de exámenes médico legales por presunto delito sexual contra niños, niñas y adolescentes",2018,4,1,1282,78.003120124805,0,658,0,1,624,160.25641025641
25261,13,13212,81,"Tasa de exámenes médico legales por presunto delito sexual contra niños, niñas y adolescentes",2018,3,1,1613,61.9962802231866,0,838,0,1,775,129.032258064516
25262,13,13212,81,"Tasa de exámenes médico legales por presunto delito sexual contra niños, niñas y adolescentes",2018,4,2,1471,135.961930659415,0,764,0,2,707,282.885431400283
25263,13,13222,81,"Tasa de exámenes médico legales por presunto delito sexual contra niños, niñas y adolescentes",2018,3,3,1661,180.614087898856,2,877,228.050171037628,1,784,127.551020408163
25264,13,13222,81,"Tasa de exámenes médico legales por presunto delito sexual contra niños, niñas y adolescentes",2018,4,4,1596,250.62656641604,0,855,0,4,741,539.811066126856
25265,13,13222,121,Tasa de exámenes médico legales por presunto delito sexual cuando la víctima está entre 18 y 28 años,2018,5,1,2728,36.6568914956012,0,1464,0,1,1264,79.1139240506329
25266,13,13244,81,"Tasa de exámenes médico legales por presunto delito sexual contra niños, niñas y adolescentes",2018,2,9,9429,95.4502068087814,4,4817,83.0392360390285,5,4612,108.412836079792
25267,13,13244,81,"Tasa de exámenes médico legales por presunto delito sexual contra niños, niñas y adolescentes",2018,3,17,10253,165.805130205793,3,5314,56.4546480993602,14,4939,283.458189916987
25268,13,13244,81,"Tasa de exámenes médico legales por presunto delito sexual contra niños, niñas y adolescentes",2018,4,27,9309,290.04189494038,3,4855,61.7919670442842,24,4454,538.841490794791
25269,13,13244,121,Tasa de exámenes médico legales por presunto delito sexual cuando la víctima está entre 18 y 28 años,2018,5,2,15705,12.7347978350844,0,8211,0,2,7494,26.6880170803309
25270,13,13248,81,"Tasa de exámenes médico legales por presunto delito sexual contra niños, niñas y adolescentes",2018,3,1,831,120.336943441637,0,434,0,1,397,251.889168765743
25271,13,13268,81,"Tasa de exámenes médico legales por presunto delito sexual contra niños, niñas y adolescentes",2018,3,6,1331,450.788880540947,1,692,144.508670520231,5,639,782.472613458529
25272,13,13430,81,"Tasa de exámenes médico legales por presunto delito sexual contra niños, niñas y adolescentes",2018,2,16,12509,127.907906307459,3,6410,46.801872074883,13,6099,213.149696671586
25273,13,13430,81,"Tasa de exámenes médico legales por presunto delito sexual contra niños, niñas y adolescentes",2018,3,24,14460,165.97510373444,9,7426,121.19579854565,15,7034,213.24992891669
25274,13,13430,81,"Tasa de exámenes médico legales por presunto delito sexual contra niños, niñas y adolescentes",2018,4,49,13612,359.976491331178,4,6983,57.2819704997852,45,6629,678.835420123699
25275,13,13430,121,Tasa de exámenes médico legales por presunto delito sexual cuando la víctima está entre 18 y 28 años,2018,5,5,23851,20.9634816150266,0,12215,0,5,11636,42.9700928154005
25276,13,13433,81,"Tasa de exámenes médico legales por presunto delito sexual contra niños, niñas y adolescentes",2018,2,1,2673,37.4111485222596,0,1374,0,1,1299,76.9822940723633
25277,13,13433,81,"Tasa de exámenes médico legales por presunto delito sexual contra niños, niñas y adolescentes",2018,3,3,3017,99.4365263506795,0,1553,0,3,1464,204.918032786885
25278,13,13433,81,"Tasa de exámenes médico legales por presunto delito sexual contra niños, niñas y adolescentes",2018,4,18,2837,634.473034896017,0,1457,0,18,1380,1304.34782608696
25279,13,13433,121,Tasa de exámenes médico legales por presunto delito sexual cuando la víctima está entre 18 y 28 años,2018,5,2,4869,41.0761963442185,0,2544,0,2,2325,86.0215053763441
25280,13,13440,81,"Tasa de exámenes médico legales por presunto delito sexual contra niños, niñas y adolescentes",2018,4,1,1186,84.3170320404722,0,603,0,1,583,171.526586620926
25281,13,13442,81,"Tasa de exámenes médico legales por presunto delito sexual contra niños, niñas y adolescentes",2018,2,8,5799,137.954819796517,2,2976,67.2043010752688,6,2823,212.539851222104
25282,13,13442,81,"Tasa de exámenes médico legales por presunto delito sexual contra niños, niñas y adolescentes",2018,3,5,6296,79.4155019059721,1,3271,30.571690614491,4,3025,132.231404958678
25283,13,13442,81,"Tasa de exámenes médico legales por presunto delito sexual contra niños, niñas y adolescentes",2018,4,15,5740,261.324041811847,0,2996,0,15,2744,546.6472303207
25284,13,13458,81,"Tasa de exámenes médico legales por presunto delito sexual contra niños, niñas y adolescentes",2018,2,1,2651,37.7216144851,0,1361,0,1,1290,77.5193798449612
25285,13,13458,81,"Tasa de exámenes médico legales por presunto delito sexual contra niños, niñas y adolescentes",2018,3,2,2933,68.1895669962496,0,1513,0,2,1420,140.845070422535
25286,13,13468,81,"Tasa de exámenes médico legales por presunto delito sexual contra niños, niñas y adolescentes",2018,2,4,5087,78.6318065657559,3,2598,115.473441108545,1,2489,40.1767778224186
25287,13,13468,81,"Tasa de exámenes médico legales por presunto delito sexual contra niños, niñas y adolescentes",2018,3,5,5683,87.9816998064403,2,2901,68.9417442261289,3,2782,107.8360891445
25288,13,13468,81,"Tasa de exámenes médico legales por presunto delito sexual contra niños, niñas y adolescentes",2018,4,12,5261,228.09351834252,1,2661,37.5798571965427,11,2600,423.076923076923
25289,13,13473,81,"Tasa de exámenes médico legales por presunto delito sexual contra niños, niñas y adolescentes",2018,3,1,2851,35.0754121360926,0,1460,0,1,1391,71.8907260963336
25290,13,13549,81,"Tasa de exámenes médico legales por presunto delito sexual contra niños, niñas y adolescentes",2018,4,4,3132,127.713920817369,0,1651,0,4,1481,270.087778528022
25291,13,13580,81,"Tasa de exámenes médico legales por presunto delito sexual contra niños, niñas y adolescentes",2018,3,1,1536,65.1041666666667,0,783,0,1,753,132.802124833997
25292,13,13580,81,"Tasa de exámenes médico legales por presunto delito sexual contra niños, niñas y adolescentes",2018,4,1,1453,68.8231245698555,0,743,0,1,710,140.845070422535
25293,13,13620,81,"Tasa de exámenes médico legales por presunto delito sexual contra niños, niñas y adolescentes",2018,2,1,592,168.918918918919,0,300,0,1,292,342.465753424658
25294,13,13647,81,"Tasa de exámenes médico legales por presunto delito sexual contra niños, niñas y adolescentes",2018,2,1,1772,56.4334085778781,0,901,0,1,871,114.810562571757
25295,13,13647,121,Tasa de exámenes médico legales por presunto delito sexual cuando la víctima está entre 18 y 28 años,2018,5,1,3095,32.3101777059774,0,1580,0,1,1515,66.006600660066
25296,13,13650,81,"Tasa de exámenes médico legales por presunto delito sexual contra niños, niñas y adolescentes",2018,4,1,1622,61.652281134402,1,854,117.096018735363,0,768,0
25297,13,13650,121,Tasa de exámenes médico legales por presunto delito sexual cuando la víctima está entre 18 y 28 años,2018,5,2,2811,71.1490572749911,0,1508,0,2,1303,153.491941673062
25298,13,13654,81,"Tasa de exámenes médico legales por presunto delito sexual contra niños, niñas y adolescentes",2018,3,2,2296,87.1080139372822,0,1187,0,2,1109,180.34265103697
25299,13,13654,81,"Tasa de exámenes médico legales por presunto delito sexual contra niños, niñas y adolescentes",2018,4,10,2222,450.04500450045,0,1153,0,10,1069,935.453695042095
25300,13,13657,81,"Tasa de exámenes médico legales por presunto delito sexual contra niños, niñas y adolescentes",2018,2,1,3234,30.9214594928881,0,1650,0,1,1584,63.1313131313131
25301,13,13657,81,"Tasa de exámenes médico legales por presunto delito sexual contra niños, niñas y adolescentes",2018,3,1,3704,26.9978401727862,0,1920,0,1,1784,56.0538116591928
25302,13,13657,81,"Tasa de exámenes médico legales por presunto delito sexual contra niños, niñas y adolescentes",2018,4,8,3561,224.65599550688,0,1835,0,8,1726,463.499420625724
25303,13,13657,121,Tasa de exámenes médico legales por presunto delito sexual cuando la víctima está entre 18 y 28 años,2018,5,1,6589,15.1768098345728,0,3390,0,1,3199,31.2597686777118
25304,13,13667,81,"Tasa de exámenes médico legales por presunto delito sexual contra niños, niñas y adolescentes",2018,2,1,2488,40.1929260450161,0,1259,0,1,1229,81.366965012205
25305,13,13667,81,"Tasa de exámenes médico legales por presunto delito sexual contra niños, niñas y adolescentes",2018,3,2,2530,79.0513833992095,0,1284,0,2,1246,160.513643659711
25306,13,13667,81,"Tasa de exámenes médico legales por presunto delito sexual contra niños, niñas y adolescentes",2018,4,1,2191,45.6412596987677,0,1115,0,1,1076,92.9368029739777
25307,13,13667,121,Tasa de exámenes médico legales por presunto delito sexual cuando la víctima está entre 18 y 28 años,2018,5,1,3799,26.3227165043432,0,1926,0,1,1873,53.3902829684997
25308,13,13670,81,"Tasa de exámenes médico legales por presunto delito sexual contra niños, niñas y adolescentes",2018,2,1,3858,25.9201658890617,0,1955,0,1,1903,52.5486074619023
25309,13,13670,81,"Tasa de exámenes médico legales por presunto delito sexual contra niños, niñas y adolescentes",2018,3,1,4296,23.2774674115456,0,2107,0,1,2189,45.6829602558246
25310,13,13673,81,"Tasa de exámenes médico legales por presunto delito sexual contra niños, niñas y adolescentes",2018,3,2,1734,115.340253748558,0,876,0,2,858,233.100233100233
25311,13,13673,81,"Tasa de exámenes médico legales por presunto delito sexual contra niños, niñas y adolescentes",2018,4,3,1554,193.050193050193,0,793,0,3,761,394.218134034166
25312,13,13683,81,"Tasa de exámenes médico legales por presunto delito sexual contra niños, niñas y adolescentes",2018,2,2,2629,76.0745530620008,0,1346,0,2,1283,155.884645362432
25313,13,13683,81,"Tasa de exámenes médico legales por presunto delito sexual contra niños, niñas y adolescentes",2018,3,3,3028,99.0752972258917,0,1558,0,3,1470,204.081632653061
25314,13,13683,81,"Tasa de exámenes médico legales por presunto delito sexual contra niños, niñas y adolescentes",2018,4,5,2947,169.664065151001,0,1520,0,5,1427,350.385423966363
25315,13,13683,121,Tasa de exámenes médico legales por presunto delito sexual cuando la víctima está entre 18 y 28 años,2018,5,3,4758,63.0517023959647,0,2504,0,3,2254,133.096716947649
25316,13,13688,81,"Tasa de exámenes médico legales por presunto delito sexual contra niños, niñas y adolescentes",2018,2,2,5595,35.7462019660411,0,2934,0,2,2661,75.1597143930853
25317,13,13688,81,"Tasa de exámenes médico legales por presunto delito sexual contra niños, niñas y adolescentes",2018,3,3,6178,48.5594043379735,0,3307,0,3,2871,104.493207941484
25318,13,13744,81,"Tasa de exámenes médico legales por presunto delito sexual contra niños, niñas y adolescentes",2018,4,1,2778,35.9971202303816,0,1407,0,1,1371,72.9394602479942
25319,13,13760,81,"Tasa de exámenes médico legales por presunto delito sexual contra niños, niñas y adolescentes",2018,3,2,848,235.849056603774,0,433,0,2,415,481.927710843374
25320,13,13780,81,"Tasa de exámenes médico legales por presunto delito sexual contra niños, niñas y adolescentes",2018,3,4,1536,260.416666666667,0,807,0,4,729,548.696844993141
25321,13,13780,81,"Tasa de exámenes médico legales por presunto delito sexual contra niños, niñas y adolescentes",2018,4,2,1438,139.082058414465,0,762,0,2,676,295.85798816568
25322,13,13810,81,"Tasa de exámenes médico legales por presunto delito sexual contra niños, niñas y adolescentes",2018,2,1,3426,29.1885580852306,0,1749,0,1,1677,59.6302921884317
25323,13,13810,81,"Tasa de exámenes médico legales por presunto delito sexual contra niños, niñas y adolescentes",2018,4,3,3013,99.5685363425158,0,1526,0,3,1487,201.748486886348
25324,13,13836,81,"Tasa de exámenes médico legales por presunto delito sexual contra niños, niñas y adolescentes",2018,2,6,6259,95.8619587793577,1,3199,31.2597686777118,5,3060,163.398692810458
25325,13,13836,81,"Tasa de exámenes médico legales por presunto delito sexual contra niños, niñas y adolescentes",2018,3,16,7541,212.173451796844,2,3847,51.9885625162464,14,3694,378.992961559285
25326,13,13836,81,"Tasa de exámenes médico legales por presunto delito sexual contra niños, niñas y adolescentes",2018,4,17,7869,216.037615961367,1,3988,25.0752256770311,16,3881,412.264880185519
25327,13,13838,81,"Tasa de exámenes médico legales por presunto delito sexual contra niños, niñas y adolescentes",2018,2,1,1674,59.7371565113501,0,857,0,1,817,122.399020807834
25328,13,13838,81,"Tasa de exámenes médico legales por presunto delito sexual contra niños, niñas y adolescentes",2018,3,1,2015,49.6277915632754,0,1038,0,1,977,102.354145342886
25329,13,13838,81,"Tasa de exámenes médico legales por presunto delito sexual contra niños, niñas y adolescentes",2018,4,3,1959,153.139356814701,0,1012,0,3,947,316.789862724393
25330,13,13838,121,Tasa de exámenes médico legales por presunto delito sexual cuando la víctima está entre 18 y 28 años,2018,5,1,2826,35.3857041755131,0,1463,0,1,1363,73.3675715333822
25331,13,13873,81,"Tasa de exámenes médico legales por presunto delito sexual contra niños, niñas y adolescentes",2018,3,5,2388,209.380234505863,0,1220,0,5,1168,428.082191780822
25332,13,13873,81,"Tasa de exámenes médico legales por presunto delito sexual contra niños, niñas y adolescentes",2018,4,5,2325,215.05376344086,0,1182,0,5,1143,437.445319335083
25333,13,13873,121,Tasa de exámenes médico legales por presunto delito sexual cuando la víctima está entre 18 y 28 años,2018,5,4,3926,101.884870096791,0,1994,0,4,1932,207.03933747412
25334,13,13894,81,"Tasa de exámenes médico legales por presunto delito sexual contra niños, niñas y adolescentes",2018,2,1,1373,72.8332119446468,0,703,0,1,670,149.253731343284
25335,13,13894,81,"Tasa de exámenes médico legales por presunto delito sexual contra niños, niñas y adolescentes",2018,3,3,1461,205.338809034908,0,760,0,3,701,427.960057061341
25336,15,15001,81,"Tasa de exámenes médico legales por presunto delito sexual contra niños, niñas y adolescentes",2018,2,25,14536,171.986791414419,7,7432,94.1872981700754,18,7104,253.378378378378
25337,15,15001,81,"Tasa de exámenes médico legales por presunto delito sexual contra niños, niñas y adolescentes",2018,3,48,19385,247.614134640186,6,9793,61.2682528336567,42,9592,437.864887406172
25338,15,15001,81,"Tasa de exámenes médico legales por presunto delito sexual contra niños, niñas y adolescentes",2018,4,63,21678,290.617215610296,8,10916,73.2869182850861,55,10762,511.057424270582
25339,15,15001,121,Tasa de exámenes médico legales por presunto delito sexual cuando la víctima está entre 18 y 28 años,2018,5,17,36113,47.0744607205162,0,18810,0,17,17303,98.2488585794371
25340,15,15047,81,"Tasa de exámenes médico legales por presunto delito sexual contra niños, niñas y adolescentes",2018,3,2,1826,109.529025191676,1,937,106.723585912487,1,889,112.485939257593
25341,15,15047,81,"Tasa de exámenes médico legales por presunto delito sexual contra niños, niñas y adolescentes",2018,4,1,1767,56.5930956423316,0,908,0,1,859,116.414435389988
25342,15,15051,81,"Tasa de exámenes médico legales por presunto delito sexual contra niños, niñas y adolescentes",2018,3,3,558,537.634408602151,1,293,341.296928327645,2,265,754.716981132075
25343,15,15051,81,"Tasa de exámenes médico legales por presunto delito sexual contra niños, niñas y adolescentes",2018,4,5,517,967.117988394584,1,277,361.01083032491,4,240,1666.66666666667
25344,15,15051,121,Tasa de exámenes médico legales por presunto delito sexual cuando la víctima está entre 18 y 28 años,2018,5,1,779,128.369704749679,0,418,0,1,361,277.008310249307
25345,15,15087,81,"Tasa de exámenes médico legales por presunto delito sexual contra niños, niñas y adolescentes",2018,3,1,687,145.560407569141,0,355,0,1,332,301.204819277108
25346,15,15087,81,"Tasa de exámenes médico legales por presunto delito sexual contra niños, niñas y adolescentes",2018,4,4,684,584.795321637427,0,356,0,4,328,1219.51219512195
25347,15,15087,121,Tasa de exámenes médico legales por presunto delito sexual cuando la víctima está entre 18 y 28 años,2018,5,1,1145,87.3362445414847,0,604,0,1,541,184.842883548983
25348,15,15104,81,"Tasa de exámenes médico legales por presunto delito sexual contra niños, niñas y adolescentes",2018,3,3,490,612.244897959184,0,250,0,3,240,1250
25349,15,15106,81,"Tasa de exámenes médico legales por presunto delito sexual contra niños, niñas y adolescentes",2018,4,2,260,769.230769230769,0,140,0,2,120,1666.66666666667
25350,15,15109,81,"Tasa de exámenes médico legales por presunto delito sexual contra niños, niñas y adolescentes",2018,3,1,643,155.52099533437,0,339,0,1,304,328.947368421053
25351,15,15114,81,"Tasa de exámenes médico legales por presunto delito sexual contra niños, niñas y adolescentes",2018,4,1,115,869.565217391304,0,56,0,1,59,1694.91525423729
25352,15,15131,81,"Tasa de exámenes médico legales por presunto delito sexual contra niños, niñas y adolescentes",2018,4,2,336,595.238095238095,0,176,0,2,160,1250
25353,15,15172,81,"Tasa de exámenes médico legales por presunto delito sexual contra niños, niñas y adolescentes",2018,2,1,259,386.100386100386,1,132,757.575757575758,0,127,0
25354,15,15172,81,"Tasa de exámenes médico legales por presunto delito sexual contra niños, niñas y adolescentes",2018,4,1,327,305.810397553517,0,172,0,1,155,645.161290322581
25355,15,15176,81,"Tasa de exámenes médico legales por presunto delito sexual contra niños, niñas y adolescentes",2018,2,4,5669,70.5591815134945,0,2904,0,4,2765,144.665461121157
25356,15,15176,81,"Tasa de exámenes médico legales por presunto delito sexual contra niños, niñas y adolescentes",2018,3,8,7462,107.209863307424,4,3895,102.695763799743,4,3567,112.139052425007
25357,15,15176,81,"Tasa de exámenes médico legales por presunto delito sexual contra niños, niñas y adolescentes",2018,4,18,7954,226.301232084486,4,4213,94.944220270591,14,3741,374.231488906709
25358,15,15176,121,Tasa de exámenes médico legales por presunto delito sexual cuando la víctima está entre 18 y 28 años,2018,5,6,12620,47.5435816164818,2,6717,29.7751972606818,4,5903,67.7621548365238
25359,15,15183,81,"Tasa de exámenes médico legales por presunto delito sexual contra niños, niñas y adolescentes",2018,3,1,1262,79.2393026941363,1,666,150.15015015015,0,596,0
25360,15,15185,81,"Tasa de exámenes médico legales por presunto delito sexual contra niños, niñas y adolescentes",2018,4,1,511,195.694716242661,0,282,0,1,229,436.681222707424
25361,15,15204,81,"Tasa de exámenes médico legales por presunto delito sexual contra niños, niñas y adolescentes",2018,4,4,1126,355.239786856128,2,624,320.51282051282,2,502,398.406374501992
25362,15,15212,81,"Tasa de exámenes médico legales por presunto delito sexual contra niños, niñas y adolescentes",2018,4,1,368,271.739130434783,0,203,0,1,165,606.060606060606
25363,15,15215,81,"Tasa de exámenes médico legales por presunto delito sexual contra niños, niñas y adolescentes",2018,3,1,206,485.436893203883,1,102,980.392156862745,0,104,0
25364,15,15218,121,Tasa de exámenes médico legales por presunto delito sexual cuando la víctima está entre 18 y 28 años,2018,5,1,448,223.214285714286,0,247,0,1,201,497.512437810945
25365,15,15223,81,"Tasa de exámenes médico legales por presunto delito sexual contra niños, niñas y adolescentes",2018,2,1,730,136.986301369863,0,374,0,1,356,280.898876404494
25366,15,15223,81,"Tasa de exámenes médico legales por presunto delito sexual contra niños, niñas y adolescentes",2018,3,1,865,115.606936416185,0,450,0,1,415,240.963855421687
25367,15,15224,81,"Tasa de exámenes médico legales por presunto delito sexual contra niños, niñas y adolescentes",2018,3,1,560,178.571428571429,0,296,0,1,264,378.787878787879
25368,15,15224,81,"Tasa de exámenes médico legales por presunto delito sexual contra niños, niñas y adolescentes",2018,4,2,554,361.01083032491,0,303,0,2,251,796.812749003984
25369,15,15236,81,"Tasa de exámenes médico legales por presunto delito sexual contra niños, niñas y adolescentes",2018,3,1,198,505.050505050505,0,107,0,1,91,1098.9010989011
25370,15,15236,81,"Tasa de exámenes médico legales por presunto delito sexual contra niños, niñas y adolescentes",2018,4,1,190,526.315789473684,0,105,0,1,85,1176.47058823529
25371,15,15238,81,"Tasa de exámenes médico legales por presunto delito sexual contra niños, niñas y adolescentes",2018,2,13,8878,146.429375985582,2,4528,44.1696113074205,11,4350,252.873563218391
25372,15,15238,81,"Tasa de exámenes médico legales por presunto delito sexual contra niños, niñas y adolescentes",2018,3,28,11361,246.457178065311,3,5660,53.0035335689046,25,5701,438.519557972286
25373,15,15238,81,"Tasa de exámenes médico legales por presunto delito sexual contra niños, niñas y adolescentes",2018,4,37,12265,301.671422747656,2,5955,33.5852225020991,35,6310,554.675118858954
25374,15,15238,121,Tasa de exámenes médico legales por presunto delito sexual cuando la víctima está entre 18 y 28 años,2018,5,16,19711,81.1729491147075,2,9663,20.697505950533,14,10048,139.331210191083
25375,15,15276,81,"Tasa de exámenes médico legales por presunto delito sexual contra niños, niñas y adolescentes",2018,3,2,415,481.927710843374,0,213,0,2,202,990.09900990099
25376,15,15276,81,"Tasa de exámenes médico legales por presunto delito sexual contra niños, niñas y adolescentes",2018,4,1,413,242.130750605327,0,214,0,1,199,502.51256281407
25377,15,15293,81,"Tasa de exámenes médico legales por presunto delito sexual contra niños, niñas y adolescentes",2018,2,1,220,454.545454545455,1,114,877.19298245614,0,106,0
25378,15,15293,81,"Tasa de exámenes médico legales por presunto delito sexual contra niños, niñas y adolescentes",2018,3,2,270,740.740740740741,0,142,0,2,128,1562.5
25379,15,15293,81,"Tasa de exámenes médico legales por presunto delito sexual contra niños, niñas y adolescentes",2018,4,1,250,400,0,134,0,1,116,862.068965517241
25380,15,15296,81,"Tasa de exámenes médico legales por presunto delito sexual contra niños, niñas y adolescentes",2018,2,1,420,238.095238095238,0,214,0,1,206,485.436893203883
25381,15,15299,81,"Tasa de exámenes médico legales por presunto delito sexual contra niños, niñas y adolescentes",2018,3,6,1859,322.754168908015,0,934,0,6,925,648.648648648649
25382,15,15299,81,"Tasa de exámenes médico legales por presunto delito sexual contra niños, niñas y adolescentes",2018,4,4,1868,214.132762312634,2,929,215.285252960172,2,939,212.992545260916
25383,15,15322,81,"Tasa de exámenes médico legales por presunto delito sexual contra niños, niñas y adolescentes",2018,3,3,852,352.112676056338,0,457,0,3,395,759.493670886076
25384,15,15322,81,"Tasa de exámenes médico legales por presunto delito sexual contra niños, niñas y adolescentes",2018,4,1,875,114.285714285714,0,474,0,1,401,249.376558603491
25385,15,15325,81,"Tasa de exámenes médico legales por presunto delito sexual contra niños, niñas y adolescentes",2018,4,1,353,283.28611898017,0,192,0,1,161,621.11801242236
25386,15,15332,81,"Tasa de exámenes médico legales por presunto delito sexual contra niños, niñas y adolescentes",2018,4,1,918,108.932461873638,0,458,0,1,460,217.391304347826
25387,15,15367,81,"Tasa de exámenes médico legales por presunto delito sexual contra niños, niñas y adolescentes",2018,3,2,834,239.808153477218,0,432,0,2,402,497.512437810945
25388,15,15367,81,"Tasa de exámenes médico legales por presunto delito sexual contra niños, niñas y adolescentes",2018,4,3,792,378.787878787879,0,404,0,3,388,773.19587628866
25389,15,15367,121,Tasa de exámenes médico legales por presunto delito sexual cuando la víctima está entre 18 y 28 años,2018,5,1,1186,84.3170320404722,0,606,0,1,580,172.413793103448
25390,15,15368,81,"Tasa de exámenes médico legales por presunto delito sexual contra niños, niñas y adolescentes",2018,4,1,383,261.096605744125,1,204,490.196078431373,0,179,0
25391,15,15377,81,"Tasa de exámenes médico legales por presunto delito sexual contra niños, niñas y adolescentes",2018,4,1,421,237.529691211401,0,226,0,1,195,512.820512820513
25392,15,15407,81,"Tasa de exámenes médico legales por presunto delito sexual contra niños, niñas y adolescentes",2018,2,1,1347,74.2390497401633,0,696,0,1,651,153.609831029186
25393,15,15407,81,"Tasa de exámenes médico legales por presunto delito sexual contra niños, niñas y adolescentes",2018,3,8,1695,471.976401179941,1,898,111.358574610245,7,797,878.293601003764
25394,15,15407,81,"Tasa de exámenes médico legales por presunto delito sexual contra niños, niñas y adolescentes",2018,4,7,1828,382.932166301969,0,992,0,7,836,837.320574162679
25395,15,15466,81,"Tasa de exámenes médico legales por presunto delito sexual contra niños, niñas y adolescentes",2018,2,1,444,225.225225225225,0,225,0,1,219,456.62100456621
25396,15,15466,81,"Tasa de exámenes médico legales por presunto delito sexual contra niños, niñas y adolescentes",2018,3,3,537,558.659217877095,1,264,378.787878787879,2,273,732.600732600733
25397,15,15469,81,"Tasa de exámenes médico legales por presunto delito sexual contra niños, niñas y adolescentes",2018,2,1,1792,55.8035714285714,1,923,108.342361863489,0,869,0
25398,15,15469,81,"Tasa de exámenes médico legales por presunto delito sexual contra niños, niñas y adolescentes",2018,3,6,2138,280.636108512629,0,1101,0,6,1037,578.592092574735
25399,15,15469,81,"Tasa de exámenes médico legales por presunto delito sexual contra niños, niñas y adolescentes",2018,4,2,2046,97.7517106549365,1,1052,95.0570342205323,1,994,100.603621730382
25400,15,15476,81,"Tasa de exámenes médico legales por presunto delito sexual contra niños, niñas y adolescentes",2018,2,1,738,135.50135501355,0,383,0,1,355,281.69014084507
25401,15,15476,81,"Tasa de exámenes médico legales por presunto delito sexual contra niños, niñas y adolescentes",2018,3,2,911,219.53896816685,0,480,0,2,431,464.037122969838
25402,15,15476,81,"Tasa de exámenes médico legales por presunto delito sexual contra niños, niñas y adolescentes",2018,4,1,840,119.047619047619,0,449,0,1,391,255.754475703325
25403,15,15476,121,Tasa de exámenes médico legales por presunto delito sexual cuando la víctima está entre 18 y 28 años,2018,5,1,1245,80.3212851405623,0,662,0,1,583,171.526586620926
25404,15,15491,81,"Tasa de exámenes médico legales por presunto delito sexual contra niños, niñas y adolescentes",2018,3,4,1791,223.338916806253,1,931,107.411385606874,3,860,348.837209302326
25405,15,15491,81,"Tasa de exámenes médico legales por presunto delito sexual contra niños, niñas y adolescentes",2018,4,3,1891,158.646218931782,0,975,0,3,916,327.510917030568
25406,15,15491,121,Tasa de exámenes médico legales por presunto delito sexual cuando la víctima está entre 18 y 28 años,2018,5,2,2838,70.4721634954193,0,1513,0,2,1325,150.943396226415
25407,15,15494,81,"Tasa de exámenes médico legales por presunto delito sexual contra niños, niñas y adolescentes",2018,2,1,598,167.224080267559,0,302,0,1,296,337.837837837838
25408,15,15494,81,"Tasa de exámenes médico legales por presunto delito sexual contra niños, niñas y adolescentes",2018,4,1,709,141.043723554302,0,353,0,1,356,280.898876404494
25409,15,15494,121,Tasa de exámenes médico legales por presunto delito sexual cuando la víctima está entre 18 y 28 años,2018,5,1,968,103.305785123967,0,488,0,1,480,208.333333333333
25410,15,15500,81,"Tasa de exámenes médico legales por presunto delito sexual contra niños, niñas y adolescentes",2018,3,2,336,595.238095238095,1,174,574.712643678161,1,162,617.283950617284
25411,15,15511,81,"Tasa de exámenes médico legales por presunto delito sexual contra niños, niñas y adolescentes",2018,3,1,229,436.681222707424,0,118,0,1,111,900.900900900901
25412,15,15511,81,"Tasa de exámenes médico legales por presunto delito sexual contra niños, niñas y adolescentes",2018,4,2,226,884.955752212389,1,119,840.336134453781,1,107,934.579439252336
25413,15,15514,81,"Tasa de exámenes médico legales por presunto delito sexual contra niños, niñas y adolescentes",2018,2,1,275,363.636363636364,0,140,0,1,135,740.740740740741
25414,15,15516,81,"Tasa de exámenes médico legales por presunto delito sexual contra niños, niñas y adolescentes",2018,3,5,3210,155.763239875389,0,1640,0,5,1570,318.471337579618
25415,15,15516,81,"Tasa de exámenes médico legales por presunto delito sexual contra niños, niñas y adolescentes",2018,4,4,3299,121.248863291907,0,1689,0,4,1610,248.447204968944
25416,15,15516,121,Tasa de exámenes médico legales por presunto delito sexual cuando la víctima está entre 18 y 28 años,2018,5,1,5267,18.9861401177141,0,2684,0,1,2583,38.7146728610143
25417,15,15531,81,"Tasa de exámenes médico legales por presunto delito sexual contra niños, niñas y adolescentes",2018,4,3,1238,242.32633279483,0,683,0,3,555,540.540540540541
25418,15,15533,81,"Tasa de exámenes médico legales por presunto delito sexual contra niños, niñas y adolescentes",2018,4,1,209,478.468899521531,1,120,833.333333333333,0,89,0
25419,15,15537,81,"Tasa de exámenes médico legales por presunto delito sexual contra niños, niñas y adolescentes",2018,3,1,478,209.205020920502,0,241,0,1,237,421.940928270042
25420,15,15537,81,"Tasa de exámenes médico legales por presunto delito sexual contra niños, niñas y adolescentes",2018,4,1,496,201.612903225806,0,252,0,1,244,409.83606557377
25421,15,15542,81,"Tasa de exámenes médico legales por presunto delito sexual contra niños, niñas y adolescentes",2018,3,1,780,128.205128205128,0,410,0,1,370,270.27027027027
25422,15,15542,81,"Tasa de exámenes médico legales por presunto delito sexual contra niños, niñas y adolescentes",2018,4,1,781,128.040973111396,0,415,0,1,366,273.224043715847
25423,15,15550,81,"Tasa de exámenes médico legales por presunto delito sexual contra niños, niñas y adolescentes",2018,4,3,107,2803.73831775701,0,62,0,3,45,6666.66666666667
25424,15,15572,81,"Tasa de exámenes médico legales por presunto delito sexual contra niños, niñas y adolescentes",2018,2,6,4844,123.864574731627,2,2488,80.3858520900322,4,2356,169.779286926995
25425,15,15572,81,"Tasa de exámenes médico legales por presunto delito sexual contra niños, niñas y adolescentes",2018,3,12,6307,190.264785159347,2,3214,62.2277535780958,10,3093,323.310701584222
25426,15,15572,81,"Tasa de exámenes médico legales por presunto delito sexual contra niños, niñas y adolescentes",2018,4,16,6455,247.869868319132,2,3308,60.459492140266,14,3147,444.868128376231
25427,15,15572,121,Tasa de exámenes médico legales por presunto delito sexual cuando la víctima está entre 18 y 28 años,2018,5,3,9595,31.2662845231892,1,5156,19.3948797517455,2,4439,45.0551926109484
25428,15,15599,81,"Tasa de exámenes médico legales por presunto delito sexual contra niños, niñas y adolescentes",2018,3,1,1116,89.6057347670251,0,565,0,1,551,181.488203266788
25429,15,15599,81,"Tasa de exámenes médico legales por presunto delito sexual contra niños, niñas y adolescentes",2018,4,2,1117,179.05102954342,0,577,0,2,540,370.37037037037
25430,15,15600,81,"Tasa de exámenes médico legales por presunto delito sexual contra niños, niñas y adolescentes",2018,3,1,1973,50.6842372022301,0,1066,0,1,907,110.253583241455
25431,15,15600,81,"Tasa de exámenes médico legales por presunto delito sexual contra niños, niñas y adolescentes",2018,4,1,2097,47.6871721506915,0,1161,0,1,936,106.837606837607
25432,15,15621,81,"Tasa de exámenes médico legales por presunto delito sexual contra niños, niñas y adolescentes",2018,3,3,276,1086.95652173913,2,147,1360.54421768707,1,129,775.193798449612
25433,15,15632,81,"Tasa de exámenes médico legales por presunto delito sexual contra niños, niñas y adolescentes",2018,4,2,1337,149.588631264024,0,717,0,2,620,322.58064516129
25434,15,15638,81,"Tasa de exámenes médico legales por presunto delito sexual contra niños, niñas y adolescentes",2018,4,1,456,219.298245614035,0,234,0,1,222,450.45045045045
25435,15,15646,81,"Tasa de exámenes médico legales por presunto delito sexual contra niños, niñas y adolescentes",2018,2,1,2075,48.1927710843373,0,1071,0,1,1004,99.601593625498
25436,15,15646,81,"Tasa de exámenes médico legales por presunto delito sexual contra niños, niñas y adolescentes",2018,3,6,2586,232.018561484919,2,1343,148.920327624721,4,1243,321.802091713596
25437,15,15646,81,"Tasa de exámenes médico legales por presunto delito sexual contra niños, niñas y adolescentes",2018,4,6,2516,238.473767885533,2,1320,151.515151515152,4,1196,334.448160535117
25438,15,15664,81,"Tasa de exámenes médico legales por presunto delito sexual contra niños, niñas y adolescentes",2018,4,1,500,200,0,277,0,1,223,448.430493273543
25439,15,15667,81,"Tasa de exámenes médico legales por presunto delito sexual contra niños, niñas y adolescentes",2018,4,1,502,199.203187250996,0,263,0,1,239,418.410041841004
25440,15,15673,81,"Tasa de exámenes médico legales por presunto delito sexual contra niños, niñas y adolescentes",2018,3,1,360,277.777777777778,1,185,540.540540540541,0,175,0
25441,15,15681,81,"Tasa de exámenes médico legales por presunto delito sexual contra niños, niñas y adolescentes",2018,3,1,1162,86.0585197934596,1,612,163.398692810458,0,550,0
25442,15,15686,81,"Tasa de exámenes médico legales por presunto delito sexual contra niños, niñas y adolescentes",2018,3,1,871,114.810562571757,1,458,218.340611353712,0,413,0
25443,15,15690,81,"Tasa de exámenes médico legales por presunto delito sexual contra niños, niñas y adolescentes",2018,4,1,408,245.098039215686,0,211,0,1,197,507.614213197969
25444,15,15693,81,"Tasa de exámenes médico legales por presunto delito sexual contra niños, niñas y adolescentes",2018,3,4,996,401.606425702811,1,474,210.970464135021,3,522,574.712643678161
25445,15,15693,81,"Tasa de exámenes médico legales por presunto delito sexual contra niños, niñas y adolescentes",2018,4,3,1315,228.136882129278,0,758,0,3,557,538.599640933573
25446,15,15693,121,Tasa de exámenes médico legales por presunto delito sexual cuando la víctima está entre 18 y 28 años,2018,5,1,2871,34.8310693138279,0,1820,0,1,1051,95.1474785918173
25447,15,15696,81,"Tasa de exámenes médico legales por presunto delito sexual contra niños, niñas y adolescentes",2018,3,1,273,366.300366300366,0,141,0,1,132,757.575757575758
25448,15,15740,81,"Tasa de exámenes médico legales por presunto delito sexual contra niños, niñas y adolescentes",2018,3,1,1089,91.8273645546373,0,565,0,1,524,190.839694656489
25449,15,15740,81,"Tasa de exámenes médico legales por presunto delito sexual contra niños, niñas y adolescentes",2018,4,2,993,201.409869083585,0,520,0,2,473,422.832980972516
25450,15,15740,121,Tasa de exámenes médico legales por presunto delito sexual cuando la víctima está entre 18 y 28 años,2018,5,2,1548,129.198966408269,0,849,0,2,699,286.123032904149
25451,15,15757,81,"Tasa de exámenes médico legales por presunto delito sexual contra niños, niñas y adolescentes",2018,3,1,782,127.877237851662,0,412,0,1,370,270.27027027027
25452,15,15757,81,"Tasa de exámenes médico legales por presunto delito sexual contra niños, niñas y adolescentes",2018,4,1,757,132.100396301189,0,406,0,1,351,284.900284900285
25453,15,15759,81,"Tasa de exámenes médico legales por presunto delito sexual contra niños, niñas y adolescentes",2018,2,5,7903,63.2671137542705,0,3976,0,5,3927,127.323656735421
25454,15,15759,81,"Tasa de exámenes médico legales por presunto delito sexual contra niños, niñas y adolescentes",2018,3,7,10612,65.9630606860158,0,5296,0,7,5316,131.677953348382
25455,15,15759,81,"Tasa de exámenes médico legales por presunto delito sexual contra niños, niñas y adolescentes",2018,4,14,11449,122.28142195825,1,5722,17.4764068507515,13,5727,226.994936266806
25456,15,15759,121,Tasa de exámenes médico legales por presunto delito sexual cuando la víctima está entre 18 y 28 años,2018,5,6,18553,32.3397833234517,0,9448,0,6,9105,65.8978583196046
25457,15,15763,81,"Tasa de exámenes médico legales por presunto delito sexual contra niños, niñas y adolescentes",2018,3,2,953,209.863588667366,0,477,0,2,476,420.168067226891
25458,15,15763,81,"Tasa de exámenes médico legales por presunto delito sexual contra niños, niñas y adolescentes",2018,4,3,921,325.732899022801,1,463,215.982721382289,2,458,436.681222707424
25459,15,15764,81,"Tasa de exámenes médico legales por presunto delito sexual contra niños, niñas y adolescentes",2018,4,1,568,176.056338028169,0,295,0,1,273,366.300366300366
25460,15,15764,121,Tasa de exámenes médico legales por presunto delito sexual cuando la víctima está entre 18 y 28 años,2018,5,1,847,118.063754427391,0,438,0,1,409,244.498777506112
25461,15,15776,81,"Tasa de exámenes médico legales por presunto delito sexual contra niños, niñas y adolescentes",2018,3,7,587,1192.50425894378,0,306,0,7,281,2491.10320284697
25462,15,15778,81,"Tasa de exámenes médico legales por presunto delito sexual contra niños, niñas y adolescentes",2018,3,1,343,291.545189504373,0,168,0,1,175,571.428571428571
25463,15,15790,81,"Tasa de exámenes médico legales por presunto delito sexual contra niños, niñas y adolescentes",2018,3,2,709,282.087447108604,0,364,0,2,345,579.710144927536
25464,15,15790,81,"Tasa de exámenes médico legales por presunto delito sexual contra niños, niñas y adolescentes",2018,4,1,685,145.985401459854,0,349,0,1,336,297.619047619048
25465,15,15804,81,"Tasa de exámenes médico legales por presunto delito sexual contra niños, niñas y adolescentes",2018,4,4,907,441.014332965821,1,476,210.084033613445,3,431,696.055684454756
25466,15,15804,121,Tasa de exámenes médico legales por presunto delito sexual cuando la víctima está entre 18 y 28 años,2018,5,1,1421,70.3729767769177,0,788,0,1,633,157.977883096366
25467,15,15806,81,"Tasa de exámenes médico legales por presunto delito sexual contra niños, niñas y adolescentes",2018,2,2,1201,166.527893422148,1,616,162.337662337662,1,585,170.940170940171
25468,15,15806,81,"Tasa de exámenes médico legales por presunto delito sexual contra niños, niñas y adolescentes",2018,3,4,1554,257.400257400257,0,804,0,4,750,533.333333333333
25469,15,15806,81,"Tasa de exámenes médico legales por presunto delito sexual contra niños, niñas y adolescentes",2018,4,3,1598,187.734668335419,1,831,120.336943441637,2,767,260.756192959583
25470,15,15814,81,"Tasa de exámenes médico legales por presunto delito sexual contra niños, niñas y adolescentes",2018,3,1,1175,85.1063829787234,0,615,0,1,560,178.571428571429
25471,15,15814,81,"Tasa de exámenes médico legales por presunto delito sexual contra niños, niñas y adolescentes",2018,4,2,1137,175.901495162709,0,602,0,2,535,373.831775700935
25472,15,15816,81,"Tasa de exámenes médico legales por presunto delito sexual contra niños, niñas y adolescentes",2018,3,1,577,173.310225303293,0,304,0,1,273,366.300366300366
25473,15,15820,81,"Tasa de exámenes médico legales por presunto delito sexual contra niños, niñas y adolescentes",2018,3,2,387,516.795865633075,0,193,0,2,194,1030.92783505155
25474,15,15820,81,"Tasa de exámenes médico legales por presunto delito sexual contra niños, niñas y adolescentes",2018,4,1,396,252.525252525253,0,193,0,1,203,492.610837438424
25475,15,15832,81,"Tasa de exámenes médico legales por presunto delito sexual contra niños, niñas y adolescentes",2018,3,2,206,970.873786407767,1,109,917.431192660551,1,97,1030.92783505155
25476,15,15835,81,"Tasa de exámenes médico legales por presunto delito sexual contra niños, niñas y adolescentes",2018,3,1,618,161.812297734628,0,322,0,1,296,337.837837837838
25477,15,15837,81,"Tasa de exámenes médico legales por presunto delito sexual contra niños, niñas y adolescentes",2018,2,1,877,114.025085518814,0,458,0,1,419,238.663484486874
25478,15,15837,81,"Tasa de exámenes médico legales por presunto delito sexual contra niños, niñas y adolescentes",2018,4,2,1025,195.121951219512,0,532,0,2,493,405.679513184584
25479,15,15837,121,Tasa de exámenes médico legales por presunto delito sexual cuando la víctima está entre 18 y 28 años,2018,5,1,1581,63.2511068943707,0,866,0,1,715,139.86013986014
25480,15,15839,81,"Tasa de exámenes médico legales por presunto delito sexual contra niños, niñas y adolescentes",2018,4,1,137,729.92700729927,0,77,0,1,60,1666.66666666667
25481,15,15861,81,"Tasa de exámenes médico legales por presunto delito sexual contra niños, niñas y adolescentes",2018,2,2,1515,132.013201320132,1,776,128.865979381443,1,739,135.31799729364
25482,15,15861,81,"Tasa de exámenes médico legales por presunto delito sexual contra niños, niñas y adolescentes",2018,3,3,1842,162.866449511401,0,940,0,3,902,332.594235033259
25483,15,15861,81,"Tasa de exámenes médico legales por presunto delito sexual contra niños, niñas y adolescentes",2018,4,4,1847,216.567406605306,1,928,107.758620689655,3,919,326.441784548422
25484,15,15879,81,"Tasa de exámenes médico legales por presunto delito sexual contra niños, niñas y adolescentes",2018,4,1,335,298.507462686567,0,191,0,1,144,694.444444444444
25485,17,17001,81,"Tasa de exámenes médico legales por presunto delito sexual contra niños, niñas y adolescentes",2018,2,38,24944,152.341244387428,10,12747,78.4498313328626,28,12197,229.564647044355
25486,17,17001,81,"Tasa de exámenes médico legales por presunto delito sexual contra niños, niñas y adolescentes",2018,3,96,31813,301.763430044321,16,16226,98.6071736718846,80,15587,513.248219670238
25487,17,17001,81,"Tasa de exámenes médico legales por presunto delito sexual contra niños, niñas y adolescentes",2018,4,104,34331,302.933209053042,10,17396,57.4844791906185,94,16935,555.063478004133
25488,17,17001,121,Tasa de exámenes médico legales por presunto delito sexual cuando la víctima está entre 18 y 28 años,2018,5,24,70579,34.0044489153998,4,36476,10.9661147055598,20,34103,58.6458669325279
25489,17,17013,81,"Tasa de exámenes médico legales por presunto delito sexual contra niños, niñas y adolescentes",2018,4,1,2166,46.1680517082179,0,1107,0,1,1059,94.4287063267233
25490,17,17042,81,"Tasa de exámenes médico legales por presunto delito sexual contra niños, niñas y adolescentes",2018,2,6,2667,224.971878515186,1,1363,73.3675715333822,5,1304,383.435582822086
25491,17,17042,81,"Tasa de exámenes médico legales por presunto delito sexual contra niños, niñas y adolescentes",2018,3,13,3316,392.038600723764,6,1659,361.663652802893,7,1657,422.450211225106
25492,17,17042,81,"Tasa de exámenes médico legales por presunto delito sexual contra niños, niñas y adolescentes",2018,4,9,3160,284.810126582278,0,1553,0,9,1607,560.049782202863
25493,17,17042,121,Tasa de exámenes médico legales por presunto delito sexual cuando la víctima está entre 18 y 28 años,2018,5,2,5222,38.2995021064726,1,2610,38.3141762452107,1,2612,38.2848392036753
25494,17,17050,81,"Tasa de exámenes médico legales por presunto delito sexual contra niños, niñas y adolescentes",2018,2,1,1009,99.1080277502478,1,514,194.552529182879,0,495,0
25495,17,17050,81,"Tasa de exámenes médico legales por presunto delito sexual contra niños, niñas y adolescentes",2018,3,2,1229,162.73393002441,1,629,158.982511923688,1,600,166.666666666667
25496,17,17050,81,"Tasa de exámenes médico legales por presunto delito sexual contra niños, niñas y adolescentes",2018,4,2,1139,175.592625109745,0,584,0,2,555,360.36036036036
25497,17,17088,81,"Tasa de exámenes médico legales por presunto delito sexual contra niños, niñas y adolescentes",2018,4,1,1060,94.3396226415094,0,562,0,1,498,200.803212851406
25498,17,17088,121,Tasa de exámenes médico legales por presunto delito sexual cuando la víctima está entre 18 y 28 años,2018,5,1,1826,54.7645125958379,0,952,0,1,874,114.41647597254
25499,17,17174,81,"Tasa de exámenes médico legales por presunto delito sexual contra niños, niñas y adolescentes",2018,2,4,4233,94.4956295771321,0,2163,0,4,2070,193.236714975845
25500,17,17174,81,"Tasa de exámenes médico legales por presunto delito sexual contra niños, niñas y adolescentes",2018,3,9,5217,172.512938470385,3,2652,113.122171945701,6,2565,233.918128654971
25501,17,17174,81,"Tasa de exámenes médico legales por presunto delito sexual contra niños, niñas y adolescentes",2018,4,15,5171,290.079288338813,2,2603,76.8344218209758,13,2568,506.230529595016
25502,17,17174,121,Tasa de exámenes médico legales por presunto delito sexual cuando la víctima está entre 18 y 28 años,2018,5,1,8940,11.1856823266219,0,4413,0,1,4527,22.0896841175171
25503,17,17272,81,"Tasa de exámenes médico legales por presunto delito sexual contra niños, niñas y adolescentes",2018,3,1,1155,86.5800865800866,0,596,0,1,559,178.890876565295
25504,17,17272,81,"Tasa de exámenes médico legales por presunto delito sexual contra niños, niñas y adolescentes",2018,4,2,1081,185.013876040703,0,559,0,2,522,383.141762452107
25505,17,17380,81,"Tasa de exámenes médico legales por presunto delito sexual contra niños, niñas y adolescentes",2018,2,3,6943,43.2089874693936,0,3552,0,3,3391,88.4694780300796
25506,17,17380,81,"Tasa de exámenes médico legales por presunto delito sexual contra niños, niñas y adolescentes",2018,3,11,8219,133.836233118384,4,4196,95.3288846520496,7,4023,173.999502858563
25507,17,17380,81,"Tasa de exámenes médico legales por presunto delito sexual contra niños, niñas y adolescentes",2018,4,20,7916,252.652854977261,2,4025,49.6894409937888,18,3891,462.60601387818
25508,17,17380,121,Tasa de exámenes médico legales por presunto delito sexual cuando la víctima está entre 18 y 28 años,2018,5,8,14241,56.1758303489923,0,7342,0,8,6899,115.958834613712
25509,17,17388,81,"Tasa de exámenes médico legales por presunto delito sexual contra niños, niñas y adolescentes",2018,3,2,542,369.0036900369,2,278,719.424460431655,0,264,0
25510,17,17388,81,"Tasa de exámenes médico legales por presunto delito sexual contra niños, niñas y adolescentes",2018,4,3,512,585.9375,0,264,0,3,248,1209.67741935484
25511,17,17433,81,"Tasa de exámenes médico legales por presunto delito sexual contra niños, niñas y adolescentes",2018,4,1,2383,41.9639110365086,1,1231,81.2347684809098,0,1152,0
25512,17,17442,81,"Tasa de exámenes médico legales por presunto delito sexual contra niños, niñas y adolescentes",2018,3,3,1120,267.857142857143,0,571,0,3,549,546.448087431694
25513,17,17442,121,Tasa de exámenes médico legales por presunto delito sexual cuando la víctima está entre 18 y 28 años,2018,5,2,1807,110.680686220255,0,952,0,2,855,233.918128654971
25514,17,17444,81,"Tasa de exámenes médico legales por presunto delito sexual contra niños, niñas y adolescentes",2018,3,1,1807,55.3403431101273,1,944,105.932203389831,0,863,0
25515,17,17486,81,"Tasa de exámenes médico legales por presunto delito sexual contra niños, niñas y adolescentes",2018,2,6,3211,186.857676736219,2,1651,121.138703815869,4,1560,256.410256410256
25516,17,17486,81,"Tasa de exámenes médico legales por presunto delito sexual contra niños, niñas y adolescentes",2018,3,8,3891,205.602672834747,4,2015,198.511166253102,4,1876,213.219616204691
25517,17,17486,81,"Tasa de exámenes médico legales por presunto delito sexual contra niños, niñas y adolescentes",2018,4,4,3590,111.42061281337,0,1862,0,4,1728,231.481481481481
25518,17,17486,121,Tasa de exámenes médico legales por presunto delito sexual cuando la víctima está entre 18 y 28 años,2018,5,1,5517,18.1257930034439,0,2952,0,1,2565,38.9863547758285
25519,17,17495,81,"Tasa de exámenes médico legales por presunto delito sexual contra niños, niñas y adolescentes",2018,3,1,781,128.040973111396,1,409,244.498777506112,0,372,0
25520,17,17495,81,"Tasa de exámenes médico legales por presunto delito sexual contra niños, niñas y adolescentes",2018,4,1,767,130.378096479791,0,414,0,1,353,283.28611898017
25521,17,17524,81,"Tasa de exámenes médico legales por presunto delito sexual contra niños, niñas y adolescentes",2018,2,1,1607,62.2277535780958,0,824,0,1,783,127.713920817369
25522,17,17524,81,"Tasa de exámenes médico legales por presunto delito sexual contra niños, niñas y adolescentes",2018,3,3,1991,150.678051230537,1,1027,97.3709834469328,2,964,207.46887966805
25523,17,17524,81,"Tasa de exámenes médico legales por presunto delito sexual contra niños, niñas y adolescentes",2018,4,4,1901,210.415570752236,0,989,0,4,912,438.59649122807
25524,17,17524,121,Tasa de exámenes médico legales por presunto delito sexual cuando la víctima está entre 18 y 28 años,2018,5,1,3197,31.2793243665937,0,1672,0,1,1525,65.5737704918033
25525,17,17541,81,"Tasa de exámenes médico legales por presunto delito sexual contra niños, niñas y adolescentes",2018,3,3,2948,101.763907734057,1,1512,66.1375661375661,2,1436,139.275766016713
25526,17,17541,81,"Tasa de exámenes médico legales por presunto delito sexual contra niños, niñas y adolescentes",2018,4,1,2685,37.243947858473,1,1394,71.7360114777618,0,1291,0
25527,17,17614,81,"Tasa de exámenes médico legales por presunto delito sexual contra niños, niñas y adolescentes",2018,2,2,5260,38.0228136882129,1,2698,37.0644922164566,1,2562,39.032006245121
25528,17,17614,81,"Tasa de exámenes médico legales por presunto delito sexual contra niños, niñas y adolescentes",2018,3,10,6175,161.943319838057,0,3182,0,10,2993,334.112930170398
25529,17,17614,81,"Tasa de exámenes médico legales por presunto delito sexual contra niños, niñas y adolescentes",2018,4,5,5858,85.3533629224992,1,3043,32.8623069339468,4,2815,142.095914742451
25530,17,17616,81,"Tasa de exámenes médico legales por presunto delito sexual contra niños, niñas y adolescentes",2018,2,2,848,235.849056603774,2,440,454.545454545455,0,408,0
25531,17,17616,81,"Tasa de exámenes médico legales por presunto delito sexual contra niños, niñas y adolescentes",2018,4,3,1006,298.210735586481,0,545,0,3,461,650.759219088937
25532,17,17653,81,"Tasa de exámenes médico legales por presunto delito sexual contra niños, niñas y adolescentes",2018,3,5,1821,274.574409665019,1,939,106.496272630458,4,882,453.514739229025
25533,17,17653,81,"Tasa de exámenes médico legales por presunto delito sexual contra niños, niñas y adolescentes",2018,4,4,1732,230.94688221709,1,907,110.253583241455,3,825,363.636363636364
25534,17,17662,81,"Tasa de exámenes médico legales por presunto delito sexual contra niños, niñas y adolescentes",2018,3,3,2850,105.263157894737,2,1472,135.869565217391,1,1378,72.5689404934688
25535,17,17662,81,"Tasa de exámenes médico legales por presunto delito sexual contra niños, niñas y adolescentes",2018,4,3,2660,112.781954887218,0,1412,0,3,1248,240.384615384615
25536,17,17665,81,"Tasa de exámenes médico legales por presunto delito sexual contra niños, niñas y adolescentes",2018,2,1,700,142.857142857143,1,358,279.329608938547,0,342,0
25537,17,17665,81,"Tasa de exámenes médico legales por presunto delito sexual contra niños, niñas y adolescentes",2018,3,4,833,480.192076830732,1,425,235.294117647059,3,408,735.294117647059
25538,17,17665,81,"Tasa de exámenes médico legales por presunto delito sexual contra niños, niñas y adolescentes",2018,4,1,773,129.366106080207,0,393,0,1,380,263.157894736842
25539,17,17777,81,"Tasa de exámenes médico legales por presunto delito sexual contra niños, niñas y adolescentes",2018,2,1,2375,42.1052631578947,0,1213,0,1,1162,86.0585197934596
25540,17,17777,81,"Tasa de exámenes médico legales por presunto delito sexual contra niños, niñas y adolescentes",2018,3,7,2879,243.13997915943,0,1465,0,7,1414,495.049504950495
25541,17,17777,81,"Tasa de exámenes médico legales por presunto delito sexual contra niños, niñas y adolescentes",2018,4,4,2730,146.520146520147,0,1379,0,4,1351,296.076980014804
25542,17,17777,121,Tasa de exámenes médico legales por presunto delito sexual cuando la víctima está entre 18 y 28 años,2018,5,1,4826,20.7210940737671,0,2434,0,1,2392,41.8060200668896
25543,17,17867,81,"Tasa de exámenes médico legales por presunto delito sexual contra niños, niñas y adolescentes",2018,3,1,824,121.359223300971,1,421,237.529691211401,0,403,0
25544,17,17867,121,Tasa de exámenes médico legales por presunto delito sexual cuando la víctima está entre 18 y 28 años,2018,5,1,1443,69.3000693000693,0,737,0,1,706,141.643059490085
25545,17,17873,81,"Tasa de exámenes médico legales por presunto delito sexual contra niños, niñas y adolescentes",2018,2,5,4556,109.745390693591,1,2351,42.5350914504466,4,2205,181.40589569161
25546,17,17873,81,"Tasa de exámenes médico legales por presunto delito sexual contra niños, niñas y adolescentes",2018,3,7,5609,124.799429488322,1,2899,34.494653328734,6,2710,221.40221402214
25547,17,17873,81,"Tasa de exámenes médico legales por presunto delito sexual contra niños, niñas y adolescentes",2018,4,18,5573,322.985824511035,2,2869,69.710700592541,16,2704,591.715976331361
25548,17,17873,121,Tasa de exámenes médico legales por presunto delito sexual cuando la víctima está entre 18 y 28 años,2018,5,1,10733,9.31705953601043,0,5413,0,1,5320,18.796992481203
25549,17,17877,81,"Tasa de exámenes médico legales por presunto delito sexual contra niños, niñas y adolescentes",2018,2,1,1146,87.260034904014,0,590,0,1,556,179.856115107914
25550,17,17877,81,"Tasa de exámenes médico legales por presunto delito sexual contra niños, niñas y adolescentes",2018,3,3,1345,223.048327137546,0,696,0,3,649,462.249614791988
25551,18,18001,81,"Tasa de exámenes médico legales por presunto delito sexual contra niños, niñas y adolescentes",2018,2,15,16934,88.5791897956773,8,8539,93.6877854549713,7,8395,83.382966051221
25552,18,18001,81,"Tasa de exámenes médico legales por presunto delito sexual contra niños, niñas y adolescentes",2018,3,44,20193,217.897291140494,2,10146,19.712201852947,42,10047,418.035234398328
25553,18,18001,81,"Tasa de exámenes médico legales por presunto delito sexual contra niños, niñas y adolescentes",2018,4,60,20718,289.603243556328,5,10528,47.4924012158055,55,10190,539.744847890088
25554,18,18001,121,Tasa de exámenes médico legales por presunto delito sexual cuando la víctima está entre 18 y 28 años,2018,5,20,36604,54.6388372855426,0,18659,0,20,17945,111.45165784341
25555,18,18094,81,"Tasa de exámenes médico legales por presunto delito sexual contra niños, niñas y adolescentes",2018,2,1,1583,63.1711939355654,0,802,0,1,781,128.040973111396
25556,18,18094,81,"Tasa de exámenes médico legales por presunto delito sexual contra niños, niñas y adolescentes",2018,3,2,1767,113.186191284663,0,878,0,2,889,224.971878515186
25557,18,18094,81,"Tasa de exámenes médico legales por presunto delito sexual contra niños, niñas y adolescentes",2018,4,4,1598,250.312891113892,2,769,260.078023407022,2,829,241.254523522316
25558,18,18150,81,"Tasa de exámenes médico legales por presunto delito sexual contra niños, niñas y adolescentes",2018,2,4,4535,88.2028665931643,1,2324,43.0292598967298,3,2211,135.685210312076
25559,18,18150,81,"Tasa de exámenes médico legales por presunto delito sexual contra niños, niñas y adolescentes",2018,3,28,5044,555.114988104679,8,2589,308.999613750483,20,2455,814.663951120163
25560,18,18150,81,"Tasa de exámenes médico legales por presunto delito sexual contra niños, niñas y adolescentes",2018,4,13,4700,276.595744680851,1,2366,42.2654268808115,12,2334,514.13881748072
25561,18,18150,121,Tasa de exámenes médico legales por presunto delito sexual cuando la víctima está entre 18 y 28 años,2018,5,1,6796,14.7145379635079,0,3319,0,1,3477,28.7604256542997
25562,18,18205,81,"Tasa de exámenes médico legales por presunto delito sexual contra niños, niñas y adolescentes",2018,4,1,1489,67.1591672263264,0,762,0,1,727,137.551581843191
25563,18,18247,81,"Tasa de exámenes médico legales por presunto delito sexual contra niños, niñas y adolescentes",2018,3,5,2664,187.687687687688,0,1368,0,5,1296,385.802469135802
25564,18,18247,81,"Tasa de exámenes médico legales por presunto delito sexual contra niños, niñas y adolescentes",2018,4,4,2602,153.727901614143,0,1340,0,4,1262,316.957210776545
25565,18,18247,121,Tasa de exámenes médico legales por presunto delito sexual cuando la víctima está entre 18 y 28 años,2018,5,1,4537,22.0409962530306,0,2306,0,1,2231,44.8229493500672
25566,18,18256,81,"Tasa de exámenes médico legales por presunto delito sexual contra niños, niñas y adolescentes",2018,3,7,2937,238.338440585632,0,1514,0,7,1423,491.918482080112
25567,18,18256,81,"Tasa de exámenes médico legales por presunto delito sexual contra niños, niñas y adolescentes",2018,4,4,2795,143.112701252236,1,1386,72.1500721500721,3,1409,212.91696238467
25568,18,18410,81,"Tasa de exámenes médico legales por presunto delito sexual contra niños, niñas y adolescentes",2018,4,5,3193,156.592546194801,0,1646,0,5,1547,323.206205559147
25569,18,18410,121,Tasa de exámenes médico legales por presunto delito sexual cuando la víctima está entre 18 y 28 años,2018,5,1,4977,20.0924251557163,0,2565,0,1,2412,41.4593698175788
25570,18,18460,81,"Tasa de exámenes médico legales por presunto delito sexual contra niños, niñas y adolescentes",2018,4,2,1572,127.226463104326,0,795,0,2,777,257.400257400257
25571,18,18479,81,"Tasa de exámenes médico legales por presunto delito sexual contra niños, niñas y adolescentes",2018,3,1,520,192.307692307692,0,263,0,1,257,389.105058365759
25572,18,18479,81,"Tasa de exámenes médico legales por presunto delito sexual contra niños, niñas y adolescentes",2018,4,1,500,200,0,256,0,1,244,409.83606557377
25573,18,18592,81,"Tasa de exámenes médico legales por presunto delito sexual contra niños, niñas y adolescentes",2018,2,2,3960,50.5050505050505,0,2034,0,2,1926,103.842159916926
25574,18,18592,81,"Tasa de exámenes médico legales por presunto delito sexual contra niños, niñas y adolescentes",2018,3,9,4501,199.955565429904,0,2314,0,9,2187,411.522633744856
25575,18,18592,81,"Tasa de exámenes médico legales por presunto delito sexual contra niños, niñas y adolescentes",2018,4,6,4304,139.405204460967,1,2220,45.045045045045,5,2084,239.923224568138
25576,18,18610,81,"Tasa de exámenes médico legales por presunto delito sexual contra niños, niñas y adolescentes",2018,2,1,1767,56.5930956423316,0,912,0,1,855,116.959064327485
25577,18,18610,81,"Tasa de exámenes médico legales por presunto delito sexual contra niños, niñas y adolescentes",2018,3,2,2013,99.3541977148535,0,1044,0,2,969,206.398348813209
25578,18,18610,81,"Tasa de exámenes médico legales por presunto delito sexual contra niños, niñas y adolescentes",2018,4,4,1929,207.361327112494,0,1010,0,4,919,435.25571273123
25579,18,18610,121,Tasa de exámenes médico legales por presunto delito sexual cuando la víctima está entre 18 y 28 años,2018,5,1,3159,31.6555872111428,0,1650,0,1,1509,66.2690523525514
25580,18,18753,81,"Tasa de exámenes médico legales por presunto delito sexual contra niños, niñas y adolescentes",2018,2,7,8336,83.9731285988484,1,4266,23.441162681669,6,4070,147.420147420147
25581,18,18753,81,"Tasa de exámenes médico legales por presunto delito sexual contra niños, niñas y adolescentes",2018,3,16,9453,169.258436475193,3,4816,62.2923588039867,13,4637,280.353676946301
25582,18,18753,81,"Tasa de exámenes médico legales por presunto delito sexual contra niños, niñas y adolescentes",2018,4,26,9077,286.438250523301,1,4594,21.767522855899,25,4483,557.662279723399
25583,18,18753,121,Tasa de exámenes médico legales por presunto delito sexual cuando la víctima está entre 18 y 28 años,2018,5,10,14680,68.1198910081744,2,7625,26.2295081967213,8,7055,113.394755492558
25584,18,18756,81,"Tasa de exámenes médico legales por presunto delito sexual contra niños, niñas y adolescentes",2018,4,2,3177,62.9524708844822,0,1617,0,2,1560,128.205128205128
25585,18,18785,81,"Tasa de exámenes médico legales por presunto delito sexual contra niños, niñas y adolescentes",2018,2,2,1059,188.857412653447,0,544,0,2,515,388.349514563107
25586,18,18785,81,"Tasa de exámenes médico legales por presunto delito sexual contra niños, niñas y adolescentes",2018,3,2,1202,166.389351081531,0,616,0,2,586,341.296928327645
25587,18,18785,81,"Tasa de exámenes médico legales por presunto delito sexual contra niños, niñas y adolescentes",2018,4,6,1159,517.687661777394,0,598,0,6,561,1069.51871657754
25588,18,18860,81,"Tasa de exámenes médico legales por presunto delito sexual contra niños, niñas y adolescentes",2018,3,1,1548,64.5994832041344,0,795,0,1,753,132.802124833997
25589,19,19001,81,"Tasa de exámenes médico legales por presunto delito sexual contra niños, niñas y adolescentes",2018,2,30,18318,163.773337700622,9,9296,96.815834767642,21,9022,232.764353801818
25590,19,19001,81,"Tasa de exámenes médico legales por presunto delito sexual contra niños, niñas y adolescentes",2018,3,67,22787,294.027296265415,12,11606,103.394795795278,55,11181,491.905911814686
25591,19,19001,81,"Tasa de exámenes médico legales por presunto delito sexual contra niños, niñas y adolescentes",2018,4,108,25268,427.418078201678,11,12856,85.5631611698818,97,12412,781.501772478247
25592,19,19001,121,Tasa de exámenes médico legales por presunto delito sexual cuando la víctima está entre 18 y 28 años,2018,5,31,51675,59.9903241412675,1,26040,3.84024577572965,30,25635,117.027501462844
25593,19,19022,81,"Tasa de exámenes médico legales por presunto delito sexual contra niños, niñas y adolescentes",2018,4,1,2246,44.5235975066785,0,1166,0,1,1080,92.5925925925926
25594,19,19050,81,"Tasa de exámenes médico legales por presunto delito sexual contra niños, niñas y adolescentes",2018,3,2,3046,65.6598818122127,0,1516,0,2,1530,130.718954248366
25595,19,19050,81,"Tasa de exámenes médico legales por presunto delito sexual contra niños, niñas y adolescentes",2018,4,3,2992,100.267379679144,0,1491,0,3,1501,199.866755496336
25596,19,19050,121,Tasa de exámenes médico legales por presunto delito sexual cuando la víctima está entre 18 y 28 años,2018,5,1,5420,18.450184501845,0,2718,0,1,2702,37.0096225018505
25597,19,19075,81,"Tasa de exámenes médico legales por presunto delito sexual contra niños, niñas y adolescentes",2018,3,1,2926,34.1763499658237,0,1523,0,1,1403,71.2758374910905
25598,19,19075,81,"Tasa de exámenes médico legales por presunto delito sexual contra niños, niñas y adolescentes",2018,4,2,2943,67.9578661230037,0,1537,0,2,1406,142.247510668563
25599,19,19110,81,"Tasa de exámenes médico legales por presunto delito sexual contra niños, niñas y adolescentes",2018,3,4,3627,110.283981251723,2,1850,108.108108108108,2,1777,112.549240292628
25600,19,19110,81,"Tasa de exámenes médico legales por presunto delito sexual contra niños, niñas y adolescentes",2018,4,3,3799,78.9681495130297,0,1935,0,3,1864,160.944206008584
25601,19,19110,121,Tasa de exámenes médico legales por presunto delito sexual cuando la víctima está entre 18 y 28 años,2018,5,1,6968,14.3513203214696,0,3601,0,1,3367,29.7000297000297
25602,19,19130,81,"Tasa de exámenes médico legales por presunto delito sexual contra niños, niñas y adolescentes",2018,3,4,4468,89.5255147717099,0,2314,0,4,2154,185.701021355617
25603,19,19130,81,"Tasa de exámenes médico legales por presunto delito sexual contra niños, niñas y adolescentes",2018,4,2,4374,45.7247370827618,0,2340,0,2,2034,98.3284169124877
25604,19,19130,121,Tasa de exámenes médico legales por presunto delito sexual cuando la víctima está entre 18 y 28 años,2018,5,1,7616,13.1302521008403,0,4152,0,1,3464,28.8683602771363
25605,19,19137,81,"Tasa de exámenes médico legales por presunto delito sexual contra niños, niñas y adolescentes",2018,2,1,4009,24.9438762783737,0,2025,0,1,1984,50.4032258064516
25606,19,19137,81,"Tasa de exámenes médico legales por presunto delito sexual contra niños, niñas y adolescentes",2018,3,2,4204,47.5737392959087,0,2116,0,2,2088,95.7854406130268
25607,19,19137,81,"Tasa de exámenes médico legales por presunto delito sexual contra niños, niñas y adolescentes",2018,4,1,4131,24.2072137496974,0,2095,0,1,2036,49.1159135559921
25608,19,19142,81,"Tasa de exámenes médico legales por presunto delito sexual contra niños, niñas y adolescentes",2018,2,1,1489,67.1591672263264,0,755,0,1,734,136.239782016349
25609,19,19142,81,"Tasa de exámenes médico legales por presunto delito sexual contra niños, niñas y adolescentes",2018,3,3,1743,172.117039586919,0,878,0,3,865,346.820809248555
25610,19,19212,81,"Tasa de exámenes médico legales por presunto delito sexual contra niños, niñas y adolescentes",2018,2,3,3218,93.2256059664388,0,1638,0,3,1580,189.873417721519
25611,19,19212,81,"Tasa de exámenes médico legales por presunto delito sexual contra niños, niñas y adolescentes",2018,4,5,3667,136.351240796291,0,1873,0,5,1794,278.706800445931
25612,19,19212,121,Tasa de exámenes médico legales por presunto delito sexual cuando la víctima está entre 18 y 28 años,2018,5,1,7082,14.120304998588,0,3719,0,1,3363,29.7353553374963
25613,19,19256,121,Tasa de exámenes médico legales por presunto delito sexual cuando la víctima está entre 18 y 28 años,2018,5,1,7942,12.591286829514,0,4155,0,1,3787,26.4061262212833
25614,19,19300,81,"Tasa de exámenes médico legales por presunto delito sexual contra niños, niñas y adolescentes",2018,3,1,2395,41.7536534446764,0,1197,0,1,1198,83.4724540901503
25615,19,19300,81,"Tasa de exámenes médico legales por presunto delito sexual contra niños, niñas y adolescentes",2018,4,4,2337,171.159606332905,1,1139,87.7963125548727,3,1198,250.417362270451
25616,19,19300,121,Tasa de exámenes médico legales por presunto delito sexual cuando la víctima está entre 18 y 28 años,2018,5,1,4086,24.4738130200685,0,1999,0,1,2087,47.9156684235745
25617,19,19355,81,"Tasa de exámenes médico legales por presunto delito sexual contra niños, niñas y adolescentes",2018,2,1,4103,24.3724104313917,0,2082,0,1,2021,49.480455220188
25618,19,19364,81,"Tasa de exámenes médico legales por presunto delito sexual contra niños, niñas y adolescentes",2018,4,1,2381,41.9991600167997,0,1196,0,1,1185,84.3881856540084
25619,19,19392,81,"Tasa de exámenes médico legales por presunto delito sexual contra niños, niñas y adolescentes",2018,4,2,948,210.970464135021,0,499,0,2,449,445.43429844098
25620,19,19397,81,"Tasa de exámenes médico legales por presunto delito sexual contra niños, niñas y adolescentes",2018,4,1,5026,19.8965380023876,0,2546,0,1,2480,40.3225806451613
25621,19,19418,81,"Tasa de exámenes médico legales por presunto delito sexual contra niños, niñas y adolescentes",2018,4,1,2703,36.9959304476508,0,1348,0,1,1355,73.8007380073801
25622,19,19450,81,"Tasa de exámenes médico legales por presunto delito sexual contra niños, niñas y adolescentes",2018,3,1,1880,53.1914893617021,0,958,0,1,922,108.459869848156
25623,19,19455,81,"Tasa de exámenes médico legales por presunto delito sexual contra niños, niñas y adolescentes",2018,3,3,4989,60.1322910402886,0,2519,0,3,2470,121.457489878543
25624,19,19455,81,"Tasa de exámenes médico legales por presunto delito sexual contra niños, niñas y adolescentes",2018,4,8,5010,159.680638722555,0,2556,0,8,2454,325.99837000815
25625,19,19473,81,"Tasa de exámenes médico legales por presunto delito sexual contra niños, niñas y adolescentes",2018,3,1,3010,33.2225913621262,0,1554,0,1,1456,68.6813186813187
25626,19,19473,81,"Tasa de exámenes médico legales por presunto delito sexual contra niños, niñas y adolescentes",2018,4,2,3006,66.5335994677312,0,1556,0,2,1450,137.931034482759
25627,19,19513,81,"Tasa de exámenes médico legales por presunto delito sexual contra niños, niñas y adolescentes",2018,3,2,838,238.663484486874,0,425,0,2,413,484.261501210654
25628,19,19513,81,"Tasa de exámenes médico legales por presunto delito sexual contra niños, niñas y adolescentes",2018,4,1,849,117.785630153121,0,425,0,1,424,235.849056603774
25629,19,19517,81,"Tasa de exámenes médico legales por presunto delito sexual contra niños, niñas y adolescentes",2018,3,1,4786,20.8942749686586,0,2466,0,1,2320,43.1034482758621
25630,19,19517,81,"Tasa de exámenes médico legales por presunto delito sexual contra niños, niñas y adolescentes",2018,4,3,4621,64.9210127677992,0,2397,0,3,2224,134.892086330935
25631,19,19532,81,"Tasa de exámenes médico legales por presunto delito sexual contra niños, niñas y adolescentes",2018,2,3,3661,81.9448238186288,0,1882,0,3,1779,168.634064080944
25632,19,19532,81,"Tasa de exámenes médico legales por presunto delito sexual contra niños, niñas y adolescentes",2018,3,4,4051,98.7410515921995,0,2107,0,4,1944,205.761316872428
25633,19,19532,81,"Tasa de exámenes médico legales por presunto delito sexual contra niños, niñas y adolescentes",2018,4,5,4247,117.730162467624,0,2226,0,5,2021,247.40227610094
25634,19,19533,81,"Tasa de exámenes médico legales por presunto delito sexual contra niños, niñas y adolescentes",2018,4,1,900,111.111111111111,0,477,0,1,423,236.406619385343
25635,19,19548,81,"Tasa de exámenes médico legales por presunto delito sexual contra niños, niñas y adolescentes",2018,3,1,4719,21.1909302818394,0,2413,0,1,2306,43.3651344319167
25636,19,19548,81,"Tasa de exámenes médico legales por presunto delito sexual contra niños, niñas y adolescentes",2018,4,2,4815,41.5368639667705,0,2468,0,2,2347,85.2151682999574
25637,19,19548,121,Tasa de exámenes médico legales por presunto delito sexual cuando la víctima está entre 18 y 28 años,2018,5,1,9102,10.98659635245,0,4605,0,1,4497,22.237046920169
25638,19,19573,81,"Tasa de exámenes médico legales por presunto delito sexual contra niños, niñas y adolescentes",2018,2,3,3888,77.1604938271605,0,1983,0,3,1905,157.48031496063
25639,19,19573,81,"Tasa de exámenes médico legales por presunto delito sexual contra niños, niñas y adolescentes",2018,3,6,4517,132.831525348683,0,2303,0,6,2214,271.0027100271
25640,19,19573,81,"Tasa de exámenes médico legales por presunto delito sexual contra niños, niñas y adolescentes",2018,4,3,4755,63.0914826498423,0,2410,0,3,2345,127.931769722815
25641,19,19573,121,Tasa de exámenes médico legales por presunto delito sexual cuando la víctima está entre 18 y 28 años,2018,5,4,9506,42.0786871449611,0,4813,0,4,4693,85.2333262305561
25642,19,19585,81,"Tasa de exámenes médico legales por presunto delito sexual contra niños, niñas y adolescentes",2018,2,1,1594,62.7352572145546,0,809,0,1,785,127.388535031847
25643,19,19585,81,"Tasa de exámenes médico legales por presunto delito sexual contra niños, niñas y adolescentes",2018,3,3,1670,179.640718562874,0,853,0,3,817,367.197062423501
25644,19,19585,81,"Tasa de exámenes médico legales por presunto delito sexual contra niños, niñas y adolescentes",2018,4,3,1692,177.304964539007,0,878,0,3,814,368.550368550369
25645,19,19585,121,Tasa de exámenes médico legales por presunto delito sexual cuando la víctima está entre 18 y 28 años,2018,5,1,3361,29.753049687593,0,1766,0,1,1595,62.6959247648903
25646,19,19622,81,"Tasa de exámenes médico legales por presunto delito sexual contra niños, niñas y adolescentes",2018,3,2,1249,160.128102481986,0,638,0,2,611,327.332242225859
25647,19,19622,121,Tasa de exámenes médico legales por presunto delito sexual cuando la víctima está entre 18 y 28 años,2018,5,1,2459,40.6669377795852,0,1306,0,1,1153,86.7302688638335
25648,19,19698,81,"Tasa de exámenes médico legales por presunto delito sexual contra niños, niñas y adolescentes",2018,3,11,9667,113.789179683459,1,4865,20.5549845837616,10,4802,208.246563931695
25649,19,19698,81,"Tasa de exámenes médico legales por presunto delito sexual contra niños, niñas y adolescentes",2018,4,9,10180,88.4086444007859,0,5216,0,9,4964,181.305398871878
25650,19,19698,121,Tasa de exámenes médico legales por presunto delito sexual cuando la víctima está entre 18 y 28 años,2018,5,6,19940,30.0902708124373,0,9930,0,6,10010,59.9400599400599
25651,19,19701,81,"Tasa de exámenes médico legales por presunto delito sexual contra niños, niñas y adolescentes",2018,2,1,1220,81.9672131147541,0,627,0,1,593,168.634064080944
25652,19,19743,81,"Tasa de exámenes médico legales por presunto delito sexual contra niños, niñas y adolescentes",2018,3,2,3622,55.2181115405853,0,1856,0,2,1766,113.250283125708
25653,19,19760,81,"Tasa de exámenes médico legales por presunto delito sexual contra niños, niñas y adolescentes",2018,4,5,1729,289.184499710815,0,897,0,5,832,600.961538461538
25654,19,19760,121,Tasa de exámenes médico legales por presunto delito sexual cuando la víctima está entre 18 y 28 años,2018,5,1,3406,29.3599530240752,0,1782,0,1,1624,61.576354679803
25655,19,19780,81,"Tasa de exámenes médico legales por presunto delito sexual contra niños, niñas y adolescentes",2018,3,3,2215,135.440180586907,0,1128,0,3,1087,275.988960441582
25656,19,19780,81,"Tasa de exámenes médico legales por presunto delito sexual contra niños, niñas y adolescentes",2018,4,4,2242,178.412132024978,0,1164,0,4,1078,371.057513914657
25657,19,19780,121,Tasa de exámenes médico legales por presunto delito sexual cuando la víctima está entre 18 y 28 años,2018,5,1,3808,26.2605042016807,0,2034,0,1,1774,56.369785794814
25658,19,19785,81,"Tasa de exámenes médico legales por presunto delito sexual contra niños, niñas y adolescentes",2018,3,1,852,117.370892018779,0,437,0,1,415,240.963855421687
25659,19,19807,81,"Tasa de exámenes médico legales por presunto delito sexual contra niños, niñas y adolescentes",2018,2,2,2684,74.5156482861401,0,1381,0,2,1303,153.491941673062
25660,19,19807,81,"Tasa de exámenes médico legales por presunto delito sexual contra niños, niñas y adolescentes",2018,3,8,3185,251.177394034537,2,1662,120.336943441637,6,1523,393.959290873276
25661,19,19807,81,"Tasa de exámenes médico legales por presunto delito sexual contra niños, niñas y adolescentes",2018,4,6,3271,183.430143686946,1,1732,57.7367205542725,5,1539,324.88628979857
25662,19,19809,81,"Tasa de exámenes médico legales por presunto delito sexual contra niños, niñas y adolescentes",2018,3,2,3103,64.4537544311956,1,1602,62.4219725343321,1,1501,66.6222518321119
25663,19,19809,81,"Tasa de exámenes médico legales por presunto delito sexual contra niños, niñas y adolescentes",2018,4,2,2986,66.9792364367046,0,1532,0,2,1454,137.551581843191
25664,19,19821,81,"Tasa de exámenes médico legales por presunto delito sexual contra niños, niñas y adolescentes",2018,3,2,3746,53.3902829684997,0,1910,0,2,1836,108.932461873638
25665,19,19824,81,"Tasa de exámenes médico legales por presunto delito sexual contra niños, niñas y adolescentes",2018,3,2,2621,76.3067531476536,1,1341,74.5712155108128,1,1280,78125
25666,19,19845,81,"Tasa de exámenes médico legales por presunto delito sexual contra niños, niñas y adolescentes",2018,2,1,1598,62.5782227784731,1,815,122.699386503067,0,783,0
25667,19,19845,81,"Tasa de exámenes médico legales por presunto delito sexual contra niños, niñas y adolescentes",2018,3,3,1879,159.659393294305,1,955,104.712041884817,2,924,216.450216450216
25668,19,19845,81,"Tasa de exámenes médico legales por presunto delito sexual contra niños, niñas y adolescentes",2018,4,1,1953,51.2032770097286,0,995,0,1,958,104.384133611691
25669,19,19845,121,Tasa de exámenes médico legales por presunto delito sexual cuando la víctima está entre 18 y 28 años,2018,5,2,3390,58.9970501474926,0,1720,0,2,1670,119.760479041916
25670,20,20001,81,"Tasa de exámenes médico legales por presunto delito sexual contra niños, niñas y adolescentes",2018,2,45,45167,99.6302610312839,9,23016,39.1032325338895,36,22151,162.520879418536
25671,20,20001,81,"Tasa de exámenes médico legales por presunto delito sexual contra niños, niñas y adolescentes",2018,3,94,55011,170.874915925906,19,27797,68.3526999316473,75,27214,275.593444550599
25672,20,20001,81,"Tasa de exámenes médico legales por presunto delito sexual contra niños, niñas y adolescentes",2018,4,140,56421,248.134559827015,11,28639,38.409162331087,129,27782,464.329421927867
25673,20,20001,121,Tasa de exámenes médico legales por presunto delito sexual cuando la víctima está entre 18 y 28 años,2018,5,35,96835,36.1439562141788,1,49249,2.03049808117931,34,47586,71.4495860126928
25674,20,20001,81,"Tasa de exámenes médico legales por presunto delito sexual contra niños, niñas y adolescentes",2018,1,3,9051,33.1455087835598,0,4647,0,3,4404,68.1198910081744
25675,20,20011,81,"Tasa de exámenes médico legales por presunto delito sexual contra niños, niñas y adolescentes",2018,2,9,9689,92.8888430178553,1,4928,20.2922077922078,8,4761,168.031926065953
25676,20,20011,81,"Tasa de exámenes médico legales por presunto delito sexual contra niños, niñas y adolescentes",2018,3,25,11458,218.188165473905,2,5829,34.3112026076514,23,5629,408.59833007639
25677,20,20011,81,"Tasa de exámenes médico legales por presunto delito sexual contra niños, niñas y adolescentes",2018,4,22,11116,197.912918315941,1,5619,17.7967609894999,21,5497,382.026559941786
25678,20,20011,121,Tasa de exámenes médico legales por presunto delito sexual cuando la víctima está entre 18 y 28 años,2018,5,3,19321,15.5271466280213,0,9560,0,3,9761,30.7345558856675
25679,20,20013,81,"Tasa de exámenes médico legales por presunto delito sexual contra niños, niñas y adolescentes",2018,2,1,5585,17.905102954342,0,2856,0,1,2729,36.6434591425431
25680,20,20013,81,"Tasa de exámenes médico legales por presunto delito sexual contra niños, niñas y adolescentes",2018,3,14,6540,214.067278287462,4,3349,119.438638399522,10,3191,313.381385145722
25681,20,20013,81,"Tasa de exámenes médico legales por presunto delito sexual contra niños, niñas y adolescentes",2018,4,9,6233,144.392748275309,0,3199,0,9,3034,296.63810151615
25682,20,20013,121,Tasa de exámenes médico legales por presunto delito sexual cuando la víctima está entre 18 y 28 años,2018,5,2,9802,20.40399918384,1,5028,19.8886237072395,1,4774,20.9467951403435
25683,20,20032,81,"Tasa de exámenes médico legales por presunto delito sexual contra niños, niñas y adolescentes",2018,3,2,2890,69.2041522491349,0,1512,0,2,1378,145.137880986938
25684,20,20032,81,"Tasa de exámenes médico legales por presunto delito sexual contra niños, niñas y adolescentes",2018,4,1,2515,39.7614314115308,0,1325,0,1,1190,84.0336134453782
25685,20,20045,81,"Tasa de exámenes médico legales por presunto delito sexual contra niños, niñas y adolescentes",2018,2,1,1620,61.7283950617284,0,845,0,1,775,129.032258064516
25686,20,20045,81,"Tasa de exámenes médico legales por presunto delito sexual contra niños, niñas y adolescentes",2018,3,3,1750,171.428571428571,2,932,214.592274678112,1,818,122.249388753056
25687,20,20045,81,"Tasa de exámenes médico legales por presunto delito sexual contra niños, niñas y adolescentes",2018,4,1,1693,59.0667454223272,0,908,0,1,785,127.388535031847
25688,20,20060,81,"Tasa de exámenes médico legales por presunto delito sexual contra niños, niñas y adolescentes",2018,2,3,4708,63.7213254035684,1,2405,41.5800415800416,2,2303,86.8432479374729
25689,20,20060,81,"Tasa de exámenes médico legales por presunto delito sexual contra niños, niñas y adolescentes",2018,3,18,5475,328.767123287671,4,2816,142.045454545455,14,2659,526.513726965024
25690,20,20060,81,"Tasa de exámenes médico legales por presunto delito sexual contra niños, niñas y adolescentes",2018,4,16,5126,312.134217713617,1,2654,37.6789751318764,15,2472,606.796116504854
25691,20,20060,121,Tasa de exámenes médico legales por presunto delito sexual cuando la víctima está entre 18 y 28 años,2018,5,2,7690,26.0078023407022,0,3977,0,2,3713,53.8647993536224
25692,20,20175,81,"Tasa de exámenes médico legales por presunto delito sexual contra niños, niñas y adolescentes",2018,4,1,4015,24.906600249066,0,2176,0,1,1839,54.3773790103317
25693,20,20175,121,Tasa de exámenes médico legales por presunto delito sexual cuando la víctima está entre 18 y 28 años,2018,5,1,6077,16.4554879052164,1,3358,29.7796307325789,0,2719,0
25694,20,20178,81,"Tasa de exámenes médico legales por presunto delito sexual contra niños, niñas y adolescentes",2018,3,7,2553,274.18723070897,1,1309,76.3941940412529,6,1244,482.315112540193
25695,20,20178,81,"Tasa de exámenes médico legales por presunto delito sexual contra niños, niñas y adolescentes",2018,4,12,2378,504.625735912532,0,1220,0,12,1158,1036.26943005181
25696,20,20178,121,Tasa de exámenes médico legales por presunto delito sexual cuando la víctima está entre 18 y 28 años,2018,5,1,3643,27.4499039253363,0,1859,0,1,1784,56.0538116591928
25697,20,20228,81,"Tasa de exámenes médico legales por presunto delito sexual contra niños, niñas y adolescentes",2018,2,4,2683,149.086843086098,2,1370,145.985401459854,2,1313,152.322924600152
25698,20,20228,81,"Tasa de exámenes médico legales por presunto delito sexual contra niños, niñas y adolescentes",2018,3,8,3001,266.577807397534,1,1534,65.1890482398957,7,1467,477.164280845262
25699,20,20228,81,"Tasa de exámenes médico legales por presunto delito sexual contra niños, niñas y adolescentes",2018,4,17,2757,616.612259702575,0,1394,0,17,1363,1247.2487160675
25700,20,20228,121,Tasa de exámenes médico legales por presunto delito sexual cuando la víctima está entre 18 y 28 años,2018,5,1,4531,22.0701831825204,0,2246,0,1,2285,43.7636761487965
25701,20,20228,81,"Tasa de exámenes médico legales por presunto delito sexual contra niños, niñas y adolescentes",2018,1,1,547,182.815356489945,0,279,0,1,268,373.134328358209
25702,20,20238,81,"Tasa de exámenes médico legales por presunto delito sexual contra niños, niñas y adolescentes",2018,2,9,3192,281.954887218045,1,1633,61.2369871402327,8,1559,513.149454778704
25703,20,20238,81,"Tasa de exámenes médico legales por presunto delito sexual contra niños, niñas y adolescentes",2018,3,12,3541,338.887319966111,2,1809,110.558319513543,10,1732,577.367205542725
25704,20,20238,81,"Tasa de exámenes médico legales por presunto delito sexual contra niños, niñas y adolescentes",2018,4,20,3345,597.907324364724,0,1697,0,20,1648,1213.59223300971
25705,20,20238,121,Tasa de exámenes médico legales por presunto delito sexual cuando la víctima está entre 18 y 28 años,2018,5,2,5384,37.147102526003,0,2772,0,2,2612,76.5696784073507
25706,20,20250,81,"Tasa de exámenes médico legales por presunto delito sexual contra niños, niñas y adolescentes",2018,3,5,3234,154.60729746444,1,1664,60.0961538461538,4,1570,254.777070063694
25707,20,20250,81,"Tasa de exámenes médico legales por presunto delito sexual contra niños, niñas y adolescentes",2018,4,10,3061,326.690623979092,0,1553,0,10,1508,663.129973474801
25708,20,20250,121,Tasa de exámenes médico legales por presunto delito sexual cuando la víctima está entre 18 y 28 años,2018,5,1,4720,21.1864406779661,0,2359,0,1,2361,42.3549343498518
25709,20,20295,81,"Tasa de exámenes médico legales por presunto delito sexual contra niños, niñas y adolescentes",2018,3,1,1846,54.1711809317443,1,941,106.269925611052,0,905,0
25710,20,20295,81,"Tasa de exámenes médico legales por presunto delito sexual contra niños, niñas y adolescentes",2018,4,1,1843,54.2593597395551,1,942,106.157112526539,0,901,0
25711,20,20310,121,Tasa de exámenes médico legales por presunto delito sexual cuando la víctima está entre 18 y 28 años,2018,5,1,1243,80.450522928399,0,655,0,1,588,170.068027210884
25712,20,20383,81,"Tasa de exámenes médico legales por presunto delito sexual contra niños, niñas y adolescentes",2018,3,1,1614,61.9578686493185,0,844,0,1,770,129.87012987013
25713,20,20383,81,"Tasa de exámenes médico legales por presunto delito sexual contra niños, niñas y adolescentes",2018,4,1,1527,65.4878847413229,0,811,0,1,716,139.664804469274
25714,20,20383,121,Tasa de exámenes médico legales por presunto delito sexual cuando la víctima está entre 18 y 28 años,2018,5,1,2381,41.9991600167997,0,1244,0,1,1137,87.9507475813544
25715,20,20400,81,"Tasa de exámenes médico legales por presunto delito sexual contra niños, niñas y adolescentes",2018,2,4,2433,164.406083025072,1,1253,79.8084596967279,3,1180,254.237288135593
25716,20,20400,81,"Tasa de exámenes médico legales por presunto delito sexual contra niños, niñas y adolescentes",2018,3,6,2830,212.014134275618,2,1478,135.31799729364,4,1352,295.85798816568
25717,20,20400,81,"Tasa de exámenes médico legales por presunto delito sexual contra niños, niñas y adolescentes",2018,4,8,2670,299.625468164794,0,1421,0,8,1249,640.512409927942
25718,20,20400,121,Tasa de exámenes médico legales por presunto delito sexual cuando la víctima está entre 18 y 28 años,2018,5,3,4458,67.2947510094213,0,2371,0,3,2087,143.747005270724
25719,20,20443,81,"Tasa de exámenes médico legales por presunto delito sexual contra niños, niñas y adolescentes",2018,4,2,1976,101.214574898785,0,1023,0,2,953,209.863588667366
25720,20,20443,121,Tasa de exámenes médico legales por presunto delito sexual cuando la víctima está entre 18 y 28 años,2018,5,2,2953,67.7277345072807,1,1521,65.7462195923734,1,1432,69.8324022346369
25721,20,20517,81,"Tasa de exámenes médico legales por presunto delito sexual contra niños, niñas y adolescentes",2018,4,2,1984,100.806451612903,0,1002,0,2,982,203.665987780041
25722,20,20550,81,"Tasa de exámenes médico legales por presunto delito sexual contra niños, niñas y adolescentes",2018,2,1,2065,48.4261501210654,0,1054,0,1,1011,98.9119683481701
25723,20,20550,81,"Tasa de exámenes médico legales por presunto delito sexual contra niños, niñas y adolescentes",2018,3,1,2423,41.2711514651259,0,1237,0,1,1186,84.3170320404722
25724,20,20550,81,"Tasa de exámenes médico legales por presunto delito sexual contra niños, niñas y adolescentes",2018,4,1,2240,44.6428571428571,0,1144,0,1,1096,91.2408759124088
25725,20,20570,81,"Tasa de exámenes médico legales por presunto delito sexual contra niños, niñas y adolescentes",2018,3,3,3493,85.8860578299456,1,1831,54.6149645002731,2,1662,120.336943441637
25726,20,20570,81,"Tasa de exámenes médico legales por presunto delito sexual contra niños, niñas y adolescentes",2018,4,9,3360,267.857142857143,0,1786,0,9,1574,571.791613722999
25727,20,20614,81,"Tasa de exámenes médico legales por presunto delito sexual contra niños, niñas y adolescentes",2018,3,3,1443,207.900207900208,1,744,134.408602150538,2,699,286.123032904149
25728,20,20614,81,"Tasa de exámenes médico legales por presunto delito sexual contra niños, niñas y adolescentes",2018,4,1,1399,71.4796283059328,0,734,0,1,665,150.375939849624
25729,20,20621,81,"Tasa de exámenes médico legales por presunto delito sexual contra niños, niñas y adolescentes",2018,2,1,2573,38.8651379712398,1,1322,75.642965204236,0,1251,0
25730,20,20621,81,"Tasa de exámenes médico legales por presunto delito sexual contra niños, niñas y adolescentes",2018,3,6,2959,202.771206488679,1,1529,65.402223675605,5,1430,349.65034965035
25731,20,20621,81,"Tasa de exámenes médico legales por presunto delito sexual contra niños, niñas y adolescentes",2018,4,6,2916,205.761316872428,3,1504,199.468085106383,3,1412,212.464589235128
25732,20,20710,121,Tasa de exámenes médico legales por presunto delito sexual cuando la víctima está entre 18 y 28 años,2018,5,1,5442,18.3755972069092,0,2723,0,1,2719,36.7782272894447
25733,20,20750,81,"Tasa de exámenes médico legales por presunto delito sexual contra niños, niñas y adolescentes",2018,2,2,1407,142.146410803127,0,723,0,2,684,292.397660818713
25734,20,20750,81,"Tasa de exámenes médico legales por presunto delito sexual contra niños, niñas y adolescentes",2018,3,1,1718,58.2072176949942,0,899,0,1,819,122.100122100122
25735,20,20750,81,"Tasa de exámenes médico legales por presunto delito sexual contra niños, niñas y adolescentes",2018,4,3,1625,184.615384615385,0,862,0,3,763,393.184796854522
25736,20,20770,81,"Tasa de exámenes médico legales por presunto delito sexual contra niños, niñas y adolescentes",2018,2,1,2051,48.7567040468064,1,1060,94.3396226415094,0,991,0
25737,20,20770,81,"Tasa de exámenes médico legales por presunto delito sexual contra niños, niñas y adolescentes",2018,3,1,2269,44.0722785368004,0,1174,0,1,1095,91.324200913242
25738,20,20787,81,"Tasa de exámenes médico legales por presunto delito sexual contra niños, niñas y adolescentes",2018,3,2,1791,111.669458403127,0,938,0,2,853,234.466588511137
25739,20,20787,81,"Tasa de exámenes médico legales por presunto delito sexual contra niños, niñas y adolescentes",2018,4,2,1692,118.203309692671,1,897,111.482720178372,1,795,125.786163522013
25740,23,23001,81,"Tasa de exámenes médico legales por presunto delito sexual contra niños, niñas y adolescentes",2018,2,40,40257,99.3616017090196,3,20476,14.6512990818519,37,19781,187.048177544108
25741,23,23001,81,"Tasa de exámenes médico legales por presunto delito sexual contra niños, niñas y adolescentes",2018,3,80,49369,162.045008000972,18,24901,72.2862535641139,62,24468,253.39218571195
25742,23,23001,81,"Tasa de exámenes médico legales por presunto delito sexual contra niños, niñas y adolescentes",2018,4,109,49833,218.730560070636,11,24998,44.0035202816225,98,24835,394.604388967183
25743,23,23001,121,Tasa de exámenes médico legales por presunto delito sexual cuando la víctima está entre 18 y 28 años,2018,5,26,90838,28.622382703274,3,46046,6.51522390652825,23,44792,51.3484550812645
25744,23,23001,81,"Tasa de exámenes médico legales por presunto delito sexual contra niños, niñas y adolescentes",2018,1,1,8004,12.4937531234383,0,4080,0,1,3924,25.4841997961264
25745,23,23068,81,"Tasa de exámenes médico legales por presunto delito sexual contra niños, niñas y adolescentes",2018,2,1,6201,16.1264312207708,0,3190,0,1,3011,33.2115576220525
25746,23,23068,81,"Tasa de exámenes médico legales por presunto delito sexual contra niños, niñas y adolescentes",2018,3,1,6908,14.4759698899826,1,3624,27.5938189845475,0,3284,0
25747,23,23068,81,"Tasa de exámenes médico legales por presunto delito sexual contra niños, niñas y adolescentes",2018,4,3,6440,46.583850931677,0,3471,0,3,2969,101.044122600202
25748,23,23079,81,"Tasa de exámenes médico legales por presunto delito sexual contra niños, niñas y adolescentes",2018,2,1,2572,38.8802488335925,1,1323,75.5857898715042,0,1249,0
25749,23,23079,81,"Tasa de exámenes médico legales por presunto delito sexual contra niños, niñas y adolescentes",2018,4,2,2671,74.878322725571,0,1440,0,2,1231,162.46953696182
25750,23,23079,121,Tasa de exámenes médico legales por presunto delito sexual cuando la víctima está entre 18 y 28 años,2018,5,1,4617,21.6590859865714,0,2486,0,1,2131,46.9263256687001
25751,23,23090,81,"Tasa de exámenes médico legales por presunto delito sexual contra niños, niñas y adolescentes",2018,4,2,2595,77.0712909441233,0,1445,0,2,1150,173.913043478261
25752,23,23162,81,"Tasa de exámenes médico legales por presunto delito sexual contra niños, niñas y adolescentes",2018,2,3,8068,37.183936539415,1,4117,24.2895312120476,2,3951,50.6200961781827
25753,23,23162,81,"Tasa de exámenes médico legales por presunto delito sexual contra niños, niñas y adolescentes",2018,3,15,9773,153.484088816126,1,4919,20.329335230738,14,4854,288.421920065925
25754,23,23162,81,"Tasa de exámenes médico legales por presunto delito sexual contra niños, niñas y adolescentes",2018,4,17,9797,173.522506889864,1,4844,20.6440957886045,16,4953,323.036543508984
25755,23,23162,121,Tasa de exámenes médico legales por presunto delito sexual cuando la víctima está entre 18 y 28 años,2018,5,5,17916,27.9080151819603,0,8951,0,5,8965,55.7724484104852
25756,23,23168,81,"Tasa de exámenes médico legales por presunto delito sexual contra niños, niñas y adolescentes",2018,4,3,1696,176.88679245283,0,877,0,3,819,366.300366300366
25757,23,23182,81,"Tasa de exámenes médico legales por presunto delito sexual contra niños, niñas y adolescentes",2018,3,5,5122,97.6181179226865,1,2556,39.1236306729264,4,2566,155.884645362432
25758,23,23182,81,"Tasa de exámenes médico legales por presunto delito sexual contra niños, niñas y adolescentes",2018,4,7,4911,142.537161474241,0,2458,0,7,2453,285.364859355891
25759,23,23189,81,"Tasa de exámenes médico legales por presunto delito sexual contra niños, niñas y adolescentes",2018,2,1,6635,15.0715900527506,0,3410,0,1,3225,31.0077519379845
25760,23,23189,81,"Tasa de exámenes médico legales por presunto delito sexual contra niños, niñas y adolescentes",2018,3,3,7808,38.422131147541,0,4045,0,3,3763,79.7236247674728
25761,23,23189,81,"Tasa de exámenes médico legales por presunto delito sexual contra niños, niñas y adolescentes",2018,4,7,7551,92.702953251225,0,3902,0,7,3649,191.833379007947
25762,23,23189,121,Tasa de exámenes médico legales por presunto delito sexual cuando la víctima está entre 18 y 28 años,2018,5,2,13268,15.0738619234248,0,6874,0,2,6394,31.2793243665937
25763,23,23300,81,"Tasa de exámenes médico legales por presunto delito sexual contra niños, niñas y adolescentes",2018,2,1,1298,77.0416024653313,1,663,150.829562594268,0,635,0
25764,23,23300,81,"Tasa de exámenes médico legales por presunto delito sexual contra niños, niñas y adolescentes",2018,3,2,1474,135.685210312076,1,759,131.752305665349,1,715,139.86013986014
25765,23,23300,81,"Tasa de exámenes médico legales por presunto delito sexual contra niños, niñas y adolescentes",2018,4,2,1465,136.518771331058,0,752,0,2,713,280.504908835905
25766,23,23300,121,Tasa de exámenes médico legales por presunto delito sexual cuando la víctima está entre 18 y 28 años,2018,5,2,2851,70.1508242721852,0,1455,0,2,1396,143.266475644699
25767,23,23350,81,"Tasa de exámenes médico legales por presunto delito sexual contra niños, niñas y adolescentes",2018,2,3,1900,157.894736842105,1,968,103.305785123967,2,932,214.592274678112
25768,23,23350,81,"Tasa de exámenes médico legales por presunto delito sexual contra niños, niñas y adolescentes",2018,3,5,2119,235.960358659745,0,1068,0,5,1051,475.737392959087
25769,23,23350,81,"Tasa de exámenes médico legales por presunto delito sexual contra niños, niñas y adolescentes",2018,4,3,1985,151.133501259446,1,997,100.300902708124,2,988,202.429149797571
25770,23,23350,121,Tasa de exámenes médico legales por presunto delito sexual cuando la víctima está entre 18 y 28 años,2018,5,1,3301,30.2938503483793,0,1628,0,1,1673,59.7728631201434
25771,23,23417,81,"Tasa de exámenes médico legales por presunto delito sexual contra niños, niñas y adolescentes",2018,2,4,12016,33.288948069241,1,6144,16.2760416666667,3,5872,51.0899182561308
25772,23,23417,81,"Tasa de exámenes médico legales por presunto delito sexual contra niños, niñas y adolescentes",2018,3,10,14124,70.8014726706316,2,7267,27.5216733177377,8,6857,116.66909727286
25773,23,23417,81,"Tasa de exámenes médico legales por presunto delito sexual contra niños, niñas y adolescentes",2018,4,26,13346,194.814925820471,0,6818,0,26,6528,398.28431372549
25774,23,23417,121,Tasa de exámenes médico legales por presunto delito sexual cuando la víctima está entre 18 y 28 años,2018,5,4,23523,17.0046337627003,0,12008,0,4,11515,34.7372991749891
25775,23,23419,81,"Tasa de exámenes médico legales por presunto delito sexual contra niños, niñas y adolescentes",2018,3,1,3643,27.4499039253363,0,1864,0,1,1779,56.2113546936481
25776,23,23419,81,"Tasa de exámenes médico legales por presunto delito sexual contra niños, niñas y adolescentes",2018,4,3,3279,91.4913083257091,0,1686,0,3,1593,188.323917137476
25777,23,23464,81,"Tasa de exámenes médico legales por presunto delito sexual contra niños, niñas y adolescentes",2018,3,2,1687,118.5536455246,0,875,0,2,812,246.305418719212
25778,23,23464,81,"Tasa de exámenes médico legales por presunto delito sexual contra niños, niñas y adolescentes",2018,4,3,1625,184.615384615385,0,830,0,3,795,377.358490566038
25779,23,23466,81,"Tasa de exámenes médico legales por presunto delito sexual contra niños, niñas y adolescentes",2018,2,8,9397,85.1335532616793,2,4778,41.8585182084554,6,4619,129.898246373674
25780,23,23466,81,"Tasa de exámenes médico legales por presunto delito sexual contra niños, niñas y adolescentes",2018,3,23,10761,213.734783012731,5,5434,92.0132499079867,18,5327,337.901257743571
25781,23,23466,81,"Tasa de exámenes médico legales por presunto delito sexual contra niños, niñas y adolescentes",2018,4,34,10298,330.161196348806,2,5108,39.1542678151919,32,5190,616.570327552987
25782,23,23466,121,Tasa de exámenes médico legales por presunto delito sexual cuando la víctima está entre 18 y 28 años,2018,5,6,18086,33.1748313612739,0,8969,0,6,9117,65.8111220796315
25783,23,23466,81,"Tasa de exámenes médico legales por presunto delito sexual contra niños, niñas y adolescentes",2018,1,1,1941,51.5198351365276,0,988,0,1,953,104.931794333683
25784,23,23500,81,"Tasa de exámenes médico legales por presunto delito sexual contra niños, niñas y adolescentes",2018,2,4,3555,112.517580872011,3,1828,164.113785557987,1,1727,57.9038795599305
25785,23,23500,81,"Tasa de exámenes médico legales por presunto delito sexual contra niños, niñas y adolescentes",2018,3,2,3889,51.4271020827976,1,2010,49.7512437810945,1,1879,53.2197977647685
25786,23,23500,81,"Tasa de exámenes médico legales por presunto delito sexual contra niños, niñas y adolescentes",2018,4,6,3472,172.811059907834,0,1789,0,6,1683,356.50623885918
25787,23,23555,81,"Tasa de exámenes médico legales por presunto delito sexual contra niños, niñas y adolescentes",2018,2,5,6827,73.2386113959279,1,3486,28.6861732644865,4,3341,119.72463334331
25788,23,23555,81,"Tasa de exámenes médico legales por presunto delito sexual contra niños, niñas y adolescentes",2018,3,4,8065,49.5970241785493,1,4110,24.330900243309,3,3955,75.8533501896334
25789,23,23555,81,"Tasa de exámenes médico legales por presunto delito sexual contra niños, niñas y adolescentes",2018,4,16,7683,208.251984901731,2,3906,51.2032770097286,14,3777,370.664548583532
25790,23,23570,81,"Tasa de exámenes médico legales por presunto delito sexual contra niños, niñas y adolescentes",2018,3,3,5141,58.3544057576347,1,2645,37.8071833648393,2,2496,80.1282051282051
25791,23,23570,81,"Tasa de exámenes médico legales por presunto delito sexual contra niños, niñas y adolescentes",2018,4,3,4720,63.5593220338983,0,2438,0,3,2282,131.463628396144
25792,23,23574,81,"Tasa de exámenes médico legales por presunto delito sexual contra niños, niñas y adolescentes",2018,3,2,4267,46.8713381767049,0,2230,0,2,2037,98.1836033382425
25793,23,23574,81,"Tasa de exámenes médico legales por presunto delito sexual contra niños, niñas y adolescentes",2018,4,2,3846,52.0020800832033,0,2049,0,2,1797,111.296605453534
25794,23,23580,81,"Tasa de exámenes médico legales por presunto delito sexual contra niños, niñas y adolescentes",2018,3,2,7071,28.2845424975251,0,3651,0,2,3420,58.4795321637427
25795,23,23580,81,"Tasa de exámenes médico legales por presunto delito sexual contra niños, niñas y adolescentes",2018,4,1,6597,15.1584053357587,0,3406,0,1,3191,31.3381385145722
25796,23,23586,81,"Tasa de exámenes médico legales por presunto delito sexual contra niños, niñas y adolescentes",2018,2,1,1586,63.0517023959647,1,812,123.152709359606,0,774,0
25797,23,23586,81,"Tasa de exámenes médico legales por presunto delito sexual contra niños, niñas y adolescentes",2018,4,3,1756,170.842824601367,0,914,0,3,842,356.294536817102
25798,23,23586,121,Tasa de exámenes médico legales por presunto delito sexual cuando la víctima está entre 18 y 28 años,2018,5,1,2960,33.7837837837838,0,1502,0,1,1458,68.5871056241427
25799,23,23660,81,"Tasa de exámenes médico legales por presunto delito sexual contra niños, niñas y adolescentes",2018,2,5,8335,59.9880023995201,1,4252,23.5183443085607,4,4083,97.9671809943669
25800,23,23660,81,"Tasa de exámenes médico legales por presunto delito sexual contra niños, niñas y adolescentes",2018,3,21,9890,212.335692618807,3,5042,59.5001983339944,18,4848,371.287128712871
25801,23,23660,81,"Tasa de exámenes médico legales por presunto delito sexual contra niños, niñas y adolescentes",2018,4,25,9586,260.79699561861,0,4864,0,25,4722,529.436679373147
25802,23,23660,121,Tasa de exámenes médico legales por presunto delito sexual cuando la víctima está entre 18 y 28 años,2018,5,2,17404,11.4916111238796,0,8898,0,2,8506,23.5128144838937
25803,23,23670,81,"Tasa de exámenes médico legales por presunto delito sexual contra niños, niñas y adolescentes",2018,3,3,6133,48.9157019403228,0,3117,0,3,3016,99.4694960212202
25804,23,23670,81,"Tasa de exámenes médico legales por presunto delito sexual contra niños, niñas y adolescentes",2018,4,9,5623,160.056909123244,0,2940,0,9,2683,335.44539694372
25805,23,23670,121,Tasa de exámenes médico legales por presunto delito sexual cuando la víctima está entre 18 y 28 años,2018,5,2,10235,19.5407914020518,0,5247,0,2,4988,40.0962309542903
25806,23,23672,81,"Tasa de exámenes médico legales por presunto delito sexual contra niños, niñas y adolescentes",2018,3,2,3760,53.1914893617021,1,1905,52.49343832021,1,1855,53.9083557951483
25807,23,23672,81,"Tasa de exámenes médico legales por presunto delito sexual contra niños, niñas y adolescentes",2018,4,4,3589,111.45165784341,1,1832,54.5851528384279,3,1757,170.745589072282
25808,23,23672,121,Tasa de exámenes médico legales por presunto delito sexual cuando la víctima está entre 18 y 28 años,2018,5,1,6712,14.8986889153754,0,3451,0,1,3261,30.6654400490647
25809,23,23675,81,"Tasa de exámenes médico legales por presunto delito sexual contra niños, niñas y adolescentes",2018,3,1,4258,23.4852043212776,0,2224,0,1,2034,49.1642084562439
25810,23,23675,81,"Tasa de exámenes médico legales por presunto delito sexual contra niños, niñas y adolescentes",2018,4,10,3852,259.605399792316,1,2037,49.0918016691213,9,1815,495.867768595041
25811,23,23678,81,"Tasa de exámenes médico legales por presunto delito sexual contra niños, niñas y adolescentes",2018,3,2,3400,58.8235294117647,0,1728,0,2,1672,119.617224880383
25812,23,23678,81,"Tasa de exámenes médico legales por presunto delito sexual contra niños, niñas y adolescentes",2018,4,2,3136,63.7755102040816,0,1590,0,2,1546,129.366106080207
25813,23,23682,81,"Tasa de exámenes médico legales por presunto delito sexual contra niños, niñas y adolescentes",2018,3,1,1581,63.2511068943707,0,804,0,1,777,128.700128700129
25814,23,23682,81,"Tasa de exámenes médico legales por presunto delito sexual contra niños, niñas y adolescentes",2018,4,2,1407,142.146410803127,0,744,0,2,663,301.659125188537
25815,23,23686,81,"Tasa de exámenes médico legales por presunto delito sexual contra niños, niñas y adolescentes",2018,2,1,4065,24.60024600246,1,2084,47.9846449136276,0,1981,0
25816,23,23686,81,"Tasa de exámenes médico legales por presunto delito sexual contra niños, niñas y adolescentes",2018,3,4,4731,84.5487212005918,0,2428,0,4,2303,173.686495874946
25817,23,23686,81,"Tasa de exámenes médico legales por presunto delito sexual contra niños, niñas y adolescentes",2018,4,5,4657,107.365256602963,0,2364,0,5,2293,218.054949847362
25818,23,23686,121,Tasa de exámenes médico legales por presunto delito sexual cuando la víctima está entre 18 y 28 años,2018,5,1,8519,11.7384669562155,0,4306,0,1,4213,23.7360550676478
25819,23,23807,81,"Tasa de exámenes médico legales por presunto delito sexual contra niños, niñas y adolescentes",2018,3,4,14671,27.2646718015132,0,7484,0,4,7187,55.6560456379574
25820,23,23807,81,"Tasa de exámenes médico legales por presunto delito sexual contra niños, niñas y adolescentes",2018,4,1,13449,7.43549706297866,0,6862,0,1,6587,15.181417944436
25821,23,23807,121,Tasa de exámenes médico legales por presunto delito sexual cuando la víctima está entre 18 y 28 años,2018,5,1,22382,4.46787597176302,0,11429,0,1,10953,9.12991874372318
25822,23,23815,81,"Tasa de exámenes médico legales por presunto delito sexual contra niños, niñas y adolescentes",2018,2,2,5972,33.4896182183523,1,3082,32.4464633354964,1,2890,34.6020761245675
25823,23,23815,81,"Tasa de exámenes médico legales por presunto delito sexual contra niños, niñas y adolescentes",2018,3,3,6407,46.8237864835336,0,3262,0,3,3145,95.389507154213
25824,23,23815,81,"Tasa de exámenes médico legales por presunto delito sexual contra niños, niñas y adolescentes",2018,4,5,5508,90.7770515613653,0,2797,0,5,2711,184.433788270011
25825,23,23855,121,Tasa de exámenes médico legales por presunto delito sexual cuando la víctima está entre 18 y 28 años,2018,5,2,9212,21.7108119843682,0,4808,0,2,4404,45.4132606721163
25826,25,25001,81,"Tasa de exámenes médico legales por presunto delito sexual contra niños, niñas y adolescentes",2018,2,1,861,116.144018583043,0,446,0,1,415,240.963855421687
25827,25,25001,81,"Tasa de exámenes médico legales por presunto delito sexual contra niños, niñas y adolescentes",2018,3,1,1030,97.0873786407767,1,534,187.265917602996,0,496,0
25828,25,25001,81,"Tasa de exámenes médico legales por presunto delito sexual contra niños, niñas y adolescentes",2018,4,1,991,100.908173562059,0,510,0,1,481,207.900207900208
25829,25,25001,121,Tasa de exámenes médico legales por presunto delito sexual cuando la víctima está entre 18 y 28 años,2018,5,2,1813,110.314396028682,0,930,0,2,883,226.500566251416
25830,25,25019,81,"Tasa de exámenes médico legales por presunto delito sexual contra niños, niñas y adolescentes",2018,2,2,539,371.057513914657,0,277,0,2,262,763.358778625954
25831,25,25019,81,"Tasa de exámenes médico legales por presunto delito sexual contra niños, niñas y adolescentes",2018,3,2,605,330.578512396694,1,302,331.12582781457,1,303,330.03300330033
25832,25,25019,81,"Tasa de exámenes médico legales por presunto delito sexual contra niños, niñas y adolescentes",2018,4,1,591,169.204737732656,0,288,0,1,303,330.03300330033
25833,25,25035,81,"Tasa de exámenes médico legales por presunto delito sexual contra niños, niñas y adolescentes",2018,2,4,1142,350.262697022767,2,582,343.642611683849,2,560,357.142857142857
25834,25,25035,81,"Tasa de exámenes médico legales por presunto delito sexual contra niños, niñas y adolescentes",2018,3,3,1255,239.043824701195,0,632,0,3,623,481.540930979133
25835,25,25035,81,"Tasa de exámenes médico legales por presunto delito sexual contra niños, niñas y adolescentes",2018,4,5,1242,402.576489533011,0,630,0,5,612,816.993464052288
25836,25,25035,121,Tasa de exámenes médico legales por presunto delito sexual cuando la víctima está entre 18 y 28 años,2018,5,1,2773,36.0620266858998,0,1411,0,1,1362,73.4214390602056
25837,25,25040,81,"Tasa de exámenes médico legales por presunto delito sexual contra niños, niñas y adolescentes",2018,3,3,1175,255.31914893617,2,601,332.778702163062,1,574,174.216027874564
25838,25,25040,81,"Tasa de exámenes médico legales por presunto delito sexual contra niños, niñas y adolescentes",2018,4,4,1066,375.234521575985,0,553,0,4,513,779.727095516569
25839,25,25053,81,"Tasa de exámenes médico legales por presunto delito sexual contra niños, niñas y adolescentes",2018,2,1,1287,77.7000777000777,0,656,0,1,631,158.478605388273
25840,25,25053,81,"Tasa de exámenes médico legales por presunto delito sexual contra niños, niñas y adolescentes",2018,3,5,1465,341.296928327645,1,749,133.511348464619,4,716,558.659217877095
25841,25,25053,81,"Tasa de exámenes médico legales por presunto delito sexual contra niños, niñas y adolescentes",2018,4,2,1413,141.542816702052,1,713,140.252454417952,1,700,142.857142857143
25842,25,25053,121,Tasa de exámenes médico legales por presunto delito sexual cuando la víctima está entre 18 y 28 años,2018,5,1,2364,42.3011844331641,0,1187,0,1,1177,84.9617672047579
25843,25,25099,81,"Tasa de exámenes médico legales por presunto delito sexual contra niños, niñas y adolescentes",2018,3,3,1567,191.4486279515,0,791,0,3,776,386.59793814433
25844,25,25099,81,"Tasa de exámenes médico legales por presunto delito sexual contra niños, niñas y adolescentes",2018,4,1,1501,66.6222518321119,0,760,0,1,741,134.952766531714
25845,25,25099,121,Tasa de exámenes médico legales por presunto delito sexual cuando la víctima está entre 18 y 28 años,2018,5,2,2430,82.3045267489712,1,1235,80.9716599190283,1,1195,83.6820083682008
25846,25,25123,81,"Tasa de exámenes médico legales por presunto delito sexual contra niños, niñas y adolescentes",2018,2,3,1050,285.714285714286,1,534,187.265917602996,2,516,387.596899224806
25847,25,25123,81,"Tasa de exámenes médico legales por presunto delito sexual contra niños, niñas y adolescentes",2018,3,2,1253,159.616919393456,1,633,157.977883096366,1,620,161.290322580645
25848,25,25123,81,"Tasa de exámenes médico legales por presunto delito sexual contra niños, niñas y adolescentes",2018,4,2,1190,168.067226890756,0,604,0,2,586,341.296928327645
25849,25,25126,81,"Tasa de exámenes médico legales por presunto delito sexual contra niños, niñas y adolescentes",2018,2,8,4931,162.238896775502,3,2523,118.906064209275,5,2408,207.641196013289
25850,25,25126,81,"Tasa de exámenes médico legales por presunto delito sexual contra niños, niñas y adolescentes",2018,3,9,6264,143.67816091954,0,3267,0,9,2997,300.3003003003
25851,25,25126,81,"Tasa de exámenes médico legales por presunto delito sexual contra niños, niñas y adolescentes",2018,4,29,6479,447.599938262078,6,3419,175.489909330214,23,3060,751.633986928105
25852,25,25126,121,Tasa de exámenes médico legales por presunto delito sexual cuando la víctima está entre 18 y 28 años,2018,5,4,11596,34.494653328734,0,5976,0,4,5620,71.1743772241993
25853,25,25148,81,"Tasa de exámenes médico legales por presunto delito sexual contra niños, niñas y adolescentes",2018,2,1,1515,66.006600660066,0,779,0,1,736,135.869565217391
25854,25,25148,81,"Tasa de exámenes médico legales por presunto delito sexual contra niños, niñas y adolescentes",2018,3,3,1690,177.514792899408,1,875,114.285714285714,2,815,245.398773006135
25855,25,25148,81,"Tasa de exámenes médico legales por presunto delito sexual contra niños, niñas y adolescentes",2018,4,1,1608,62.1890547263682,0,840,0,1,768,130.208333333333
25856,25,25151,81,"Tasa de exámenes médico legales por presunto delito sexual contra niños, niñas y adolescentes",2018,3,7,1759,397.953382603752,4,899,444.938820912125,3,860,348.837209302326
25857,25,25151,81,"Tasa de exámenes médico legales por presunto delito sexual contra niños, niñas y adolescentes",2018,4,8,1706,468.933177022274,1,880,113.636363636364,7,826,847.457627118644
25858,25,25151,121,Tasa de exámenes médico legales por presunto delito sexual cuando la víctima está entre 18 y 28 años,2018,5,3,3160,94.9367088607595,0,1650,0,3,1510,198.675496688742
25859,25,25154,81,"Tasa de exámenes médico legales por presunto delito sexual contra niños, niñas y adolescentes",2018,3,2,923,216.684723726977,2,482,414.9377593361,0,441,0
25860,25,25154,81,"Tasa de exámenes médico legales por presunto delito sexual contra niños, niñas y adolescentes",2018,4,2,894,223.713646532438,1,474,210.970464135021,1,420,238.095238095238
25861,25,25154,121,Tasa de exámenes médico legales por presunto delito sexual cuando la víctima está entre 18 y 28 años,2018,5,1,1676,59.6658711217184,0,859,0,1,817,122.399020807834
25862,25,25168,81,"Tasa de exámenes médico legales por presunto delito sexual contra niños, niñas y adolescentes",2018,3,1,429,233.100233100233,0,222,0,1,207,483.091787439613
25863,25,25168,81,"Tasa de exámenes médico legales por presunto delito sexual contra niños, niñas y adolescentes",2018,4,2,406,492.610837438424,1,210,476.190476190476,1,196,510.204081632653
25864,25,25175,81,"Tasa de exámenes médico legales por presunto delito sexual contra niños, niñas y adolescentes",2018,2,12,10582,113.400113400113,2,5408,36.9822485207101,10,5174,193.274062620796
25865,25,25175,81,"Tasa de exámenes médico legales por presunto delito sexual contra niños, niñas y adolescentes",2018,3,25,13055,191.497510532363,6,6667,89.9955002249887,19,6388,297.432686286788
25866,25,25175,81,"Tasa de exámenes médico legales por presunto delito sexual contra niños, niñas y adolescentes",2018,4,28,13270,211.002260738508,3,6640,45.1807228915663,25,6630,377.073906485671
25867,25,25175,121,Tasa de exámenes médico legales por presunto delito sexual cuando la víctima está entre 18 y 28 años,2018,5,8,24868,32.169856844137,1,12385,8.0742834073476,7,12483,56.0762637186574
25868,25,25178,81,"Tasa de exámenes médico legales por presunto delito sexual contra niños, niñas y adolescentes",2018,2,1,808,123.762376237624,0,423,0,1,385,259.74025974026
25869,25,25178,81,"Tasa de exámenes médico legales por presunto delito sexual contra niños, niñas y adolescentes",2018,3,3,949,316.122233930453,0,498,0,3,451,665.188470066519
25870,25,25178,81,"Tasa de exámenes médico legales por presunto delito sexual contra niños, niñas y adolescentes",2018,4,2,904,221.238938053097,1,475,210.526315789474,1,429,233.100233100233
25871,25,25181,81,"Tasa de exámenes médico legales por presunto delito sexual contra niños, niñas y adolescentes",2018,2,2,977,204.708290685773,1,500,200,1,477,209.643605870021
25872,25,25181,81,"Tasa de exámenes médico legales por presunto delito sexual contra niños, niñas y adolescentes",2018,3,2,1189,168.20857863751,0,605,0,2,584,342.465753424658
25873,25,25181,81,"Tasa de exámenes médico legales por presunto delito sexual contra niños, niñas y adolescentes",2018,4,1,1099,90.9918107370337,0,562,0,1,537,186.219739292365
25874,25,25183,81,"Tasa de exámenes médico legales por presunto delito sexual contra niños, niñas y adolescentes",2018,3,9,2879,312.608544633553,4,1463,273.410799726589,5,1416,353.107344632768
25875,25,25183,81,"Tasa de exámenes médico legales por presunto delito sexual contra niños, niñas y adolescentes",2018,4,6,2714,221.075902726603,2,1370,145.985401459854,4,1344,297.619047619048
25876,25,25183,121,Tasa de exámenes médico legales por presunto delito sexual cuando la víctima está entre 18 y 28 años,2018,5,1,5016,19.9362041467305,0,2527,0,1,2489,40.1767778224186
25877,25,25200,81,"Tasa de exámenes médico legales por presunto delito sexual contra niños, niñas y adolescentes",2018,4,4,2518,158.856235107228,0,1253,0,4,1265,316.205533596838
25878,25,25200,121,Tasa de exámenes médico legales por presunto delito sexual cuando la víctima está entre 18 y 28 años,2018,5,1,4615,21.6684723726977,0,2376,0,1,2239,44.6627958910228
25879,25,25214,81,"Tasa de exámenes médico legales por presunto delito sexual contra niños, niñas y adolescentes",2018,2,1,2165,46.189376443418,1,1110,90.0900900900901,0,1055,0
25880,25,25214,81,"Tasa de exámenes médico legales por presunto delito sexual contra niños, niñas y adolescentes",2018,3,3,2657,112.90929619872,3,1359,220.75055187638,0,1298,0
25881,25,25214,81,"Tasa de exámenes médico legales por presunto delito sexual contra niños, niñas y adolescentes",2018,4,5,2683,186.358553857622,5,1346,371.47102526003,0,1337,0
25882,25,25224,81,"Tasa de exámenes médico legales por presunto delito sexual contra niños, niñas y adolescentes",2018,4,1,931,107.411385606874,0,484,0,1,447,223.713646532438
25883,25,25224,121,Tasa de exámenes médico legales por presunto delito sexual cuando la víctima está entre 18 y 28 años,2018,5,2,1458,137.174211248285,0,761,0,2,697,286.944045911047
25884,25,25245,81,"Tasa de exámenes médico legales por presunto delito sexual contra niños, niñas y adolescentes",2018,2,5,1704,293.427230046948,2,875,228.571428571429,3,829,361.881785283474
25885,25,25245,81,"Tasa de exámenes médico legales por presunto delito sexual contra niños, niñas y adolescentes",2018,3,12,2088,574.712643678161,3,1055,284.36018957346,9,1033,871.248789932236
25886,25,25245,81,"Tasa de exámenes médico legales por presunto delito sexual contra niños, niñas y adolescentes",2018,4,12,2126,564.440263405456,0,1072,0,12,1054,1138.51992409867
25887,25,25245,121,Tasa de exámenes médico legales por presunto delito sexual cuando la víctima está entre 18 y 28 años,2018,5,2,4068,49.1642084562439,0,2054,0,2,2014,99.304865938431
25888,25,25258,81,"Tasa de exámenes médico legales por presunto delito sexual contra niños, niñas y adolescentes",2018,3,2,434,460.829493087558,0,228,0,2,206,970.873786407767
25889,25,25260,81,"Tasa de exámenes médico legales por presunto delito sexual contra niños, niñas y adolescentes",2018,2,4,1806,221.483942414175,0,925,0,4,881,454.029511918275
25890,25,25260,81,"Tasa de exámenes médico legales por presunto delito sexual contra niños, niñas y adolescentes",2018,3,4,2154,185.701021355617,0,1093,0,4,1061,377.002827521206
25891,25,25260,81,"Tasa de exámenes médico legales por presunto delito sexual contra niños, niñas y adolescentes",2018,4,7,2207,317.17263253285,2,1103,181.323662737987,5,1104,452.898550724638
25892,25,25260,121,Tasa de exámenes médico legales por presunto delito sexual cuando la víctima está entre 18 y 28 años,2018,5,1,3671,27.2405339144647,1,1855,53.9083557951483,0,1816,0
25893,25,25269,81,"Tasa de exámenes médico legales por presunto delito sexual contra niños, niñas y adolescentes",2018,2,17,12062,140.938484496767,3,6197,48.4105212199451,14,5865,238.704177323103
25894,25,25269,81,"Tasa de exámenes médico legales por presunto delito sexual contra niños, niñas y adolescentes",2018,3,42,14845,282.923543280566,9,7588,118.608328940432,33,7257,454.733360892931
25895,25,25269,81,"Tasa de exámenes médico legales por presunto delito sexual contra niños, niñas y adolescentes",2018,4,42,14997,280.05601120224,3,7699,38.9660994934407,39,7298,534.392984379282
25896,25,25269,121,Tasa de exámenes médico legales por presunto delito sexual cuando la víctima está entre 18 y 28 años,2018,5,12,25929,46.2802267731112,2,13184,15.1699029126214,10,12745,78.462142016477
25897,25,25279,81,"Tasa de exámenes médico legales por presunto delito sexual contra niños, niñas y adolescentes",2018,2,1,1022,97.8473581213307,0,529,0,1,493,202.839756592292
25898,25,25279,81,"Tasa de exámenes médico legales por presunto delito sexual contra niños, niñas y adolescentes",2018,3,3,1184,253.378378378378,0,620,0,3,564,531.914893617021
25899,25,25279,81,"Tasa de exámenes médico legales por presunto delito sexual contra niños, niñas y adolescentes",2018,4,3,1125,266.666666666667,1,589,169.779286926995,2,536,373.134328358209
25900,25,25279,121,Tasa de exámenes médico legales por presunto delito sexual cuando la víctima está entre 18 y 28 años,2018,5,1,2181,45.8505272810637,0,1116,0,1,1065,93.8967136150235
25901,25,25281,81,"Tasa de exámenes médico legales por presunto delito sexual contra niños, niñas y adolescentes",2018,2,1,737,135.685210312076,1,375,266.666666666667,0,362,0
25902,25,25281,81,"Tasa de exámenes médico legales por presunto delito sexual contra niños, niñas y adolescentes",2018,4,1,885,112.994350282486,0,458,0,1,427,234.192037470726
25903,25,25286,81,"Tasa de exámenes médico legales por presunto delito sexual contra niños, niñas y adolescentes",2018,2,8,6770,118.168389955687,4,3464,115.473441108545,4,3306,120.992135511192
25904,25,25286,81,"Tasa de exámenes médico legales por presunto delito sexual contra niños, niñas y adolescentes",2018,3,15,8055,186.219739292365,3,4022,74.5897563401293,12,4033,297.545251673692
25905,25,25286,81,"Tasa de exámenes médico legales por presunto delito sexual contra niños, niñas y adolescentes",2018,4,13,8159,159.333251623974,1,3996,25.025025025025,12,4163,288.253663223637
25906,25,25286,121,Tasa de exámenes médico legales por presunto delito sexual cuando la víctima está entre 18 y 28 años,2018,5,7,15277,45.8205144989199,0,7323,0,7,7954,88.0060346995222
25907,25,25288,81,"Tasa de exámenes médico legales por presunto delito sexual contra niños, niñas y adolescentes",2018,3,2,622,321.543408360129,0,319,0,2,303,660.06600660066
25908,25,25288,121,Tasa de exámenes médico legales por presunto delito sexual cuando la víctima está entre 18 y 28 años,2018,5,1,1119,89.3655049151028,0,594,0,1,525,190.47619047619
25909,25,25290,81,"Tasa de exámenes médico legales por presunto delito sexual contra niños, niñas y adolescentes",2018,2,13,10810,120.259019426457,3,5509,54.4563441640951,10,5301,188.643652141105
25910,25,25290,81,"Tasa de exámenes médico legales por presunto delito sexual contra niños, niñas y adolescentes",2018,3,49,13080,374.617737003058,6,6737,89.0604126465786,43,6343,677.912659624783
25911,25,25290,81,"Tasa de exámenes médico legales por presunto delito sexual contra niños, niñas y adolescentes",2018,4,43,12275,350.30549898167,6,6010,99.8336106489185,37,6265,590.582601755786
25912,25,25290,121,Tasa de exámenes médico legales por presunto delito sexual cuando la víctima está entre 18 y 28 años,2018,5,12,25206,47.6077124494168,0,12892,0,12,12314,97.4500568458665
25913,25,25293,81,"Tasa de exámenes médico legales por presunto delito sexual contra niños, niñas y adolescentes",2018,3,1,724,138.121546961326,0,371,0,1,353,283.28611898017
25914,25,25293,121,Tasa de exámenes médico legales por presunto delito sexual cuando la víctima está entre 18 y 28 años,2018,5,1,1141,87.6424189307625,0,557,0,1,584,171.232876712329
25915,25,25295,81,"Tasa de exámenes médico legales por presunto delito sexual contra niños, niñas y adolescentes",2018,2,1,1731,57.7700751010976,1,886,112.866817155756,0,845,0
25916,25,25295,81,"Tasa de exámenes médico legales por presunto delito sexual contra niños, niñas y adolescentes",2018,3,4,1992,200.803212851406,1,1019,98.135426889107,3,973,308.324768756423
25917,25,25295,81,"Tasa de exámenes médico legales por presunto delito sexual contra niños, niñas y adolescentes",2018,4,4,1928,207.46887966805,0,984,0,4,944,423.728813559322
25918,25,25295,121,Tasa de exámenes médico legales por presunto delito sexual cuando la víctima está entre 18 y 28 años,2018,5,3,3140,95.5414012738854,0,1532,0,3,1608,186.567164179104
25919,25,25297,81,"Tasa de exámenes médico legales por presunto delito sexual contra niños, niñas y adolescentes",2018,2,1,1082,92.4214417744917,0,548,0,1,534,187.265917602996
25920,25,25297,81,"Tasa de exámenes médico legales por presunto delito sexual contra niños, niñas y adolescentes",2018,3,2,1137,175.901495162709,1,561,178.25311942959,1,576,173.611111111111
25921,25,25307,81,"Tasa de exámenes médico legales por presunto delito sexual contra niños, niñas y adolescentes",2018,2,6,7717,77.7504211481146,0,3889,0,6,3828,156.739811912226
25922,25,25307,81,"Tasa de exámenes médico legales por presunto delito sexual contra niños, niñas y adolescentes",2018,3,23,9399,244.706883711033,1,4600,21.7391304347826,22,4799,458.42883934153
25923,25,25307,81,"Tasa de exámenes médico legales por presunto delito sexual contra niños, niñas y adolescentes",2018,4,18,9427,190.940914394823,1,4510,22.1729490022173,17,4917,345.739271913769
25924,25,25307,121,Tasa de exámenes médico legales por presunto delito sexual cuando la víctima está entre 18 y 28 años,2018,5,4,19139,20.8997335283975,1,9292,10.7619457597934,3,9847,30.466131816797
25925,25,25307,81,"Tasa de exámenes médico legales por presunto delito sexual contra niños, niñas y adolescentes",2018,1,1,1546,64.6830530401035,0,788,0,1,758,131.926121372032
25926,25,25312,81,"Tasa de exámenes médico legales por presunto delito sexual contra niños, niñas y adolescentes",2018,3,1,1085,92.1658986175115,0,545,0,1,540,185.185185185185
25927,25,25312,81,"Tasa de exámenes médico legales por presunto delito sexual contra niños, niñas y adolescentes",2018,4,2,1008,198.412698412698,0,501,0,2,507,394.477317554241
25928,25,25317,81,"Tasa de exámenes médico legales por presunto delito sexual contra niños, niñas y adolescentes",2018,2,3,1011,296.73590504451,0,512,0,3,499,601.202404809619
25929,25,25317,81,"Tasa de exámenes médico legales por presunto delito sexual contra niños, niñas y adolescentes",2018,3,1,1169,85.5431993156544,0,590,0,1,579,172.711571675302
25930,25,25317,81,"Tasa de exámenes médico legales por presunto delito sexual contra niños, niñas y adolescentes",2018,4,3,1098,273.224043715847,1,563,177.619893428064,2,535,373.831775700935
25931,25,25320,81,"Tasa de exámenes médico legales por presunto delito sexual contra niños, niñas y adolescentes",2018,2,4,3867,103.439358675976,2,1984,100.806451612903,2,1883,106.213489113117
25932,25,25320,81,"Tasa de exámenes médico legales por presunto delito sexual contra niños, niñas y adolescentes",2018,3,5,4546,109.98680158381,0,2320,0,5,2226,224.618149146451
25933,25,25320,81,"Tasa de exámenes médico legales por presunto delito sexual contra niños, niñas y adolescentes",2018,4,5,4278,116.877045348294,2,2155,92.8074245939675,3,2123,141.309467734338
25934,25,25320,121,Tasa de exámenes médico legales por presunto delito sexual cuando la víctima está entre 18 y 28 años,2018,5,1,7140,14.0056022408964,0,3508,0,1,3632,27.5330396475771
25935,25,25322,81,"Tasa de exámenes médico legales por presunto delito sexual contra niños, niñas y adolescentes",2018,4,2,1744,114.678899082569,0,902,0,2,842,237.529691211401
25936,25,25322,121,Tasa de exámenes médico legales por presunto delito sexual cuando la víctima está entre 18 y 28 años,2018,5,1,3116,32.0924261874198,0,1635,0,1,1481,67.5219446320054
25937,25,25326,81,"Tasa de exámenes médico legales por presunto delito sexual contra niños, niñas y adolescentes",2018,3,1,717,139.470013947001,1,360,277.777777777778,0,357,0
25938,25,25326,81,"Tasa de exámenes médico legales por presunto delito sexual contra niños, niñas y adolescentes",2018,4,1,704,142.045454545455,0,362,0,1,342,292.397660818713
25939,25,25328,81,"Tasa de exámenes médico legales por presunto delito sexual contra niños, niñas y adolescentes",2018,2,1,329,303.951367781155,0,170,0,1,159,628.930817610063
25940,25,25328,81,"Tasa de exámenes médico legales por presunto delito sexual contra niños, niñas y adolescentes",2018,3,2,385,519.480519480519,0,200,0,2,185,1081.08108108108
25941,25,25328,81,"Tasa de exámenes médico legales por presunto delito sexual contra niños, niñas y adolescentes",2018,4,2,385,519.480519480519,0,204,0,2,181,1104.97237569061
25942,25,25335,81,"Tasa de exámenes médico legales por presunto delito sexual contra niños, niñas y adolescentes",2018,2,1,414,241.545893719807,0,212,0,1,202,495.049504950495
25943,25,25335,81,"Tasa de exámenes médico legales por presunto delito sexual contra niños, niñas y adolescentes",2018,4,2,443,451.467268623025,0,216,0,2,227,881.057268722467
25944,25,25377,81,"Tasa de exámenes médico legales por presunto delito sexual contra niños, niñas y adolescentes",2018,3,2,2771,72.1761097076867,1,1397,71.5819613457409,1,1374,72.7802037845706
25945,25,25377,81,"Tasa de exámenes médico legales por presunto delito sexual contra niños, niñas y adolescentes",2018,4,4,2836,141.043723554302,4,1440,277.777777777778,0,1396,0
25946,25,25377,121,Tasa de exámenes médico legales por presunto delito sexual cuando la víctima está entre 18 y 28 años,2018,5,2,5369,37.2508847085118,0,2801,0,2,2568,77.8816199376947
25947,25,25386,81,"Tasa de exámenes médico legales por presunto delito sexual contra niños, niñas y adolescentes",2018,2,7,2520,277.777777777778,3,1294,231.839258114374,4,1226,326.26427406199
25948,25,25386,81,"Tasa de exámenes médico legales por presunto delito sexual contra niños, niñas y adolescentes",2018,3,12,3088,388.60103626943,1,1561,64.0614990390775,11,1527,720.366732154551
25949,25,25386,81,"Tasa de exámenes médico legales por presunto delito sexual contra niños, niñas y adolescentes",2018,4,12,3145,381.558028616852,3,1585,189.274447949527,9,1560,576.923076923077
25950,25,25386,121,Tasa de exámenes médico legales por presunto delito sexual cuando la víctima está entre 18 y 28 años,2018,5,1,6018,16.6168162180126,0,3041,0,1,2977,33.5908632851864
25951,25,25394,81,"Tasa de exámenes médico legales por presunto delito sexual contra niños, niñas y adolescentes",2018,3,1,1063,94.0733772342427,1,543,184.162062615101,0,520,0
25952,25,25394,81,"Tasa de exámenes médico legales por presunto delito sexual contra niños, niñas y adolescentes",2018,4,1,1036,96.5250965250965,1,523,191.204588910134,0,513,0
25953,25,25398,81,"Tasa de exámenes médico legales por presunto delito sexual contra niños, niñas y adolescentes",2018,2,1,600,166.666666666667,0,306,0,1,294,340.136054421769
25954,25,25402,81,"Tasa de exámenes médico legales por presunto delito sexual contra niños, niñas y adolescentes",2018,2,1,1236,80.9061488673139,0,631,0,1,605,165.289256198347
25955,25,25402,81,"Tasa de exámenes médico legales por presunto delito sexual contra niños, niñas y adolescentes",2018,3,7,1397,501.073729420186,3,714,420.168067226891,4,683,585.651537335286
25956,25,25402,81,"Tasa de exámenes médico legales por presunto delito sexual contra niños, niñas y adolescentes",2018,4,5,1365,366.300366300366,0,689,0,5,676,739.644970414201
25957,25,25402,121,Tasa de exámenes médico legales por presunto delito sexual cuando la víctima está entre 18 y 28 años,2018,5,2,2844,70.323488045007,0,1423,0,2,1421,140.745953553835
25958,25,25402,81,"Tasa de exámenes médico legales por presunto delito sexual contra niños, niñas y adolescentes",2018,1,1,258,387.596899224806,0,133,0,1,125,800
25959,25,25407,81,"Tasa de exámenes médico legales por presunto delito sexual contra niños, niñas y adolescentes",2018,3,3,1134,264.550264550265,2,590,338.983050847458,1,544,183.823529411765
25960,25,25407,81,"Tasa de exámenes médico legales por presunto delito sexual contra niños, niñas y adolescentes",2018,4,2,1063,188.146754468485,1,552,181.159420289855,1,511,195.694716242661
25961,25,25426,81,"Tasa de exámenes médico legales por presunto delito sexual contra niños, niñas y adolescentes",2018,3,1,621,161.030595813205,0,306,0,1,315,317.460317460317
25962,25,25430,81,"Tasa de exámenes médico legales por presunto delito sexual contra niños, niñas y adolescentes",2018,2,2,7176,27.8706800445931,0,3684,0,2,3492,57.2737686139748
25963,25,25430,81,"Tasa de exámenes médico legales por presunto delito sexual contra niños, niñas y adolescentes",2018,3,10,8822,113.352981183405,3,4455,67.3400673400673,7,4367,160.293107396382
25964,25,25430,81,"Tasa de exámenes médico legales por presunto delito sexual contra niños, niñas y adolescentes",2018,4,16,8921,179.352090572806,2,4522,44.2282176028306,14,4399,318.254148670152
25965,25,25430,121,Tasa de exámenes médico legales por presunto delito sexual cuando la víctima está entre 18 y 28 años,2018,5,2,15637,12.7901771439534,0,7929,0,2,7708,25.9470679813181
25966,25,25436,81,"Tasa de exámenes médico legales por presunto delito sexual contra niños, niñas y adolescentes",2018,4,2,528,378.787878787879,0,269,0,2,259,772.200772200772
25967,25,25438,81,"Tasa de exámenes médico legales por presunto delito sexual contra niños, niñas y adolescentes",2018,3,4,1231,324.939073923639,0,650,0,4,581,688.468158347676
25968,25,25438,81,"Tasa de exámenes médico legales por presunto delito sexual contra niños, niñas y adolescentes",2018,4,5,1140,438.59649122807,0,609,0,5,531,941.619585687382
25969,25,25473,81,"Tasa de exámenes médico legales por presunto delito sexual contra niños, niñas y adolescentes",2018,2,5,7919,63.1392852632908,0,4053,0,5,3866,129.332643559234
25970,25,25473,81,"Tasa de exámenes médico legales por presunto delito sexual contra niños, niñas y adolescentes",2018,3,10,9269,107.886503398425,4,4752,84.1750841750842,6,4517,132.831525348683
25971,25,25473,81,"Tasa de exámenes médico legales por presunto delito sexual contra niños, niñas y adolescentes",2018,4,15,9704,154.575432811212,2,5026,39.7930760047752,13,4678,277.896536981616
25972,25,25473,121,Tasa de exámenes médico legales por presunto delito sexual cuando la víctima está entre 18 y 28 años,2018,5,3,17767,16.8852366747341,0,8950,0,3,8817,34.0251786321878
25973,25,25486,81,"Tasa de exámenes médico legales por presunto delito sexual contra niños, niñas y adolescentes",2018,4,5,1675,298.507462686567,0,853,0,5,822,608.272506082725
25974,25,25488,81,"Tasa de exámenes médico legales por presunto delito sexual contra niños, niñas y adolescentes",2018,2,1,1595,62.6959247648903,0,847,0,1,748,133.689839572193
25975,25,25488,81,"Tasa de exámenes médico legales por presunto delito sexual contra niños, niñas y adolescentes",2018,3,3,1546,194.04915912031,3,757,396.301188903567,0,789,0
25976,25,25488,81,"Tasa de exámenes médico legales por presunto delito sexual contra niños, niñas y adolescentes",2018,4,2,2536,78.8643533123028,0,1816,0,2,720,277.777777777778
25977,25,25488,121,Tasa de exámenes médico legales por presunto delito sexual cuando la víctima está entre 18 y 28 años,2018,5,1,7358,13.5906496330525,0,6040,0,1,1318,75.8725341426404
25978,25,25489,81,"Tasa de exámenes médico legales por presunto delito sexual contra niños, niñas y adolescentes",2018,3,2,779,256.739409499358,0,390,0,2,389,514.13881748072
25979,25,25489,81,"Tasa de exámenes médico legales por presunto delito sexual contra niños, niñas y adolescentes",2018,4,1,732,136.612021857924,0,362,0,1,370,270.27027027027
25980,25,25491,81,"Tasa de exámenes médico legales por presunto delito sexual contra niños, niñas y adolescentes",2018,3,1,591,169.204737732656,0,306,0,1,285,350.877192982456
25981,25,25491,81,"Tasa de exámenes médico legales por presunto delito sexual contra niños, niñas y adolescentes",2018,4,2,659,303.490136570561,0,349,0,2,310,645.161290322581
25982,25,25513,81,"Tasa de exámenes médico legales por presunto delito sexual contra niños, niñas y adolescentes",2018,2,1,2455,40.7331975560082,0,1253,0,1,1202,83.1946755407654
25983,25,25513,81,"Tasa de exámenes médico legales por presunto delito sexual contra niños, niñas y adolescentes",2018,3,2,2924,68.3994528043776,2,1446,138.312586445367,0,1478,0
25984,25,25513,81,"Tasa de exámenes médico legales por presunto delito sexual contra niños, niñas y adolescentes",2018,4,7,2957,236.726411903957,1,1472,67.9347826086957,6,1485,404.040404040404
25985,25,25518,81,"Tasa de exámenes médico legales por presunto delito sexual contra niños, niñas y adolescentes",2018,3,1,417,239.808153477218,0,216,0,1,201,497.512437810945
25986,25,25524,81,"Tasa de exámenes médico legales por presunto delito sexual contra niños, niñas y adolescentes",2018,3,2,571,350.262697022767,1,302,331.12582781457,1,269,371.747211895911
25987,25,25530,81,"Tasa de exámenes médico legales por presunto delito sexual contra niños, niñas y adolescentes",2018,2,1,819,122.100122100122,0,420,0,1,399,250.62656641604
25988,25,25530,81,"Tasa de exámenes médico legales por presunto delito sexual contra niños, niñas y adolescentes",2018,3,7,887,789.177001127396,0,450,0,7,437,1601.83066361556
25989,25,25530,81,"Tasa de exámenes médico legales por presunto delito sexual contra niños, niñas y adolescentes",2018,4,7,829,844.390832328106,1,418,239.234449760766,6,411,1459.85401459854
25990,25,25535,81,"Tasa de exámenes médico legales por presunto delito sexual contra niños, niñas y adolescentes",2018,3,3,1463,205.058099794942,1,734,136.239782016349,2,729,274.348422496571
25991,25,25535,81,"Tasa de exámenes médico legales por presunto delito sexual contra niños, niñas y adolescentes",2018,4,2,1357,147.383935151069,1,673,148.588410104012,1,684,146.198830409357
25992,25,25572,81,"Tasa de exámenes médico legales por presunto delito sexual contra niños, niñas y adolescentes",2018,2,2,1901,105.207785376118,1,967,103.412616339193,1,934,107.066381156317
25993,25,25572,81,"Tasa de exámenes médico legales por presunto delito sexual contra niños, niñas y adolescentes",2018,3,4,2199,181.900864029104,0,1129,0,4,1070,373.831775700935
25994,25,25572,81,"Tasa de exámenes médico legales por presunto delito sexual contra niños, niñas y adolescentes",2018,4,5,2191,228.206298493838,0,1115,0,5,1076,464.684014869888
25995,25,25580,81,"Tasa de exámenes médico legales por presunto delito sexual contra niños, niñas y adolescentes",2018,3,1,311,321.543408360129,0,162,0,1,149,671.140939597315
25996,25,25580,81,"Tasa de exámenes médico legales por presunto delito sexual contra niños, niñas y adolescentes",2018,4,1,299,334.448160535117,0,153,0,1,146,684.931506849315
25997,25,25580,121,Tasa de exámenes médico legales por presunto delito sexual cuando la víctima está entre 18 y 28 años,2018,5,1,595,168.067226890756,0,302,0,1,293,341.296928327645
25998,25,25592,81,"Tasa de exámenes médico legales por presunto delito sexual contra niños, niñas y adolescentes",2018,3,4,506,790.513833992095,3,251,1195.21912350598,1,255,392.156862745098
25999,25,25592,81,"Tasa de exámenes médico legales por presunto delito sexual contra niños, niñas y adolescentes",2018,4,1,479,208.768267223382,0,249,0,1,230,434.782608695652
26000,25,25592,121,Tasa de exámenes médico legales por presunto delito sexual cuando la víctima está entre 18 y 28 años,2018,5,1,870,114.942528735632,0,479,0,1,391,255.754475703325
26001,25,25594,81,"Tasa de exámenes médico legales por presunto delito sexual contra niños, niñas y adolescentes",2018,2,1,579,172.711571675302,0,302,0,1,277,361.01083032491
26002,25,25594,81,"Tasa de exámenes médico legales por presunto delito sexual contra niños, niñas y adolescentes",2018,3,1,678,147.492625368732,0,361,0,1,317,315.457413249211
26003,25,25596,81,"Tasa de exámenes médico legales por presunto delito sexual contra niños, niñas y adolescentes",2018,3,6,1028,583.657587548638,5,527,948.76660341556,1,501,199.600798403194
26004,25,25596,81,"Tasa de exámenes médico legales por presunto delito sexual contra niños, niñas y adolescentes",2018,4,1,941,106.269925611052,1,495,202.020202020202,0,446,0
26005,25,25612,81,"Tasa de exámenes médico legales por presunto delito sexual contra niños, niñas y adolescentes",2018,3,1,898,111.358574610245,1,439,227.790432801822,0,459,0
26006,25,25612,81,"Tasa de exámenes médico legales por presunto delito sexual contra niños, niñas y adolescentes",2018,4,1,920,108.695652173913,0,439,0,1,481,207.900207900208
26007,25,25645,81,"Tasa de exámenes médico legales por presunto delito sexual contra niños, niñas y adolescentes",2018,3,2,1249,160.128102481986,1,631,158.478605388273,1,618,161.812297734628
26008,25,25645,81,"Tasa de exámenes médico legales por presunto delito sexual contra niños, niñas y adolescentes",2018,4,2,1274,156.985871271586,0,642,0,2,632,316.455696202532
26009,25,25649,81,"Tasa de exámenes médico legales por presunto delito sexual contra niños, niñas y adolescentes",2018,3,2,1123,178.094390026714,1,577,173.310225303293,1,546,183.150183150183
26010,25,25649,81,"Tasa de exámenes médico legales por presunto delito sexual contra niños, niñas y adolescentes",2018,4,2,1076,185.873605947955,0,547,0,2,529,378.071833648393
26011,25,25649,121,Tasa de exámenes médico legales por presunto delito sexual cuando la víctima está entre 18 y 28 años,2018,5,1,1981,50.4795557799091,0,965,0,1,1016,98.4251968503937
26012,25,25658,81,"Tasa de exámenes médico legales por presunto delito sexual contra niños, niñas y adolescentes",2018,3,2,1134,176.36684303351,0,595,0,2,539,371.057513914657
26013,25,25658,121,Tasa de exámenes médico legales por presunto delito sexual cuando la víctima está entre 18 y 28 años,2018,5,1,1748,57.20823798627,1,919,108.813928182807,0,829,0
26014,25,25662,81,"Tasa de exámenes médico legales por presunto delito sexual contra niños, niñas y adolescentes",2018,3,2,1011,197.82393669634,0,501,0,2,510,392.156862745098
26015,25,25662,81,"Tasa de exámenes médico legales por presunto delito sexual contra niños, niñas y adolescentes",2018,4,2,964,207.46887966805,1,470,212.765957446809,1,494,202.429149797571
26016,25,25718,81,"Tasa de exámenes médico legales por presunto delito sexual contra niños, niñas y adolescentes",2018,3,1,1023,97.7517106549365,0,525,0,1,498,200.803212851406
26017,25,25718,81,"Tasa de exámenes médico legales por presunto delito sexual contra niños, niñas y adolescentes",2018,4,2,992,201.612903225806,1,505,198.019801980198,1,487,205.338809034908
26018,25,25718,121,Tasa de exámenes médico legales por presunto delito sexual cuando la víctima está entre 18 y 28 años,2018,5,1,1861,53.7345513164965,0,954,0,1,907,110.253583241455
26019,25,25736,81,"Tasa de exámenes médico legales por presunto delito sexual contra niños, niñas y adolescentes",2018,2,3,1458,205.761316872428,0,752,0,3,706,424.929178470255
26020,25,25736,81,"Tasa de exámenes médico legales por presunto delito sexual contra niños, niñas y adolescentes",2018,3,3,1716,174.825174825175,0,883,0,3,833,360.144057623049
26021,25,25736,81,"Tasa de exámenes médico legales por presunto delito sexual contra niños, niñas y adolescentes",2018,4,3,1702,176.263219741481,0,852,0,3,850,352.941176470588
26022,25,25736,121,Tasa de exámenes médico legales por presunto delito sexual cuando la víctima está entre 18 y 28 años,2018,5,1,3029,33.0141961043249,0,1535,0,1,1494,66.9344042838019
26023,25,25740,81,"Tasa de exámenes médico legales por presunto delito sexual contra niños, niñas y adolescentes",2018,2,1,3490,28.6532951289398,1,1780,56.1797752808989,0,1710,0
26024,25,25740,81,"Tasa de exámenes médico legales por presunto delito sexual contra niños, niñas y adolescentes",2018,3,5,4037,123.85434728759,0,2050,0,5,1987,251.635631605435
26025,25,25740,81,"Tasa de exámenes médico legales por presunto delito sexual contra niños, niñas y adolescentes",2018,4,8,4266,187.529301453352,1,2179,45.8926112895824,7,2087,335.409678965022
26026,25,25740,121,Tasa de exámenes médico legales por presunto delito sexual cuando la víctima está entre 18 y 28 años,2018,5,2,8081,24.7494122014602,1,4168,23.9923224568138,1,3913,25.5558395093279
26027,25,25743,81,"Tasa de exámenes médico legales por presunto delito sexual contra niños, niñas y adolescentes",2018,2,11,1858,592.034445640474,4,954,419.287211740042,7,904,774.336283185841
26028,25,25743,81,"Tasa de exámenes médico legales por presunto delito sexual contra niños, niñas y adolescentes",2018,3,7,2120,330.188679245283,0,1092,0,7,1028,680.933852140078
26029,25,25743,81,"Tasa de exámenes médico legales por presunto delito sexual contra niños, niñas y adolescentes",2018,4,6,2159,277.906438165818,1,1108,90.2527075812274,5,1051,475.737392959087
26030,25,25743,121,Tasa de exámenes médico legales por presunto delito sexual cuando la víctima está entre 18 y 28 años,2018,5,1,4134,24.1896468311563,0,2059,0,1,2075,48.1927710843373
26031,25,25745,81,"Tasa de exámenes médico legales por presunto delito sexual contra niños, niñas y adolescentes",2018,2,3,1384,216.763005780347,1,709,141.043723554302,2,675,296.296296296296
26032,25,25745,81,"Tasa de exámenes médico legales por presunto delito sexual contra niños, niñas y adolescentes",2018,3,3,1596,187.96992481203,1,806,124.069478908189,2,790,253.164556962025
26033,25,25745,81,"Tasa de exámenes médico legales por presunto delito sexual contra niños, niñas y adolescentes",2018,4,4,1519,263.331138907176,0,757,0,4,762,524.9343832021
26034,25,25745,121,Tasa de exámenes médico legales por presunto delito sexual cuando la víctima está entre 18 y 28 años,2018,5,2,2658,75.2445447705041,0,1349,0,2,1309,152.788388082506
26035,25,25754,81,"Tasa de exámenes médico legales por presunto delito sexual contra niños, niñas y adolescentes",2018,2,59,49465,119.276255938542,13,25358,51.2658727028946,46,24107,190.815945575974
26036,25,25754,81,"Tasa de exámenes médico legales por presunto delito sexual contra niños, niñas y adolescentes",2018,3,122,57969,210.45731339164,17,29607,57.4188536494748,105,28362,370.213666173048
26037,25,25754,81,"Tasa de exámenes médico legales por presunto delito sexual contra niños, niñas y adolescentes",2018,4,142,57827,245.560032510765,9,29455,30.5550840264811,133,28372,468.77202876075
26038,25,25754,121,Tasa de exámenes médico legales por presunto delito sexual cuando la víctima está entre 18 y 28 años,2018,5,25,106478,23.4790285317155,1,53325,1.87529301453352,24,53153,45.152672473802
26039,25,25754,81,"Tasa de exámenes médico legales por presunto delito sexual contra niños, niñas y adolescentes",2018,1,1,10032,9.96810207336523,0,5146,0,1,4886,20.4666393778142
26040,25,25758,81,"Tasa de exámenes médico legales por presunto delito sexual contra niños, niñas y adolescentes",2018,2,1,2447,40.8663669799755,0,1252,0,1,1195,83.6820083682008
26041,25,25758,81,"Tasa de exámenes médico legales por presunto delito sexual contra niños, niñas y adolescentes",2018,3,2,2927,68.3293474547318,0,1488,0,2,1439,138.985406532314
26042,25,25758,81,"Tasa de exámenes médico legales por presunto delito sexual contra niños, niñas y adolescentes",2018,4,2,2998,66.711140760507,1,1529,65.402223675605,1,1469,68.073519400953
26043,25,25769,81,"Tasa de exámenes médico legales por presunto delito sexual contra niños, niñas y adolescentes",2018,2,5,1391,359.453630481668,1,707,141.442715700141,4,684,584.795321637427
26044,25,25769,81,"Tasa de exámenes médico legales por presunto delito sexual contra niños, niñas y adolescentes",2018,3,4,1655,241.691842900302,0,834,0,4,821,487.21071863581
26045,25,25769,81,"Tasa de exámenes médico legales por presunto delito sexual contra niños, niñas y adolescentes",2018,4,3,1651,181.708055723804,1,843,118.623962040332,2,808,247.524752475248
26046,25,25772,81,"Tasa de exámenes médico legales por presunto delito sexual contra niños, niñas y adolescentes",2018,4,3,2349,127.713920817369,0,1144,0,3,1205,248.96265560166
26047,25,25777,81,"Tasa de exámenes médico legales por presunto delito sexual contra niños, niñas y adolescentes",2018,2,1,563,177.619893428064,0,285,0,1,278,359.712230215827
26048,25,25777,81,"Tasa de exámenes médico legales por presunto delito sexual contra niños, niñas y adolescentes",2018,3,2,642,311.526479750779,0,318,0,2,324,617.283950617284
26049,25,25779,81,"Tasa de exámenes médico legales por presunto delito sexual contra niños, niñas y adolescentes",2018,2,1,1451,68.9179875947622,0,741,0,1,710,140.845070422535
26050,25,25779,81,"Tasa de exámenes médico legales por presunto delito sexual contra niños, niñas y adolescentes",2018,3,4,1641,243.75380865326,0,832,0,4,809,494.437577255871
26051,25,25785,81,"Tasa de exámenes médico legales por presunto delito sexual contra niños, niñas y adolescentes",2018,3,1,2899,34.494653328734,0,1485,0,1,1414,70.7213578500707
26052,25,25785,81,"Tasa de exámenes médico legales por presunto delito sexual contra niños, niñas y adolescentes",2018,4,1,3079,32.478077297824,0,1567,0,1,1512,66.1375661375661
26053,25,25793,121,Tasa de exámenes médico legales por presunto delito sexual cuando la víctima está entre 18 y 28 años,2018,5,1,1791,55.8347292015634,0,976,0,1,815,122.699386503067
26054,25,25797,81,"Tasa de exámenes médico legales por presunto delito sexual contra niños, niñas y adolescentes",2018,2,1,1052,95.0570342205323,0,534,0,1,518,193.050193050193
26055,25,25797,81,"Tasa de exámenes médico legales por presunto delito sexual contra niños, niñas y adolescentes",2018,3,4,1193,335.289186923722,0,591,0,4,602,664.451827242525
26056,25,25797,81,"Tasa de exámenes médico legales por presunto delito sexual contra niños, niñas y adolescentes",2018,4,4,1190,336.134453781513,0,579,0,4,611,654.664484451719
26057,25,25799,81,"Tasa de exámenes médico legales por presunto delito sexual contra niños, niñas y adolescentes",2018,2,1,1829,54.6746856205577,0,941,0,1,888,112.612612612613
26058,25,25799,81,"Tasa de exámenes médico legales por presunto delito sexual contra niños, niñas y adolescentes",2018,3,5,2126,235.183443085607,1,1088,91.9117647058823,4,1038,385.356454720617
26059,25,25799,81,"Tasa de exámenes médico legales por presunto delito sexual contra niños, niñas y adolescentes",2018,4,6,2224,269.784172661871,0,1128,0,6,1096,547.445255474453
26060,25,25799,121,Tasa de exámenes médico legales por presunto delito sexual cuando la víctima está entre 18 y 28 años,2018,5,3,3941,76.1228114691703,0,1992,0,3,1949,153.925089789636
26061,25,25805,81,"Tasa de exámenes médico legales por presunto delito sexual contra niños, niñas y adolescentes",2018,2,1,452,221.238938053097,1,227,440.528634361234,0,225,0
26062,25,25805,81,"Tasa de exámenes médico legales por presunto delito sexual contra niños, niñas y adolescentes",2018,4,1,562,177.935943060498,0,271,0,1,291,343.642611683849
26063,25,25807,81,"Tasa de exámenes médico legales por presunto delito sexual contra niños, niñas y adolescentes",2018,4,1,330,303.030303030303,1,165,606.060606060606,0,165,0
26064,25,25807,121,Tasa de exámenes médico legales por presunto delito sexual cuando la víctima está entre 18 y 28 años,2018,5,1,575,173.913043478261,0,291,0,1,284,352.112676056338
26065,25,25815,81,"Tasa de exámenes médico legales por presunto delito sexual contra niños, niñas y adolescentes",2018,2,1,1501,66.6222518321119,0,776,0,1,725,137.931034482759
26066,25,25815,81,"Tasa de exámenes médico legales por presunto delito sexual contra niños, niñas y adolescentes",2018,4,5,1722,290.360046457607,0,888,0,5,834,599.520383693046
26067,25,25817,81,"Tasa de exámenes médico legales por presunto delito sexual contra niños, niñas y adolescentes",2018,2,1,3509,28.4981476204047,0,1803,0,1,1706,58.6166471277843
26068,25,25817,81,"Tasa de exámenes médico legales por presunto delito sexual contra niños, niñas y adolescentes",2018,3,5,4102,121.891760117016,0,2110,0,5,1992,251.004016064257
26069,25,25817,81,"Tasa de exámenes médico legales por presunto delito sexual contra niños, niñas y adolescentes",2018,4,4,4126,96.9461948618517,0,2100,0,4,2026,197.433366238894
26070,25,25817,121,Tasa de exámenes médico legales por presunto delito sexual cuando la víctima está entre 18 y 28 años,2018,5,1,6932,14.4258511252164,0,3430,0,1,3502,28.5551113649343
26071,25,25839,81,"Tasa de exámenes médico legales por presunto delito sexual contra niños, niñas y adolescentes",2018,3,1,1184,84.4594594594595,0,621,0,1,563,177.619893428064
26072,25,25839,81,"Tasa de exámenes médico legales por presunto delito sexual contra niños, niñas y adolescentes",2018,4,2,1168,171.232876712329,1,654,152.905198776758,1,514,194.552529182879
26073,25,25841,81,"Tasa de exámenes médico legales por presunto delito sexual contra niños, niñas y adolescentes",2018,3,1,560,178.571428571429,0,300,0,1,260,384.615384615385
26074,25,25841,81,"Tasa de exámenes médico legales por presunto delito sexual contra niños, niñas y adolescentes",2018,4,1,530,188.679245283019,0,286,0,1,244,409.83606557377
26075,25,25843,81,"Tasa de exámenes médico legales por presunto delito sexual contra niños, niñas y adolescentes",2018,2,5,3761,132.94336612603,0,1912,0,5,1849,270.416441319632
26076,25,25843,81,"Tasa de exámenes médico legales por presunto delito sexual contra niños, niñas y adolescentes",2018,3,6,4337,138.344477749596,2,2168,92.2509225092251,4,2169,184.416781927155
26077,25,25843,81,"Tasa de exámenes médico legales por presunto delito sexual contra niños, niñas y adolescentes",2018,4,19,4208,451.520912547528,0,2067,0,19,2141,887.435777673984
26078,25,25843,121,Tasa de exámenes médico legales por presunto delito sexual cuando la víctima está entre 18 y 28 años,2018,5,8,7682,104.139546992971,1,3686,27.1296798697775,7,3996,175.175175175175
26079,25,25843,81,"Tasa de exámenes médico legales por presunto delito sexual contra niños, niñas y adolescentes",2018,1,1,765,130.718954248366,0,393,0,1,372,268.817204301075
26080,25,25845,81,"Tasa de exámenes médico legales por presunto delito sexual contra niños, niñas y adolescentes",2018,2,1,831,120.336943441637,0,425,0,1,406,246.305418719212
26081,25,25862,81,"Tasa de exámenes médico legales por presunto delito sexual contra niños, niñas y adolescentes",2018,3,2,796,251.256281407035,2,406,492.610837438424,0,390,0
26082,25,25862,81,"Tasa de exámenes médico legales por presunto delito sexual contra niños, niñas y adolescentes",2018,4,2,750,266.666666666667,0,365,0,2,385,519.480519480519
26083,25,25867,81,"Tasa de exámenes médico legales por presunto delito sexual contra niños, niñas y adolescentes",2018,4,1,397,251.889168765743,0,185,0,1,212,471.698113207547
26084,25,25871,81,"Tasa de exámenes médico legales por presunto delito sexual contra niños, niñas y adolescentes",2018,2,1,217,460.829493087558,0,111,0,1,106,943.396226415094
26085,25,25871,81,"Tasa de exámenes médico legales por presunto delito sexual contra niños, niñas y adolescentes",2018,4,2,223,896.860986547085,2,114,1754.38596491228,0,109,0
26086,25,25873,81,"Tasa de exámenes médico legales por presunto delito sexual contra niños, niñas y adolescentes",2018,4,8,2452,326.26427406199,1,1296,77.1604938271605,7,1156,605.536332179931
26087,25,25875,81,"Tasa de exámenes médico legales por presunto delito sexual contra niños, niñas y adolescentes",2018,2,3,2168,138.376383763838,0,1110,0,3,1058,283.553875236295
26088,25,25875,81,"Tasa de exámenes médico legales por presunto delito sexual contra niños, niñas y adolescentes",2018,3,11,2572,427.682737169518,3,1301,230.591852421214,8,1271,629.425649095201
26089,25,25875,81,"Tasa de exámenes médico legales por presunto delito sexual contra niños, niñas y adolescentes",2018,4,18,2537,709.499408750493,0,1286,0,18,1251,1438.84892086331
26090,25,25875,121,Tasa de exámenes médico legales por presunto delito sexual cuando la víctima está entre 18 y 28 años,2018,5,2,4781,41.8322526668061,1,2448,40.8496732026144,1,2333,42.863266180883
26091,25,25878,81,"Tasa de exámenes médico legales por presunto delito sexual contra niños, niñas y adolescentes",2018,3,3,1282,234.009360374415,0,658,0,3,624,480.769230769231
26092,25,25878,81,"Tasa de exámenes médico legales por presunto delito sexual contra niños, niñas y adolescentes",2018,4,1,1263,79.1765637371338,0,643,0,1,620,161.290322580645
26093,25,25878,121,Tasa de exámenes médico legales por presunto delito sexual cuando la víctima está entre 18 y 28 años,2018,5,2,2502,79.9360511590727,0,1302,0,2,1200,166.666666666667
26094,25,25885,81,"Tasa de exámenes médico legales por presunto delito sexual contra niños, niñas y adolescentes",2018,2,1,1702,58.7544065804935,0,885,0,1,817,122.399020807834
26095,25,25885,81,"Tasa de exámenes médico legales por presunto delito sexual contra niños, niñas y adolescentes",2018,3,1,1871,53.4473543559594,0,990,0,1,881,113.507377979569
26096,25,25898,81,"Tasa de exámenes médico legales por presunto delito sexual contra niños, niñas y adolescentes",2018,2,1,586,170.648464163823,0,296,0,1,290,344.827586206897
26097,25,25898,121,Tasa de exámenes médico legales por presunto delito sexual cuando la víctima está entre 18 y 28 años,2018,5,1,977,102.354145342886,0,495,0,1,482,207.46887966805
26098,25,25899,81,"Tasa de exámenes médico legales por presunto delito sexual contra niños, niñas y adolescentes",2018,2,15,10764,139.353400222965,2,5509,36.3042294427301,13,5255,247.383444338725
26099,25,25899,81,"Tasa de exámenes médico legales por presunto delito sexual contra niños, niñas y adolescentes",2018,3,14,13113,106.764279722413,5,6730,74.2942050520059,9,6383,140.999530001567
26100,25,25899,81,"Tasa de exámenes médico legales por presunto delito sexual contra niños, niñas y adolescentes",2018,4,20,13327,150.071283859833,4,6749,59.2680397095866,16,6578,243.235025843722
26101,25,25899,121,Tasa de exámenes médico legales por presunto delito sexual cuando la víctima está entre 18 y 28 años,2018,5,3,23890,12.5575554625366,1,11969,8.35491686857716,2,11921,16.7771160137572
26102,27,27001,81,"Tasa de exámenes médico legales por presunto delito sexual contra niños, niñas y adolescentes",2018,2,17,14264,119.181155356141,4,7259,55.1040088166414,13,7005,185.581727337616
26103,27,27001,81,"Tasa de exámenes médico legales por presunto delito sexual contra niños, niñas y adolescentes",2018,3,38,17053,222.834691843077,5,8687,57.5572694831357,33,8366,394.453741333971
26104,27,27001,81,"Tasa de exámenes médico legales por presunto delito sexual contra niños, niñas y adolescentes",2018,4,48,15799,303.81669725932,1,8076,12.3823675086677,47,7723,608.57179852389
26105,27,27001,121,Tasa de exámenes médico legales por presunto delito sexual cuando la víctima está entre 18 y 28 años,2018,5,19,25158,75.522696557755,1,13030,7.67459708365311,18,12128,148.416886543536
26106,27,27001,81,"Tasa de exámenes médico legales por presunto delito sexual contra niños, niñas y adolescentes",2018,1,1,2786,35.8937544867193,0,1422,0,1,1364,73.3137829912023
26107,27,27006,81,"Tasa de exámenes médico legales por presunto delito sexual contra niños, niñas y adolescentes",2018,3,1,1124,88.9679715302491,0,546,0,1,578,173.010380622837
26108,27,27025,81,"Tasa de exámenes médico legales por presunto delito sexual contra niños, niñas y adolescentes",2018,4,5,5799,86.2217623728229,1,2997,33.3667000333667,4,2802,142.755174875089
26109,27,27050,81,"Tasa de exámenes médico legales por presunto delito sexual contra niños, niñas y adolescentes",2018,2,1,1354,73.8552437223043,0,685,0,1,669,149.476831091181
26110,27,27050,81,"Tasa de exámenes médico legales por presunto delito sexual contra niños, niñas y adolescentes",2018,3,3,1586,189.155107187894,1,811,123.304562268804,2,775,258.064516129032
26111,27,27050,121,Tasa de exámenes médico legales por presunto delito sexual cuando la víctima está entre 18 y 28 años,2018,5,1,2217,45.10599909788,0,1148,0,1,1069,93.5453695042095
26112,27,27073,81,"Tasa de exámenes médico legales por presunto delito sexual contra niños, niñas y adolescentes",2018,2,1,1002,99.8003992015968,0,507,0,1,495,202.020202020202
26113,27,27073,81,"Tasa de exámenes médico legales por presunto delito sexual contra niños, niñas y adolescentes",2018,4,1,1073,93.1966449207828,0,556,0,1,517,193.423597678917
26114,27,27075,81,"Tasa de exámenes médico legales por presunto delito sexual contra niños, niñas y adolescentes",2018,3,1,1326,75.4147812971342,0,668,0,1,658,151.975683890577
26115,27,27077,81,"Tasa de exámenes médico legales por presunto delito sexual contra niños, niñas y adolescentes",2018,3,4,2856,140.056022408964,0,1485,0,4,1371,291.757840991977
26116,27,27099,81,"Tasa de exámenes médico legales por presunto delito sexual contra niños, niñas y adolescentes",2018,2,1,1272,78.6163522012579,0,646,0,1,626,159.744408945687
26117,27,27099,81,"Tasa de exámenes médico legales por presunto delito sexual contra niños, niñas y adolescentes",2018,3,1,1524,65.6167979002625,0,780,0,1,744,134.408602150538
26118,27,27135,81,"Tasa de exámenes médico legales por presunto delito sexual contra niños, niñas y adolescentes",2018,3,2,1154,173.310225303293,0,586,0,2,568,352.112676056338
26119,27,27135,81,"Tasa de exámenes médico legales por presunto delito sexual contra niños, niñas y adolescentes",2018,4,2,1011,197.82393669634,0,517,0,2,494,404.858299595142
26120,27,27160,81,"Tasa de exámenes médico legales por presunto delito sexual contra niños, niñas y adolescentes",2018,3,1,1165,85.8369098712446,0,592,0,1,573,174.520069808028
26121,27,27160,81,"Tasa de exámenes médico legales por presunto delito sexual contra niños, niñas y adolescentes",2018,4,1,1184,84.4594594594595,0,627,0,1,557,179.533213644524
26122,27,27205,81,"Tasa de exámenes médico legales por presunto delito sexual contra niños, niñas y adolescentes",2018,2,1,1794,55.7413600891862,0,900,0,1,894,111.856823266219
26123,27,27205,81,"Tasa de exámenes médico legales por presunto delito sexual contra niños, niñas y adolescentes",2018,3,8,2122,377.002827521206,1,1038,96.3391136801541,7,1084,645.756457564576
26124,27,27205,81,"Tasa de exámenes médico legales por presunto delito sexual contra niños, niñas y adolescentes",2018,4,3,2067,145.137880986938,0,983,0,3,1084,276.752767527675
26125,27,27205,121,Tasa de exámenes médico legales por presunto delito sexual cuando la víctima está entre 18 y 28 años,2018,5,2,3604,55.4938956714761,2,1780,112.359550561798,0,1824,0
26126,27,27245,81,"Tasa de exámenes médico legales por presunto delito sexual contra niños, niñas y adolescentes",2018,4,2,1999,100.050025012506,0,1007,0,2,992,201.612903225806
26127,27,27361,81,"Tasa de exámenes médico legales por presunto delito sexual contra niños, niñas y adolescentes",2018,2,4,3048,131.233595800525,1,1529,65.402223675605,3,1519,197.498354180382
26128,27,27361,81,"Tasa de exámenes médico legales por presunto delito sexual contra niños, niñas y adolescentes",2018,3,9,3642,247.116968698517,1,1783,56.0852495793606,8,1859,430.338891877353
26129,27,27361,81,"Tasa de exámenes médico legales por presunto delito sexual contra niños, niñas y adolescentes",2018,4,6,3199,187.558612066271,0,1556,0,6,1643,365.185636031649
26130,27,27361,121,Tasa de exámenes médico legales por presunto delito sexual cuando la víctima está entre 18 y 28 años,2018,5,4,5710,70.0525394045534,0,2728,0,4,2982,134.138162307176
26131,27,27372,81,"Tasa de exámenes médico legales por presunto delito sexual contra niños, niñas y adolescentes",2018,4,1,431,232.018561484919,0,211,0,1,220,454.545454545455
26132,27,27413,81,"Tasa de exámenes médico legales por presunto delito sexual contra niños, niñas y adolescentes",2018,2,2,1397,143.16392269148199,2,691,289.435600578871,0,706,0
26133,27,27425,81,"Tasa de exámenes médico legales por presunto delito sexual contra niños, niñas y adolescentes",2018,3,1,3978,25.1382604323781,0,1996,0,1,1982,50.4540867810293
26134,27,27430,81,"Tasa de exámenes médico legales por presunto delito sexual contra niños, niñas y adolescentes",2018,3,1,2151,46.4900046490005,1,1072,93.2835820895522,0,1079,0
26135,27,27430,81,"Tasa de exámenes médico legales por presunto delito sexual contra niños, niñas y adolescentes",2018,4,1,1933,51.7330574236937,0,967,0,1,966,103.51966873706
26136,27,27430,121,Tasa de exámenes médico legales por presunto delito sexual cuando la víctima está entre 18 y 28 años,2018,5,1,2854,35.0385423966363,0,1475,0,1,1379,72.5163161711385
26137,27,27450,81,"Tasa de exámenes médico legales por presunto delito sexual contra niños, niñas y adolescentes",2018,2,1,2263,44.1891294741494,0,1148,0,1,1115,89.6860986547085
26138,27,27450,81,"Tasa de exámenes médico legales por presunto delito sexual contra niños, niñas y adolescentes",2018,3,2,2539,78.7711697518708,0,1288,0,2,1251,159.872102318145
26139,27,27450,81,"Tasa de exámenes médico legales por presunto delito sexual contra niños, niñas y adolescentes",2018,4,1,2205,45.3514739229025,0,1112,0,1,1093,91.4913083257091
26140,27,27491,81,"Tasa de exámenes médico legales por presunto delito sexual contra niños, niñas y adolescentes",2018,3,1,1187,84.24599831508,0,612,0,1,575,173.913043478261
26141,27,27491,81,"Tasa de exámenes médico legales por presunto delito sexual contra niños, niñas y adolescentes",2018,4,3,1080,277.777777777778,0,562,0,3,518,579.150579150579
26142,27,27495,81,"Tasa de exámenes médico legales por presunto delito sexual contra niños, niñas y adolescentes",2018,4,1,1221,81.9000819000819,0,609,0,1,612,163.398692810458
26143,27,27495,121,Tasa de exámenes médico legales por presunto delito sexual cuando la víctima está entre 18 y 28 años,2018,5,1,1797,55.6483027267668,0,925,0,1,872,114.678899082569
26144,27,27580,81,"Tasa de exámenes médico legales por presunto delito sexual contra niños, niñas y adolescentes",2018,3,3,1522,197.109067017083,0,744,0,3,778,385.60411311054
26145,27,27615,81,"Tasa de exámenes médico legales por presunto delito sexual contra niños, niñas y adolescentes",2018,2,1,4032,24.8015873015873,0,2044,0,1,1988,50.3018108651912
26146,27,27615,81,"Tasa de exámenes médico legales por presunto delito sexual contra niños, niñas y adolescentes",2018,4,1,4130,24.2130750605327,0,2082,0,1,2048,48.828125
26147,27,27615,121,Tasa de exámenes médico legales por presunto delito sexual cuando la víctima está entre 18 y 28 años,2018,5,1,6637,15.0670483652253,0,3409,0,1,3228,30.9789343246592
26148,27,27745,81,"Tasa de exámenes médico legales por presunto delito sexual contra niños, niñas y adolescentes",2018,2,1,529,189.035916824197,0,266,0,1,263,380.228136882129
26149,27,27745,81,"Tasa de exámenes médico legales por presunto delito sexual contra niños, niñas y adolescentes",2018,4,1,572,174.825174825175,0,287,0,1,285,350.877192982456
26150,27,27787,81,"Tasa de exámenes médico legales por presunto delito sexual contra niños, niñas y adolescentes",2018,3,6,2914,205.902539464653,0,1458,0,6,1456,412.087912087912
26151,27,27787,81,"Tasa de exámenes médico legales por presunto delito sexual contra niños, niñas y adolescentes",2018,4,9,2596,346.687211093991,0,1290,0,9,1306,689.127105666156
26152,27,27787,121,Tasa de exámenes médico legales por presunto delito sexual cuando la víctima está entre 18 y 28 años,2018,5,1,4189,23.872045834328,0,2070,0,1,2119,47.192071731949
26153,27,27810,81,"Tasa de exámenes médico legales por presunto delito sexual contra niños, niñas y adolescentes",2018,3,5,1530,326.797385620915,1,781,128.040973111396,4,749,534.045393858478
26154,27,27810,81,"Tasa de exámenes médico legales por presunto delito sexual contra niños, niñas y adolescentes",2018,4,1,1396,71.6332378223496,0,717,0,1,679,147.275405007364
26155,41,41001,81,"Tasa de exámenes médico legales por presunto delito sexual contra niños, niñas y adolescentes",2018,2,53,25437,208.357903840862,13,12922,100.603621730382,40,12515,319.616460247703
26156,41,41001,81,"Tasa de exámenes médico legales por presunto delito sexual contra niños, niñas y adolescentes",2018,3,111,32602,340.469909821483,17,16494,103.067782223839,94,16108,583.560963496399
26157,41,41001,81,"Tasa de exámenes médico legales por presunto delito sexual contra niños, niñas y adolescentes",2018,4,140,34278,408.425229009861,20,17056,117.260787992495,120,17222,696.783184299152
26158,41,41001,121,Tasa de exámenes médico legales por presunto delito sexual cuando la víctima está entre 18 y 28 años,2018,5,38,67720,56.1134081512109,3,33482,8.96003822949645,35,34238,102.225597289561
26159,41,41006,81,"Tasa de exámenes médico legales por presunto delito sexual contra niños, niñas y adolescentes",2018,2,1,4292,23.2991612301957,0,2201,0,1,2091,47.8240076518412
26160,41,41006,81,"Tasa de exámenes médico legales por presunto delito sexual contra niños, niñas y adolescentes",2018,3,17,4701,361.62518613061,2,2416,82.7814569536424,15,2285,656.455142231947
26161,41,41006,81,"Tasa de exámenes médico legales por presunto delito sexual contra niños, niñas y adolescentes",2018,4,18,4507,399.378744175727,0,2297,0,18,2210,814.47963800905
26162,41,41006,121,Tasa de exámenes médico legales por presunto delito sexual cuando la víctima está entre 18 y 28 años,2018,5,2,7221,27.6969948760559,0,3677,0,2,3544,56.4334085778781
26163,41,41016,81,"Tasa de exámenes médico legales por presunto delito sexual contra niños, niñas y adolescentes",2018,2,1,2978,33.5795836131632,0,1522,0,1,1456,68.6813186813187
26164,41,41016,81,"Tasa de exámenes médico legales por presunto delito sexual contra niños, niñas y adolescentes",2018,3,3,3529,85.0099178237461,0,1830,0,3,1699,176.574455562095
26165,41,41016,81,"Tasa de exámenes médico legales por presunto delito sexual contra niños, niñas y adolescentes",2018,4,2,3353,59.6480763495377,1,1725,57.9710144927536,1,1628,61.4250614250614
26166,41,41016,121,Tasa de exámenes médico legales por presunto delito sexual cuando la víctima está entre 18 y 28 años,2018,5,4,5570,71.8132854578097,0,2826,0,4,2744,145.772594752187
26167,41,41020,81,"Tasa de exámenes médico legales por presunto delito sexual contra niños, niñas y adolescentes",2018,3,10,2888,346.260387811634,1,1499,66.711140760507,9,1389,647.948164146868
26168,41,41020,81,"Tasa de exámenes médico legales por presunto delito sexual contra niños, niñas y adolescentes",2018,4,14,2711,516.414607156031,1,1408,71.0227272727273,13,1303,997.697620874904
26169,41,41020,121,Tasa de exámenes médico legales por presunto delito sexual cuando la víctima está entre 18 y 28 años,2018,5,2,4491,44.5335114673792,0,2295,0,2,2196,91.0746812386157
26170,41,41026,81,"Tasa de exámenes médico legales por presunto delito sexual contra niños, niñas y adolescentes",2018,2,1,488,204.918032786885,0,245,0,1,243,411.522633744856
26171,41,41078,81,"Tasa de exámenes médico legales por presunto delito sexual contra niños, niñas y adolescentes",2018,4,4,1061,377.002827521206,0,561,0,4,500,800
26172,41,41078,121,Tasa de exámenes médico legales por presunto delito sexual cuando la víctima está entre 18 y 28 años,2018,5,1,1957,51.0986203372509,0,999,0,1,958,104.384133611691
26173,41,41132,81,"Tasa de exámenes médico legales por presunto delito sexual contra niños, niñas y adolescentes",2018,2,1,3134,31.9081046585833,1,1595,62.6959247648903,0,1539,0
26174,41,41132,81,"Tasa de exámenes médico legales por presunto delito sexual contra niños, niñas y adolescentes",2018,3,3,3782,79.3231094658911,0,1928,0,3,1854,161.812297734628
26175,41,41132,81,"Tasa de exámenes médico legales por presunto delito sexual contra niños, niñas y adolescentes",2018,4,6,3778,158.814187400741,1,1911,52.3286237571952,5,1867,267.809319764328
26176,41,41206,81,"Tasa de exámenes médico legales por presunto delito sexual contra niños, niñas y adolescentes",2018,3,10,1448,690.60773480663,0,752,0,10,696,1436.7816091954
26177,41,41206,81,"Tasa de exámenes médico legales por presunto delito sexual contra niños, niñas y adolescentes",2018,4,1,1394,71.7360114777618,0,738,0,1,656,152.439024390244
26178,41,41244,81,"Tasa de exámenes médico legales por presunto delito sexual contra niños, niñas y adolescentes",2018,3,2,564,354.609929078014,0,281,0,2,283,706.713780918728
26179,41,41244,81,"Tasa de exámenes médico legales por presunto delito sexual contra niños, niñas y adolescentes",2018,4,3,522,574.712643678161,0,260,0,3,262,1145.03816793893
26180,41,41298,81,"Tasa de exámenes médico legales por presunto delito sexual contra niños, niñas y adolescentes",2018,2,10,10301,97.0779535967382,0,5279,0,10,5022,199.123855037834
26181,41,41298,81,"Tasa de exámenes médico legales por presunto delito sexual contra niños, niñas y adolescentes",2018,3,8,11581,69.0786633278646,1,5949,16.8095478231636,7,5632,124.289772727273
26182,41,41298,81,"Tasa de exámenes médico legales por presunto delito sexual contra niños, niñas y adolescentes",2018,4,17,11655,145.860145860146,1,6146,16.2707452001302,16,5509,290.433835541841
26183,41,41298,121,Tasa de exámenes médico legales por presunto delito sexual cuando la víctima está entre 18 y 28 años,2018,5,1,20631,4.84707479036402,1,11635,8.59475719810915,0,8996,0
26184,41,41306,81,"Tasa de exámenes médico legales por presunto delito sexual contra niños, niñas y adolescentes",2018,4,3,4016,74.7011952191235,0,2043,0,3,1973,152.05271160669
26185,41,41319,81,"Tasa de exámenes médico legales por presunto delito sexual contra niños, niñas y adolescentes",2018,4,1,2695,37.1057513914657,0,1384,0,1,1311,76.27765064836
26186,41,41349,81,"Tasa de exámenes médico legales por presunto delito sexual contra niños, niñas y adolescentes",2018,3,1,812,123.152709359606,0,439,0,1,373,268.096514745308
26187,41,41349,81,"Tasa de exámenes médico legales por presunto delito sexual contra niños, niñas y adolescentes",2018,4,4,774,516.795865633075,0,418,0,4,356,1123.59550561798
26188,41,41357,81,"Tasa de exámenes médico legales por presunto delito sexual contra niños, niñas y adolescentes",2018,3,4,1451,275.671950379049,0,762,0,4,689,580.55152394775
26189,41,41357,81,"Tasa de exámenes médico legales por presunto delito sexual contra niños, niñas y adolescentes",2018,4,3,1382,217.076700434153,0,742,0,3,640,468.75
26190,41,41359,81,"Tasa de exámenes médico legales por presunto delito sexual contra niños, niñas y adolescentes",2018,2,5,2957,169.090294217112,1,1511,66.1813368630046,4,1446,276.625172890733
26191,41,41359,81,"Tasa de exámenes médico legales por presunto delito sexual contra niños, niñas y adolescentes",2018,3,7,3270,214.067278287462,1,1667,59.9880023995201,6,1603,374.298190892077
26192,41,41359,81,"Tasa de exámenes médico legales por presunto delito sexual contra niños, niñas y adolescentes",2018,4,6,3218,186.451211932878,1,1668,59.9520383693046,5,1550,322.58064516129
26193,41,41359,121,Tasa de exámenes médico legales por presunto delito sexual cuando la víctima está entre 18 y 28 años,2018,5,4,5774,69.2760651195012,0,2960,0,4,2814,142.146410803127
26194,41,41378,81,"Tasa de exámenes médico legales por presunto delito sexual contra niños, niñas y adolescentes",2018,3,2,1873,106.780565936999,1,948,105.485232067511,1,925,108.108108108108
26195,41,41378,81,"Tasa de exámenes médico legales por presunto delito sexual contra niños, niñas y adolescentes",2018,4,4,1777,225.098480585256,2,903,221.483942414175,2,874,228.83295194508
26196,41,41378,121,Tasa de exámenes médico legales por presunto delito sexual cuando la víctima está entre 18 y 28 años,2018,5,1,3031,32.9924117452986,0,1512,0,1,1519,65.8327847267939
26197,41,41396,81,"Tasa de exámenes médico legales por presunto delito sexual contra niños, niñas y adolescentes",2018,2,3,7283,41.1918165591103,0,3721,0,3,3562,84.2223469960696
26198,41,41396,81,"Tasa de exámenes médico legales por presunto delito sexual contra niños, niñas y adolescentes",2018,3,24,8277,289.960130482059,3,4245,70.6713780918728,21,4032,520.833333333333
26199,41,41396,81,"Tasa de exámenes médico legales por presunto delito sexual contra niños, niñas y adolescentes",2018,4,18,8146,220.967345936656,1,4231,23.6350744504845,17,3915,434.227330779055
26200,41,41396,121,Tasa de exámenes médico legales por presunto delito sexual cuando la víctima está entre 18 y 28 años,2018,5,2,13351,14.9801512995281,1,6848,14.6028037383178,1,6503,15.3775180685837
26201,41,41483,81,"Tasa de exámenes médico legales por presunto delito sexual contra niños, niñas y adolescentes",2018,2,2,745,268.456375838926,0,383,0,2,362,552.486187845304
26202,41,41483,81,"Tasa de exámenes médico legales por presunto delito sexual contra niños, niñas y adolescentes",2018,4,1,760,131.578947368421,0,405,0,1,355,281.69014084507
26203,41,41524,81,"Tasa de exámenes médico legales por presunto delito sexual contra niños, niñas y adolescentes",2018,2,3,3201,93.7207122774133,1,1631,61.3120784794605,2,1570,127.388535031847
26204,41,41524,81,"Tasa de exámenes médico legales por presunto delito sexual contra niños, niñas y adolescentes",2018,3,6,3806,157.645822385707,0,1939,0,6,1867,321.371183717193
26205,41,41524,81,"Tasa de exámenes médico legales por presunto delito sexual contra niños, niñas y adolescentes",2018,4,5,3758,133.049494411921,0,1929,0,5,1829,273.373428102788
26206,41,41530,81,"Tasa de exámenes médico legales por presunto delito sexual contra niños, niñas y adolescentes",2018,2,3,1293,232.018561484919,0,679,0,3,614,488.599348534202
26207,41,41530,81,"Tasa de exámenes médico legales por presunto delito sexual contra niños, niñas y adolescentes",2018,3,3,1445,207.612456747405,0,773,0,3,672,446.428571428571
26208,41,41530,81,"Tasa de exámenes médico legales por presunto delito sexual contra niños, niñas y adolescentes",2018,4,1,1409,70.97232079489,0,751,0,1,658,151.975683890577
26209,41,41530,121,Tasa de exámenes médico legales por presunto delito sexual cuando la víctima está entre 18 y 28 años,2018,5,2,2510,79.6812749003984,0,1287,0,2,1223,163.532297628782
26210,41,41548,81,"Tasa de exámenes médico legales por presunto delito sexual contra niños, niñas y adolescentes",2018,2,1,1517,65.9195781147001,0,781,0,1,736,135.869565217391
26211,41,41548,81,"Tasa de exámenes médico legales por presunto delito sexual contra niños, niñas y adolescentes",2018,3,4,1596,250.62656641604,0,833,0,4,763,524.246395806029
26212,41,41548,81,"Tasa de exámenes médico legales por presunto delito sexual contra niños, niñas y adolescentes",2018,4,4,1477,270.8192281652,0,768,0,4,709,564.174894217207
26213,41,41551,81,"Tasa de exámenes médico legales por presunto delito sexual contra niños, niñas y adolescentes",2018,2,14,13232,105.804111245466,2,6737,29.6868042155262,12,6495,184.757505773672
26214,41,41551,81,"Tasa de exámenes médico legales por presunto delito sexual contra niños, niñas y adolescentes",2018,3,24,15457,155.269457203856,6,7818,76.7459708365311,18,7639,235.6329362482
26215,41,41551,81,"Tasa de exámenes médico legales por presunto delito sexual contra niños, niñas y adolescentes",2018,4,29,15554,186.447216150186,5,7872,63.5162601626016,24,7682,312.418640978912
26216,41,41551,121,Tasa de exámenes médico legales por presunto delito sexual cuando la víctima está entre 18 y 28 años,2018,5,7,27237,25.7003341043434,0,13526,0,7,13711,51.0538983298082
26217,41,41615,81,"Tasa de exámenes médico legales por presunto delito sexual contra niños, niñas y adolescentes",2018,2,2,1752,114.155251141553,1,892,112.107623318386,1,860,116.279069767442
26218,41,41615,81,"Tasa de exámenes médico legales por presunto delito sexual contra niños, niñas y adolescentes",2018,3,7,2070,338.164251207729,1,1056,94.6969696969697,6,1014,591.715976331361
26219,41,41615,81,"Tasa de exámenes médico legales por presunto delito sexual contra niños, niñas y adolescentes",2018,4,4,1981,201.918223119637,0,1001,0,4,980,408.163265306122
26220,41,41615,121,Tasa de exámenes médico legales por presunto delito sexual cuando la víctima está entre 18 y 28 años,2018,5,2,3597,55.6018904642758,0,1796,0,2,1801,111.049416990561
26221,41,41660,81,"Tasa de exámenes médico legales por presunto delito sexual contra niños, niñas y adolescentes",2018,3,2,1574,127.064803049555,0,823,0,2,751,266.311584553928
26222,41,41660,81,"Tasa de exámenes médico legales por presunto delito sexual contra niños, niñas y adolescentes",2018,4,1,1475,67.7966101694915,0,772,0,1,703,142.247510668563
26223,41,41668,81,"Tasa de exámenes médico legales por presunto delito sexual contra niños, niñas y adolescentes",2018,2,2,3200,62.5,0,1622,0,2,1578,126.742712294043
26224,41,41668,81,"Tasa de exámenes médico legales por presunto delito sexual contra niños, niñas y adolescentes",2018,3,4,3736,107.066381156317,0,1895,0,4,1841,217.273221075502
26225,41,41668,81,"Tasa de exámenes médico legales por presunto delito sexual contra niños, niñas y adolescentes",2018,4,9,3659,245.968843946433,2,1857,107.700592353258,7,1802,388.457269700333
26226,41,41668,121,Tasa de exámenes médico legales por presunto delito sexual cuando la víctima está entre 18 y 28 años,2018,5,4,6953,57.5291241190853,0,3559,0,4,3394,117.855038302887
26227,41,41676,81,"Tasa de exámenes médico legales por presunto delito sexual contra niños, niñas y adolescentes",2018,3,1,1418,70.5218617771509,0,748,0,1,670,149.253731343284
26228,41,41770,81,"Tasa de exámenes médico legales por presunto delito sexual contra niños, niñas y adolescentes",2018,2,1,2310,43.2900432900433,1,1179,84.8176420695505,0,1131,0
26229,41,41770,81,"Tasa de exámenes médico legales por presunto delito sexual contra niños, niñas y adolescentes",2018,3,1,2616,38.2262996941896,1,1341,74.5712155108128,0,1275,0
26230,41,41770,81,"Tasa de exámenes médico legales por presunto delito sexual contra niños, niñas y adolescentes",2018,4,3,2440,122.950819672131,0,1262,0,3,1178,254.668930390492
26231,41,41770,121,Tasa de exámenes médico legales por presunto delito sexual cuando la víctima está entre 18 y 28 años,2018,5,2,4185,47.78972520908,0,2171,0,2,2014,99.304865938431
26232,41,41791,81,"Tasa de exámenes médico legales por presunto delito sexual contra niños, niñas y adolescentes",2018,4,1,2227,44.9034575662326,1,1147,87.1839581517001,0,1080,0
26233,41,41791,121,Tasa de exámenes médico legales por presunto delito sexual cuando la víctima está entre 18 y 28 años,2018,5,1,3554,28.137310073157,0,1850,0,1,1704,58.6854460093897
26234,41,41797,81,"Tasa de exámenes médico legales por presunto delito sexual contra niños, niñas y adolescentes",2018,3,1,1073,93.1966449207828,0,561,0,1,512,195.3125
26235,41,41797,81,"Tasa de exámenes médico legales por presunto delito sexual contra niños, niñas y adolescentes",2018,4,9,1038,867.052023121387,0,541,0,9,497,1810.86519114688
26236,41,41797,121,Tasa de exámenes médico legales por presunto delito sexual cuando la víctima está entre 18 y 28 años,2018,5,1,1807,55.3403431101273,0,946,0,1,861,116.144018583043
26237,41,41799,81,"Tasa de exámenes médico legales por presunto delito sexual contra niños, niñas y adolescentes",2018,2,2,1713,116.754232340922,1,876,114.155251141553,1,837,119.4743130227
26238,41,41799,81,"Tasa de exámenes médico legales por presunto delito sexual contra niños, niñas y adolescentes",2018,3,2,1913,104.547830632514,0,976,0,2,937,213.447171824973
26239,41,41799,81,"Tasa de exámenes médico legales por presunto delito sexual contra niños, niñas y adolescentes",2018,4,2,1778,112.485939257593,0,912,0,2,866,230.94688221709
26240,41,41799,121,Tasa de exámenes médico legales por presunto delito sexual cuando la víctima está entre 18 y 28 años,2018,5,1,2867,34.8796651552145,0,1483,0,1,1384,72.2543352601156
26241,41,41801,81,"Tasa de exámenes médico legales por presunto delito sexual contra niños, niñas y adolescentes",2018,2,2,875,228.571428571429,0,454,0,2,421,475.059382422803
26242,41,41801,81,"Tasa de exámenes médico legales por presunto delito sexual contra niños, niñas y adolescentes",2018,3,2,1026,194.931773879142,0,550,0,2,476,420.168067226891
26243,41,41801,81,"Tasa de exámenes médico legales por presunto delito sexual contra niños, niñas y adolescentes",2018,4,4,1014,394.477317554241,1,552,181.159420289855,3,462,649.350649350649
26244,41,41807,81,"Tasa de exámenes médico legales por presunto delito sexual contra niños, niñas y adolescentes",2018,3,6,2424,247.524752475248,2,1230,162.60162601626,4,1194,335.00837520938
26245,41,41807,81,"Tasa de exámenes médico legales por presunto delito sexual contra niños, niñas y adolescentes",2018,4,3,2408,124.584717607973,0,1208,0,3,1200,250
26246,41,41807,121,Tasa de exámenes médico legales por presunto delito sexual cuando la víctima está entre 18 y 28 años,2018,5,3,4218,71.1237553342817,0,2119,0,3,2099,142.92520247737
26247,41,41872,121,Tasa de exámenes médico legales por presunto delito sexual cuando la víctima está entre 18 y 28 años,2018,5,1,1432,69.8324022346369,0,728,0,1,704,142.045454545455
26248,41,41885,81,"Tasa de exámenes médico legales por presunto delito sexual contra niños, niñas y adolescentes",2018,2,2,765,261.437908496732,1,392,255.102040816327,1,373,268.096514745308
26249,41,41885,81,"Tasa de exámenes médico legales por presunto delito sexual contra niños, niñas y adolescentes",2018,3,2,894,223.713646532438,0,455,0,2,439,455.580865603645
26250,44,44001,81,"Tasa de exámenes médico legales por presunto delito sexual contra niños, niñas y adolescentes",2018,2,9,36082,24.9431849675739,3,18495,16.220600162206,6,17587,34.116108489225
26251,44,44001,81,"Tasa de exámenes médico legales por presunto delito sexual contra niños, niñas y adolescentes",2018,3,31,41247,75.156981113778,4,21173,18.8919850753318,27,20074,134.502341337053
26252,44,44001,81,"Tasa de exámenes médico legales por presunto delito sexual contra niños, niñas y adolescentes",2018,4,46,36009,127.745841317448,2,18341,10.9045308325609,44,17668,249.037808467285
26253,44,44001,121,Tasa de exámenes médico legales por presunto delito sexual cuando la víctima está entre 18 y 28 años,2018,5,10,51727,19.3322636147467,0,25515,0,10,26212,38.1504654356783
26254,44,44035,81,"Tasa de exámenes médico legales por presunto delito sexual contra niños, niñas y adolescentes",2018,2,3,3527,85.0581230507513,0,1812,0,3,1715,174.927113702624
26255,44,44035,81,"Tasa de exámenes médico legales por presunto delito sexual contra niños, niñas y adolescentes",2018,3,6,3742,160.342063067878,0,1948,0,6,1794,334.448160535117
26256,44,44035,81,"Tasa de exámenes médico legales por presunto delito sexual contra niños, niñas y adolescentes",2018,4,4,3420,116.959064327485,0,1789,0,4,1631,245.248313917842
26257,44,44035,121,Tasa de exámenes médico legales por presunto delito sexual cuando la víctima está entre 18 y 28 años,2018,5,1,5717,17.4916914465629,0,2990,0,1,2727,36.6703337000367
26258,44,44078,81,"Tasa de exámenes médico legales por presunto delito sexual contra niños, niñas y adolescentes",2018,2,1,4652,21.4961306964746,0,2352,0,1,2300,43.4782608695652
26259,44,44078,81,"Tasa de exámenes médico legales por presunto delito sexual contra niños, niñas y adolescentes",2018,3,7,5183,135.056916843527,1,2609,38.3288616328095,6,2574,233.100233100233
26260,44,44078,81,"Tasa de exámenes médico legales por presunto delito sexual contra niños, niñas y adolescentes",2018,4,5,4679,106.860440265014,0,2371,0,5,2308,216.637781629116
26261,44,44090,81,"Tasa de exámenes médico legales por presunto delito sexual contra niños, niñas y adolescentes",2018,2,6,4879,122.976019676163,0,2500,0,6,2379,252.206809583859
26262,44,44090,81,"Tasa de exámenes médico legales por presunto delito sexual contra niños, niñas y adolescentes",2018,3,10,5033,198.688654877806,1,2598,38.4911470361817,9,2435,369.609856262834
26263,44,44090,81,"Tasa de exámenes médico legales por presunto delito sexual contra niños, niñas y adolescentes",2018,4,7,4513,155.107467316641,0,2361,0,7,2152,325.278810408922
26264,44,44090,121,Tasa de exámenes médico legales por presunto delito sexual cuando la víctima está entre 18 y 28 años,2018,5,2,7384,27.0855904658722,0,3854,0,2,3530,56.657223796034
26265,44,44098,81,"Tasa de exámenes médico legales por presunto delito sexual contra niños, niñas y adolescentes",2018,2,2,1942,102.986611740474,1,996,100.401606425703,1,946,105.708245243129
26266,44,44098,81,"Tasa de exámenes médico legales por presunto delito sexual contra niños, niñas y adolescentes",2018,3,1,2143,46.6635557629491,0,1081,0,1,1062,94.1619585687382
26267,44,44098,81,"Tasa de exámenes médico legales por presunto delito sexual contra niños, niñas y adolescentes",2018,4,4,2092,191.204588910134,0,1106,0,4,986,405.679513184584
26268,44,44098,121,Tasa de exámenes médico legales por presunto delito sexual cuando la víctima está entre 18 y 28 años,2018,5,1,3934,25.419420437214,0,2322,0,1,1612,62.0347394540943
26269,44,44110,81,"Tasa de exámenes médico legales por presunto delito sexual contra niños, niñas y adolescentes",2018,4,1,835,119.760479041916,0,433,0,1,402,248.756218905473
26270,44,44279,81,"Tasa de exámenes médico legales por presunto delito sexual contra niños, niñas y adolescentes",2018,2,6,3863,155.319699715247,3,1964,152.749490835031,3,1899,157.977883096366
26271,44,44279,81,"Tasa de exámenes médico legales por presunto delito sexual contra niños, niñas y adolescentes",2018,3,9,4349,206.944125086227,1,2195,45.5580865603645,8,2154,371.402042711235
26272,44,44279,81,"Tasa de exámenes médico legales por presunto delito sexual contra niños, niñas y adolescentes",2018,4,18,3773,477.073946461702,2,1899,105.318588730911,16,1874,853.788687299893
26273,44,44279,121,Tasa de exámenes médico legales por presunto delito sexual cuando la víctima está entre 18 y 28 años,2018,5,3,6901,43.4719605854224,0,3445,0,3,3456,86.8055555555556
26274,44,44378,81,"Tasa de exámenes médico legales por presunto delito sexual contra niños, niñas y adolescentes",2018,2,1,3445,29.0275761973875,0,1770,0,1,1675,59.7014925373134
26275,44,44378,81,"Tasa de exámenes médico legales por presunto delito sexual contra niños, niñas y adolescentes",2018,3,3,3678,81.5660685154976,1,1901,52.6038926880589,2,1777,112.549240292628
26276,44,44378,81,"Tasa de exámenes médico legales por presunto delito sexual contra niños, niñas y adolescentes",2018,4,3,3289,91.2131346913956,0,1705,0,3,1584,189.393939393939
26277,44,44420,81,"Tasa de exámenes médico legales por presunto delito sexual contra niños, niñas y adolescentes",2018,2,1,325,307.692307692308,0,171,0,1,154,649.350649350649
26278,44,44420,81,"Tasa de exámenes médico legales por presunto delito sexual contra niños, niñas y adolescentes",2018,3,1,359,278.551532033426,0,196,0,1,163,613.496932515337
26279,44,44420,81,"Tasa de exámenes médico legales por presunto delito sexual contra niños, niñas y adolescentes",2018,4,2,318,628.930817610063,0,175,0,2,143,1398.6013986014
26280,44,44430,81,"Tasa de exámenes médico legales por presunto delito sexual contra niños, niñas y adolescentes",2018,2,13,19136,67.9347826086957,2,9781,20.4478069727022,11,9355,117.584179583111
26281,44,44430,81,"Tasa de exámenes médico legales por presunto delito sexual contra niños, niñas y adolescentes",2018,3,48,22916,209.460638854949,12,11708,102.494021182098,36,11208,321.199143468951
26282,44,44430,81,"Tasa de exámenes médico legales por presunto delito sexual contra niños, niñas y adolescentes",2018,4,34,21091,161.206201697406,1,10712,9.33532486930545,33,10379,317.949706137393
26283,44,44430,121,Tasa de exámenes médico legales por presunto delito sexual cuando la víctima está entre 18 y 28 años,2018,5,5,29572,16.9078858379548,1,14968,6.68091929449492,4,14604,27.3897562311695
26284,44,44560,81,"Tasa de exámenes médico legales por presunto delito sexual contra niños, niñas y adolescentes",2018,2,3,16508,18.1730070268961,1,8387,11.9232144986288,2,8121,24.627508927472
26285,44,44560,81,"Tasa de exámenes médico legales por presunto delito sexual contra niños, niñas y adolescentes",2018,3,4,16782,23.835061375283,0,8437,0,4,8345,47.9328939484721
26286,44,44560,81,"Tasa de exámenes médico legales por presunto delito sexual contra niños, niñas y adolescentes",2018,4,1,14812,6.75128274372131,0,7351,0,1,7461,13.4030290845731
26287,44,44560,121,Tasa de exámenes médico legales por presunto delito sexual cuando la víctima está entre 18 y 28 años,2018,5,1,23258,4.29959583799123,0,11342,0,1,11916,8.39207787848271
26288,44,44650,81,"Tasa de exámenes médico legales por presunto delito sexual contra niños, niñas y adolescentes",2018,2,1,4156,24.0615976900866,0,2155,0,1,2001,49.9750124937531
26289,44,44650,81,"Tasa de exámenes médico legales por presunto delito sexual contra niños, niñas y adolescentes",2018,3,5,4637,107.828337287039,0,2438,0,5,2199,227.37608003638
26290,44,44650,81,"Tasa de exámenes médico legales por presunto delito sexual contra niños, niñas y adolescentes",2018,4,10,4068,245.821042281219,1,2124,47.0809792843691,9,1944,462.962962962963
26291,44,44650,121,Tasa de exámenes médico legales por presunto delito sexual cuando la víctima está entre 18 y 28 años,2018,5,4,7266,55.0509221029452,0,3674,0,4,3592,111.358574610245
26292,44,44847,81,"Tasa de exámenes médico legales por presunto delito sexual contra niños, niñas y adolescentes",2018,2,2,27010,7.40466493891151,1,13714,7.29181857955374,1,13296,7.52105896510229
26293,44,44847,81,"Tasa de exámenes médico legales por presunto delito sexual contra niños, niñas y adolescentes",2018,3,2,27734,7.21136511141559,0,13959,0,2,13775,14.519056261343
26294,44,44847,81,"Tasa de exámenes médico legales por presunto delito sexual contra niños, niñas y adolescentes",2018,4,2,24535,8.15162013450173,0,12261,0,2,12274,16.2946064852534
26295,44,44855,81,"Tasa de exámenes médico legales por presunto delito sexual contra niños, niñas y adolescentes",2018,3,3,2182,137.488542621448,1,1112,89.9280575539568,2,1070,186.915887850467
26296,44,44855,81,"Tasa de exámenes médico legales por presunto delito sexual contra niños, niñas y adolescentes",2018,4,2,1930,103.626943005181,0,973,0,2,957,208.986415882968
26297,44,44874,81,"Tasa de exámenes médico legales por presunto delito sexual contra niños, niñas y adolescentes",2018,2,1,2942,33.9904826648538,0,1502,0,1,1440,69.4444444444444
26298,44,44874,81,"Tasa de exámenes médico legales por presunto delito sexual contra niños, niñas y adolescentes",2018,3,4,3187,125.509883903357,1,1633,61.2369871402327,3,1554,193.050193050193
26299,44,44874,81,"Tasa de exámenes médico legales por presunto delito sexual contra niños, niñas y adolescentes",2018,4,5,2773,180.310133429499,1,1425,70.1754385964912,4,1348,296.73590504451
26300,47,47001,81,"Tasa de exámenes médico legales por presunto delito sexual contra niños, niñas y adolescentes",2018,2,48,47161,101.779012319501,14,24130,58.0190634065479,34,23031,147.62711128479
26301,47,47001,81,"Tasa de exámenes médico legales por presunto delito sexual contra niños, niñas y adolescentes",2018,3,97,58610,165.500767787067,8,29724,26.914278024492,89,28886,308.107733850308
26302,47,47001,81,"Tasa de exámenes médico legales por presunto delito sexual contra niños, niñas y adolescentes",2018,4,139,61751,225.097569270133,11,30948,35.5434923096808,128,30803,415.543940525274
26303,47,47001,121,Tasa de exámenes médico legales por presunto delito sexual cuando la víctima está entre 18 y 28 años,2018,5,31,99047,31.2982725372803,2,50165,3.98684341672481,29,48882,59.3265414672067
26304,47,47030,121,Tasa de exámenes médico legales por presunto delito sexual cuando la víctima está entre 18 y 28 años,2018,5,1,2379,42.0344682639765,0,1259,0,1,1120,89.2857142857143
26305,47,47053,81,"Tasa de exámenes médico legales por presunto delito sexual contra niños, niñas y adolescentes",2018,4,4,5255,76.1179828734539,0,2707,0,4,2548,156.985871271586
26306,47,47053,121,Tasa de exámenes médico legales por presunto delito sexual cuando la víctima está entre 18 y 28 años,2018,5,1,7882,12.6871352448617,0,4054,0,1,3828,26.123301985371
26307,47,47058,81,"Tasa de exámenes médico legales por presunto delito sexual contra niños, niñas y adolescentes",2018,2,1,3422,29.2226767971946,1,1757,56.9151963574274,0,1665,0
26308,47,47058,81,"Tasa de exámenes médico legales por presunto delito sexual contra niños, niñas y adolescentes",2018,3,2,4057,49.297510475721,1,2122,47.1253534401508,1,1935,51.6795865633075
26309,47,47058,81,"Tasa de exámenes médico legales por presunto delito sexual contra niños, niñas y adolescentes",2018,4,2,3827,52.2602560752548,0,2058,0,2,1769,113.058224985868
26310,47,47058,121,Tasa de exámenes médico legales por presunto delito sexual cuando la víctima está entre 18 y 28 años,2018,5,1,5963,16.7700821734026,0,3228,0,1,2735,36.563071297989
26311,47,47161,81,"Tasa de exámenes médico legales por presunto delito sexual contra niños, niñas y adolescentes",2018,3,1,954,104.82180293501,0,487,0,1,467,214.132762312634
26312,47,47170,81,"Tasa de exámenes médico legales por presunto delito sexual contra niños, niñas y adolescentes",2018,3,5,2334,214.224507283633,1,1180,84.7457627118644,4,1154,346.620450606586
26313,47,47170,81,"Tasa de exámenes médico legales por presunto delito sexual contra niños, niñas y adolescentes",2018,4,2,2165,92.378752886836,0,1131,0,2,1034,193.423597678917
26314,47,47170,121,Tasa de exámenes médico legales por presunto delito sexual cuando la víctima está entre 18 y 28 años,2018,5,1,2960,33.7837837837838,0,1591,0,1,1369,73.0460189919649
26315,47,47189,81,"Tasa de exámenes médico legales por presunto delito sexual contra niños, niñas y adolescentes",2018,2,2,10910,18.3318056828598,0,5605,0,2,5305,37.7002827521206
26316,47,47189,81,"Tasa de exámenes médico legales por presunto delito sexual contra niños, niñas y adolescentes",2018,3,9,12709,70.8159571956881,1,6576,15.2068126520681,8,6133,130.441871840861
26317,47,47189,81,"Tasa de exámenes médico legales por presunto delito sexual contra niños, niñas y adolescentes",2018,4,16,12790,125.097732603597,1,6688,14.9521531100478,15,6102,245.821042281219
26318,47,47189,121,Tasa de exámenes médico legales por presunto delito sexual cuando la víctima está entre 18 y 28 años,2018,5,2,20126,9.93739441518434,0,10368,0,2,9758,20.4960032793605
26319,47,47245,81,"Tasa de exámenes médico legales por presunto delito sexual contra niños, niñas y adolescentes",2018,2,3,6718,44.6561476629949,1,3438,29.086678301338,2,3280,60.9756097560976
26320,47,47245,81,"Tasa de exámenes médico legales por presunto delito sexual contra niños, niñas y adolescentes",2018,3,16,7600,210.526315789474,2,3901,51.2689054088695,14,3699,378.480670451473
26321,47,47245,81,"Tasa de exámenes médico legales por presunto delito sexual contra niños, niñas y adolescentes",2018,4,17,6947,244.7099467396,4,3564,112.233445566779,13,3383,384.274312740171
26322,47,47245,121,Tasa de exámenes médico legales por presunto delito sexual cuando la víctima está entre 18 y 28 años,2018,5,1,11291,8.85661146045523,0,5865,0,1,5426,18.4297825285662
26323,47,47268,81,"Tasa de exámenes médico legales por presunto delito sexual contra niños, niñas y adolescentes",2018,3,1,3019,33.1235508446505,1,1573,63.5727908455181,0,1446,0
26324,47,47268,81,"Tasa de exámenes médico legales por presunto delito sexual contra niños, niñas y adolescentes",2018,4,1,2955,33.8409475465313,0,1574,0,1,1381,72.4112961622013
26325,47,47288,81,"Tasa de exámenes médico legales por presunto delito sexual contra niños, niñas y adolescentes",2018,2,1,6719,14.883167137967,0,3421,0,1,3298,30.3214069132808
26326,47,47288,81,"Tasa de exámenes médico legales por presunto delito sexual contra niños, niñas y adolescentes",2018,3,2,7886,25.3613999492772,0,4005,0,2,3881,51.5331100231899
26327,47,47318,81,"Tasa de exámenes médico legales por presunto delito sexual contra niños, niñas y adolescentes",2018,4,2,3205,62.402496099844,0,1699,0,2,1506,132.802124833997
26328,47,47318,121,Tasa de exámenes médico legales por presunto delito sexual cuando la víctima está entre 18 y 28 años,2018,5,1,5693,17.5654312313367,1,3103,32.2268772155978,0,2590,0
26329,47,47460,81,"Tasa de exámenes médico legales por presunto delito sexual contra niños, niñas y adolescentes",2018,3,7,2636,265.553869499241,1,1379,72.5163161711385,6,1257,477.326968973747
26330,47,47460,81,"Tasa de exámenes médico legales por presunto delito sexual contra niños, niñas y adolescentes",2018,4,8,2485,321.931589537223,1,1336,74.8502994011976,7,1149,609.225413402959
26331,47,47460,121,Tasa de exámenes médico legales por presunto delito sexual cuando la víctima está entre 18 y 28 años,2018,5,1,3872,25.8264462809917,0,2094,0,1,1778,56.2429696287964
26332,47,47541,81,"Tasa de exámenes médico legales por presunto delito sexual contra niños, niñas y adolescentes",2018,3,3,973,308.324768756423,0,496,0,3,477,628.930817610063
26333,47,47541,81,"Tasa de exámenes médico legales por presunto delito sexual contra niños, niñas y adolescentes",2018,4,1,921,108.5776330076,0,478,0,1,443,225.733634311512
26334,47,47545,81,"Tasa de exámenes médico legales por presunto delito sexual contra niños, niñas y adolescentes",2018,4,1,2400,41.6666666666667,0,1306,0,1,1094,91.4076782449726
26335,47,47551,81,"Tasa de exámenes médico legales por presunto delito sexual contra niños, niñas y adolescentes",2018,3,1,3763,26.5745415891576,1,1954,51.1770726714432,0,1809,0
26336,47,47551,81,"Tasa de exámenes médico legales por presunto delito sexual contra niños, niñas y adolescentes",2018,4,4,3631,110.162489672267,0,1909,0,4,1722,232.288037166086
26337,47,47555,81,"Tasa de exámenes médico legales por presunto delito sexual contra niños, niñas y adolescentes",2018,2,2,6865,29.1332847778587,0,3500,0,2,3365,59.4353640416047
26338,47,47555,81,"Tasa de exámenes médico legales por presunto delito sexual contra niños, niñas y adolescentes",2018,3,10,8095,123.533045089561,3,4144,72.3938223938224,7,3951,177.17033662364
26339,47,47555,81,"Tasa de exámenes médico legales por presunto delito sexual contra niños, niñas y adolescentes",2018,4,14,7597,184.283269711728,1,3942,25.3678335870117,13,3655,355.677154582763
26340,47,47555,121,Tasa de exámenes médico legales por presunto delito sexual cuando la víctima está entre 18 y 28 años,2018,5,2,11623,17.207261464338,0,6065,0,2,5558,35.9841669665347
26341,47,47570,81,"Tasa de exámenes médico legales por presunto delito sexual contra niños, niñas y adolescentes",2018,3,1,4710,21.2314225053079,0,2398,0,1,2312,43.2525951557093
26342,47,47570,81,"Tasa de exámenes médico legales por presunto delito sexual contra niños, niñas y adolescentes",2018,4,3,4559,65.8039043649923,0,2333,0,3,2226,134.770889487871
26343,47,47570,121,Tasa de exámenes médico legales por presunto delito sexual cuando la víctima está entre 18 y 28 años,2018,5,1,6109,16.3692912096906,0,3201,0,1,2908,34.3878954607978
26344,47,47605,81,"Tasa de exámenes médico legales por presunto delito sexual contra niños, niñas y adolescentes",2018,4,1,955,104.712041884817,0,495,0,1,460,217.391304347826
26345,47,47660,81,"Tasa de exámenes médico legales por presunto delito sexual contra niños, niñas y adolescentes",2018,4,1,2409,41.51100041511,1,1258,79.4912559618442,0,1151,0
26346,47,47692,81,"Tasa de exámenes médico legales por presunto delito sexual contra niños, niñas y adolescentes",2018,4,1,2063,48.4730974309258,0,1071,0,1,992,100.806451612903
26347,47,47707,81,"Tasa de exámenes médico legales por presunto delito sexual contra niños, niñas y adolescentes",2018,4,1,3596,27.8086763070078,0,1895,0,1,1701,58.7889476778366
26348,47,47745,81,"Tasa de exámenes médico legales por presunto delito sexual contra niños, niñas y adolescentes",2018,2,1,3595,27.8164116828929,1,1841,54.3183052688756,0,1754,0
26349,47,47745,81,"Tasa de exámenes médico legales por presunto delito sexual contra niños, niñas y adolescentes",2018,3,1,4194,23.8435860753457,0,2155,0,1,2039,49.0436488474743
26350,47,47745,81,"Tasa de exámenes médico legales por presunto delito sexual contra niños, niñas y adolescentes",2018,4,6,4090,146.699266503668,0,2106,0,6,1984,302.41935483871
26351,47,47745,121,Tasa de exámenes médico legales por presunto delito sexual cuando la víctima está entre 18 y 28 años,2018,5,1,5794,17.2592336900242,0,2992,0,1,2802,35.6887937187723
26352,47,47798,81,"Tasa de exámenes médico legales por presunto delito sexual contra niños, niñas y adolescentes",2018,3,1,1639,61.012812690665,0,848,0,1,791,126.422250316056
26353,47,47798,81,"Tasa de exámenes médico legales por presunto delito sexual contra niños, niñas y adolescentes",2018,4,4,1502,266.311584553928,1,763,131.061598951507,3,739,405.95399188092
26354,47,47960,81,"Tasa de exámenes médico legales por presunto delito sexual contra niños, niñas y adolescentes",2018,3,3,1101,272.479564032698,1,563,177.619893428064,2,538,371.747211895911
26355,47,47980,81,"Tasa de exámenes médico legales por presunto delito sexual contra niños, niñas y adolescentes",2018,2,2,7927,25.230225810521,0,4067,0,2,3860,51.8134715025907
26356,47,47980,81,"Tasa de exámenes médico legales por presunto delito sexual contra niños, niñas y adolescentes",2018,3,9,9232,97.4870017331023,0,4778,0,9,4454,202.065559048047
26357,47,47980,81,"Tasa de exámenes médico legales por presunto delito sexual contra niños, niñas y adolescentes",2018,4,12,8771,136.814502337248,1,4582,21.8245307725884,11,4189,262.592504177608
26358,47,47980,121,Tasa de exámenes médico legales por presunto delito sexual cuando la víctima está entre 18 y 28 años,2018,5,3,12466,24.0654580458848,0,6545,0,3,5921,50.6671170410404
26359,5,5001,81,"Tasa de exámenes médico legales por presunto delito sexual contra niños, niñas y adolescentes",2018,2,331,146239,226.341810324195,63,74697,84.3407365757661,268,71542,374.605127058232
26360,5,5001,81,"Tasa de exámenes médico legales por presunto delito sexual contra niños, niñas y adolescentes",2018,3,486,181690,267.488579448511,95,92730,102.44796721665,391,88960,439.523381294964
26361,5,5001,81,"Tasa de exámenes médico legales por presunto delito sexual contra niños, niñas y adolescentes",2018,4,501,192509,260.24757284075,54,98827,54.6409382051464,447,93682,477.146089963921
26362,5,5001,121,Tasa de exámenes médico legales por presunto delito sexual cuando la víctima está entre 18 y 28 años,2018,5,125,413611,30.2216333704858,15,208500,7.19424460431655,110,205111,53.6294981741594
26363,5,5001,81,"Tasa de exámenes médico legales por presunto delito sexual contra niños, niñas y adolescentes",2018,1,2,28673,6.97520315279183,0,14716,0,2,13957,14.3297270187003
26364,5,5002,81,"Tasa de exámenes médico legales por presunto delito sexual contra niños, niñas y adolescentes",2018,2,2,1683,118.83541295306,1,868,115.207373271889,1,815,122.699386503067
26365,5,5002,81,"Tasa de exámenes médico legales por presunto delito sexual contra niños, niñas y adolescentes",2018,3,5,1891,264.410364886304,1,978,102.249488752556,4,913,438.116100766703
26366,5,5002,81,"Tasa de exámenes médico legales por presunto delito sexual contra niños, niñas y adolescentes",2018,4,8,1785,448.179271708683,0,928,0,8,857,933.488914819136
26367,5,5002,121,Tasa de exámenes médico legales por presunto delito sexual cuando la víctima está entre 18 y 28 años,2018,5,1,3269,30.5903946160905,0,1722,0,1,1547,64.6412411118293
26368,5,5021,81,"Tasa de exámenes médico legales por presunto delito sexual contra niños, niñas y adolescentes",2018,2,1,230,434.782608695652,0,119,0,1,111,900.900900900901
26369,5,5021,81,"Tasa de exámenes médico legales por presunto delito sexual contra niños, niñas y adolescentes",2018,3,2,273,732.600732600733,0,141,0,2,132,1515.15151515152
26370,5,5021,81,"Tasa de exámenes médico legales por presunto delito sexual contra niños, niñas y adolescentes",2018,4,1,288,347.222222222222,0,148,0,1,140,714.285714285714
26371,5,5030,81,"Tasa de exámenes médico legales por presunto delito sexual contra niños, niñas y adolescentes",2018,2,8,2765,289.330922242315,1,1423,70.2740688685875,7,1342,521.609538002981
26372,5,5030,81,"Tasa de exámenes médico legales por presunto delito sexual contra niños, niñas y adolescentes",2018,3,12,3352,357.99522673031,0,1745,0,12,1607,746.73304293715
26373,5,5030,81,"Tasa de exámenes médico legales por presunto delito sexual contra niños, niñas y adolescentes",2018,4,12,3205,374.414976599064,0,1653,0,12,1552,773.19587628866
26374,5,5030,121,Tasa de exámenes médico legales por presunto delito sexual cuando la víctima está entre 18 y 28 años,2018,5,2,6105,32.7600327600328,0,3170,0,2,2935,68.1431005110733
26375,5,5031,81,"Tasa de exámenes médico legales por presunto delito sexual contra niños, niñas y adolescentes",2018,2,1,2435,41.0677618069815,1,1247,80.1924619085806,0,1188,0
26376,5,5031,81,"Tasa de exámenes médico legales por presunto delito sexual contra niños, niñas y adolescentes",2018,3,2,2683,74.5434215430488,0,1379,0,2,1304,153.374233128834
26377,5,5031,81,"Tasa de exámenes médico legales por presunto delito sexual contra niños, niñas y adolescentes",2018,4,2,2480,80.6451612903226,0,1275,0,2,1205,165.97510373444
26378,5,5031,121,Tasa de exámenes médico legales por presunto delito sexual cuando la víctima está entre 18 y 28 años,2018,5,1,4533,22.0604456210015,0,2326,0,1,2207,45.3103760761214
26379,5,5034,81,"Tasa de exámenes médico legales por presunto delito sexual contra niños, niñas y adolescentes",2018,2,4,4345,92.0598388952819,0,2213,0,4,2132,187.617260787993
26380,5,5034,81,"Tasa de exámenes médico legales por presunto delito sexual contra niños, niñas y adolescentes",2018,3,12,5217,230.017251293847,6,2666,225.056264066016,6,2551,235.201881615053
26381,5,5034,81,"Tasa de exámenes médico legales por presunto delito sexual contra niños, niñas y adolescentes",2018,4,11,4988,220.529270248597,2,2589,77.2499034376207,9,2399,375.156315131305
26382,5,5034,121,Tasa de exámenes médico legales por presunto delito sexual cuando la víctima está entre 18 y 28 años,2018,5,1,9209,10.8589423390162,1,4726,21.1595429538722,0,4483,0
26383,5,5038,81,"Tasa de exámenes médico legales por presunto delito sexual contra niños, niñas y adolescentes",2018,2,1,1277,78.3085356303837,0,663,0,1,614,162.866449511401
26384,5,5038,81,"Tasa de exámenes médico legales por presunto delito sexual contra niños, niñas y adolescentes",2018,3,1,1261,79.3021411578113,1,665,150.375939849624,0,596,0
26385,5,5038,81,"Tasa de exámenes médico legales por presunto delito sexual contra niños, niñas y adolescentes",2018,4,6,1285,466.92607003891,1,678,147.492625368732,5,607,823.723228995058
26386,5,5040,81,"Tasa de exámenes médico legales por presunto delito sexual contra niños, niñas y adolescentes",2018,2,3,1771,169.395821569735,1,908,110.132158590308,2,863,231.749710312862
26387,5,5040,81,"Tasa de exámenes médico legales por presunto delito sexual contra niños, niñas y adolescentes",2018,3,3,2041,146.986771190593,0,1059,0,3,982,305.498981670061
26388,5,5040,81,"Tasa de exámenes médico legales por presunto delito sexual contra niños, niñas y adolescentes",2018,4,7,1886,371.155885471898,0,998,0,7,888,788.288288288288
26389,5,5040,121,Tasa de exámenes médico legales por presunto delito sexual cuando la víctima está entre 18 y 28 años,2018,5,1,3236,30.902348578492,0,1726,0,1,1510,66.2251655629139
26390,5,5042,81,"Tasa de exámenes médico legales por presunto delito sexual contra niños, niñas y adolescentes",2018,2,7,2579,271.423032183017,2,1330,150.375939849624,5,1249,400.320256204964
26391,5,5042,81,"Tasa de exámenes médico legales por presunto delito sexual contra niños, niñas y adolescentes",2018,3,22,2951,745.509996611318,6,1542,389.105058365759,16,1409,1135.55713271824
26392,5,5042,81,"Tasa de exámenes médico legales por presunto delito sexual contra niños, niñas y adolescentes",2018,4,5,2658,188.11136192626,1,1389,71.9942404607631,4,1269,315.208825847124
26393,5,5042,121,Tasa de exámenes médico legales por presunto delito sexual cuando la víctima está entre 18 y 28 años,2018,5,2,4904,40.7830342577488,0,2580,0,2,2324,86.0585197934596
26394,5,5044,81,"Tasa de exámenes médico legales por presunto delito sexual contra niños, niñas y adolescentes",2018,3,1,866,115.473441108545,0,464,0,1,402,248.756218905473
26395,5,5044,81,"Tasa de exámenes médico legales por presunto delito sexual contra niños, niñas y adolescentes",2018,4,3,829,361.881785283474,1,452,221.238938053097,2,377,530.503978779841
26396,5,5045,81,"Tasa de exámenes médico legales por presunto delito sexual contra niños, niñas y adolescentes",2018,2,2,23511,8.50665645867892,0,12053,0,2,11458,17.4550532379124
26397,5,5045,81,"Tasa de exámenes médico legales por presunto delito sexual contra niños, niñas y adolescentes",2018,3,11,25579,43.0040267406857,3,13092,22.9147571035747,8,12487,64.0666292944663
26398,5,5045,81,"Tasa de exámenes médico legales por presunto delito sexual contra niños, niñas y adolescentes",2018,4,5,24491,20.4156628965743,0,12460,0,5,12031,41.5593051284183
26399,5,5045,121,Tasa de exámenes médico legales por presunto delito sexual cuando la víctima está entre 18 y 28 años,2018,5,2,42068,4.75420747361415,0,21183,0,2,20885,9.57625089777352
26400,5,5051,81,"Tasa de exámenes médico legales por presunto delito sexual contra niños, niñas y adolescentes",2018,4,1,5719,17.4855744011191,0,2915,0,1,2804,35.6633380884451
26401,5,5079,81,"Tasa de exámenes médico legales por presunto delito sexual contra niños, niñas y adolescentes",2018,2,8,4773,167.609469935051,1,2442,40.950040950041,7,2331,300.3003003003
26402,5,5079,81,"Tasa de exámenes médico legales por presunto delito sexual contra niños, niñas y adolescentes",2018,3,14,5721,244.712462856144,1,2930,34.1296928327645,13,2791,465.782873522035
26403,5,5079,81,"Tasa de exámenes médico legales por presunto delito sexual contra niños, niñas y adolescentes",2018,4,16,5621,284.646859989326,0,2875,0,16,2746,582.665695557174
26404,5,5079,121,Tasa de exámenes médico legales por presunto delito sexual cuando la víctima está entre 18 y 28 años,2018,5,5,10346,48.3278561763,0,5234,0,5,5112,97.8090766823161
26405,5,5086,81,"Tasa de exámenes médico legales por presunto delito sexual contra niños, niñas y adolescentes",2018,3,1,829,120.627261761158,1,436,229.357798165138,0,393,0
26406,5,5086,81,"Tasa de exámenes médico legales por presunto delito sexual contra niños, niñas y adolescentes",2018,4,3,790,379.746835443038,0,422,0,3,368,815.217391304348
26407,5,5088,81,"Tasa de exámenes médico legales por presunto delito sexual contra niños, niñas y adolescentes",2018,2,45,38942,115.55646859432,12,19881,60.3591368643428,33,19061,173.128377314936
26408,5,5088,81,"Tasa de exámenes médico legales por presunto delito sexual contra niños, niñas y adolescentes",2018,3,74,46691,158.48878798912,19,23671,80.2669933674116,55,23020,238.92267593397
26409,5,5088,81,"Tasa de exámenes médico legales por presunto delito sexual contra niños, niñas y adolescentes",2018,4,84,48184,174.331728374564,11,23933,45.9616429198178,73,24251,301.018514700425
26410,5,5088,121,Tasa de exámenes médico legales por presunto delito sexual cuando la víctima está entre 18 y 28 años,2018,5,16,100138,15.9779504284088,1,49687,2.01259886891944,15,50451,29.731818992686
26411,5,5088,81,"Tasa de exámenes médico legales por presunto delito sexual contra niños, niñas y adolescentes",2018,1,2,7921,25.2493372048984,0,4067,0,2,3854,51.8941359626362
26412,5,5091,81,"Tasa de exámenes médico legales por presunto delito sexual contra niños, niñas y adolescentes",2018,3,1,1078,92.7643784786642,0,557,0,1,521,191.938579654511
26413,5,5091,81,"Tasa de exámenes médico legales por presunto delito sexual contra niños, niñas y adolescentes",2018,4,1,1026,97.4658869395711,0,540,0,1,486,205.761316872428
26414,5,5091,121,Tasa de exámenes médico legales por presunto delito sexual cuando la víctima está entre 18 y 28 años,2018,5,1,1810,55.2486187845304,0,977,0,1,833,120.048019207683
26415,5,5093,81,"Tasa de exámenes médico legales por presunto delito sexual contra niños, niñas y adolescentes",2018,2,1,1796,55.6792873051225,0,908,0,1,888,112.612612612613
26416,5,5093,81,"Tasa de exámenes médico legales por presunto delito sexual contra niños, niñas y adolescentes",2018,3,8,2146,372.786579683131,2,1065,187.793427230047,6,1081,555.041628122109
26417,5,5093,81,"Tasa de exámenes médico legales por presunto delito sexual contra niños, niñas y adolescentes",2018,4,2,1995,100.250626566416,0,994,0,2,1001,199.8001998002
26418,5,5093,81,"Tasa de exámenes médico legales por presunto delito sexual contra niños, niñas y adolescentes",2018,1,1,364,274.725274725275,0,186,0,1,178,561.797752808989
26419,5,5101,81,"Tasa de exámenes médico legales por presunto delito sexual contra niños, niñas y adolescentes",2018,2,2,2543,78.6472670074715,0,1297,0,2,1246,160.513643659711
26420,5,5101,81,"Tasa de exámenes médico legales por presunto delito sexual contra niños, niñas y adolescentes",2018,3,4,2986,133.958472873409,1,1528,65.4450261780105,3,1458,205.761316872428
26421,5,5101,81,"Tasa de exámenes médico legales por presunto delito sexual contra niños, niñas y adolescentes",2018,4,3,2899,103.483959986202,0,1491,0,3,1408,213.068181818182
26422,5,5101,121,Tasa de exámenes médico legales por presunto delito sexual cuando la víctima está entre 18 y 28 años,2018,5,2,5320,37.593984962406,0,2740,0,2,2580,77.5193798449612
26423,5,5107,81,"Tasa de exámenes médico legales por presunto delito sexual contra niños, niñas y adolescentes",2018,2,2,894,223.713646532438,1,459,217.864923747277,1,435,229.885057471264
26424,5,5107,81,"Tasa de exámenes médico legales por presunto delito sexual contra niños, niñas y adolescentes",2018,3,7,1077,649.953574744661,0,551,0,7,526,1330.79847908745
26425,5,5107,81,"Tasa de exámenes médico legales por presunto delito sexual contra niños, niñas y adolescentes",2018,4,3,996,301.204819277108,0,511,0,3,485,618.556701030928
26426,5,5107,121,Tasa de exámenes médico legales por presunto delito sexual cuando la víctima está entre 18 y 28 años,2018,5,1,1752,57.0776255707763,0,883,0,1,869,115.074798619102
26427,5,5125,81,"Tasa de exámenes médico legales por presunto delito sexual contra niños, niñas y adolescentes",2018,4,1,1003,99.7008973080758,0,538,0,1,465,215.05376344086
26428,5,5129,81,"Tasa de exámenes médico legales por presunto delito sexual contra niños, niñas y adolescentes",2018,2,6,5663,105.950909411972,0,2893,0,6,2770,216.606498194946
26429,5,5129,81,"Tasa de exámenes médico legales por presunto delito sexual contra niños, niñas y adolescentes",2018,3,16,7166,223.276583868267,4,3662,109.229929000546,12,3504,342.465753424658
26430,5,5129,81,"Tasa de exámenes médico legales por presunto delito sexual contra niños, niñas y adolescentes",2018,4,11,7475,147.157190635451,3,3825,78.4313725490196,8,3650,219.178082191781
26431,5,5129,121,Tasa de exámenes médico legales por presunto delito sexual cuando la víctima está entre 18 y 28 años,2018,5,6,15033,39.912193175015,0,7582,0,6,7451,80.526103878674
26432,5,5129,81,"Tasa de exámenes médico legales por presunto delito sexual contra niños, niñas y adolescentes",2018,1,1,1129,88.5739592559787,0,578,0,1,551,181.488203266788
26433,5,5134,81,"Tasa de exámenes médico legales por presunto delito sexual contra niños, niñas y adolescentes",2018,4,2,950,210.526315789474,0,501,0,2,449,445.43429844098
26434,5,5134,121,Tasa de exámenes médico legales por presunto delito sexual cuando la víctima está entre 18 y 28 años,2018,5,2,1625,123.076923076923,2,865,231.21387283237,0,760,0
26435,5,5138,81,"Tasa de exámenes médico legales por presunto delito sexual contra niños, niñas y adolescentes",2018,4,5,1876,266.524520255864,0,946,0,5,930,537.634408602151
26436,5,5142,81,"Tasa de exámenes médico legales por presunto delito sexual contra niños, niñas y adolescentes",2018,3,1,488,204.918032786885,0,251,0,1,237,421.940928270042
26437,5,5147,81,"Tasa de exámenes médico legales por presunto delito sexual contra niños, niñas y adolescentes",2018,3,3,7847,38.2311711482095,0,3975,0,3,3872,77.4793388429752
26438,5,5147,81,"Tasa de exámenes médico legales por presunto delito sexual contra niños, niñas y adolescentes",2018,4,3,7322,40.9724119093144,0,3659,0,3,3663,81.9000819000819
26439,5,5148,81,"Tasa de exámenes médico legales por presunto delito sexual contra niños, niñas y adolescentes",2018,2,2,4856,41.1861614497529,1,2492,40.1284109149278,1,2364,42.3011844331641
26440,5,5148,81,"Tasa de exámenes médico legales por presunto delito sexual contra niños, niñas y adolescentes",2018,3,6,5717,104.950148679377,1,2937,34.0483486550902,5,2780,179.856115107914
26441,5,5148,81,"Tasa de exámenes médico legales por presunto delito sexual contra niños, niñas y adolescentes",2018,4,7,5405,129.509713228492,0,2787,0,7,2618,267.379679144385
26442,5,5148,121,Tasa de exámenes médico legales por presunto delito sexual cuando la víctima está entre 18 y 28 años,2018,5,1,10062,9.93838203140529,0,5178,0,1,4884,20.4750204750205
26443,5,5150,81,"Tasa de exámenes médico legales por presunto delito sexual contra niños, niñas y adolescentes",2018,3,1,343,291.545189504373,0,175,0,1,168,595.238095238095
26444,5,5150,81,"Tasa de exámenes médico legales por presunto delito sexual contra niños, niñas y adolescentes",2018,4,1,336,297.619047619048,0,177,0,1,159,628.930817610063
26445,5,5154,81,"Tasa de exámenes médico legales por presunto delito sexual contra niños, niñas y adolescentes",2018,2,9,12813,70.2411613205338,6,6542,91.7150718434729,3,6271,47.8392600861107
26446,5,5154,81,"Tasa de exámenes médico legales por presunto delito sexual contra niños, niñas y adolescentes",2018,3,25,14364,174.046226677806,3,7286,41.1748558880044,22,7078,310.822266176886
26447,5,5154,81,"Tasa de exámenes médico legales por presunto delito sexual contra niños, niñas y adolescentes",2018,4,21,14043,149.540696432386,3,7054,42.5290615253757,18,6989,257.547574760338
26448,5,5154,121,Tasa de exámenes médico legales por presunto delito sexual cuando la víctima está entre 18 y 28 años,2018,5,6,25430,23.5941801022414,1,12388,8.07232805941233,5,13042,38.337678270204
26449,5,5154,81,"Tasa de exámenes médico legales por presunto delito sexual contra niños, niñas y adolescentes",2018,1,1,2637,37.9218809252939,0,1351,0,1,1286,77.7604976671851
26450,5,5172,81,"Tasa de exámenes médico legales por presunto delito sexual contra niños, niñas y adolescentes",2018,2,4,9770,40.9416581371546,0,4983,0,4,4787,83.559640693545
26451,5,5172,81,"Tasa de exámenes médico legales por presunto delito sexual contra niños, niñas y adolescentes",2018,3,10,10742,93.0925339787749,0,5423,0,10,5319,188.005264147396
26452,5,5172,81,"Tasa de exámenes médico legales por presunto delito sexual contra niños, niñas y adolescentes",2018,4,8,10040,79.6812749003984,1,4997,20.0120072043226,7,5043,138.806266111442
26453,5,5172,121,Tasa de exámenes médico legales por presunto delito sexual cuando la víctima está entre 18 y 28 años,2018,5,1,17553,5.69703184640802,0,8608,0,1,8945,11.1794298490777
26454,5,5172,81,"Tasa de exámenes médico legales por presunto delito sexual contra niños, niñas y adolescentes",2018,1,1,2068,48.3558994197292,0,1059,0,1,1009,99.1080277502478
26455,5,5190,81,"Tasa de exámenes médico legales por presunto delito sexual contra niños, niñas y adolescentes",2018,3,3,885,338.983050847458,0,454,0,3,431,696.055684454756
26456,5,5190,81,"Tasa de exámenes médico legales por presunto delito sexual contra niños, niñas y adolescentes",2018,4,4,844,473.9336492891,0,439,0,4,405,987.654320987654
26457,5,5206,81,"Tasa de exámenes médico legales por presunto delito sexual contra niños, niñas y adolescentes",2018,3,3,273,1098.9010989011,1,141,709.219858156028,2,132,1515.15151515152
26458,5,5206,81,"Tasa de exámenes médico legales por presunto delito sexual contra niños, niñas y adolescentes",2018,4,1,253,395.256916996047,0,132,0,1,121,826.446280991736
26459,5,5209,81,"Tasa de exámenes médico legales por presunto delito sexual contra niños, niñas y adolescentes",2018,2,2,2087,95.831336847149,2,1080,185.185185185185,0,1007,0
26460,5,5209,81,"Tasa de exámenes médico legales por presunto delito sexual contra niños, niñas y adolescentes",2018,3,11,2488,442.122186495177,2,1304,153.374233128834,9,1184,760.135135135135
26461,5,5209,81,"Tasa de exámenes médico legales por presunto delito sexual contra niños, niñas y adolescentes",2018,4,15,2349,638.569604086846,4,1232,324.675324675325,11,1117,984.780662488809
26462,5,5209,121,Tasa de exámenes médico legales por presunto delito sexual cuando la víctima está entre 18 y 28 años,2018,5,1,4040,24.7524752475248,0,2107,0,1,1933,51.7330574236937
26463,5,5212,81,"Tasa de exámenes médico legales por presunto delito sexual contra niños, niñas y adolescentes",2018,2,7,4751,147.337402652073,1,2410,41.49377593361,6,2341,256.300726185391
26464,5,5212,81,"Tasa de exámenes médico legales por presunto delito sexual contra niños, niñas y adolescentes",2018,3,10,5970,167.50418760469,0,3067,0,10,2903,344.47123665174
26465,5,5212,81,"Tasa de exámenes médico legales por presunto delito sexual contra niños, niñas y adolescentes",2018,4,22,6388,344.395742016281,2,3308,60.459492140266,20,3080,649.350649350649
26466,5,5212,121,Tasa de exámenes médico legales por presunto delito sexual cuando la víctima está entre 18 y 28 años,2018,5,6,13282,45.1739195904231,0,6801,0,6,6481,92.5783058170036
26467,5,5234,81,"Tasa de exámenes médico legales por presunto delito sexual contra niños, niñas y adolescentes",2018,2,3,2656,112.951807228916,1,1355,73.8007380073801,2,1301,153.727901614143
26468,5,5234,81,"Tasa de exámenes médico legales por presunto delito sexual contra niños, niñas y adolescentes",2018,3,6,2668,224.887556221889,2,1392,143.67816091954,4,1276,313.479623824451
26469,5,5234,81,"Tasa de exámenes médico legales por presunto delito sexual contra niños, niñas y adolescentes",2018,4,5,2673,187.055742611298,0,1438,0,5,1235,404.858299595142
26470,5,5237,81,"Tasa de exámenes médico legales por presunto delito sexual contra niños, niñas y adolescentes",2018,2,2,2206,90.6618313689937,2,1135,176.211453744493,0,1071,0
26471,5,5240,81,"Tasa de exámenes médico legales por presunto delito sexual contra niños, niñas y adolescentes",2018,2,2,1182,169.204737732656,0,602,0,2,580,344.827586206897
26472,5,5240,81,"Tasa de exámenes médico legales por presunto delito sexual contra niños, niñas y adolescentes",2018,3,1,1375,72.7272727272727,0,702,0,1,673,148.588410104012
26473,5,5240,81,"Tasa de exámenes médico legales por presunto delito sexual contra niños, niñas y adolescentes",2018,4,5,1292,386.996904024768,0,666,0,5,626,798.722044728435
26474,5,5250,81,"Tasa de exámenes médico legales por presunto delito sexual contra niños, niñas y adolescentes",2018,3,1,6254,15.9897665494084,1,3225,31.0077519379845,0,3029,0
26475,5,5250,81,"Tasa de exámenes médico legales por presunto delito sexual contra niños, niñas y adolescentes",2018,4,2,6069,32.9543582138738,0,3150,0,2,2919,68.5166152792052
26476,5,5264,81,"Tasa de exámenes médico legales por presunto delito sexual contra niños, niñas y adolescentes",2018,3,2,1144,174.825174825175,0,593,0,2,551,362.976406533575
26477,5,5264,81,"Tasa de exámenes médico legales por presunto delito sexual contra niños, niñas y adolescentes",2018,4,1,1111,90.00900090009,0,576,0,1,535,186.915887850467
26478,5,5266,81,"Tasa de exámenes médico legales por presunto delito sexual contra niños, niñas y adolescentes",2018,2,16,16625,96.2406015037594,1,8491,11.7771758332352,15,8134,184.411113843128
26479,5,5266,81,"Tasa de exámenes médico legales por presunto delito sexual contra niños, niñas y adolescentes",2018,3,6,20901,28.7067604420841,3,10708,28.0164363093015,3,10193,29.4319631119396
26480,5,5266,81,"Tasa de exámenes médico legales por presunto delito sexual contra niños, niñas y adolescentes",2018,4,16,21841,73.2567190146971,1,11234,8.90154886950329,15,10607,141.416046007354
26481,5,5266,121,Tasa de exámenes médico legales por presunto delito sexual cuando la víctima está entre 18 y 28 años,2018,5,3,42285,7.09471443774388,1,21434,4.66548474386489,2,20851,9.59186609754928
26482,5,5266,81,"Tasa de exámenes médico legales por presunto delito sexual contra niños, niñas y adolescentes",2018,1,1,3219,31.0655483069276,0,1653,0,1,1566,63.8569604086846
26483,5,5282,81,"Tasa de exámenes médico legales por presunto delito sexual contra niños, niñas y adolescentes",2018,2,2,1771,112.930547713156,1,900,111.111111111111,1,871,114.810562571757
26484,5,5282,81,"Tasa de exámenes médico legales por presunto delito sexual contra niños, niñas y adolescentes",2018,3,6,2178,275.482093663912,2,1112,179.856115107914,4,1066,375.234521575985
26485,5,5282,81,"Tasa de exámenes médico legales por presunto delito sexual contra niños, niñas y adolescentes",2018,4,4,2160,185.185185185185,0,1104,0,4,1056,378.787878787879
26486,5,5282,121,Tasa de exámenes médico legales por presunto delito sexual cuando la víctima está entre 18 y 28 años,2018,5,2,4099,48.7923883874116,0,2109,0,2,1990,100.502512562814
26487,5,5284,81,"Tasa de exámenes médico legales por presunto delito sexual contra niños, niñas y adolescentes",2018,2,1,1752,57.0776255707763,0,892,0,1,860,116.279069767442
26488,5,5284,81,"Tasa de exámenes médico legales por presunto delito sexual contra niños, niñas y adolescentes",2018,3,1,1964,50.9164969450102,0,1006,0,1,958,104.384133611691
26489,5,5306,81,"Tasa de exámenes médico legales por presunto delito sexual contra niños, niñas y adolescentes",2018,3,1,462,216.450216450216,1,238,420.168067226891,0,224,0
26490,5,5306,81,"Tasa de exámenes médico legales por presunto delito sexual contra niños, niñas y adolescentes",2018,4,3,421,712.589073634204,0,218,0,3,203,1477.83251231527
26491,5,5308,81,"Tasa de exámenes médico legales por presunto delito sexual contra niños, niñas y adolescentes",2018,2,8,4810,166.320166320166,0,2451,0,8,2359,339.126748622298
26492,5,5308,81,"Tasa de exámenes médico legales por presunto delito sexual contra niños, niñas y adolescentes",2018,3,8,5893,135.754284744612,1,2969,33.6813742000674,7,2924,239.398084815321
26493,5,5308,81,"Tasa de exámenes médico legales por presunto delito sexual contra niños, niñas y adolescentes",2018,4,13,6125,212.244897959184,0,3097,0,13,3028,429.326287978864
26494,5,5308,121,Tasa de exámenes médico legales por presunto delito sexual cuando la víctima está entre 18 y 28 años,2018,5,2,11682,17.1203561034069,0,5933,0,2,5749,34.7886588971995
26495,5,5310,81,"Tasa de exámenes médico legales por presunto delito sexual contra niños, niñas y adolescentes",2018,3,2,1289,155.159038013964,0,652,0,2,637,313.971742543171
26496,5,5310,81,"Tasa de exámenes médico legales por presunto delito sexual contra niños, niñas y adolescentes",2018,4,2,1284,155.763239875389,0,662,0,2,622,321.543408360129
26497,5,5313,81,"Tasa de exámenes médico legales por presunto delito sexual contra niños, niñas y adolescentes",2018,3,5,1009,495.540138751239,2,520,384.615384615385,3,489,613.496932515337
26498,5,5313,121,Tasa de exámenes médico legales por presunto delito sexual cuando la víctima está entre 18 y 28 años,2018,5,1,1875,53.3333333333333,0,970,0,1,905,110.497237569061
26499,5,5315,81,"Tasa de exámenes médico legales por presunto delito sexual contra niños, niñas y adolescentes",2018,3,1,621,161.030595813205,0,317,0,1,304,328.947368421053
26500,5,5315,81,"Tasa de exámenes médico legales por presunto delito sexual contra niños, niñas y adolescentes",2018,4,2,603,331.67495854063,0,318,0,2,285,701.754385964912
26501,5,5315,121,Tasa de exámenes médico legales por presunto delito sexual cuando la víctima está entre 18 y 28 años,2018,5,2,1123,178.094390026714,1,602,166.112956810631,1,521,191.938579654511
26502,5,5318,81,"Tasa de exámenes médico legales por presunto delito sexual contra niños, niñas y adolescentes",2018,2,8,4661,171.636987770865,2,2385,83.8574423480084,6,2276,263.620386643234
26503,5,5318,81,"Tasa de exámenes médico legales por presunto delito sexual contra niños, niñas y adolescentes",2018,3,10,5544,180.37518037518,2,2826,70.7714083510262,8,2718,294.334069168506
26504,5,5318,81,"Tasa de exámenes médico legales por presunto delito sexual contra niños, niñas y adolescentes",2018,4,10,5361,186.532363365044,2,2764,72.3589001447178,8,2597,308.047747400847
26505,5,5318,121,Tasa de exámenes médico legales por presunto delito sexual cuando la víctima está entre 18 y 28 años,2018,5,4,9813,40.7622541526546,0,4999,0,4,4814,83.0909846281678
26506,5,5321,81,"Tasa de exámenes médico legales por presunto delito sexual contra niños, niñas y adolescentes",2018,2,1,413,242.130750605327,0,210,0,1,203,492.610837438424
26507,5,5321,81,"Tasa de exámenes médico legales por presunto delito sexual contra niños, niñas y adolescentes",2018,3,4,499,801.603206412826,1,253,395.256916996047,3,246,1219.51219512195
26508,5,5321,81,"Tasa de exámenes médico legales por presunto delito sexual contra niños, niñas y adolescentes",2018,4,1,494,202.429149797571,0,254,0,1,240,416.666666666667
26509,5,5353,81,"Tasa de exámenes médico legales por presunto delito sexual contra niños, niñas y adolescentes",2018,2,1,398,251.256281407035,0,203,0,1,195,512.820512820513
26510,5,5353,81,"Tasa de exámenes médico legales por presunto delito sexual contra niños, niñas y adolescentes",2018,3,1,461,216.919739696312,0,237,0,1,224,446.428571428571
26511,5,5353,81,"Tasa de exámenes médico legales por presunto delito sexual contra niños, niñas y adolescentes",2018,4,1,451,221.729490022173,1,231,432.900432900433,0,220,0
26512,5,5360,81,"Tasa de exámenes médico legales por presunto delito sexual contra niños, niñas y adolescentes",2018,2,25,20610,121.300339640951,5,10581,47.254512805973,20,10029,199.421677136305
26513,5,5360,81,"Tasa de exámenes médico legales por presunto delito sexual contra niños, niñas y adolescentes",2018,3,31,24791,125.045379371546,8,12605,63.4668782229274,23,12186,188.741178401444
26514,5,5360,81,"Tasa de exámenes médico legales por presunto delito sexual contra niños, niñas y adolescentes",2018,4,29,26562,109.178525713425,3,13278,22.5937641211026,26,13284,195.724179464017
26515,5,5360,121,Tasa de exámenes médico legales por presunto delito sexual cuando la víctima está entre 18 y 28 años,2018,5,12,55432,21.6481454755376,2,28397,7.04299749973589,10,27035,36.9890882189754
26516,5,5361,81,"Tasa de exámenes médico legales por presunto delito sexual contra niños, niñas y adolescentes",2018,2,3,2663,112.654900488171,1,1347,74.2390497401633,2,1316,151.975683890577
26517,5,5361,81,"Tasa de exámenes médico legales por presunto delito sexual contra niños, niñas y adolescentes",2018,3,8,2839,281.789362451567,0,1439,0,8,1400,571.428571428571
26518,5,5361,81,"Tasa de exámenes médico legales por presunto delito sexual contra niños, niñas y adolescentes",2018,4,5,2446,204.415372035977,0,1244,0,5,1202,415.973377703827
26519,5,5364,81,"Tasa de exámenes médico legales por presunto delito sexual contra niños, niñas y adolescentes",2018,2,3,1276,235.109717868339,1,655,152.671755725191,2,621,322.061191626409
26520,5,5364,81,"Tasa de exámenes médico legales por presunto delito sexual contra niños, niñas y adolescentes",2018,3,5,1508,331.564986737401,3,780,384.615384615385,2,728,274.725274725275
26521,5,5364,81,"Tasa de exámenes médico legales por presunto delito sexual contra niños, niñas y adolescentes",2018,4,3,1426,210.378681626928,0,742,0,3,684,438.59649122807
26522,5,5368,81,"Tasa de exámenes médico legales por presunto delito sexual contra niños, niñas y adolescentes",2018,3,2,1226,163.132137030995,0,621,0,2,605,330.578512396694
26523,5,5368,81,"Tasa de exámenes médico legales por presunto delito sexual contra niños, niñas y adolescentes",2018,4,6,1188,505.050505050505,0,601,0,6,587,1022.1465076661
26524,5,5376,81,"Tasa de exámenes médico legales por presunto delito sexual contra niños, niñas y adolescentes",2018,2,11,4588,239.755884917175,3,2335,128.47965738758,8,2253,355.082112738571
26525,5,5376,81,"Tasa de exámenes médico legales por presunto delito sexual contra niños, niñas y adolescentes",2018,3,11,5599,196.463654223969,4,2871,139.324277255312,7,2728,256.598240469208
26526,5,5376,81,"Tasa de exámenes médico legales por presunto delito sexual contra niños, niñas y adolescentes",2018,4,13,5671,229.236466231705,1,2896,34.5303867403315,12,2775,432.432432432432
26527,5,5376,121,Tasa de exámenes médico legales por presunto delito sexual cuando la víctima está entre 18 y 28 años,2018,5,2,11184,17.8826895565093,1,5637,17.7399325882562,1,5547,18.0277627546422
26528,5,5380,81,"Tasa de exámenes médico legales por presunto delito sexual contra niños, niñas y adolescentes",2018,2,7,5143,136.107330351935,3,2651,113.1648434553,4,2492,160.513643659711
26529,5,5380,81,"Tasa de exámenes médico legales por presunto delito sexual contra niños, niñas y adolescentes",2018,3,9,6243,144.161460836136,3,3203,93.6621916952857,6,3040,197.368421052632
26530,5,5380,81,"Tasa de exámenes médico legales por presunto delito sexual contra niños, niñas y adolescentes",2018,4,10,6541,152.881822351322,1,3306,30.2480338777979,9,3235,278.207109737249
26531,5,5380,121,Tasa de exámenes médico legales por presunto delito sexual cuando la víctima está entre 18 y 28 años,2018,5,2,13086,15.2835090936879,0,6614,0,2,6472,30.902348578492
26532,5,5380,81,"Tasa de exámenes médico legales por presunto delito sexual contra niños, niñas y adolescentes",2018,1,1,1045,95.6937799043062,0,534,0,1,511,195.694716242661
26533,5,5390,121,Tasa de exámenes médico legales por presunto delito sexual cuando la víctima está entre 18 y 28 años,2018,5,1,1226,81.5660685154976,0,616,0,1,610,163.934426229508
26534,5,5400,81,"Tasa de exámenes médico legales por presunto delito sexual contra niños, niñas y adolescentes",2018,4,2,2136,93.6329588014981,0,1109,0,2,1027,194.741966893866
26535,5,5425,81,"Tasa de exámenes médico legales por presunto delito sexual contra niños, niñas y adolescentes",2018,4,1,640,156.25,0,330,0,1,310,322.58064516129
26536,5,5440,81,"Tasa de exámenes médico legales por presunto delito sexual contra niños, niñas y adolescentes",2018,2,8,5411,147.846978377379,2,2743,72.9128691213999,6,2668,224.887556221889
26537,5,5440,81,"Tasa de exámenes médico legales por presunto delito sexual contra niños, niñas y adolescentes",2018,3,10,6649,150.398556173861,2,3373,59.2943966795138,8,3276,244.200244200244
26538,5,5440,81,"Tasa de exámenes médico legales por presunto delito sexual contra niños, niñas y adolescentes",2018,4,5,6301,79.3524837327408,0,3254,0,5,3047,164.095831965868
26539,5,5467,81,"Tasa de exámenes médico legales por presunto delito sexual contra niños, niñas y adolescentes",2018,3,1,631,158.478605388273,0,329,0,1,302,331.12582781457
26540,5,5467,121,Tasa de exámenes médico legales por presunto delito sexual cuando la víctima está entre 18 y 28 años,2018,5,1,1096,91.2408759124088,0,578,0,1,518,193.050193050193
26541,5,5480,81,"Tasa de exámenes médico legales por presunto delito sexual contra niños, niñas y adolescentes",2018,3,7,2667,262.46719160105,1,1368,73.0994152046784,6,1299,461.89376443418
26542,5,5480,81,"Tasa de exámenes médico legales por presunto delito sexual contra niños, niñas y adolescentes",2018,4,3,2555,117.416829745597,1,1310,76.3358778625954,2,1245,160.642570281125
26543,5,5490,81,"Tasa de exámenes médico legales por presunto delito sexual contra niños, niñas y adolescentes",2018,2,4,8108,49.3339911198816,0,4152,0,4,3956,101.112234580384
26544,5,5490,81,"Tasa de exámenes médico legales por presunto delito sexual contra niños, niñas y adolescentes",2018,3,8,8775,91.1680911680912,2,4486,44.5831475702185,6,4289,139.892748892516
26545,5,5490,81,"Tasa de exámenes médico legales por presunto delito sexual contra niños, niñas y adolescentes",2018,4,23,8378,274.528527094772,0,4261,0,23,4117,558.659217877095
26546,5,5490,121,Tasa de exámenes médico legales por presunto delito sexual cuando la víctima está entre 18 y 28 años,2018,5,1,14489,6.90178756297881,0,7298,0,1,7191,13.9062717285496
26547,5,5495,81,"Tasa de exámenes médico legales por presunto delito sexual contra niños, niñas y adolescentes",2018,3,2,3404,58.7544065804935,0,1729,0,2,1675,119.402985074627
26548,5,5495,81,"Tasa de exámenes médico legales por presunto delito sexual contra niños, niñas y adolescentes",2018,4,1,3330,30.03003003003,0,1676,0,1,1654,60.459492140266
26549,5,5541,81,"Tasa de exámenes médico legales por presunto delito sexual contra niños, niñas y adolescentes",2018,2,1,1522,65.7030223390276,1,771,129.70168612192,0,751,0
26550,5,5541,81,"Tasa de exámenes médico legales por presunto delito sexual contra niños, niñas y adolescentes",2018,3,6,1714,350.058343057176,0,864,0,6,850,705.882352941176
26551,5,5541,81,"Tasa de exámenes médico legales por presunto delito sexual contra niños, niñas y adolescentes",2018,4,7,1661,421.432871763998,0,843,0,7,818,855.745721271394
26552,5,5541,121,Tasa de exámenes médico legales por presunto delito sexual cuando la víctima está entre 18 y 28 años,2018,5,2,3112,64.26735218509,0,1571,0,2,1541,129.785853341986
26553,5,5579,81,"Tasa de exámenes médico legales por presunto delito sexual contra niños, niñas y adolescentes",2018,2,7,4369,160.219729915312,0,2234,0,7,2135,327.868852459016
26554,5,5579,81,"Tasa de exámenes médico legales por presunto delito sexual contra niños, niñas y adolescentes",2018,3,16,5266,303.835928598557,5,2678,186.706497386109,11,2588,425.038639876352
26555,5,5579,81,"Tasa de exámenes médico legales por presunto delito sexual contra niños, niñas y adolescentes",2018,4,16,5137,311.465836091104,1,2594,38.550501156515,15,2543,589.854502556036
26556,5,5579,121,Tasa de exámenes médico legales por presunto delito sexual cuando la víctima está entre 18 y 28 años,2018,5,5,9953,50.2361097156636,0,4944,0,5,5009,99.8203234178479
26557,5,5585,81,"Tasa de exámenes médico legales por presunto delito sexual contra niños, niñas y adolescentes",2018,2,1,1881,53.1632110579479,0,972,0,1,909,110.01100110011
26558,5,5585,81,"Tasa de exámenes médico legales por presunto delito sexual contra niños, niñas y adolescentes",2018,4,2,1989,100.553041729512,1,1067,93.7207122774133,1,922,108.459869848156
26559,5,5591,81,"Tasa de exámenes médico legales por presunto delito sexual contra niños, niñas y adolescentes",2018,2,2,2208,90.5797101449275,0,1134,0,2,1074,186.219739292365
26560,5,5591,81,"Tasa de exámenes médico legales por presunto delito sexual contra niños, niñas y adolescentes",2018,3,2,2435,82.135523613963,0,1270,0,2,1165,171.673819742489
26561,5,5591,81,"Tasa de exámenes médico legales por presunto delito sexual contra niños, niñas y adolescentes",2018,4,6,2344,255.972696245734,0,1245,0,6,1099,545.950864422202
26562,5,5591,121,Tasa de exámenes médico legales por presunto delito sexual cuando la víctima está entre 18 y 28 años,2018,5,1,4288,23.3208955223881,1,2279,43.8788942518649,0,2009,0
26563,5,5604,81,"Tasa de exámenes médico legales por presunto delito sexual contra niños, niñas y adolescentes",2018,3,4,3658,109.349371241115,1,1907,52.4383848977452,3,1751,171.330668189606
26564,5,5604,81,"Tasa de exámenes médico legales por presunto delito sexual contra niños, niñas y adolescentes",2018,4,9,3657,246.103363412633,0,1921,0,9,1736,518.433179723502
26565,5,5604,121,Tasa de exámenes médico legales por presunto delito sexual cuando la víctima está entre 18 y 28 años,2018,5,1,6665,15.0037509377344,0,3505,0,1,3160,31.6455696202532
26566,5,5607,81,"Tasa de exámenes médico legales por presunto delito sexual contra niños, niñas y adolescentes",2018,2,2,1644,121.654501216545,0,842,0,2,802,249.376558603491
26567,5,5607,81,"Tasa de exámenes médico legales por presunto delito sexual contra niños, niñas y adolescentes",2018,3,3,1993,150.526843953838,0,1019,0,3,974,308.008213552361
26568,5,5607,81,"Tasa de exámenes médico legales por presunto delito sexual contra niños, niñas y adolescentes",2018,4,5,2025,246.913580246914,0,1049,0,5,976,512.295081967213
26569,5,5607,121,Tasa de exámenes médico legales por presunto delito sexual cuando la víctima está entre 18 y 28 años,2018,5,2,3869,51.6929439131559,0,2027,0,2,1842,108.5776330076
26570,5,5615,81,"Tasa de exámenes médico legales por presunto delito sexual contra niños, niñas y adolescentes",2018,2,5,10111,49.4510928691524,2,5200,38.4615384615385,3,4911,61.0873549175321
26571,5,5615,81,"Tasa de exámenes médico legales por presunto delito sexual contra niños, niñas y adolescentes",2018,3,20,12431,160.888102324833,0,6370,0,20,6061,329.978551394159
26572,5,5615,81,"Tasa de exámenes médico legales por presunto delito sexual contra niños, niñas y adolescentes",2018,4,19,12622,150.530819204563,4,6419,62.3150023368126,15,6203,241.818474931485
26573,5,5615,121,Tasa de exámenes médico legales por presunto delito sexual cuando la víctima está entre 18 y 28 años,2018,5,9,24577,36.6196036945111,2,12654,15.8052789631737,7,11923,58.7100561939109
26574,5,5631,81,"Tasa de exámenes médico legales por presunto delito sexual contra niños, niñas y adolescentes",2018,2,4,2822,141.743444365698,1,1434,69.7350069735007,3,1388,216.138328530259
26575,5,5631,81,"Tasa de exámenes médico legales por presunto delito sexual contra niños, niñas y adolescentes",2018,3,7,3488,200.688073394495,2,1758,113.765642775882,5,1730,289.017341040462
26576,5,5631,81,"Tasa de exámenes médico legales por presunto delito sexual contra niños, niñas y adolescentes",2018,4,10,3915,255.427841634738,1,1962,50.9683995922528,9,1953,460.829493087558
26577,5,5642,81,"Tasa de exámenes médico legales por presunto delito sexual contra niños, niñas y adolescentes",2018,2,3,1775,169.014084507042,0,913,0,3,862,348.027842227378
26578,5,5642,81,"Tasa de exámenes médico legales por presunto delito sexual contra niños, niñas y adolescentes",2018,3,14,2096,667.93893129771,1,1092,91.5750915750916,13,1004,1294.82071713147
26579,5,5642,81,"Tasa de exámenes médico legales por presunto delito sexual contra niños, niñas y adolescentes",2018,4,1,1977,50.5816894284269,0,1044,0,1,933,107.181136120043
26580,5,5647,81,"Tasa de exámenes médico legales por presunto delito sexual contra niños, niñas y adolescentes",2018,2,1,595,168.067226890756,0,305,0,1,290,344.827586206897
26581,5,5647,81,"Tasa de exámenes médico legales por presunto delito sexual contra niños, niñas y adolescentes",2018,3,1,680,147.058823529412,0,353,0,1,327,305.810397553517
26582,5,5647,81,"Tasa de exámenes médico legales por presunto delito sexual contra niños, niñas y adolescentes",2018,4,1,631,158.478605388273,0,333,0,1,298,335.570469798658
26583,5,5649,81,"Tasa de exámenes médico legales por presunto delito sexual contra niños, niñas y adolescentes",2018,3,1,1763,56.7214974475326,1,918,108.932461873638,0,845,0
26584,5,5649,121,Tasa de exámenes médico legales por presunto delito sexual cuando la víctima está entre 18 y 28 años,2018,5,1,2577,38.8048117966628,0,1365,0,1,1212,82.5082508250825
26585,5,5656,81,"Tasa de exámenes médico legales por presunto delito sexual contra niños, niñas y adolescentes",2018,4,2,1363,146.735143066764,0,700,0,2,663,301.659125188537
26586,5,5659,81,"Tasa de exámenes médico legales por presunto delito sexual contra niños, niñas y adolescentes",2018,3,2,3865,51.7464424320828,0,1979,0,2,1886,106.044538706257
26587,5,5659,81,"Tasa de exámenes médico legales por presunto delito sexual contra niños, niñas y adolescentes",2018,4,1,3316,30.1568154402895,0,1709,0,1,1607,62.2277535780958
26588,5,5660,81,"Tasa de exámenes médico legales por presunto delito sexual contra niños, niñas y adolescentes",2018,3,5,1236,404.53074433657,2,659,303.490136570561,3,577,519.930675909879
26589,5,5660,81,"Tasa de exámenes médico legales por presunto delito sexual contra niños, niñas y adolescentes",2018,4,6,1133,529.567519858782,0,620,0,6,513,1169.59064327485
26590,5,5660,121,Tasa de exámenes médico legales por presunto delito sexual cuando la víctima está entre 18 y 28 años,2018,5,1,1963,50.9424350483953,0,1096,0,1,867,115.340253748558
26591,5,5664,81,"Tasa de exámenes médico legales por presunto delito sexual contra niños, niñas y adolescentes",2018,2,1,2631,38.0083618396047,0,1341,0,1,1290,77.5193798449612
26592,5,5664,81,"Tasa de exámenes médico legales por presunto delito sexual contra niños, niñas y adolescentes",2018,3,4,3257,122.812404052809,0,1641,0,4,1616,247.524752475248
26593,5,5664,81,"Tasa de exámenes médico legales por presunto delito sexual contra niños, niñas y adolescentes",2018,4,11,3181,345.803206538824,0,1629,0,11,1552,708.762886597938
26594,5,5664,121,Tasa de exámenes médico legales por presunto delito sexual cuando la víctima está entre 18 y 28 años,2018,5,5,5801,86.1920358558869,0,3031,0,5,2770,180.505415162455
26595,5,5665,81,"Tasa de exámenes médico legales por presunto delito sexual contra niños, niñas y adolescentes",2018,3,2,4360,45.8715596330275,2,2248,88.9679715302491,0,2112,0
26596,5,5667,81,"Tasa de exámenes médico legales por presunto delito sexual contra niños, niñas y adolescentes",2018,2,2,1041,192.122958693564,0,539,0,2,502,398.406374501992
26597,5,5667,81,"Tasa de exámenes médico legales por presunto delito sexual contra niños, niñas y adolescentes",2018,3,2,1174,170.357751277683,0,621,0,2,553,361.663652802893
26598,5,5667,81,"Tasa de exámenes médico legales por presunto delito sexual contra niños, niñas y adolescentes",2018,4,5,1136,440.140845070423,1,604,165.562913907285,4,532,751.87969924812
26599,5,5670,81,"Tasa de exámenes médico legales por presunto delito sexual contra niños, niñas y adolescentes",2018,2,1,1657,60.3500301750151,0,847,0,1,810,123.456790123457
26600,5,5670,81,"Tasa de exámenes médico legales por presunto delito sexual contra niños, niñas y adolescentes",2018,3,3,1937,154.878678368611,0,992,0,3,945,317.460317460317
26601,5,5670,81,"Tasa de exámenes médico legales por presunto delito sexual contra niños, niñas y adolescentes",2018,4,3,1731,173.310225303293,1,884,113.122171945701,2,847,236.127508854782
26602,5,5670,121,Tasa de exámenes médico legales por presunto delito sexual cuando la víctima está entre 18 y 28 años,2018,5,1,2937,34.0483486550902,0,1489,0,1,1448,69.060773480663
26603,5,5679,81,"Tasa de exámenes médico legales por presunto delito sexual contra niños, niñas y adolescentes",2018,2,2,1953,102.406554019457,0,992,0,2,961,208.116545265349
26604,5,5679,81,"Tasa de exámenes médico legales por presunto delito sexual contra niños, niñas y adolescentes",2018,3,7,2347,298.253089049851,2,1199,166.805671392827,5,1148,435.540069686411
26605,5,5679,81,"Tasa de exámenes médico legales por presunto delito sexual contra niños, niñas y adolescentes",2018,4,6,2225,269.662921348315,0,1139,0,6,1086,552.486187845304
26606,5,5679,121,Tasa de exámenes médico legales por presunto delito sexual cuando la víctima está entre 18 y 28 años,2018,5,2,4134,48.3792936623125,0,2063,0,2,2071,96.5717044905843
26607,5,5686,81,"Tasa de exámenes médico legales por presunto delito sexual contra niños, niñas y adolescentes",2018,2,3,3294,91.0746812386157,1,1685,59.3471810089021,2,1609,124.300807955252
26608,5,5686,81,"Tasa de exámenes médico legales por presunto delito sexual contra niños, niñas y adolescentes",2018,3,8,4005,199.750312109863,4,2030,197.044334975369,4,1975,202.53164556962
26609,5,5686,81,"Tasa de exámenes médico legales por presunto delito sexual contra niños, niñas y adolescentes",2018,4,5,4070,122.850122850123,0,2120,0,5,1950,256.410256410256
26610,5,5686,121,Tasa de exámenes médico legales por presunto delito sexual cuando la víctima está entre 18 y 28 años,2018,5,1,7579,13.1943528169943,0,3955,0,1,3624,27.5938189845475
26611,5,5690,81,"Tasa de exámenes médico legales por presunto delito sexual contra niños, niñas y adolescentes",2018,2,1,967,103.412616339193,0,498,0,1,469,213.219616204691
26612,5,5690,81,"Tasa de exámenes médico legales por presunto delito sexual contra niños, niñas y adolescentes",2018,4,1,1087,91.9963201471941,0,566,0,1,521,191.938579654511
26613,5,5697,81,"Tasa de exámenes médico legales por presunto delito sexual contra niños, niñas y adolescentes",2018,2,3,2213,135.562584726615,1,1127,88.7311446317658,2,1086,184.162062615101
26614,5,5697,81,"Tasa de exámenes médico legales por presunto delito sexual contra niños, niñas y adolescentes",2018,3,8,2628,304.41400304414,0,1345,0,8,1283,623.538581449727
26615,5,5697,81,"Tasa de exámenes médico legales por presunto delito sexual contra niños, niñas y adolescentes",2018,4,11,2625,419.047619047619,1,1364,73.3137829912023,10,1261,793.021411578113
26616,5,5697,121,Tasa de exámenes médico legales por presunto delito sexual cuando la víctima está entre 18 y 28 años,2018,5,8,5035,158.88778550149,0,2579,0,8,2456,325.732899022801
26617,5,5736,81,"Tasa de exámenes médico legales por presunto delito sexual contra niños, niñas y adolescentes",2018,2,3,4313,69.557152793879,0,2218,0,3,2095,143.198090692124
26618,5,5736,81,"Tasa de exámenes médico legales por presunto delito sexual contra niños, niñas y adolescentes",2018,3,2,4909,40.7414952128743,0,2541,0,2,2368,84.4594594594595
26619,5,5736,81,"Tasa de exámenes médico legales por presunto delito sexual contra niños, niñas y adolescentes",2018,4,12,4864,246.710526315789,0,2523,0,12,2341,512.601452370782
26620,5,5736,121,Tasa de exámenes médico legales por presunto delito sexual cuando la víctima está entre 18 y 28 años,2018,5,1,9011,11.0975474420153,0,4688,0,1,4323,23.1320842007865
26621,5,5756,81,"Tasa de exámenes médico legales por presunto delito sexual contra niños, niñas y adolescentes",2018,2,3,2961,101.317122593718,0,1509,0,3,1452,206.611570247934
26622,5,5756,81,"Tasa de exámenes médico legales por presunto delito sexual contra niños, niñas y adolescentes",2018,3,8,3780,211.640211640212,2,1930,103.626943005181,6,1850,324.324324324324
26623,5,5756,81,"Tasa de exámenes médico legales por presunto delito sexual contra niños, niñas y adolescentes",2018,4,17,3615,470.262793914246,2,1847,108.283703302653,15,1768,848.41628959276
26624,5,5756,121,Tasa de exámenes médico legales por presunto delito sexual cuando la víctima está entre 18 y 28 años,2018,5,2,6926,28.8766965059197,1,3505,28.5306704707561,1,3421,29.2312189418299
26625,5,5761,81,"Tasa de exámenes médico legales por presunto delito sexual contra niños, niñas y adolescentes",2018,3,3,1609,186.451211932878,0,833,0,3,776,386.59793814433
26626,5,5761,81,"Tasa de exámenes médico legales por presunto delito sexual contra niños, niñas y adolescentes",2018,4,1,1570,63.6942675159236,0,836,0,1,734,136.239782016349
26627,5,5789,81,"Tasa de exámenes médico legales por presunto delito sexual contra niños, niñas y adolescentes",2018,3,1,1374,72.7802037845706,0,704,0,1,670,149.253731343284
26628,5,5790,81,"Tasa de exámenes médico legales por presunto delito sexual contra niños, niñas y adolescentes",2018,2,1,5966,16.7616493462957,0,3042,0,1,2924,34.1997264021888
26629,5,5790,81,"Tasa de exámenes médico legales por presunto delito sexual contra niños, niñas y adolescentes",2018,3,4,6603,60.5785249129184,1,3379,29.5945546019532,3,3224,93.0521091811414
26630,5,5790,81,"Tasa de exámenes médico legales por presunto delito sexual contra niños, niñas y adolescentes",2018,4,4,6125,65.3061224489796,0,3148,0,4,2977,134.363453140746
26631,5,5792,81,"Tasa de exámenes médico legales por presunto delito sexual contra niños, niñas y adolescentes",2018,2,2,806,248.138957816377,1,419,238.663484486874,1,387,258.397932816537
26632,5,5792,81,"Tasa de exámenes médico legales por presunto delito sexual contra niños, niñas y adolescentes",2018,4,2,891,224.466891133558,0,469,0,2,422,473.9336492891
26633,5,5809,81,"Tasa de exámenes médico legales por presunto delito sexual contra niños, niñas y adolescentes",2018,2,1,1132,88.339222614841,0,583,0,1,549,182.149362477231
26634,5,5809,81,"Tasa de exámenes médico legales por presunto delito sexual contra niños, niñas y adolescentes",2018,3,1,1395,71.6845878136201,0,723,0,1,672,148.809523809524
26635,5,5809,81,"Tasa de exámenes médico legales por presunto delito sexual contra niños, niñas y adolescentes",2018,4,1,1339,74.6825989544436,0,697,0,1,642,155.763239875389
26636,5,5837,81,"Tasa de exámenes médico legales por presunto delito sexual contra niños, niñas y adolescentes",2018,2,5,20925,23.89486260454,1,10734,9.31619154089808,4,10191,39.2503189088411
26637,5,5837,81,"Tasa de exámenes médico legales por presunto delito sexual contra niños, niñas y adolescentes",2018,3,10,22812,43.8365772400491,1,11856,8.43454790823212,9,10956,82.1467688937568
26638,5,5837,81,"Tasa de exámenes médico legales por presunto delito sexual contra niños, niñas y adolescentes",2018,4,14,21822,64.1554394647603,1,10914,9.16254352208173,13,10908,119.178584525119
26639,5,5837,121,Tasa de exámenes médico legales por presunto delito sexual cuando la víctima está entre 18 y 28 años,2018,5,4,37453,10.6800523322564,4,18901,21.1629014337866,0,18552,0
26640,5,5842,81,"Tasa de exámenes médico legales por presunto delito sexual contra niños, niñas y adolescentes",2018,2,1,830,120.481927710843,0,438,0,1,392,255.102040816327
26641,5,5842,81,"Tasa de exámenes médico legales por presunto delito sexual contra niños, niñas y adolescentes",2018,3,1,934,107.066381156317,0,502,0,1,432,231.481481481481
26642,5,5842,81,"Tasa de exámenes médico legales por presunto delito sexual contra niños, niñas y adolescentes",2018,4,1,898,111.358574610245,0,489,0,1,409,244.498777506112
26643,5,5847,81,"Tasa de exámenes médico legales por presunto delito sexual contra niños, niñas y adolescentes",2018,2,5,4714,106.067034365719,0,2419,0,5,2295,217.864923747277
26644,5,5847,81,"Tasa de exámenes médico legales por presunto delito sexual contra niños, niñas y adolescentes",2018,3,15,5451,275.178866263071,7,2844,246.132208157525,8,2607,306.86612965094
26645,5,5847,81,"Tasa de exámenes médico legales por presunto delito sexual contra niños, niñas y adolescentes",2018,4,9,5072,177.444794952681,3,2720,110.294117647059,6,2352,255.102040816327
26646,5,5847,121,Tasa de exámenes médico legales por presunto delito sexual cuando la víctima está entre 18 y 28 años,2018,5,5,8328,60.0384245917387,1,4485,22.2965440356745,4,3843,104.085349986989
26647,5,5854,81,"Tasa de exámenes médico legales por presunto delito sexual contra niños, niñas y adolescentes",2018,2,1,2980,33.5570469798658,0,1527,0,1,1453,68.8231245698555
26648,5,5854,81,"Tasa de exámenes médico legales por presunto delito sexual contra niños, niñas y adolescentes",2018,3,1,3173,31.5159155373464,1,1631,61.3120784794605,0,1542,0
26649,5,5854,81,"Tasa de exámenes médico legales por presunto delito sexual contra niños, niñas y adolescentes",2018,4,1,2900,34.4827586206897,1,1500,66.6666666666667,0,1400,0
26650,5,5856,81,"Tasa de exámenes médico legales por presunto delito sexual contra niños, niñas y adolescentes",2018,3,1,689,145.137880986938,0,361,0,1,328,304.878048780488
26651,5,5858,81,"Tasa de exámenes médico legales por presunto delito sexual contra niños, niñas y adolescentes",2018,2,1,986,101.419878296146,0,507,0,1,479,208.768267223382
26652,5,5858,81,"Tasa de exámenes médico legales por presunto delito sexual contra niños, niñas y adolescentes",2018,3,3,1153,260.1908065915,1,591,169.204737732656,2,562,355.871886120996
26653,5,5858,81,"Tasa de exámenes médico legales por presunto delito sexual contra niños, niñas y adolescentes",2018,4,2,1046,191.204588910134,1,531,188.323917137476,1,515,194.174757281553
26654,5,5858,121,Tasa de exámenes médico legales por presunto delito sexual cuando la víctima está entre 18 y 28 años,2018,5,2,1563,127.959053103007,0,766,0,2,797,250.941028858218
26655,5,5861,81,"Tasa de exámenes médico legales por presunto delito sexual contra niños, niñas y adolescentes",2018,3,2,1236,161.812297734628,0,641,0,2,595,336.134453781513
26656,5,5861,81,"Tasa de exámenes médico legales por presunto delito sexual contra niños, niñas y adolescentes",2018,4,5,1206,414.593698175788,0,638,0,5,568,880.281690140845
26657,5,5887,81,"Tasa de exámenes médico legales por presunto delito sexual contra niños, niñas y adolescentes",2018,2,3,5015,59.8205383848455,0,2570,0,3,2445,122.699386503067
26658,5,5887,81,"Tasa de exámenes médico legales por presunto delito sexual contra niños, niñas y adolescentes",2018,3,6,6033,99.4530084535057,1,3090,32.3624595469256,5,2943,169.894665307509
26659,5,5887,81,"Tasa de exámenes médico legales por presunto delito sexual contra niños, niñas y adolescentes",2018,4,9,5568,161.637931034483,2,2855,70.0525394045534,7,2713,258.016955399926
26660,5,5887,121,Tasa de exámenes médico legales por presunto delito sexual cuando la víctima está entre 18 y 28 años,2018,5,1,9798,10.2061645233721,0,4929,0,1,4869,20.5380981721093
26661,5,5890,81,"Tasa de exámenes médico legales por presunto delito sexual contra niños, niñas y adolescentes",2018,2,2,2458,81.366965012205,0,1255,0,2,1203,166.251039068994
26662,5,5890,81,"Tasa de exámenes médico legales por presunto delito sexual contra niños, niñas y adolescentes",2018,3,3,2997,100.1001001001,0,1535,0,3,1462,205.198358413133
26663,5,5890,81,"Tasa de exámenes médico legales por presunto delito sexual contra niños, niñas y adolescentes",2018,4,2,2731,73.2332478945441,0,1406,0,2,1325,150.943396226415
26664,5,5890,121,Tasa de exámenes médico legales por presunto delito sexual cuando la víctima está entre 18 y 28 años,2018,5,1,4933,20.271639975674,0,2541,0,1,2392,41.8060200668896
26665,5,5893,81,"Tasa de exámenes médico legales por presunto delito sexual contra niños, niñas y adolescentes",2018,3,3,2223,134.952766531714,0,1142,0,3,1081,277.520814061055
26666,5,5893,81,"Tasa de exámenes médico legales por presunto delito sexual contra niños, niñas y adolescentes",2018,4,1,2172,46.0405156537753,0,1115,0,1,1057,94.6073793755913
26667,5,5893,121,Tasa de exámenes médico legales por presunto delito sexual cuando la víctima está entre 18 y 28 años,2018,5,1,4040,24.7524752475248,0,2073,0,1,1967,50.8388408744281
26668,5,5895,81,"Tasa de exámenes médico legales por presunto delito sexual contra niños, niñas y adolescentes",2018,3,1,3944,25.3549695740365,0,2033,0,1,1911,52.3286237571952
26669,50,50001,81,"Tasa de exámenes médico legales por presunto delito sexual contra niños, niñas y adolescentes",2018,2,77,43961,175.155251245422,12,22459,53.4306959348146,65,21502,302.29746070133
26670,50,50001,81,"Tasa de exámenes médico legales por presunto delito sexual contra niños, niñas y adolescentes",2018,3,191,53685,355.779081680171,31,27274,113.661362469751,160,26411,605.808185983113
26671,50,50001,81,"Tasa de exámenes médico legales por presunto delito sexual contra niños, niñas y adolescentes",2018,4,189,54010,349.935197185706,18,27227,66.1108458515444,171,26783,638.464697756039
26672,50,50001,121,Tasa de exámenes médico legales por presunto delito sexual cuando la víctima está entre 18 y 28 años,2018,5,30,97474,30.7774380860537,1,47202,2.11855429854667,29,50272,57.6861871419478
26673,50,50006,81,"Tasa de exámenes médico legales por presunto delito sexual contra niños, niñas y adolescentes",2018,2,12,6637,180.804580382703,6,3365,178.306092124814,6,3272,183.374083129584
26674,50,50006,81,"Tasa de exámenes médico legales por presunto delito sexual contra niños, niñas y adolescentes",2018,3,35,7757,451.205362898028,12,3871,309.997416688194,23,3886,591.868244981987
26675,50,50006,81,"Tasa de exámenes médico legales por presunto delito sexual contra niños, niñas y adolescentes",2018,4,20,7406,270.051309748852,0,3669,0,20,3737,535.188654000535
26676,50,50006,121,Tasa de exámenes médico legales por presunto delito sexual cuando la víctima está entre 18 y 28 años,2018,5,4,13606,29.3987946494194,2,6625,30.188679245283,2,6981,28.6491906603638
26677,50,50110,81,"Tasa de exámenes médico legales por presunto delito sexual contra niños, niñas y adolescentes",2018,4,1,503,198.807157057654,0,252,0,1,251,398.406374501992
26678,50,50110,121,Tasa de exámenes médico legales por presunto delito sexual cuando la víctima está entre 18 y 28 años,2018,5,3,870,344.827586206897,0,421,0,3,449,668.15144766147
26679,50,50124,81,"Tasa de exámenes médico legales por presunto delito sexual contra niños, niñas y adolescentes",2018,3,1,497,201.207243460765,0,261,0,1,236,423.728813559322
26680,50,50124,81,"Tasa de exámenes médico legales por presunto delito sexual contra niños, niñas y adolescentes",2018,4,2,451,443.458980044346,0,240,0,2,211,947.867298578199
26681,50,50150,81,"Tasa de exámenes médico legales por presunto delito sexual contra niños, niñas y adolescentes",2018,2,3,1048,286.259541984733,0,540,0,3,508,590.551181102362
26682,50,50150,81,"Tasa de exámenes médico legales por presunto delito sexual contra niños, niñas y adolescentes",2018,3,1,1171,85.397096498719,0,598,0,1,573,174.520069808028
26683,50,50150,81,"Tasa de exámenes médico legales por presunto delito sexual contra niños, niñas y adolescentes",2018,4,2,1100,181.818181818182,0,548,0,2,552,362.31884057971
26684,50,50223,81,"Tasa de exámenes médico legales por presunto delito sexual contra niños, niñas y adolescentes",2018,2,1,619,161.550888529887,0,319,0,1,300,333.333333333333
26685,50,50223,81,"Tasa de exámenes médico legales por presunto delito sexual contra niños, niñas y adolescentes",2018,3,1,731,136.798905608755,0,376,0,1,355,281.69014084507
26686,50,50223,81,"Tasa de exámenes médico legales por presunto delito sexual contra niños, niñas y adolescentes",2018,4,1,641,156.00624024961,0,327,0,1,314,318.471337579618
26687,50,50226,81,"Tasa de exámenes médico legales por presunto delito sexual contra niños, niñas y adolescentes",2018,2,6,1887,317.965023847377,0,970,0,6,917,654.307524536532
26688,50,50226,81,"Tasa de exámenes médico legales por presunto delito sexual contra niños, niñas y adolescentes",2018,3,7,2368,295.608108108108,1,1210,82.6446280991735,6,1158,518.134715025907
26689,50,50226,81,"Tasa de exámenes médico legales por presunto delito sexual contra niños, niñas y adolescentes",2018,4,17,2120,801.88679245283,0,1064,0,17,1056,1609.84848484848
26690,50,50245,81,"Tasa de exámenes médico legales por presunto delito sexual contra niños, niñas y adolescentes",2018,4,1,246,406.50406504065,0,128,0,1,118,847.457627118644
26691,50,50251,81,"Tasa de exámenes médico legales por presunto delito sexual contra niños, niñas y adolescentes",2018,2,1,650,153.846153846154,0,335,0,1,315,317.460317460317
26692,50,50251,81,"Tasa de exámenes médico legales por presunto delito sexual contra niños, niñas y adolescentes",2018,3,3,725,413.793103448276,0,378,0,3,347,864.553314121037
26693,50,50251,81,"Tasa de exámenes médico legales por presunto delito sexual contra niños, niñas y adolescentes",2018,4,3,645,465.116279069767,0,336,0,3,309,970.873786407767
26694,50,50270,81,"Tasa de exámenes médico legales por presunto delito sexual contra niños, niñas y adolescentes",2018,3,1,453,220.75055187638,0,239,0,1,214,467.289719626168
26695,50,50287,81,"Tasa de exámenes médico legales por presunto delito sexual contra niños, niñas y adolescentes",2018,2,1,1459,68.5400959561343,1,741,134.952766531714,0,718,0
26696,50,50287,81,"Tasa de exámenes médico legales por presunto delito sexual contra niños, niñas y adolescentes",2018,3,4,1678,238.379022646007,2,848,235.849056603774,2,830,240.963855421687
26697,50,50287,81,"Tasa de exámenes médico legales por presunto delito sexual contra niños, niñas y adolescentes",2018,4,1,1615,61.9195046439629,0,823,0,1,792,126.262626262626
26698,50,50313,81,"Tasa de exámenes médico legales por presunto delito sexual contra niños, niñas y adolescentes",2018,2,5,6764,73.9207569485512,1,3434,29.120559114735,4,3330,120.12012012012
26699,50,50313,81,"Tasa de exámenes médico legales por presunto delito sexual contra niños, niñas y adolescentes",2018,3,9,7473,120.433560818948,1,3773,26.5041081367612,8,3700,216.216216216216
26700,50,50313,81,"Tasa de exámenes médico legales por presunto delito sexual contra niños, niñas y adolescentes",2018,4,13,6940,187.319884726225,0,3493,0,13,3447,377.139541630403
26701,50,50313,121,Tasa de exámenes médico legales por presunto delito sexual cuando la víctima está entre 18 y 28 años,2018,5,4,14497,27.5919155687384,0,8838,0,4,5659,70.6838664074925
26702,50,50318,81,"Tasa de exámenes médico legales por presunto delito sexual contra niños, niñas y adolescentes",2018,2,3,826,363.19612590799,1,426,234.741784037559,2,400,500
26703,50,50318,81,"Tasa de exámenes médico legales por presunto delito sexual contra niños, niñas y adolescentes",2018,3,3,981,305.810397553517,0,511,0,3,470,638.297872340425
26704,50,50318,81,"Tasa de exámenes médico legales por presunto delito sexual contra niños, niñas y adolescentes",2018,4,3,923,325.027085590466,0,470,0,3,453,662.251655629139
26705,50,50318,121,Tasa de exámenes médico legales por presunto delito sexual cuando la víctima está entre 18 y 28 años,2018,5,1,1702,58.7544065804935,1,834,119.904076738609,0,868,0
26706,50,50325,81,"Tasa de exámenes médico legales por presunto delito sexual contra niños, niñas y adolescentes",2018,4,1,1951,51.2557662737058,0,981,0,1,970,103.092783505155
26707,50,50330,81,"Tasa de exámenes médico legales por presunto delito sexual contra niños, niñas y adolescentes",2018,2,1,1422,70.323488045007,0,734,0,1,688,145.348837209302
26708,50,50330,81,"Tasa de exámenes médico legales por presunto delito sexual contra niños, niñas y adolescentes",2018,3,4,1472,271.739130434783,1,765,130.718954248366,3,707,424.328147100424
26709,50,50330,81,"Tasa de exámenes médico legales por presunto delito sexual contra niños, niñas y adolescentes",2018,4,3,1340,223.880597014925,0,682,0,3,658,455.927051671732
26710,50,50330,121,Tasa de exámenes médico legales por presunto delito sexual cuando la víctima está entre 18 y 28 años,2018,5,2,2223,89.9685110211426,0,1077,0,2,1146,174.520069808028
26711,50,50350,81,"Tasa de exámenes médico legales por presunto delito sexual contra niños, niñas y adolescentes",2018,2,1,3988,25.0752256770311,1,2038,49.0677134445535,0,1950,0
26712,50,50350,81,"Tasa de exámenes médico legales por presunto delito sexual contra niños, niñas y adolescentes",2018,3,5,4608,108.506944444444,0,2359,0,5,2249,222.321031569586
26713,50,50350,81,"Tasa de exámenes médico legales por presunto delito sexual contra niños, niñas y adolescentes",2018,4,11,4323,254.452926208651,0,2234,0,11,2089,526.567735758736
26714,50,50370,81,"Tasa de exámenes médico legales por presunto delito sexual contra niños, niñas y adolescentes",2018,3,1,2060,48.5436893203883,0,1046,0,1,1014,98.6193293885602
26715,50,50370,81,"Tasa de exámenes médico legales por presunto delito sexual contra niños, niñas y adolescentes",2018,4,4,1905,209.97375328084,1,984,101.626016260163,3,921,325.732899022801
26716,50,50400,81,"Tasa de exámenes médico legales por presunto delito sexual contra niños, niñas y adolescentes",2018,3,4,1116,358.4229390681,0,598,0,4,518,772.200772200772
26717,50,50400,81,"Tasa de exámenes médico legales por presunto delito sexual contra niños, niñas y adolescentes",2018,4,1,1043,95.8772770853308,0,572,0,1,471,212.314225053079
26718,50,50400,121,Tasa de exámenes médico legales por presunto delito sexual cuando la víctima está entre 18 y 28 años,2018,5,1,1877,53.276505061268,0,1015,0,1,862,116.009280742459
26719,50,50450,81,"Tasa de exámenes médico legales por presunto delito sexual contra niños, niñas y adolescentes",2018,2,1,2382,41.9815281276238,0,1222,0,1,1160,86.2068965517241
26720,50,50450,81,"Tasa de exámenes médico legales por presunto delito sexual contra niños, niñas y adolescentes",2018,3,4,2698,148.257968865827,1,1393,71.7875089734386,3,1305,229.885057471264
26721,50,50450,81,"Tasa de exámenes médico legales por presunto delito sexual contra niños, niñas y adolescentes",2018,4,2,2506,79.8084596967279,1,1308,76.4525993883792,1,1198,83.4724540901503
26722,50,50568,81,"Tasa de exámenes médico legales por presunto delito sexual contra niños, niñas y adolescentes",2018,2,4,2649,151.000377500944,0,1372,0,4,1277,313.234142521535
26723,50,50568,81,"Tasa de exámenes médico legales por presunto delito sexual contra niños, niñas y adolescentes",2018,3,4,2890,138.40830449827,0,1501,0,4,1389,287.976961843053
26724,50,50568,81,"Tasa de exámenes médico legales por presunto delito sexual contra niños, niñas y adolescentes",2018,4,10,2557,391.083300743058,0,1307,0,10,1250,800
26725,50,50568,121,Tasa de exámenes médico legales por presunto delito sexual cuando la víctima está entre 18 y 28 años,2018,5,3,3656,82.0568927789934,1,1750,57.1428571428571,2,1906,104.931794333683
26726,50,50573,81,"Tasa de exámenes médico legales por presunto delito sexual contra niños, niñas y adolescentes",2018,2,10,3420,292.397660818713,3,1769,169.587337478802,7,1651,423.985463355542
26727,50,50573,81,"Tasa de exámenes médico legales por presunto delito sexual contra niños, niñas y adolescentes",2018,3,18,4152,433.526011560694,6,2188,274.223034734918,12,1964,610.997963340122
26728,50,50573,81,"Tasa de exámenes médico legales por presunto delito sexual contra niños, niñas y adolescentes",2018,4,21,3987,526.711813393529,0,2169,0,21,1818,1155.11551155116
26729,50,50573,121,Tasa de exámenes médico legales por presunto delito sexual cuando la víctima está entre 18 y 28 años,2018,5,3,6512,46.0687960687961,0,3499,0,3,3013,99.5685363425158
26730,50,50577,81,"Tasa de exámenes médico legales por presunto delito sexual contra niños, niñas y adolescentes",2018,2,2,993,201.409869083585,0,516,0,2,477,419.287211740042
26731,50,50577,81,"Tasa de exámenes médico legales por presunto delito sexual contra niños, niñas y adolescentes",2018,3,2,1174,170.357751277683,0,617,0,2,557,359.066427289048
26732,50,50577,81,"Tasa de exámenes médico legales por presunto delito sexual contra niños, niñas y adolescentes",2018,4,2,1136,176.056338028169,0,605,0,2,531,376.647834274953
26733,50,50577,121,Tasa de exámenes médico legales por presunto delito sexual cuando la víctima está entre 18 y 28 años,2018,5,1,1791,55.8347292015634,0,992,0,1,799,125.156445556946
26734,50,50590,81,"Tasa de exámenes médico legales por presunto delito sexual contra niños, niñas y adolescentes",2018,2,1,2178,45.9136822773186,0,1138,0,1,1040,96.1538461538462
26735,50,50590,81,"Tasa de exámenes médico legales por presunto delito sexual contra niños, niñas y adolescentes",2018,3,1,2491,40.1445202729827,0,1357,0,1,1134,88.1834215167548
26736,50,50590,81,"Tasa de exámenes médico legales por presunto delito sexual contra niños, niñas y adolescentes",2018,4,8,2313,345.871162991786,0,1319,0,8,994,804.828973843058
26737,50,50606,81,"Tasa de exámenes médico legales por presunto delito sexual contra niños, niñas y adolescentes",2018,2,5,1008,496.031746031746,1,517,193.423597678917,4,491,814.663951120163
26738,50,50606,81,"Tasa de exámenes médico legales por presunto delito sexual contra niños, niñas y adolescentes",2018,3,4,1185,337.552742616034,0,607,0,4,578,692.041522491349
26739,50,50606,81,"Tasa de exámenes médico legales por presunto delito sexual contra niños, niñas y adolescentes",2018,4,7,1126,621.669626998224,1,565,176.991150442478,6,561,1069.51871657754
26740,50,50680,81,"Tasa de exámenes médico legales por presunto delito sexual contra niños, niñas y adolescentes",2018,2,5,1247,400.962309542903,0,637,0,5,610,819.672131147541
26741,50,50680,81,"Tasa de exámenes médico legales por presunto delito sexual contra niños, niñas y adolescentes",2018,3,3,1376,218.023255813953,1,705,141.843971631206,2,671,298.06259314456
26742,50,50680,81,"Tasa de exámenes médico legales por presunto delito sexual contra niños, niñas y adolescentes",2018,4,11,1245,883.534136546185,1,641,156.00624024961,10,604,1655.62913907285
26743,50,50683,81,"Tasa de exámenes médico legales por presunto delito sexual contra niños, niñas y adolescentes",2018,2,2,1077,185.701021355617,1,552,181.159420289855,1,525,190.47619047619
26744,50,50683,81,"Tasa de exámenes médico legales por presunto delito sexual contra niños, niñas y adolescentes",2018,4,4,1056,378.787878787879,0,547,0,4,509,785.854616895874
26745,50,50689,81,"Tasa de exámenes médico legales por presunto delito sexual contra niños, niñas y adolescentes",2018,2,1,2430,41.1522633744856,0,1239,0,1,1191,83.9630562552477
26746,50,50689,81,"Tasa de exámenes médico legales por presunto delito sexual contra niños, niñas y adolescentes",2018,3,5,2940,170.068027210884,1,1509,66.2690523525514,4,1431,279.524807826695
26747,50,50689,81,"Tasa de exámenes médico legales por presunto delito sexual contra niños, niñas y adolescentes",2018,4,8,2707,295.530107129664,0,1383,0,8,1324,604.229607250755
26748,50,50711,81,"Tasa de exámenes médico legales por presunto delito sexual contra niños, niñas y adolescentes",2018,3,2,3353,59.6480763495377,1,1714,58.343057176196,1,1639,61.012812690665
26749,50,50711,81,"Tasa de exámenes médico legales por presunto delito sexual contra niños, niñas y adolescentes",2018,4,5,3110,160.771704180064,0,1601,0,5,1509,331.345261762757
26750,50,50711,121,Tasa de exámenes médico legales por presunto delito sexual cuando la víctima está entre 18 y 28 años,2018,5,1,4998,20.0080032012805,0,2482,0,1,2516,39.7456279809221
26751,52,52001,81,"Tasa de exámenes médico legales por presunto delito sexual contra niños, niñas y adolescentes",2018,2,6,30959,19.380470945444,3,15828,18.9537528430629,3,15131,19.8268455488732
26752,52,52001,81,"Tasa de exámenes médico legales por presunto delito sexual contra niños, niñas y adolescentes",2018,3,14,39367,35.5627810094749,4,20041,19.95908387805,10,19326,51.7437648763324
26753,52,52001,81,"Tasa de exámenes médico legales por presunto delito sexual contra niños, niñas y adolescentes",2018,4,25,43330,57.696745903531,3,21655,13.8536134841838,22,21675,101.499423298731
26754,52,52001,121,Tasa de exámenes médico legales por presunto delito sexual cuando la víctima está entre 18 y 28 años,2018,5,25,84750,29.4985250737463,0,43214,0,25,41536,60.1887519260401
26755,52,52019,81,"Tasa de exámenes médico legales por presunto delito sexual contra niños, niñas y adolescentes",2018,4,1,2433,41.101520756268,1,1216,82.2368421052632,0,1217,0
26756,52,52036,81,"Tasa de exámenes médico legales por presunto delito sexual contra niños, niñas y adolescentes",2018,3,2,585,341.880341880342,0,298,0,2,287,696.864111498258
26757,52,52051,81,"Tasa de exámenes médico legales por presunto delito sexual contra niños, niñas y adolescentes",2018,4,1,721,138.69625520111,0,369,0,1,352,284.090909090909
26758,52,52207,81,"Tasa de exámenes médico legales por presunto delito sexual contra niños, niñas y adolescentes",2018,3,3,847,354.191263282172,2,428,467.289719626168,1,419,238.663484486874
26759,52,52227,81,"Tasa de exámenes médico legales por presunto delito sexual contra niños, niñas y adolescentes",2018,4,1,4218,23.7079184447606,0,2095,0,1,2123,47.1031559114461
26760,52,52240,81,"Tasa de exámenes médico legales por presunto delito sexual contra niños, niñas y adolescentes",2018,3,1,1423,70.2740688685875,0,699,0,1,724,138.121546961326
26761,52,52240,81,"Tasa de exámenes médico legales por presunto delito sexual contra niños, niñas y adolescentes",2018,4,1,1495,66.8896321070234,0,732,0,1,763,131.061598951507
26762,52,52250,81,"Tasa de exámenes médico legales por presunto delito sexual contra niños, niñas y adolescentes",2018,3,1,5906,16.9319336268202,0,2962,0,1,2944,33.9673913043478
26763,52,52250,121,Tasa de exámenes médico legales por presunto delito sexual cuando la víctima está entre 18 y 28 años,2018,5,1,8950,11.1731843575419,0,4595,0,1,4355,22.9621125143513
26764,52,52256,81,"Tasa de exámenes médico legales por presunto delito sexual contra niños, niñas y adolescentes",2018,4,2,1070,186.915887850467,0,569,0,2,501,399.201596806387
26765,52,52258,81,"Tasa de exámenes médico legales por presunto delito sexual contra niños, niñas y adolescentes",2018,3,1,1297,77.1010023130301,0,660,0,1,637,156.985871271586
26766,52,52260,81,"Tasa de exámenes médico legales por presunto delito sexual contra niños, niñas y adolescentes",2018,4,1,1187,84.24599831508,0,601,0,1,586,170.648464163823
26767,52,52356,81,"Tasa de exámenes médico legales por presunto delito sexual contra niños, niñas y adolescentes",2018,3,1,15361,6.50999283900788,0,7894,0,1,7467,13.3922592741395
26768,52,52356,81,"Tasa de exámenes médico legales por presunto delito sexual contra niños, niñas y adolescentes",2018,4,2,15973,12.5211294058724,0,8010,0,2,7963,25.1161622504081
26769,52,52356,121,Tasa de exámenes médico legales por presunto delito sexual cuando la víctima está entre 18 y 28 años,2018,5,1,26720,3.74251497005988,0,13581,0,1,13139,7.61092929446685
26770,52,52399,81,"Tasa de exámenes médico legales por presunto delito sexual contra niños, niñas y adolescentes",2018,3,1,2391,41.8235048097031,0,1205,0,1,1186,84.3170320404722
26771,52,52399,81,"Tasa de exámenes médico legales por presunto delito sexual contra niños, niñas y adolescentes",2018,4,1,2507,39.8883127243718,0,1263,0,1,1244,80.3858520900322
26772,52,52405,81,"Tasa de exámenes médico legales por presunto delito sexual contra niños, niñas y adolescentes",2018,2,1,1717,58.24111822947,0,873,0,1,844,118.483412322275
26773,52,52405,81,"Tasa de exámenes médico legales por presunto delito sexual contra niños, niñas y adolescentes",2018,4,1,1850,54.0540540540541,1,949,105.374077976818,0,901,0
26774,52,52411,81,"Tasa de exámenes médico legales por presunto delito sexual contra niños, niñas y adolescentes",2018,3,1,859,116.414435389988,0,431,0,1,428,233.644859813084
26775,52,52427,121,Tasa de exámenes médico legales por presunto delito sexual cuando la víctima está entre 18 y 28 años,2018,5,1,5036,19.8570293884035,0,2793,0,1,2243,44.5831475702185
26776,52,52480,81,"Tasa de exámenes médico legales por presunto delito sexual contra niños, niñas y adolescentes",2018,3,1,498,200.803212851406,1,256,390625,0,242,0
26777,52,52540,81,"Tasa de exámenes médico legales por presunto delito sexual contra niños, niñas y adolescentes",2018,4,1,1941,51.5198351365276,0,1032,0,1,909,110.01100110011
26778,52,52683,81,"Tasa de exámenes médico legales por presunto delito sexual contra niños, niñas y adolescentes",2018,4,1,2508,39.8724082934609,0,1302,0,1,1206,82.9187396351576
26779,52,52696,81,"Tasa de exámenes médico legales por presunto delito sexual contra niños, niñas y adolescentes",2018,4,1,2008,49.800796812749,0,1014,0,1,994,100.603621730382
26780,52,52786,81,"Tasa de exámenes médico legales por presunto delito sexual contra niños, niñas y adolescentes",2018,3,1,1958,51.0725229826353,1,1003,99.7008973080758,0,955,0
26781,52,52786,81,"Tasa de exámenes médico legales por presunto delito sexual contra niños, niñas y adolescentes",2018,4,1,1961,50.9943906170321,0,1004,0,1,957,104.493207941484
26782,52,52786,121,Tasa de exámenes médico legales por presunto delito sexual cuando la víctima está entre 18 y 28 años,2018,5,2,4013,49.838026414154,0,2076,0,2,1937,103.252452245741
26783,52,52788,81,"Tasa de exámenes médico legales por presunto delito sexual contra niños, niñas y adolescentes",2018,2,1,727,137.551581843191,0,367,0,1,360,277.777777777778
26784,52,52835,81,"Tasa de exámenes médico legales por presunto delito sexual contra niños, niñas y adolescentes",2018,2,1,25771,3.88033060416747,0,13177,0,1,12594,7.94028902652057
26785,52,52835,81,"Tasa de exámenes médico legales por presunto delito sexual contra niños, niñas y adolescentes",2018,3,2,29018,6.89227376111379,1,14802,6.75584380489123,1,14216,7.03432751828925
26786,52,52835,81,"Tasa de exámenes médico legales por presunto delito sexual contra niños, niñas y adolescentes",2018,4,2,27062,7.39043677481339,1,13704,7.29713952130765,1,13358,7.4861506213505
26787,52,52835,121,Tasa de exámenes médico legales por presunto delito sexual cuando la víctima está entre 18 y 28 años,2018,5,7,41996,16.6682541194399,1,21128,4.73305566073457,6,20868,28.7521564117309
26788,52,52838,81,"Tasa de exámenes médico legales por presunto delito sexual contra niños, niñas y adolescentes",2018,3,5,3916,127.681307456588,2,1996,100.200400801603,3,1920,156.25
26789,52,52838,81,"Tasa de exámenes médico legales por presunto delito sexual contra niños, niñas y adolescentes",2018,4,1,4026,24.8385494287134,0,2053,0,1,1973,50.6842372022301
26790,52,52838,121,Tasa de exámenes médico legales por presunto delito sexual cuando la víctima está entre 18 y 28 años,2018,5,1,7580,13.1926121372032,0,3912,0,1,3668,27.2628135223555
26791,54,54001,81,"Tasa de exámenes médico legales por presunto delito sexual contra niños, niñas y adolescentes",2018,2,46,55931,82.2441937387138,12,28605,41.9507079181961,34,27326,124.423625850838
26792,54,54001,81,"Tasa de exámenes médico legales por presunto delito sexual contra niños, niñas y adolescentes",2018,3,112,67633,165.599633315098,30,34198,87.7244283291421,82,33435,245.251981456558
26793,54,54001,81,"Tasa de exámenes médico legales por presunto delito sexual contra niños, niñas y adolescentes",2018,4,143,72268,197.874577959816,17,36377,46.7328256865602,126,35891,351.062940570059
26794,54,54001,121,Tasa de exámenes médico legales por presunto delito sexual cuando la víctima está entre 18 y 28 años,2018,5,30,133781,22.4247090394002,1,67551,1.48036298500392,29,66230,43.7868035633399
26795,54,54003,81,"Tasa de exámenes médico legales por presunto delito sexual contra niños, niñas y adolescentes",2018,2,1,4191,23.8606537819136,0,2134,0,1,2057,48.6144871171609
26796,54,54003,81,"Tasa de exámenes médico legales por presunto delito sexual contra niños, niñas y adolescentes",2018,3,1,4623,21.6309755569976,0,2332,0,1,2291,43.6490615451768
26797,54,54003,81,"Tasa de exámenes médico legales por presunto delito sexual contra niños, niñas y adolescentes",2018,4,1,4449,22.4769611148573,0,2242,0,1,2207,45.3103760761214
26798,54,54051,81,"Tasa de exámenes médico legales por presunto delito sexual contra niños, niñas y adolescentes",2018,3,1,1002,99.8003992015968,1,523,191.204588910134,0,479,0
26799,54,54051,121,Tasa de exámenes médico legales por presunto delito sexual cuando la víctima está entre 18 y 28 años,2018,5,1,1845,54.2005420054201,0,1000,0,1,845,118.343195266272
26800,54,54099,81,"Tasa de exámenes médico legales por presunto delito sexual contra niños, niñas y adolescentes",2018,3,1,766,130.548302872063,0,390,0,1,376,265.957446808511
26801,54,54099,81,"Tasa de exámenes médico legales por presunto delito sexual contra niños, niñas y adolescentes",2018,4,1,751,133.155792276964,0,398,0,1,353,283.28611898017
26802,54,54099,121,Tasa de exámenes médico legales por presunto delito sexual cuando la víctima está entre 18 y 28 años,2018,5,1,1330,75.187969924812,0,688,0,1,642,155.763239875389
26803,54,54109,81,"Tasa de exámenes médico legales por presunto delito sexual contra niños, niñas y adolescentes",2018,4,1,532,187.96992481203,0,276,0,1,256,390625
26804,54,54128,81,"Tasa de exámenes médico legales por presunto delito sexual contra niños, niñas y adolescentes",2018,4,1,1237,80.8407437348424,0,652,0,1,585,170.940170940171
26805,54,54128,121,Tasa de exámenes médico legales por presunto delito sexual cuando la víctima está entre 18 y 28 años,2018,5,3,2020,148.514851485149,0,1099,0,3,921,325.732899022801
26806,54,54172,81,"Tasa de exámenes médico legales por presunto delito sexual contra niños, niñas y adolescentes",2018,2,2,1591,125.707102451289,0,817,0,2,774,258.397932816537
26807,54,54172,81,"Tasa de exámenes médico legales por presunto delito sexual contra niños, niñas y adolescentes",2018,3,1,1786,55.9910414333707,0,906,0,1,880,113.636363636364
26808,54,54172,81,"Tasa de exámenes médico legales por presunto delito sexual contra niños, niñas y adolescentes",2018,4,6,1751,342.661336379212,1,890,112.359550561798,5,861,580.720092915215
26809,54,54172,121,Tasa de exámenes médico legales por presunto delito sexual cuando la víctima está entre 18 y 28 años,2018,5,2,3019,66.2471016893011,0,1584,0,2,1435,139.372822299652
26810,54,54174,81,"Tasa de exámenes médico legales por presunto delito sexual contra niños, niñas y adolescentes",2018,4,2,1207,165.700082850041,0,636,0,2,571,350.262697022767
26811,54,54206,121,Tasa de exámenes médico legales por presunto delito sexual cuando la víctima está entre 18 y 28 años,2018,5,1,2295,43.5729847494553,0,1227,0,1,1068,93.6329588014981
26812,54,54223,121,Tasa de exámenes médico legales por presunto delito sexual cuando la víctima está entre 18 y 28 años,2018,5,1,1495,66.8896321070234,0,757,0,1,738,135.50135501355
26813,54,54239,81,"Tasa de exámenes médico legales por presunto delito sexual contra niños, niñas y adolescentes",2018,4,2,375,533.333333333333,0,201,0,2,174,1149.42528735632
26814,54,54245,81,"Tasa de exámenes médico legales por presunto delito sexual contra niños, niñas y adolescentes",2018,3,1,1646,60.7533414337788,1,834,119.904076738609,0,812,0
26815,54,54245,81,"Tasa de exámenes médico legales por presunto delito sexual contra niños, niñas y adolescentes",2018,4,1,1619,61.7665225447807,0,845,0,1,774,129.198966408269
26816,54,54250,81,"Tasa de exámenes médico legales por presunto delito sexual contra niños, niñas y adolescentes",2018,3,2,1500,133.333333333333,0,768,0,2,732,273.224043715847
26817,54,54261,81,"Tasa de exámenes médico legales por presunto delito sexual contra niños, niñas y adolescentes",2018,3,3,2804,106.990014265335,0,1435,0,3,1369,219.138056975895
26818,54,54261,81,"Tasa de exámenes médico legales por presunto delito sexual contra niños, niñas y adolescentes",2018,4,4,2748,145.560407569141,0,1423,0,4,1325,301.88679245283
26819,54,54261,121,Tasa de exámenes médico legales por presunto delito sexual cuando la víctima está entre 18 y 28 años,2018,5,2,4854,41.2031314379893,0,2523,0,2,2331,85.8000858000858
26820,54,54344,81,"Tasa de exámenes médico legales por presunto delito sexual contra niños, niñas y adolescentes",2018,3,2,1464,136.612021857924,0,728,0,2,736,271.739130434783
26821,54,54344,81,"Tasa de exámenes médico legales por presunto delito sexual contra niños, niñas y adolescentes",2018,4,1,1369,73.0460189919649,0,693,0,1,676,147.92899408284
26822,54,54344,121,Tasa de exámenes médico legales por presunto delito sexual cuando la víctima está entre 18 y 28 años,2018,5,1,2293,43.6109899694723,0,1232,0,1,1061,94.2507068803016
26823,54,54377,81,"Tasa de exámenes médico legales por presunto delito sexual contra niños, niñas y adolescentes",2018,4,2,686,291.545189504373,0,367,0,2,319,626.959247648903
26824,54,54385,81,"Tasa de exámenes médico legales por presunto delito sexual contra niños, niñas y adolescentes",2018,3,4,1709,234.055002925688,0,878,0,4,831,481.347773766546
26825,54,54385,81,"Tasa de exámenes médico legales por presunto delito sexual contra niños, niñas y adolescentes",2018,4,2,1640,121.951219512195,0,851,0,2,789,253.485424588086
26826,54,54398,81,"Tasa de exámenes médico legales por presunto delito sexual contra niños, niñas y adolescentes",2018,4,1,869,115.074798619102,0,431,0,1,438,228.310502283105
26827,54,54405,81,"Tasa de exámenes médico legales por presunto delito sexual contra niños, niñas y adolescentes",2018,2,4,6268,63.8162093171666,0,3209,0,4,3059,130.76168682576
26828,54,54405,81,"Tasa de exámenes médico legales por presunto delito sexual contra niños, niñas y adolescentes",2018,3,9,7649,117.66243953458,2,3846,52.0020800832033,7,3803,184.065211674993
26829,54,54405,81,"Tasa de exámenes médico legales por presunto delito sexual contra niños, niñas y adolescentes",2018,4,10,8104,123.395853899309,1,4047,24.7096614776378,9,4057,221.838797140744
26830,54,54405,121,Tasa de exámenes médico legales por presunto delito sexual cuando la víctima está entre 18 y 28 años,2018,5,3,15310,19.5950359242325,1,7741,12.9182276191707,2,7569,26.4235698242833
26831,54,54480,81,"Tasa de exámenes médico legales por presunto delito sexual contra niños, niñas y adolescentes",2018,4,1,410,243.90243902439,1,206,485.436893203883,0,204,0
26832,54,54498,81,"Tasa de exámenes médico legales por presunto delito sexual contra niños, niñas y adolescentes",2018,2,7,8712,80.3489439853076,1,4441,22.517451024544,6,4271,140.482322641068
26833,54,54498,81,"Tasa de exámenes médico legales por presunto delito sexual contra niños, niñas y adolescentes",2018,3,11,10848,101.401179941003,1,5486,18.22821728035,10,5362,186.497575531518
26834,54,54498,81,"Tasa de exámenes médico legales por presunto delito sexual contra niños, niñas y adolescentes",2018,4,20,10575,189.125295508274,2,5532,36.1532899493854,18,5043,356.930398572278
26835,54,54498,121,Tasa de exámenes médico legales por presunto delito sexual cuando la víctima está entre 18 y 28 años,2018,5,4,16505,24.2350802787034,1,8444,11.8427285646613,3,8061,37.2162262746558
26836,54,54518,81,"Tasa de exámenes médico legales por presunto delito sexual contra niños, niñas y adolescentes",2018,3,7,5150,135.922330097087,2,2614,76.5110941086458,5,2536,197.160883280757
26837,54,54518,81,"Tasa de exámenes médico legales por presunto delito sexual contra niños, niñas y adolescentes",2018,4,6,7456,80.4721030042918,2,3697,54.0979172301866,4,3759,106.411279595637
26838,54,54518,121,Tasa de exámenes médico legales por presunto delito sexual cuando la víctima está entre 18 y 28 años,2018,5,3,14970,20.0400801603206,1,7689,13.005592404734,2,7281,27.4687542919929
26839,54,54520,81,"Tasa de exámenes médico legales por presunto delito sexual contra niños, niñas y adolescentes",2018,4,1,515,194.174757281553,0,262,0,1,253,395.256916996047
26840,54,54553,81,"Tasa de exámenes médico legales por presunto delito sexual contra niños, niñas y adolescentes",2018,3,2,1181,169.348010160881,0,610,0,2,571,350.262697022767
26841,54,54599,81,"Tasa de exámenes médico legales por presunto delito sexual contra niños, niñas y adolescentes",2018,4,2,679,294.550810014728,0,342,0,2,337,593.471810089021
26842,54,54660,81,"Tasa de exámenes médico legales por presunto delito sexual contra niños, niñas y adolescentes",2018,3,1,984,101.626016260163,1,499,200.400801603206,0,485,0
26843,54,54660,121,Tasa de exámenes médico legales por presunto delito sexual cuando la víctima está entre 18 y 28 años,2018,5,1,1752,57.0776255707763,0,925,0,1,827,120.918984280532
26844,54,54673,81,"Tasa de exámenes médico legales por presunto delito sexual contra niños, niñas y adolescentes",2018,2,3,580,517.241379310345,1,300,333.333333333333,2,280,714.285714285714
26845,54,54673,81,"Tasa de exámenes médico legales por presunto delito sexual contra niños, niñas y adolescentes",2018,3,1,673,148.588410104012,0,346,0,1,327,305.810397553517
26846,54,54673,81,"Tasa de exámenes médico legales por presunto delito sexual contra niños, niñas y adolescentes",2018,4,3,644,465.83850931677,1,325,307.692307692308,2,319,626.959247648903
26847,54,54720,81,"Tasa de exámenes médico legales por presunto delito sexual contra niños, niñas y adolescentes",2018,3,2,2996,66.7556742323097,0,1570,0,2,1426,140.252454417952
26848,54,54720,81,"Tasa de exámenes médico legales por presunto delito sexual contra niños, niñas y adolescentes",2018,4,3,2666,112.528132033008,0,1439,0,3,1227,244.498777506112
26849,54,54743,81,"Tasa de exámenes médico legales por presunto delito sexual contra niños, niñas y adolescentes",2018,2,1,429,233.100233100233,0,221,0,1,208,480.769230769231
26850,54,54743,121,Tasa de exámenes médico legales por presunto delito sexual cuando la víctima está entre 18 y 28 años,2018,5,1,835,119.760479041916,0,443,0,1,392,255.102040816327
26851,54,54800,81,"Tasa de exámenes médico legales por presunto delito sexual contra niños, niñas y adolescentes",2018,4,1,3041,32.8839197632358,0,1570,0,1,1471,67.9809653297077
26852,54,54800,121,Tasa de exámenes médico legales por presunto delito sexual cuando la víctima está entre 18 y 28 años,2018,5,1,4534,22.0555800617556,1,2371,42.1762969211303,0,2163,0
26853,54,54810,81,"Tasa de exámenes médico legales por presunto delito sexual contra niños, niñas y adolescentes",2018,2,2,4704,42.5170068027211,0,2417,0,2,2287,87.4508089199825
26854,54,54810,81,"Tasa de exámenes médico legales por presunto delito sexual contra niños, niñas y adolescentes",2018,3,4,5119,78.1402617698769,0,2659,0,4,2460,162.60162601626
26855,54,54810,81,"Tasa de exámenes médico legales por presunto delito sexual contra niños, niñas y adolescentes",2018,4,11,4695,234.291799787007,2,2490,80.3212851405623,9,2205,408.163265306122
26856,54,54810,121,Tasa de exámenes médico legales por presunto delito sexual cuando la víctima está entre 18 y 28 años,2018,5,1,7395,13.5226504394861,0,3906,0,1,3489,28.6615075952995
26857,54,54820,81,"Tasa de exámenes médico legales por presunto delito sexual contra niños, niñas y adolescentes",2018,3,1,1893,52.8262017960909,0,959,0,1,934,107.066381156317
26858,54,54820,81,"Tasa de exámenes médico legales por presunto delito sexual contra niños, niñas y adolescentes",2018,4,4,1876,213.219616204691,0,949,0,4,927,431.499460625674
26859,54,54874,81,"Tasa de exámenes médico legales por presunto delito sexual contra niños, niñas y adolescentes",2018,2,4,8281,48.3033450066417,1,4269,23.4246896228625,3,4012,74.7756729810568
26860,54,54874,81,"Tasa de exámenes médico legales por presunto delito sexual contra niños, niñas y adolescentes",2018,3,14,9867,141.887098408838,5,5055,98.9119683481701,9,4812,187.032418952618
26861,54,54874,81,"Tasa de exámenes médico legales por presunto delito sexual contra niños, niñas y adolescentes",2018,4,8,10344,77.3395204949729,2,5265,37.9867046533713,6,5079,118.133490844654
26862,54,54874,121,Tasa de exámenes médico legales por presunto delito sexual cuando la víctima está entre 18 y 28 años,2018,5,4,19062,20.9841569614941,0,9802,0,4,9260,43.1965442764579
26863,63,63001,81,"Tasa de exámenes médico legales por presunto delito sexual contra niños, niñas y adolescentes",2018,2,45,22600,199.115044247788,11,11540,95.3206239168111,34,11060,307.414104882459
26864,63,63001,81,"Tasa de exámenes médico legales por presunto delito sexual contra niños, niñas y adolescentes",2018,3,74,27039,273.678760309183,18,13724,131.157097056252,56,13315,420.578295155839
26865,63,63001,81,"Tasa de exámenes médico legales por presunto delito sexual contra niños, niñas y adolescentes",2018,4,104,27194,382.437302346106,15,13781,108.845511936724,89,13413,663.535376127637
26866,63,63001,121,Tasa de exámenes médico legales por presunto delito sexual cuando la víctima está entre 18 y 28 años,2018,5,14,53451,26.192213429122,2,26973,7.41482222963704,12,26478,45.3206435531385
26867,63,63111,81,"Tasa de exámenes médico legales por presunto delito sexual contra niños, niñas y adolescentes",2018,2,1,225,444.444444444444,1,116,862.068965517241,0,109,0
26868,63,63111,81,"Tasa de exámenes médico legales por presunto delito sexual contra niños, niñas y adolescentes",2018,3,4,267,1498.12734082397,0,137,0,4,130,3076.92307692308
26869,63,63111,81,"Tasa de exámenes médico legales por presunto delito sexual contra niños, niñas y adolescentes",2018,4,2,262,763.358778625954,0,136,0,2,126,1587.30158730159
26870,63,63111,121,Tasa de exámenes médico legales por presunto delito sexual cuando la víctima está entre 18 y 28 años,2018,5,2,499,400.801603206413,0,260,0,2,239,836.820083682008
26871,63,63130,81,"Tasa de exámenes médico legales por presunto delito sexual contra niños, niñas y adolescentes",2018,2,17,6417,264.921302789465,4,3307,120.955548835803,13,3110,418.006430868167
26872,63,63130,81,"Tasa de exámenes médico legales por presunto delito sexual contra niños, niñas y adolescentes",2018,3,30,7639,392.721560413667,6,3955,151.706700379267,24,3684,651.465798045603
26873,63,63130,81,"Tasa de exámenes médico legales por presunto delito sexual contra niños, niñas y adolescentes",2018,4,34,7445,456.682337139019,6,3853,155.722813392162,28,3592,779.510022271715
26874,63,63130,121,Tasa de exámenes médico legales por presunto delito sexual cuando la víctima está entre 18 y 28 años,2018,5,2,14239,14.0459301917269,0,7390,0,2,6849,29.20134326179
26875,63,63190,81,"Tasa de exámenes médico legales por presunto delito sexual contra niños, niñas y adolescentes",2018,2,3,2401,124.947938359017,0,1226,0,3,1175,255.31914893617
26876,63,63190,81,"Tasa de exámenes médico legales por presunto delito sexual contra niños, niñas y adolescentes",2018,3,5,2813,177.746178457163,1,1416,70.6214689265537,4,1397,286.327845382963
26877,63,63190,81,"Tasa de exámenes médico legales por presunto delito sexual contra niños, niñas y adolescentes",2018,4,9,2721,330.760749724366,2,1351,148.038490007402,7,1370,510.948905109489
26878,63,63190,121,Tasa de exámenes médico legales por presunto delito sexual cuando la víctima está entre 18 y 28 años,2018,5,1,5420,18.450184501845,0,2731,0,1,2689,37.1885459278542
26879,63,63212,81,"Tasa de exámenes médico legales por presunto delito sexual contra niños, niñas y adolescentes",2018,2,1,430,232.558139534884,0,220,0,1,210,476.190476190476
26880,63,63212,81,"Tasa de exámenes médico legales por presunto delito sexual contra niños, niñas y adolescentes",2018,3,3,508,590.551181102362,2,261,766.283524904215,1,247,404.858299595142
26881,63,63212,81,"Tasa de exámenes médico legales por presunto delito sexual contra niños, niñas y adolescentes",2018,4,2,496,403.225806451613,0,255,0,2,241,829.875518672199
26882,63,63272,81,"Tasa de exámenes médico legales por presunto delito sexual contra niños, niñas y adolescentes",2018,2,2,1201,166.527893422148,0,614,0,2,587,340.715502555366
26883,63,63272,81,"Tasa de exámenes médico legales por presunto delito sexual contra niños, niñas y adolescentes",2018,3,5,1329,376.222723852521,2,678,294.985250737463,3,651,460.829493087558
26884,63,63272,81,"Tasa de exámenes médico legales por presunto delito sexual contra niños, niñas y adolescentes",2018,4,10,1304,766.871165644172,2,672,297.619047619048,8,632,1265.82278481013
26885,63,63272,121,Tasa de exámenes médico legales por presunto delito sexual cuando la víctima está entre 18 y 28 años,2018,5,1,2584,38.6996904024768,1,1337,74.794315632012,0,1247,0
26886,63,63302,81,"Tasa de exámenes médico legales por presunto delito sexual contra niños, niñas y adolescentes",2018,3,8,722,1108.03324099723,1,371,269.541778975741,7,351,1994.30199430199
26887,63,63302,81,"Tasa de exámenes médico legales por presunto delito sexual contra niños, niñas y adolescentes",2018,4,6,704,852.272727272727,1,362,276.243093922652,5,342,1461.98830409357
26888,63,63401,81,"Tasa de exámenes médico legales por presunto delito sexual contra niños, niñas y adolescentes",2018,2,8,4337,184.459303666129,1,2233,44.7828034034931,7,2104,332.699619771863
26889,63,63401,81,"Tasa de exámenes médico legales por presunto delito sexual contra niños, niñas y adolescentes",2018,3,13,4916,264.442636289666,3,2566,116.913484021824,10,2350,425.531914893617
26890,63,63401,81,"Tasa de exámenes médico legales por presunto delito sexual contra niños, niñas y adolescentes",2018,4,21,4853,432.722027611787,3,2513,119.379228014326,18,2340,769.230769230769
26891,63,63401,121,Tasa de exámenes médico legales por presunto delito sexual cuando la víctima está entre 18 y 28 años,2018,5,2,8661,23.0920217065004,0,4304,0,2,4357,45.903144365389
26892,63,63470,81,"Tasa de exámenes médico legales por presunto delito sexual contra niños, niñas y adolescentes",2018,2,10,3564,280.583613916947,2,1830,109.289617486339,8,1734,461.361014994233
26893,63,63470,81,"Tasa de exámenes médico legales por presunto delito sexual contra niños, niñas y adolescentes",2018,3,13,4187,310.484834010031,2,2169,92.2083909635777,11,2018,545.094152626363
26894,63,63470,81,"Tasa de exámenes médico legales por presunto delito sexual contra niños, niñas y adolescentes",2018,4,7,4100,170.731707317073,2,2162,92.5069380203515,5,1938,257.997936016512
26895,63,63548,81,"Tasa de exámenes médico legales por presunto delito sexual contra niños, niñas y adolescentes",2018,2,3,490,612.244897959184,0,250,0,3,240,1250
26896,63,63548,81,"Tasa de exámenes médico legales por presunto delito sexual contra niños, niñas y adolescentes",2018,3,5,579,863.557858376511,2,299,668.896321070234,3,280,1071.42857142857
26897,63,63548,81,"Tasa de exámenes médico legales por presunto delito sexual contra niños, niñas y adolescentes",2018,4,1,563,177.619893428064,0,290,0,1,273,366.300366300366
26898,63,63594,81,"Tasa de exámenes médico legales por presunto delito sexual contra niños, niñas y adolescentes",2018,2,4,2891,138.36042891733,0,1484,0,4,1407,284.292821606254
26899,63,63594,81,"Tasa de exámenes médico legales por presunto delito sexual contra niños, niñas y adolescentes",2018,3,13,3383,384.274312740171,5,1746,286.368843069874,8,1637,488.698839340257
26900,63,63594,81,"Tasa de exámenes médico legales por presunto delito sexual contra niños, niñas y adolescentes",2018,4,12,3273,366.636113657195,0,1692,0,12,1581,759.013282732448
26901,63,63690,81,"Tasa de exámenes médico legales por presunto delito sexual contra niños, niñas y adolescentes",2018,2,4,626,638.977635782748,1,326,306.748466257669,3,300,1000
26902,63,63690,81,"Tasa de exámenes médico legales por presunto delito sexual contra niños, niñas y adolescentes",2018,3,4,720,555.555555555556,0,379,0,4,341,1173.02052785924
26903,63,63690,81,"Tasa de exámenes médico legales por presunto delito sexual contra niños, niñas y adolescentes",2018,4,4,692,578.034682080925,0,359,0,4,333,1201.2012012012
26904,66,66001,81,"Tasa de exámenes médico legales por presunto delito sexual contra niños, niñas y adolescentes",2018,2,76,33579,226.331933649007,21,17202,122.078828043251,55,16377,335.836844354888
26905,66,66001,81,"Tasa de exámenes médico legales por presunto delito sexual contra niños, niñas y adolescentes",2018,3,133,40789,326.068302728677,25,20921,119.497155967688,108,19868,543.587678679283
26906,66,66001,81,"Tasa de exámenes médico legales por presunto delito sexual contra niños, niñas y adolescentes",2018,4,133,41505,320.443320081918,15,21253,70.5782713028749,118,20252,582.658502863915
26907,66,66001,121,Tasa de exámenes médico legales por presunto delito sexual cuando la víctima está entre 18 y 28 años,2018,5,36,83385,43.1732325957906,2,42602,4.69461527627811,34,40783,83.3680700291788
26908,66,66045,81,"Tasa de exámenes médico legales por presunto delito sexual contra niños, niñas y adolescentes",2018,2,5,1844,271.14967462039,1,945,105.820105820106,4,899,444.938820912125
26909,66,66045,81,"Tasa de exámenes médico legales por presunto delito sexual contra niños, niñas y adolescentes",2018,3,3,2173,138.057984353428,1,1116,89.6057347670251,2,1057,189.214758751183
26910,66,66045,81,"Tasa de exámenes médico legales por presunto delito sexual contra niños, niñas y adolescentes",2018,4,4,2063,193.892389723703,0,1068,0,4,995,402.010050251256
26911,66,66075,81,"Tasa de exámenes médico legales por presunto delito sexual contra niños, niñas y adolescentes",2018,3,2,652,306.748466257669,1,332,301.204819277108,1,320,312.5
26912,66,66075,81,"Tasa de exámenes médico legales por presunto delito sexual contra niños, niñas y adolescentes",2018,4,2,623,321.027287319422,0,320,0,2,303,660.06600660066
26913,66,66088,81,"Tasa de exámenes médico legales por presunto delito sexual contra niños, niñas y adolescentes",2018,2,5,2558,195.46520719312,1,1317,75.9301442672741,4,1241,322.32070910556
26914,66,66088,81,"Tasa de exámenes médico legales por presunto delito sexual contra niños, niñas y adolescentes",2018,3,12,2965,404.721753794266,1,1526,65.5307994757536,11,1439,764.419735927728
26915,66,66088,81,"Tasa de exámenes médico legales por presunto delito sexual contra niños, niñas y adolescentes",2018,4,5,2891,172.950536146662,1,1476,67.7506775067751,4,1415,282.685512367491
26916,66,66088,121,Tasa de exámenes médico legales por presunto delito sexual cuando la víctima está entre 18 y 28 años,2018,5,1,5020,19.9203187250996,0,2625,0,1,2395,41.7536534446764
26917,66,66170,81,"Tasa de exámenes médico legales por presunto delito sexual contra niños, niñas y adolescentes",2018,2,31,15265,203.078938748772,2,7841,25.5069506440505,29,7424,390625
26918,66,66170,81,"Tasa de exámenes médico legales por presunto delito sexual contra niños, niñas y adolescentes",2018,3,58,18501,313.496567753094,10,9485,105.429625724829,48,9016,532.386867790594
26919,66,66170,81,"Tasa de exámenes médico legales por presunto delito sexual contra niños, niñas y adolescentes",2018,4,59,19204,307.227660903978,5,9754,51.2610211195407,54,9450,571.428571428571
26920,66,66170,121,Tasa de exámenes médico legales por presunto delito sexual cuando la víctima está entre 18 y 28 años,2018,5,16,38652,41.3950119010659,1,19772,5.05765729314182,15,18880,79.4491525423729
26921,66,66170,81,"Tasa de exámenes médico legales por presunto delito sexual contra niños, niñas y adolescentes",2018,1,1,3053,32.7546675401245,0,1563,0,1,1490,67.1140939597315
26922,66,66318,81,"Tasa de exámenes médico legales por presunto delito sexual contra niños, niñas y adolescentes",2018,3,1,1505,66.4451827242525,0,751,0,1,754,132.62599469496
26923,66,66318,81,"Tasa de exámenes médico legales por presunto delito sexual contra niños, niñas y adolescentes",2018,4,7,1419,493.305144467935,1,701,142.65335235378,6,718,835.654596100279
26924,66,66318,121,Tasa de exámenes médico legales por presunto delito sexual cuando la víctima está entre 18 y 28 años,2018,5,1,2450,40.8163265306122,0,1236,0,1,1214,82.3723228995058
26925,66,66383,81,"Tasa de exámenes médico legales por presunto delito sexual contra niños, niñas y adolescentes",2018,3,1,899,111.234705228031,0,462,0,1,437,228.83295194508
26926,66,66400,81,"Tasa de exámenes médico legales por presunto delito sexual contra niños, niñas y adolescentes",2018,2,7,2759,253.715114171801,2,1397,143.163922691482,5,1362,367.107195301028
26927,66,66400,81,"Tasa de exámenes médico legales por presunto delito sexual contra niños, niñas y adolescentes",2018,3,12,3232,371.287128712871,4,1626,246.0024600246,8,1606,498.13200498132
26928,66,66400,81,"Tasa de exámenes médico legales por presunto delito sexual contra niños, niñas y adolescentes",2018,4,7,3141,222.858962113976,1,1557,64.2260757867694,6,1584,378.787878787879
26929,66,66440,81,"Tasa de exámenes médico legales por presunto delito sexual contra niños, niñas y adolescentes",2018,2,8,1895,422.163588390501,3,971,308.959835221421,5,924,541.125541125541
26930,66,66440,81,"Tasa de exámenes médico legales por presunto delito sexual contra niños, niñas y adolescentes",2018,3,6,2319,258.732212160414,2,1191,167.926112510495,4,1128,354.609929078014
26931,66,66440,81,"Tasa de exámenes médico legales por presunto delito sexual contra niños, niñas y adolescentes",2018,4,4,2349,170.285227756492,0,1199,0,4,1150,347.826086956522
26932,66,66456,81,"Tasa de exámenes médico legales por presunto delito sexual contra niños, niñas y adolescentes",2018,3,2,2381,83.9983200335993,1,1195,83.6820083682008,1,1186,84.3170320404722
26933,66,66456,81,"Tasa de exámenes médico legales por presunto delito sexual contra niños, niñas y adolescentes",2018,4,5,2124,235.404896421846,1,1065,93.8967136150235,4,1059,377.714825306893
26934,66,66572,81,"Tasa de exámenes médico legales por presunto delito sexual contra niños, niñas y adolescentes",2018,3,3,1982,151.362260343088,2,996,200.803212851406,1,986,101.419878296146
26935,66,66572,81,"Tasa de exámenes médico legales por presunto delito sexual contra niños, niñas y adolescentes",2018,4,5,1767,282.965478211658,0,886,0,5,881,567.536889897843
26936,66,66594,81,"Tasa de exámenes médico legales por presunto delito sexual contra niños, niñas y adolescentes",2018,3,2,3891,51.4006682086867,0,1953,0,2,1938,103.199174406605
26937,66,66594,81,"Tasa de exámenes médico legales por presunto delito sexual contra niños, niñas y adolescentes",2018,4,1,3577,27.9563880346659,0,1790,0,1,1787,55.9597090095132
26938,66,66594,121,Tasa de exámenes médico legales por presunto delito sexual cuando la víctima está entre 18 y 28 años,2018,5,2,6036,33.1345261762757,0,3054,0,2,2982,67.0690811535882
26939,66,66682,81,"Tasa de exámenes médico legales por presunto delito sexual contra niños, niñas y adolescentes",2018,2,5,5819,85.9254167382712,4,2986,133.958472873409,1,2833,35.2982703847511
26940,66,66682,81,"Tasa de exámenes médico legales por presunto delito sexual contra niños, niñas y adolescentes",2018,3,14,7114,196.795052010121,6,3663,163.800163800164,8,3451,231.816864676905
26941,66,66682,81,"Tasa de exámenes médico legales por presunto delito sexual contra niños, niñas y adolescentes",2018,4,6,7164,83.7520938023451,1,3657,27.3448181569593,5,3507,142.571998859424
26942,66,66682,121,Tasa de exámenes médico legales por presunto delito sexual cuando la víctima está entre 18 y 28 años,2018,5,2,13351,14.9801512995281,0,6921,0,2,6430,31.104199066874
26943,66,66687,81,"Tasa de exámenes médico legales por presunto delito sexual contra niños, niñas y adolescentes",2018,2,3,1455,206.185567010309,1,740,135.135135135135,2,715,279.72027972028
26944,66,66687,81,"Tasa de exámenes médico legales por presunto delito sexual contra niños, niñas y adolescentes",2018,3,5,1655,302.114803625378,0,841,0,5,814,614.250614250614
26945,66,66687,81,"Tasa de exámenes médico legales por presunto delito sexual contra niños, niñas y adolescentes",2018,4,8,1589,503.461296412838,0,818,0,8,771,1037.61348897536
26946,68,68001,81,"Tasa de exámenes médico legales por presunto delito sexual contra niños, niñas y adolescentes",2018,2,66,33764,195.474469849544,12,17253,69.5531211963137,54,16511,327.054690812186
26947,68,68001,81,"Tasa de exámenes médico legales por presunto delito sexual contra niños, niñas y adolescentes",2018,3,96,44049,217.939113260233,20,22518,88.8178346211919,76,21531,352.979425015095
26948,68,68001,81,"Tasa de exámenes médico legales por presunto delito sexual contra niños, niñas y adolescentes",2018,4,126,48392,260.373615473632,10,24725,40.4448938321537,116,23667,490.133941775468
26949,68,68001,121,Tasa de exámenes médico legales por presunto delito sexual cuando la víctima está entre 18 y 28 años,2018,5,34,94880,35.8347386172007,4,48650,8.22199383350462,30,46230,64.8929266709929
26950,68,68020,81,"Tasa de exámenes médico legales por presunto delito sexual contra niños, niñas y adolescentes",2018,3,1,596,167.785234899329,0,312,0,1,284,352.112676056338
26951,68,68020,81,"Tasa de exámenes médico legales por presunto delito sexual contra niños, niñas y adolescentes",2018,4,1,571,175.131348511384,0,303,0,1,268,373.134328358209
26952,68,68051,81,"Tasa de exámenes médico legales por presunto delito sexual contra niños, niñas y adolescentes",2018,2,1,713,140.252454417952,0,371,0,1,342,292.397660818713
26953,68,68051,81,"Tasa de exámenes médico legales por presunto delito sexual contra niños, niñas y adolescentes",2018,3,1,838,119.331742243437,0,451,0,1,387,258.397932816537
26954,68,68077,81,"Tasa de exámenes médico legales por presunto delito sexual contra niños, niñas y adolescentes",2018,2,6,2482,241.74053182917,0,1287,0,6,1195,502.092050209205
26955,68,68077,81,"Tasa de exámenes médico legales por presunto delito sexual contra niños, niñas y adolescentes",2018,3,17,2949,576.466598847067,4,1524,262.46719160105,13,1425,912.280701754386
26956,68,68077,81,"Tasa de exámenes médico legales por presunto delito sexual contra niños, niñas y adolescentes",2018,4,12,2834,423.429781227946,0,1477,0,12,1357,884.303610906411
26957,68,68077,121,Tasa de exámenes médico legales por presunto delito sexual cuando la víctima está entre 18 y 28 años,2018,5,1,5212,19.1864927091328,0,2654,0,1,2558,39.0930414386239
26958,68,68079,81,"Tasa de exámenes médico legales por presunto delito sexual contra niños, niñas y adolescentes",2018,3,1,726,137.741046831956,1,367,272.479564032698,0,359,0
26959,68,68079,81,"Tasa de exámenes médico legales por presunto delito sexual contra niños, niñas y adolescentes",2018,4,1,707,141.442715700141,1,358,279.329608938547,0,349,0
26960,68,68081,81,"Tasa de exámenes médico legales por presunto delito sexual contra niños, niñas y adolescentes",2018,2,34,15175,224.052718286656,18,7792,231.006160164271,16,7383,216.714072870107
26961,68,68081,81,"Tasa de exámenes médico legales por presunto delito sexual contra niños, niñas y adolescentes",2018,3,82,18490,443.482963764197,16,9541,167.697306362017,66,8949,737.51257123701
26962,68,68081,81,"Tasa de exámenes médico legales por presunto delito sexual contra niños, niñas y adolescentes",2018,4,79,18614,424.411733104115,8,9624,83.1255195344971,71,8990,789.766407119021
26963,68,68081,121,Tasa de exámenes médico legales por presunto delito sexual cuando la víctima está entre 18 y 28 años,2018,5,9,35763,25.1656740206359,1,18481,5.41096261024836,8,17282,46.2909385487791
26964,68,68081,81,"Tasa de exámenes médico legales por presunto delito sexual contra niños, niñas y adolescentes",2018,1,2,3006,66.5335994677312,0,1545,0,2,1461,136.892539356605
26965,68,68092,81,"Tasa de exámenes médico legales por presunto delito sexual contra niños, niñas y adolescentes",2018,2,2,520,384.615384615385,0,269,0,2,251,796.812749003984
26966,68,68092,81,"Tasa de exámenes médico legales por presunto delito sexual contra niños, niñas y adolescentes",2018,4,1,539,185.528756957328,0,275,0,1,264,378.787878787879
26967,68,68101,81,"Tasa de exámenes médico legales por presunto delito sexual contra niños, niñas y adolescentes",2018,4,3,1242,241.545893719807,0,613,0,3,629,476.947535771065
26968,68,68147,81,"Tasa de exámenes médico legales por presunto delito sexual contra niños, niñas y adolescentes",2018,4,2,489,408.997955010225,1,248,403.225806451613,1,241,414.9377593361
26969,68,68152,81,"Tasa de exámenes médico legales por presunto delito sexual contra niños, niñas y adolescentes",2018,4,2,436,458.715596330275,0,220,0,2,216,925.925925925926
26970,68,68152,121,Tasa de exámenes médico legales por presunto delito sexual cuando la víctima está entre 18 y 28 años,2018,5,2,876,228.310502283105,0,428,0,2,448,446.428571428571
26971,68,68160,81,"Tasa de exámenes médico legales por presunto delito sexual contra niños, niñas y adolescentes",2018,2,1,175,571.428571428571,0,90,0,1,85,1176.47058823529
26972,68,68162,81,"Tasa de exámenes médico legales por presunto delito sexual contra niños, niñas y adolescentes",2018,3,1,607,164.744645799012,0,303,0,1,304,328.947368421053
26973,68,68162,81,"Tasa de exámenes médico legales por presunto delito sexual contra niños, niñas y adolescentes",2018,4,1,580,172.413793103448,0,290,0,1,290,344.827586206897
26974,68,68162,121,Tasa de exámenes médico legales por presunto delito sexual cuando la víctima está entre 18 y 28 años,2018,5,1,1045,95.6937799043062,0,545,0,1,500,200
26975,68,68167,81,"Tasa de exámenes médico legales por presunto delito sexual contra niños, niñas y adolescentes",2018,3,5,1074,465.549348230913,1,552,181.159420289855,4,522,766.283524904215
26976,68,68167,81,"Tasa de exámenes médico legales por presunto delito sexual contra niños, niñas y adolescentes",2018,4,3,1049,285.986653956149,0,537,0,3,512,585.9375
26977,68,68179,81,"Tasa de exámenes médico legales por presunto delito sexual contra niños, niñas y adolescentes",2018,4,1,450,222.222222222222,0,235,0,1,215,465.116279069767
26978,68,68179,121,Tasa de exámenes médico legales por presunto delito sexual cuando la víctima está entre 18 y 28 años,2018,5,1,882,113.378684807256,0,454,0,1,428,233.644859813084
26979,68,68190,81,"Tasa de exámenes médico legales por presunto delito sexual contra niños, niñas y adolescentes",2018,2,4,5168,77.3993808049536,0,2675,0,4,2493,160.449257922182
26980,68,68190,81,"Tasa de exámenes médico legales por presunto delito sexual contra niños, niñas y adolescentes",2018,3,12,5770,207.972270363951,2,2989,66.9120107059217,10,2781,359.582883854728
26981,68,68190,81,"Tasa de exámenes médico legales por presunto delito sexual contra niños, niñas y adolescentes",2018,4,19,5445,348.943985307622,0,2797,0,19,2648,717.522658610272
26982,68,68190,121,Tasa de exámenes médico legales por presunto delito sexual cuando la víctima está entre 18 y 28 años,2018,5,1,9279,10.7770233861407,0,4676,0,1,4603,21.7249619813165
26983,68,68209,81,"Tasa de exámenes médico legales por presunto delito sexual contra niños, niñas y adolescentes",2018,3,1,259,386.100386100386,0,130,0,1,129,775.193798449612
26984,68,68209,81,"Tasa de exámenes médico legales por presunto delito sexual contra niños, niñas y adolescentes",2018,4,1,253,395.256916996047,0,125,0,1,128,781.25
26985,68,68217,81,"Tasa de exámenes médico legales por presunto delito sexual contra niños, niñas y adolescentes",2018,3,1,811,123.304562268804,0,420,0,1,391,255.754475703325
26986,68,68217,81,"Tasa de exámenes médico legales por presunto delito sexual contra niños, niñas y adolescentes",2018,4,1,738,135.50135501355,0,379,0,1,359,278.551532033426
26987,68,68229,81,"Tasa de exámenes médico legales por presunto delito sexual contra niños, niñas y adolescentes",2018,4,5,1115,448.430493273543,1,559,178.890876565295,4,556,719.424460431655
26988,68,68235,81,"Tasa de exámenes médico legales por presunto delito sexual contra niños, niñas y adolescentes",2018,2,2,1894,105.596620908131,0,973,0,2,921,217.155266015201
26989,68,68235,81,"Tasa de exámenes médico legales por presunto delito sexual contra niños, niñas y adolescentes",2018,3,7,2124,329.566854990584,5,1095,456.62100456621,2,1029,194.363459669582
26990,68,68235,81,"Tasa de exámenes médico legales por presunto delito sexual contra niños, niñas y adolescentes",2018,4,12,2014,595.829195630586,3,1044,287.35632183908,9,970,927.835051546392
26991,68,68235,121,Tasa de exámenes médico legales por presunto delito sexual cuando la víctima está entre 18 y 28 años,2018,5,1,4007,24.9563264287497,0,2105,0,1,1902,52.5762355415352
26992,68,68245,81,"Tasa de exámenes médico legales por presunto delito sexual contra niños, niñas y adolescentes",2018,3,1,189,529.100529100529,1,99,1010.10101010101,0,90,0
26993,68,68255,81,"Tasa de exámenes médico legales por presunto delito sexual contra niños, niñas y adolescentes",2018,2,1,1178,84.889643463497407,0,614,0,1,564,177.304964539007
26994,68,68255,81,"Tasa de exámenes médico legales por presunto delito sexual contra niños, niñas y adolescentes",2018,3,2,1308,152.905198776758,0,705,0,2,603,331.67495854063
26995,68,68255,81,"Tasa de exámenes médico legales por presunto delito sexual contra niños, niñas y adolescentes",2018,4,4,1192,335.570469798658,1,655,152.671755725191,3,537,558.659217877095
26996,68,68264,81,"Tasa de exámenes médico legales por presunto delito sexual contra niños, niñas y adolescentes",2018,4,1,195,512.820512820513,1,108,925.925925925926,0,87,0
26997,68,68271,81,"Tasa de exámenes médico legales por presunto delito sexual contra niños, niñas y adolescentes",2018,2,2,656,304.878048780488,0,340,0,2,316,632.911392405063
26998,68,68271,81,"Tasa de exámenes médico legales por presunto delito sexual contra niños, niñas y adolescentes",2018,3,1,707,141.442715700141,0,371,0,1,336,297.619047619048
26999,68,68271,81,"Tasa de exámenes médico legales por presunto delito sexual contra niños, niñas y adolescentes",2018,4,1,679,147.275405007364,0,359,0,1,320,312.5
27000,68,68276,81,"Tasa de exámenes médico legales por presunto delito sexual contra niños, niñas y adolescentes",2018,2,16,17287,92.555099207497,3,8870,33.8218714768884,13,8417,154.449328739456
27001,68,68276,81,"Tasa de exámenes médico legales por presunto delito sexual contra niños, niñas y adolescentes",2018,3,34,22012,154.461202980193,8,11354,70.459749867888,26,10658,243.948207918934
27002,68,68276,81,"Tasa de exámenes médico legales por presunto delito sexual contra niños, niñas y adolescentes",2018,4,49,23553,208.041438457946,5,12141,41.1827691293963,44,11412,385.559060637925
27003,68,68276,121,Tasa de exámenes médico legales por presunto delito sexual cuando la víctima está entre 18 y 28 años,2018,5,12,47189,25.429655216258,0,24155,0,12,23034,52.096900234436
27004,68,68298,81,"Tasa de exámenes médico legales por presunto delito sexual contra niños, niñas y adolescentes",2018,3,1,548,182.481751824818,1,284,352.112676056338,0,264,0
27005,68,68298,81,"Tasa de exámenes médico legales por presunto delito sexual contra niños, niñas y adolescentes",2018,4,3,487,616.016427104723,0,248,0,3,239,1255.23012552301
27006,68,68307,81,"Tasa de exámenes médico legales por presunto delito sexual contra niños, niñas y adolescentes",2018,2,18,15482,116.264048572536,2,7913,25.2748641476052,16,7569,211.388558594266
27007,68,68307,81,"Tasa de exámenes médico legales por presunto delito sexual contra niños, niñas y adolescentes",2018,3,39,18577,209.937018894332,4,9428,42.4268137462876,35,9149,382.555470543229
27008,68,68307,81,"Tasa de exámenes médico legales por presunto delito sexual contra niños, niñas y adolescentes",2018,4,30,19132,156.805352289358,4,9737,41.0804149121906,26,9395,276.742948376796
27009,68,68307,121,Tasa de exámenes médico legales por presunto delito sexual cuando la víctima está entre 18 y 28 años,2018,5,5,36699,13.6243494373144,0,18738,0,5,17961,27.838093647347
27010,68,68318,81,"Tasa de exámenes médico legales por presunto delito sexual contra niños, niñas y adolescentes",2018,4,2,565,353.982300884956,0,260,0,2,305,655.737704918033
27011,68,68320,81,"Tasa de exámenes médico legales por presunto delito sexual contra niños, niñas y adolescentes",2018,3,2,533,375.234521575985,0,268,0,2,265,754.716981132075
27012,68,68320,81,"Tasa de exámenes médico legales por presunto delito sexual contra niños, niñas y adolescentes",2018,4,1,485,206.185567010309,0,245,0,1,240,416.666666666667
27013,68,68322,81,"Tasa de exámenes médico legales por presunto delito sexual contra niños, niñas y adolescentes",2018,4,2,190,1052.63157894737,0,94,0,2,96,2083.33333333333
27014,68,68324,81,"Tasa de exámenes médico legales por presunto delito sexual contra niños, niñas y adolescentes",2018,3,2,355,563.380281690141,1,190,526.315789473684,1,165,606.060606060606
27015,68,68324,81,"Tasa de exámenes médico legales por presunto delito sexual contra niños, niñas y adolescentes",2018,4,1,338,295.85798816568,0,175,0,1,163,613.496932515337
27016,68,68327,81,"Tasa de exámenes médico legales por presunto delito sexual contra niños, niñas y adolescentes",2018,2,1,314,318.471337579618,0,159,0,1,155,645.161290322581
27017,68,68327,81,"Tasa de exámenes médico legales por presunto delito sexual contra niños, niñas y adolescentes",2018,3,3,351,854.700854700855,0,177,0,3,174,1724.13793103448
27018,68,68327,81,"Tasa de exámenes médico legales por presunto delito sexual contra niños, niñas y adolescentes",2018,4,2,346,578.034682080925,0,176,0,2,170,1176.47058823529
27019,68,68368,81,"Tasa de exámenes médico legales por presunto delito sexual contra niños, niñas y adolescentes",2018,4,1,314,318.471337579618,0,165,0,1,149,671.140939597315
27020,68,68377,81,"Tasa de exámenes médico legales por presunto delito sexual contra niños, niñas y adolescentes",2018,3,1,913,109.529025191676,1,477,209.643605870021,0,436,0
27021,68,68377,81,"Tasa de exámenes médico legales por presunto delito sexual contra niños, niñas y adolescentes",2018,4,1,889,112.485939257593,1,466,214.592274678112,0,423,0
27022,68,68385,81,"Tasa de exámenes médico legales por presunto delito sexual contra niños, niñas y adolescentes",2018,3,9,1742,516.647531572905,2,906,220.75055187638,7,836,837.320574162679
27023,68,68385,81,"Tasa de exámenes médico legales por presunto delito sexual contra niños, niñas y adolescentes",2018,4,2,1607,124.455507156192,1,850,117.647058823529,1,757,132.100396301189
27024,68,68385,121,Tasa de exámenes médico legales por presunto delito sexual cuando la víctima está entre 18 y 28 años,2018,5,2,2897,69.0369347600966,0,1568,0,2,1329,150.489089541008
27025,68,68397,81,"Tasa de exámenes médico legales por presunto delito sexual contra niños, niñas y adolescentes",2018,3,1,496,201.612903225806,1,258,387.596899224806,0,238,0
27026,68,68397,81,"Tasa de exámenes médico legales por presunto delito sexual contra niños, niñas y adolescentes",2018,4,4,457,875.27352297593,0,240,0,4,217,1843.31797235023
27027,68,68406,81,"Tasa de exámenes médico legales por presunto delito sexual contra niños, niñas y adolescentes",2018,2,3,3817,78.5957558291852,1,1961,50.9943906170321,2,1856,107.758620689655
27028,68,68406,81,"Tasa de exámenes médico legales por presunto delito sexual contra niños, niñas y adolescentes",2018,3,12,4327,277.328403050612,5,2243,222.915737851092,7,2084,335.892514395393
27029,68,68406,81,"Tasa de exámenes médico legales por presunto delito sexual contra niños, niñas y adolescentes",2018,4,14,4225,331.360946745562,8,2197,364.132908511607,6,2028,295.85798816568
27030,68,68406,121,Tasa de exámenes médico legales por presunto delito sexual cuando la víctima está entre 18 y 28 años,2018,5,5,7678,65.1211252930451,1,3935,25.4129606099111,4,3743,106.866150146941
27031,68,68418,81,"Tasa de exámenes médico legales por presunto delito sexual contra niños, niñas y adolescentes",2018,3,2,1258,158.982511923688,1,657,152.20700152207,1,601,166.389351081531
27032,68,68418,81,"Tasa de exámenes médico legales por presunto delito sexual contra niños, niñas y adolescentes",2018,4,4,1239,322.841000807102,1,651,153.609831029186,3,588,510.204081632653
27033,68,68418,121,Tasa de exámenes médico legales por presunto delito sexual cuando la víctima está entre 18 y 28 años,2018,5,2,2245,89.086859688196,0,1198,0,2,1047,191.021967526266
27034,68,68432,81,"Tasa de exámenes médico legales por presunto delito sexual contra niños, niñas y adolescentes",2018,3,2,1704,117.370892018779,0,863,0,2,841,237.812128418549
27035,68,68432,81,"Tasa de exámenes médico legales por presunto delito sexual contra niños, niñas y adolescentes",2018,4,3,1682,178.359096313912,0,851,0,3,831,361.01083032491
27036,68,68432,121,Tasa de exámenes médico legales por presunto delito sexual cuando la víctima está entre 18 y 28 años,2018,5,2,3559,56.1955605507165,0,1766,0,2,1793,111.54489682097
27037,68,68444,81,"Tasa de exámenes médico legales por presunto delito sexual contra niños, niñas y adolescentes",2018,3,3,525,571.428571428571,1,268,373.134328358209,2,257,778.210116731517
27038,68,68444,81,"Tasa de exámenes médico legales por presunto delito sexual contra niños, niñas y adolescentes",2018,4,3,484,619.834710743802,1,245,408.163265306122,2,239,836.820083682008
27039,68,68444,121,Tasa de exámenes médico legales por presunto delito sexual cuando la víctima está entre 18 y 28 años,2018,5,2,911,219.53896816685,0,473,0,2,438,456.62100456621
27040,68,68464,81,"Tasa de exámenes médico legales por presunto delito sexual contra niños, niñas y adolescentes",2018,2,3,1170,256.410256410256,1,600,166.666666666667,2,570,350.877192982456
27041,68,68464,81,"Tasa de exámenes médico legales por presunto delito sexual contra niños, niñas y adolescentes",2018,3,3,1271,236.0346184107,0,659,0,3,612,490.196078431373
27042,68,68464,81,"Tasa de exámenes médico legales por presunto delito sexual contra niños, niñas y adolescentes",2018,4,12,1100,1090.90909090909,3,574,522.648083623693,9,526,1711.02661596958
27043,68,68468,81,"Tasa de exámenes médico legales por presunto delito sexual contra niños, niñas y adolescentes",2018,4,1,480,208.333333333333,0,252,0,1,228,438.59649122807
27044,68,68468,121,Tasa de exámenes médico legales por presunto delito sexual cuando la víctima está entre 18 y 28 años,2018,5,1,990,101.010101010101,0,542,0,1,448,223.214285714286
27045,68,68498,81,"Tasa de exámenes médico legales por presunto delito sexual contra niños, niñas y adolescentes",2018,4,1,442,226.244343891403,0,231,0,1,211,473.9336492891
27046,68,68500,81,"Tasa de exámenes médico legales por presunto delito sexual contra niños, niñas y adolescentes",2018,3,1,1442,69.3481276005548,0,742,0,1,700,142.857142857143
27047,68,68500,81,"Tasa de exámenes médico legales por presunto delito sexual contra niños, niñas y adolescentes",2018,4,3,1269,236.406619385343,0,654,0,3,615,487.80487804878
27048,68,68500,121,Tasa de exámenes médico legales por presunto delito sexual cuando la víctima está entre 18 y 28 años,2018,5,1,2187,45.7247370827618,0,1114,0,1,1073,93.1966449207828
27049,68,68502,81,"Tasa de exámenes médico legales por presunto delito sexual contra niños, niñas y adolescentes",2018,4,1,513,194.931773879142,0,259,0,1,254,393.700787401575
27050,68,68547,81,"Tasa de exámenes médico legales por presunto delito sexual contra niños, niñas y adolescentes",2018,2,8,12425,64.3863179074447,2,6354,31.4762354422411,6,6071,98.8305056827541
27051,68,68547,81,"Tasa de exámenes médico legales por presunto delito sexual contra niños, niñas y adolescentes",2018,3,29,14918,194.39603163963,11,7544,145.811240721103,18,7374,244.100895036615
27052,68,68547,81,"Tasa de exámenes médico legales por presunto delito sexual contra niños, niñas y adolescentes",2018,4,51,15161,336.38942022294,8,7699,103.909598649175,43,7462,576.253015277406
27053,68,68547,121,Tasa de exámenes médico legales por presunto delito sexual cuando la víctima está entre 18 y 28 años,2018,5,6,29368,20.4304004358485,0,14717,0,6,14651,40.9528359838919
27054,68,68549,81,"Tasa de exámenes médico legales por presunto delito sexual contra niños, niñas y adolescentes",2018,4,1,538,185.873605947955,0,263,0,1,275,363.636363636364
27055,68,68572,81,"Tasa de exámenes médico legales por presunto delito sexual contra niños, niñas y adolescentes",2018,2,1,1011,98.9119683481701,0,519,0,1,492,203.252032520325
27056,68,68572,81,"Tasa de exámenes médico legales por presunto delito sexual contra niños, niñas y adolescentes",2018,3,2,1222,163.66612111293,0,627,0,2,595,336.134453781513
27057,68,68572,81,"Tasa de exámenes médico legales por presunto delito sexual contra niños, niñas y adolescentes",2018,4,3,1075,279.06976744186,1,548,182.481751824818,2,527,379.506641366224
27058,68,68572,121,Tasa de exámenes médico legales por presunto delito sexual cuando la víctima está entre 18 y 28 años,2018,5,3,1907,157.315154693235,0,921,0,3,986,304.259634888438
27059,68,68573,81,"Tasa de exámenes médico legales por presunto delito sexual contra niños, niñas y adolescentes",2018,3,4,1032,387.596899224806,1,534,187.265917602996,3,498,602.409638554217
27060,68,68573,81,"Tasa de exámenes médico legales por presunto delito sexual contra niños, niñas y adolescentes",2018,4,3,980,306.122448979592,0,512,0,3,468,641.025641025641
27061,68,68573,121,Tasa de exámenes médico legales por presunto delito sexual cuando la víctima está entre 18 y 28 años,2018,5,1,1596,62.65664160401,0,840,0,1,756,132.275132275132
27062,68,68575,81,"Tasa de exámenes médico legales por presunto delito sexual contra niños, niñas y adolescentes",2018,2,6,3448,174.013921113689,2,1760,113.636363636364,4,1688,236.96682464455
27063,68,68575,81,"Tasa de exámenes médico legales por presunto delito sexual contra niños, niñas y adolescentes",2018,3,17,3760,452.127659574468,1,1891,52.8820729772607,16,1869,856.072766185126
27064,68,68575,81,"Tasa de exámenes médico legales por presunto delito sexual contra niños, niñas y adolescentes",2018,4,13,3417,380.450687737782,2,1699,117.716303708064,11,1718,640.279394644936
27065,68,68615,81,"Tasa de exámenes médico legales por presunto delito sexual contra niños, niñas y adolescentes",2018,3,5,2879,173.671413685307,0,1486,0,5,1393,358.937544867193
27066,68,68615,81,"Tasa de exámenes médico legales por presunto delito sexual contra niños, niñas y adolescentes",2018,4,5,2735,182.815356489945,0,1422,0,5,1313,380.807311500381
27067,68,68615,121,Tasa de exámenes médico legales por presunto delito sexual cuando la víctima está entre 18 y 28 años,2018,5,3,5090,58.9390962671906,1,2653,37.6931775348662,2,2437,82.0681165367255
27068,68,68655,81,"Tasa de exámenes médico legales por presunto delito sexual contra niños, niñas y adolescentes",2018,2,4,1681,237.953599048186,2,861,232.288037166086,2,820,243.90243902439
27069,68,68655,81,"Tasa de exámenes médico legales por presunto delito sexual contra niños, niñas y adolescentes",2018,3,9,1882,478.214665249734,3,967,310.23784901758,6,915,655.737704918033
27070,68,68655,81,"Tasa de exámenes médico legales por presunto delito sexual contra niños, niñas y adolescentes",2018,4,15,1788,838.926174496644,2,927,215.749730312837,13,861,1509.87224157956
27071,68,68655,121,Tasa de exámenes médico legales por presunto delito sexual cuando la víctima está entre 18 y 28 años,2018,5,3,3501,85.6898029134533,0,1850,0,3,1651,181.708055723804
27072,68,68669,81,"Tasa de exámenes médico legales por presunto delito sexual contra niños, niñas y adolescentes",2018,3,1,740,135.135135135135,0,387,0,1,353,283.28611898017
27073,68,68669,81,"Tasa de exámenes médico legales por presunto delito sexual contra niños, niñas y adolescentes",2018,4,2,685,291.970802919708,0,361,0,2,324,617.283950617284
27074,68,68679,81,"Tasa de exámenes médico legales por presunto delito sexual contra niños, niñas y adolescentes",2018,2,4,3143,127.266942411709,0,1607,0,4,1536,260.416666666667
27075,68,68679,81,"Tasa de exámenes médico legales por presunto delito sexual contra niños, niñas y adolescentes",2018,3,11,3918,280.755487493619,1,1974,50.6585612968592,10,1944,514.40329218107
27076,68,68679,81,"Tasa de exámenes médico legales por presunto delito sexual contra niños, niñas y adolescentes",2018,4,14,3835,365.058670143416,3,1884,159.235668789809,11,1951,563.813429010764
27077,68,68682,81,"Tasa de exámenes médico legales por presunto delito sexual contra niños, niñas y adolescentes",2018,3,1,222,450.45045045045,0,116,0,1,106,943.396226415094
27078,68,68684,81,"Tasa de exámenes médico legales por presunto delito sexual contra niños, niñas y adolescentes",2018,2,1,410,243.90243902439,1,213,469.483568075117,0,197,0
27079,68,68684,81,"Tasa de exámenes médico legales por presunto delito sexual contra niños, niñas y adolescentes",2018,4,3,408,735.294117647059,0,207,0,3,201,1492.53731343284
27080,68,68689,81,"Tasa de exámenes médico legales por presunto delito sexual contra niños, niñas y adolescentes",2018,2,3,3325,90.2255639097744,0,1702,0,3,1623,184.842883548983
27081,68,68689,81,"Tasa de exámenes médico legales por presunto delito sexual contra niños, niñas y adolescentes",2018,3,4,3873,103.279111799639,0,1975,0,4,1898,210.748155953635
27082,68,68689,81,"Tasa de exámenes médico legales por presunto delito sexual contra niños, niñas y adolescentes",2018,4,8,3619,221.055540204476,0,1837,0,8,1782,448.933782267116
27083,68,68705,121,Tasa de exámenes médico legales por presunto delito sexual cuando la víctima está entre 18 y 28 años,2018,5,2,386,518.134715025907,0,205,0,2,181,1104.97237569061
27084,68,68720,81,"Tasa de exámenes médico legales por presunto delito sexual contra niños, niñas y adolescentes",2018,3,1,507,197.23865877712,0,261,0,1,246,406.50406504065
27085,68,68720,81,"Tasa de exámenes médico legales por presunto delito sexual contra niños, niñas y adolescentes",2018,4,1,482,207.46887966805,0,250,0,1,232,431.034482758621
27086,68,68745,81,"Tasa de exámenes médico legales por presunto delito sexual contra niños, niñas y adolescentes",2018,3,1,835,119.760479041916,0,434,0,1,401,249.376558603491
27087,68,68745,81,"Tasa de exámenes médico legales por presunto delito sexual contra niños, niñas y adolescentes",2018,4,3,757,396.301188903567,0,397,0,3,360,833.333333333333
27088,68,68755,81,"Tasa de exámenes médico legales por presunto delito sexual contra niños, niñas y adolescentes",2018,3,2,2747,72.8066982162359,0,1375,0,2,1372,145.772594752187
27089,68,68755,81,"Tasa de exámenes médico legales por presunto delito sexual contra niños, niñas y adolescentes",2018,4,1,3152,31.7258883248731,0,1748,0,1,1404,71.2250712250712
27090,68,68755,121,Tasa de exámenes médico legales por presunto delito sexual cuando la víctima está entre 18 y 28 años,2018,5,2,6683,29.9266796348945,0,4000,0,2,2683,74.5434215430488
27091,68,68770,81,"Tasa de exámenes médico legales por presunto delito sexual contra niños, niñas y adolescentes",2018,2,1,882,113.378684807256,0,453,0,1,429,233.100233100233
27092,68,68770,81,"Tasa de exámenes médico legales por presunto delito sexual contra niños, niñas y adolescentes",2018,3,1,986,101.419878296146,0,513,0,1,473,211.416490486258
27093,68,68770,81,"Tasa de exámenes médico legales por presunto delito sexual contra niños, niñas y adolescentes",2018,4,6,903,664.451827242525,1,473,211.416490486258,5,430,1162.79069767442
27094,68,68770,121,Tasa de exámenes médico legales por presunto delito sexual cuando la víctima está entre 18 y 28 años,2018,5,1,1750,57.1428571428571,0,903,0,1,847,118.063754427391
27095,68,68820,81,"Tasa de exámenes médico legales por presunto delito sexual contra niños, niñas y adolescentes",2018,3,2,724,276.243093922652,0,373,0,2,351,569.80056980057
27096,68,68820,81,"Tasa de exámenes médico legales por presunto delito sexual contra niños, niñas y adolescentes",2018,4,2,720,277.777777777778,0,374,0,2,346,578.034682080925
27097,68,68855,81,"Tasa de exámenes médico legales por presunto delito sexual contra niños, niñas y adolescentes",2018,2,1,382,261.780104712042,0,197,0,1,185,540.540540540541
27098,68,68855,81,"Tasa de exámenes médico legales por presunto delito sexual contra niños, niñas y adolescentes",2018,3,2,416,480.769230769231,0,218,0,2,198,1010.10101010101
27099,68,68861,81,"Tasa de exámenes médico legales por presunto delito sexual contra niños, niñas y adolescentes",2018,2,1,1951,51.2557662737058,0,1010,0,1,941,106.269925611052
27100,68,68861,81,"Tasa de exámenes médico legales por presunto delito sexual contra niños, niñas y adolescentes",2018,3,6,2169,276.625172890733,1,1121,89.2060660124888,5,1048,477.099236641221
27101,68,68861,81,"Tasa de exámenes médico legales por presunto delito sexual contra niños, niñas y adolescentes",2018,4,12,2085,575.539568345324,1,1086,92.0810313075506,11,999,1101.1011011011
27102,68,68861,121,Tasa de exámenes médico legales por presunto delito sexual cuando la víctima está entre 18 y 28 años,2018,5,1,3965,25.2206809583859,0,2227,0,1,1738,57.5373993095512
27103,68,68895,81,"Tasa de exámenes médico legales por presunto delito sexual contra niños, niñas y adolescentes",2018,3,2,849,235.571260306243,0,430,0,2,419,477.326968973747
27104,68,68895,81,"Tasa de exámenes médico legales por presunto delito sexual contra niños, niñas y adolescentes",2018,4,2,793,252.206809583859,0,404,0,2,389,514.13881748072
27105,70,70001,81,"Tasa de exámenes médico legales por presunto delito sexual contra niños, niñas y adolescentes",2018,2,25,23681,105.56986613741,6,12134,49.4478325366738,19,11547,164.544903438122
27106,70,70001,81,"Tasa de exámenes médico legales por presunto delito sexual contra niños, niñas y adolescentes",2018,3,58,29405,197.24536643428,7,15047,46.5209011763142,51,14358,355.202674467196
27107,70,70001,81,"Tasa de exámenes médico legales por presunto delito sexual contra niños, niñas y adolescentes",2018,4,105,31124,337.360236473461,5,15712,31.8228105906314,100,15412,648.845055800675
27108,70,70001,121,Tasa de exámenes médico legales por presunto delito sexual cuando la víctima está entre 18 y 28 años,2018,5,23,57035,40.3261155430876,1,28817,3.47017385571017,22,28218,77.9644198738394
27109,70,70110,81,"Tasa de exámenes médico legales por presunto delito sexual contra niños, niñas y adolescentes",2018,3,1,1146,87.260034904014,0,579,0,1,567,176.36684303351
27110,70,70110,81,"Tasa de exámenes médico legales por presunto delito sexual contra niños, niñas y adolescentes",2018,4,2,1108,180.505415162455,0,553,0,2,555,360.36036036036
27111,70,70124,81,"Tasa de exámenes médico legales por presunto delito sexual contra niños, niñas y adolescentes",2018,3,2,1425,140.350877192982,0,731,0,2,694,288.184438040346
27112,70,70124,81,"Tasa de exámenes médico legales por presunto delito sexual contra niños, niñas y adolescentes",2018,4,1,1393,71.7875089734386,0,721,0,1,672,148.809523809524
27113,70,70204,81,"Tasa de exámenes médico legales por presunto delito sexual contra niños, niñas y adolescentes",2018,3,3,632,474.683544303797,0,325,0,3,307,977.198697068404
27114,70,70204,81,"Tasa de exámenes médico legales por presunto delito sexual contra niños, niñas y adolescentes",2018,4,2,634,315.457413249211,0,325,0,2,309,647.249190938511
27115,70,70215,81,"Tasa de exámenes médico legales por presunto delito sexual contra niños, niñas y adolescentes",2018,2,5,5150,97.0873786407767,0,2638,0,5,2512,199.044585987261
27116,70,70215,81,"Tasa de exámenes médico legales por presunto delito sexual contra niños, niñas y adolescentes",2018,3,16,6389,250.430427296917,5,3261,153.327200245324,11,3128,351.662404092072
27117,70,70215,81,"Tasa de exámenes médico legales por presunto delito sexual contra niños, niñas y adolescentes",2018,4,26,6814,381.56736131494,2,3469,57.6535024502739,24,3345,717.488789237668
27118,70,70215,121,Tasa de exámenes médico legales por presunto delito sexual cuando la víctima está entre 18 y 28 años,2018,5,5,13727,36.4245647264515,1,7624,13.1164742917104,4,6103,65.5415369490415
27119,70,70221,81,"Tasa de exámenes médico legales por presunto delito sexual contra niños, niñas y adolescentes",2018,2,1,1533,65.2315720808871,1,796,125.628140703518,0,737,0
27120,70,70221,81,"Tasa de exámenes médico legales por presunto delito sexual contra niños, niñas y adolescentes",2018,3,2,1731,115.540150202195,0,894,0,2,837,238.9486260454
27121,70,70221,81,"Tasa de exámenes médico legales por presunto delito sexual contra niños, niñas y adolescentes",2018,4,12,1730,693.64161849711,2,865,231.21387283237,10,865,1156.06936416185
27122,70,70221,121,Tasa de exámenes médico legales por presunto delito sexual cuando la víctima está entre 18 y 28 años,2018,5,3,2902,103.376981392143,2,1422,140.646976090014,1,1480,67.5675675675676
27123,70,70233,81,"Tasa de exámenes médico legales por presunto delito sexual contra niños, niñas y adolescentes",2018,2,1,1115,89.6860986547085,1,570,175.438596491228,0,545,0
27124,70,70233,81,"Tasa de exámenes médico legales por presunto delito sexual contra niños, niñas y adolescentes",2018,4,3,1274,235.478806907378,0,659,0,3,615,487.80487804878
27125,70,70235,81,"Tasa de exámenes médico legales por presunto delito sexual contra niños, niñas y adolescentes",2018,2,1,2270,44.0528634361234,0,1160,0,1,1110,90.0900900900901
27126,70,70235,81,"Tasa de exámenes médico legales por presunto delito sexual contra niños, niñas y adolescentes",2018,3,4,2600,153.846153846154,1,1327,75.3579502637528,3,1273,235.6637863315
27127,70,70235,81,"Tasa de exámenes médico legales por presunto delito sexual contra niños, niñas y adolescentes",2018,4,6,2492,240.770465489567,1,1265,79.0513833992095,5,1227,407.497962510187
27128,70,70400,81,"Tasa de exámenes médico legales por presunto delito sexual contra niños, niñas y adolescentes",2018,4,1,1304,76.6871165644172,0,680,0,1,624,160.25641025641
27129,70,70418,81,"Tasa de exámenes médico legales por presunto delito sexual contra niños, niñas y adolescentes",2018,2,1,1714,58.343057176196,0,879,0,1,835,119.760479041916
27130,70,70418,81,"Tasa de exámenes médico legales por presunto delito sexual contra niños, niñas y adolescentes",2018,3,8,2002,399.6003996004,5,1027,486.854917234664,3,975,307.692307692308
27131,70,70418,81,"Tasa de exámenes médico legales por presunto delito sexual contra niños, niñas y adolescentes",2018,4,6,1981,302.877334679455,0,1014,0,6,967,620.47569803516
27132,70,70418,121,Tasa de exámenes médico legales por presunto delito sexual cuando la víctima está entre 18 y 28 años,2018,5,1,3803,26.2950302392848,0,1951,0,1,1852,53.9956803455724
27133,70,70429,81,"Tasa de exámenes médico legales por presunto delito sexual contra niños, niñas y adolescentes",2018,3,1,4061,24.6244767298695,1,2082,48.030739673391,0,1979,0
27134,70,70473,81,"Tasa de exámenes médico legales por presunto delito sexual contra niños, niñas y adolescentes",2018,2,4,1428,280.11204481792703,1,742,134.770889487871,3,686,437.31778425656
27135,70,70473,81,"Tasa de exámenes médico legales por presunto delito sexual contra niños, niñas y adolescentes",2018,3,7,1654,423.216444981862,1,873,114.54753722795,6,781,768.245838668374
27136,70,70473,81,"Tasa de exámenes médico legales por presunto delito sexual contra niños, niñas y adolescentes",2018,4,9,1661,541.842263696568,0,872,0,9,789,1140.68441064639
27137,70,70473,121,Tasa de exámenes médico legales por presunto delito sexual cuando la víctima está entre 18 y 28 años,2018,5,3,3019,99.3706525339516,0,1567,0,3,1452,206.611570247934
27138,70,70508,81,"Tasa de exámenes médico legales por presunto delito sexual contra niños, niñas y adolescentes",2018,3,2,2490,80.3212851405623,0,1288,0,2,1202,166.389351081531
27139,70,70508,81,"Tasa de exámenes médico legales por presunto delito sexual contra niños, niñas y adolescentes",2018,4,8,2397,333.75052148519,0,1243,0,8,1154,693.240901213172
27140,70,70523,81,"Tasa de exámenes médico legales por presunto delito sexual contra niños, niñas y adolescentes",2018,3,2,2035,98.2800982800983,0,1071,0,2,964,207.46887966805
27141,70,70523,81,"Tasa de exámenes médico legales por presunto delito sexual contra niños, niñas y adolescentes",2018,4,5,1907,262.191924488726,0,1011,0,5,896,558.035714285714
27142,70,70670,81,"Tasa de exámenes médico legales por presunto delito sexual contra niños, niñas y adolescentes",2018,2,2,3927,50.9294626941686,0,2011,0,2,1916,104.384133611691
27143,70,70670,81,"Tasa de exámenes médico legales por presunto delito sexual contra niños, niñas y adolescentes",2018,3,5,4562,109.601052170101,1,2342,42.6985482493595,4,2220,180.18018018018
27144,70,70670,81,"Tasa de exámenes médico legales por presunto delito sexual contra niños, niñas y adolescentes",2018,4,11,4482,245.426149040607,1,2321,43.0848772081,10,2161,462.748727441
27145,70,70670,81,"Tasa de exámenes médico legales por presunto delito sexual contra niños, niñas y adolescentes",2018,1,1,809,123.609394313968,1,413,242.130750605327,0,396,0
27146,70,70678,81,"Tasa de exámenes médico legales por presunto delito sexual contra niños, niñas y adolescentes",2018,2,2,3124,64.0204865556978,1,1611,62.0732464307883,1,1513,66.0938532716457
27147,70,70678,81,"Tasa de exámenes médico legales por presunto delito sexual contra niños, niñas y adolescentes",2018,4,8,3151,253.88765471279,1,1623,61.6142945163278,7,1528,458.115183246073
27148,70,70702,81,"Tasa de exámenes médico legales por presunto delito sexual contra niños, niñas y adolescentes",2018,2,1,1043,95.8772770853308,0,534,0,1,509,196.463654223969
27149,70,70702,81,"Tasa de exámenes médico legales por presunto delito sexual contra niños, niñas y adolescentes",2018,3,2,1234,162.074554294976,1,633,157.977883096366,1,601,166.389351081531
27150,70,70702,81,"Tasa de exámenes médico legales por presunto delito sexual contra niños, niñas y adolescentes",2018,4,3,1274,235.478806907378,1,651,153.609831029186,2,623,321.027287319422
27151,70,70702,121,Tasa de exámenes médico legales por presunto delito sexual cuando la víctima está entre 18 y 28 años,2018,5,2,2388,83.7520938023451,0,1212,0,2,1176,170.068027210884
27152,70,70708,81,"Tasa de exámenes médico legales por presunto delito sexual contra niños, niñas y adolescentes",2018,2,2,6351,31.4911037631869,1,3239,30.8737264587836,1,3112,32.133676092545
27153,70,70708,81,"Tasa de exámenes médico legales por presunto delito sexual contra niños, niñas y adolescentes",2018,3,4,7116,56.2113546936481,1,3581,27.9251605696733,3,3535,84.8656294200849
27154,70,70708,81,"Tasa de exámenes médico legales por presunto delito sexual contra niños, niñas y adolescentes",2018,4,5,6823,73.2815477062876,0,3366,0,5,3457,144.634075788256
27155,70,70713,81,"Tasa de exámenes médico legales por presunto delito sexual contra niños, niñas y adolescentes",2018,2,3,6326,47.4233322794815,0,3242,0,3,3084,97.2762645914397
27156,70,70713,81,"Tasa de exámenes médico legales por presunto delito sexual contra niños, niñas y adolescentes",2018,3,7,6860,102.040816326531,0,3551,0,7,3309,211.544273194319
27157,70,70713,81,"Tasa de exámenes médico legales por presunto delito sexual contra niños, niñas y adolescentes",2018,4,5,6426,77.8089013383131,0,3335,0,5,3091,161.759948236817
27158,70,70713,121,Tasa de exámenes médico legales por presunto delito sexual cuando la víctima está entre 18 y 28 años,2018,5,3,10451,28.705387044302,0,5477,0,3,4974,60.313630880579
27159,70,70717,81,"Tasa de exámenes médico legales por presunto delito sexual contra niños, niñas y adolescentes",2018,2,1,1410,70.9219858156028,0,725,0,1,685,145.985401459854
27160,70,70717,81,"Tasa de exámenes médico legales por presunto delito sexual contra niños, niñas y adolescentes",2018,3,5,1672,299.043062200957,0,865,0,5,807,619.578686493185
27161,70,70717,81,"Tasa de exámenes médico legales por presunto delito sexual contra niños, niñas y adolescentes",2018,4,2,1617,123.685837971552,0,850,0,2,767,260.756192959583
27162,70,70742,81,"Tasa de exámenes médico legales por presunto delito sexual contra niños, niñas y adolescentes",2018,3,1,3867,25.8598396689941,1,2025,49.3827160493827,0,1842,0
27163,70,70742,81,"Tasa de exámenes médico legales por presunto delito sexual contra niños, niñas y adolescentes",2018,4,11,3832,287.05636743215,1,1990,50.251256281407,10,1842,542.888165038002
27164,70,70820,81,"Tasa de exámenes médico legales por presunto delito sexual contra niños, niñas y adolescentes",2018,2,3,3611,83.079479368596,0,1858,0,3,1753,171.135196805476
27165,70,70820,81,"Tasa de exámenes médico legales por presunto delito sexual contra niños, niñas y adolescentes",2018,3,2,4094,48.8519785051295,0,2106,0,2,1988,100.603621730382
27166,70,70820,81,"Tasa de exámenes médico legales por presunto delito sexual contra niños, niñas y adolescentes",2018,4,8,4129,193.751513683701,0,2106,0,8,2023,395.452298566485
27167,70,70820,121,Tasa de exámenes médico legales por presunto delito sexual cuando la víctima está entre 18 y 28 años,2018,5,2,6909,28.947749312491,0,3440,0,2,3469,57.6535024502739
27168,70,70823,81,"Tasa de exámenes médico legales por presunto delito sexual contra niños, niñas y adolescentes",2018,3,5,2165,230.94688221709,0,1138,0,5,1027,486.854917234664
27169,70,70823,81,"Tasa de exámenes médico legales por presunto delito sexual contra niños, niñas y adolescentes",2018,4,5,2118,236.071765816808,0,1114,0,5,1004,498.00796812749
27170,70,70823,121,Tasa de exámenes médico legales por presunto delito sexual cuando la víctima está entre 18 y 28 años,2018,5,2,3737,53.5188654000535,0,1990,0,2,1747,114.481969089868
27171,73,73001,81,"Tasa de exámenes médico legales por presunto delito sexual contra niños, niñas y adolescentes",2018,2,57,43973,129.624997157347,12,22531,53.2599529537082,45,21442,209.868482417685
27172,73,73001,81,"Tasa de exámenes médico legales por presunto delito sexual contra niños, niñas y adolescentes",2018,3,118,54992,214.576665696829,19,28007,67.84018281144,99,26985,366.870483602001
27173,73,73001,81,"Tasa de exámenes médico legales por presunto delito sexual contra niños, niñas y adolescentes",2018,4,184,58397,315.084679007483,16,29809,53.6750645778121,168,28588,587.659157688541
27174,73,73001,121,Tasa de exámenes médico legales por presunto delito sexual cuando la víctima está entre 18 y 28 años,2018,5,35,107669,32.5070354512441,4,55690,7.18261806428443,31,51979,59.6394697858751
27175,73,73024,81,"Tasa de exámenes médico legales por presunto delito sexual contra niños, niñas y adolescentes",2018,4,1,483,207.03933747412,0,250,0,1,233,429.184549356223
27176,73,73026,81,"Tasa de exámenes médico legales por presunto delito sexual contra niños, niñas y adolescentes",2018,2,1,796,125.628140703518,0,415,0,1,381,262.46719160105
27177,73,73026,81,"Tasa de exámenes médico legales por presunto delito sexual contra niños, niñas y adolescentes",2018,3,5,967,517.063081695967,0,513,0,5,454,1101.32158590308
27178,73,73026,81,"Tasa de exámenes médico legales por presunto delito sexual contra niños, niñas y adolescentes",2018,4,2,915,218.579234972678,0,482,0,2,433,461.89376443418
27179,73,73030,81,"Tasa de exámenes médico legales por presunto delito sexual contra niños, niñas y adolescentes",2018,2,1,555,180.18018018018,0,285,0,1,270,370.37037037037
27180,73,73030,81,"Tasa de exámenes médico legales por presunto delito sexual contra niños, niñas y adolescentes",2018,4,2,635,314.96062992126,0,330,0,2,305,655.737704918033
27181,73,73030,121,Tasa de exámenes médico legales por presunto delito sexual cuando la víctima está entre 18 y 28 años,2018,5,1,1199,83.4028356964137,0,618,0,1,581,172.117039586919
27182,73,73043,81,"Tasa de exámenes médico legales por presunto delito sexual contra niños, niñas y adolescentes",2018,3,4,2417,165.494414563508,0,1270,0,4,1147,348.7358326068
27183,73,73043,81,"Tasa de exámenes médico legales por presunto delito sexual contra niños, niñas y adolescentes",2018,4,9,2325,387.096774193548,1,1270,78.740157480315,8,1055,758.293838862559
27184,73,73043,121,Tasa de exámenes médico legales por presunto delito sexual cuando la víctima está entre 18 y 28 años,2018,5,1,3773,26.5041081367612,0,2116,0,1,1657,60.3500301750151
27185,73,73055,81,"Tasa de exámenes médico legales por presunto delito sexual contra niños, niñas y adolescentes",2018,2,3,1016,295.275590551181,0,522,0,3,494,607.287449392713
27186,73,73055,81,"Tasa de exámenes médico legales por presunto delito sexual contra niños, niñas y adolescentes",2018,3,5,1239,403.551251008878,1,640,156.25,4,599,667.779632721202
27187,73,73055,81,"Tasa de exámenes médico legales por presunto delito sexual contra niños, niñas y adolescentes",2018,4,5,1182,423.011844331641,0,619,0,5,563,888.09946714032
27188,73,73055,121,Tasa de exámenes médico legales por presunto delito sexual cuando la víctima está entre 18 y 28 años,2018,5,1,2185,45.766590389016,0,1166,0,1,1019,98.135426889107
27189,73,73067,81,"Tasa de exámenes médico legales por presunto delito sexual contra niños, niñas y adolescentes",2018,2,1,2568,38.9408099688474,0,1315,0,1,1253,79.8084596967279
27190,73,73067,81,"Tasa de exámenes médico legales por presunto delito sexual contra niños, niñas y adolescentes",2018,3,3,2872,104.456824512535,0,1470,0,3,1402,213.98002853067
27191,73,73067,81,"Tasa de exámenes médico legales por presunto delito sexual contra niños, niñas y adolescentes",2018,4,8,2686,297.840655249442,0,1378,0,8,1308,611.620795107034
27192,73,73067,121,Tasa de exámenes médico legales por presunto delito sexual cuando la víctima está entre 18 y 28 años,2018,5,1,4456,22.4416517055655,0,2253,0,1,2203,45.3926463912846
27193,73,73124,81,"Tasa de exámenes médico legales por presunto delito sexual contra niños, niñas y adolescentes",2018,3,11,2170,506.912442396313,0,1130,0,11,1040,1057.69230769231
27194,73,73124,81,"Tasa de exámenes médico legales por presunto delito sexual contra niños, niñas y adolescentes",2018,4,9,2098,428.979980934223,0,1115,0,9,983,915.564598168871
27195,73,73148,81,"Tasa de exámenes médico legales por presunto delito sexual contra niños, niñas y adolescentes",2018,3,4,856,467.289719626168,1,435,229.885057471264,3,421,712.589073634204
27196,73,73148,81,"Tasa de exámenes médico legales por presunto delito sexual contra niños, niñas y adolescentes",2018,4,6,872,688.073394495413,0,439,0,6,433,1385.68129330254
27197,73,73168,81,"Tasa de exámenes médico legales por presunto delito sexual contra niños, niñas y adolescentes",2018,2,6,5360,111.940298507463,0,2744,0,6,2616,229.357798165138
27198,73,73168,81,"Tasa de exámenes médico legales por presunto delito sexual contra niños, niñas y adolescentes",2018,3,20,5990,333.889816360601,3,3070,97.7198697068404,17,2920,582.191780821918
27199,73,73168,81,"Tasa de exámenes médico legales por presunto delito sexual contra niños, niñas y adolescentes",2018,4,26,5584,465.616045845272,4,2856,140.056022408964,22,2728,806.451612903226
27200,73,73168,121,Tasa de exámenes médico legales por presunto delito sexual cuando la víctima está entre 18 y 28 años,2018,5,6,9227,65.0265525089412,0,4633,0,6,4594,130.605137135394
27201,73,73200,81,"Tasa de exámenes médico legales por presunto delito sexual contra niños, niñas y adolescentes",2018,2,3,960,312.5,2,488,409.83606557377,1,472,211.864406779661
27202,73,73200,81,"Tasa de exámenes médico legales por presunto delito sexual contra niños, niñas y adolescentes",2018,3,1,1175,85.1063829787234,1,604,165.562913907285,0,571,0
27203,73,73200,81,"Tasa de exámenes médico legales por presunto delito sexual contra niños, niñas y adolescentes",2018,4,3,1118,268.336314847943,1,585,170.940170940171,2,533,375.234521575985
27204,73,73200,121,Tasa de exámenes médico legales por presunto delito sexual cuando la víctima está entre 18 y 28 años,2018,5,1,1726,57.9374275782155,0,913,0,1,813,123.0012300123
27205,73,73217,81,"Tasa de exámenes médico legales por presunto delito sexual contra niños, niñas y adolescentes",2018,2,6,3406,176.159718144451,1,1751,57.1102227298686,5,1655,302.114803625378
27206,73,73217,81,"Tasa de exámenes médico legales por presunto delito sexual contra niños, niñas y adolescentes",2018,3,17,3685,461.329715061058,5,1915,261.096605744125,12,1770,677.966101694915
27207,73,73217,81,"Tasa de exámenes médico legales por presunto delito sexual contra niños, niñas y adolescentes",2018,4,17,3313,513.130093570782,0,1765,0,17,1548,1098.19121447028
27208,73,73217,121,Tasa de exámenes médico legales por presunto delito sexual cuando la víctima está entre 18 y 28 años,2018,5,3,5483,54.7145723144264,0,2989,0,3,2494,120.288692862871
27209,73,73226,81,"Tasa de exámenes médico legales por presunto delito sexual contra niños, niñas y adolescentes",2018,3,1,1135,88.1057268722467,0,595,0,1,540,185.185185185185
27210,73,73226,81,"Tasa de exámenes médico legales por presunto delito sexual contra niños, niñas y adolescentes",2018,4,4,1016,393.700787401575,0,542,0,4,474,843.881856540084
27211,73,73236,81,"Tasa de exámenes médico legales por presunto delito sexual contra niños, niñas y adolescentes",2018,2,1,700,142.857142857143,0,360,0,1,340,294.117647058824
27212,73,73236,81,"Tasa de exámenes médico legales por presunto delito sexual contra niños, niñas y adolescentes",2018,3,3,796,376.884422110553,0,412,0,3,384,781.25
27213,73,73236,81,"Tasa de exámenes médico legales por presunto delito sexual contra niños, niñas y adolescentes",2018,4,2,767,260.756192959583,0,398,0,2,369,542.0054200542
27214,73,73236,121,Tasa de exámenes médico legales por presunto delito sexual cuando la víctima está entre 18 y 28 años,2018,5,1,1401,71.3775874375446,0,729,0,1,672,148.809523809524
27215,73,73268,81,"Tasa de exámenes médico legales por presunto delito sexual contra niños, niñas y adolescentes",2018,2,4,6447,62.0443617186288,0,3276,0,4,3171,126.143172500788
27216,73,73268,81,"Tasa de exámenes médico legales por presunto delito sexual contra niños, niñas y adolescentes",2018,3,22,7935,277.252678008822,7,4088,171.232876712329,15,3847,389.914218871848
27217,73,73268,81,"Tasa de exámenes médico legales por presunto delito sexual contra niños, niñas y adolescentes",2018,4,44,8115,542.205791743685,5,4199,119.075970469159,39,3916,995.914198161389
27218,73,73268,121,Tasa de exámenes médico legales por presunto delito sexual cuando la víctima está entre 18 y 28 años,2018,5,5,13725,36.4298724954463,0,7200,0,5,6525,76.6283524904215
27219,73,73270,81,"Tasa de exámenes médico legales por presunto delito sexual contra niños, niñas y adolescentes",2018,2,1,831,120.336943441637,0,425,0,1,406,246.305418719212
27220,73,73270,81,"Tasa de exámenes médico legales por presunto delito sexual contra niños, niñas y adolescentes",2018,3,4,976,409.83606557377,1,504,198.412698412698,3,472,635.593220338983
27221,73,73270,81,"Tasa de exámenes médico legales por presunto delito sexual contra niños, niñas y adolescentes",2018,4,7,938,746.268656716418,2,490,408.163265306122,5,448,1116.07142857143
27222,73,73275,81,"Tasa de exámenes médico legales por presunto delito sexual contra niños, niñas y adolescentes",2018,3,3,2938,102.11027910143,1,1507,66.35700066357,2,1431,139.762403913347
27223,73,73275,81,"Tasa de exámenes médico legales por presunto delito sexual contra niños, niñas y adolescentes",2018,4,5,3004,166.444740346205,1,1554,64.3500643500643,4,1450,275.862068965517
27224,73,73275,121,Tasa de exámenes médico legales por presunto delito sexual cuando la víctima está entre 18 y 28 años,2018,5,1,5450,18.348623853211,0,2813,0,1,2637,37.9218809252939
27225,73,73283,81,"Tasa de exámenes médico legales por presunto delito sexual contra niños, niñas y adolescentes",2018,2,1,2776,36.0230547550432,0,1426,0,1,1350,74.0740740740741
27226,73,73283,81,"Tasa de exámenes médico legales por presunto delito sexual contra niños, niñas y adolescentes",2018,3,4,3277,122.062862374123,1,1703,58.7199060481503,3,1574,190.597204574333
27227,73,73283,81,"Tasa de exámenes médico legales por presunto delito sexual contra niños, niñas y adolescentes",2018,4,7,3195,219.092331768388,1,1683,59.41770647653,6,1512,396.825396825397
27228,73,73283,121,Tasa de exámenes médico legales por presunto delito sexual cuando la víctima está entre 18 y 28 años,2018,5,3,5492,54.6249089584851,0,2881,0,3,2611,114.898506319418
27229,73,73319,81,"Tasa de exámenes médico legales por presunto delito sexual contra niños, niñas y adolescentes",2018,2,1,2670,37.4531835205993,0,1360,0,1,1310,76.3358778625954
27230,73,73319,81,"Tasa de exámenes médico legales por presunto delito sexual contra niños, niñas y adolescentes",2018,3,4,3234,123.685837971552,1,1641,60.9384521633151,3,1593,188.323917137476
27231,73,73319,81,"Tasa de exámenes médico legales por presunto delito sexual contra niños, niñas y adolescentes",2018,4,8,3153,253.72660957818,0,1600,0,8,1553,515.13200257566
27232,73,73319,121,Tasa de exámenes médico legales por presunto delito sexual cuando la víctima está entre 18 y 28 años,2018,5,3,5463,54.9148819330038,0,2790,0,3,2673,112.233445566779
27233,73,73347,81,"Tasa de exámenes médico legales por presunto delito sexual contra niños, niñas y adolescentes",2018,2,1,724,138.121546961326,1,372,268.817204301075,0,352,0
27234,73,73347,81,"Tasa de exámenes médico legales por presunto delito sexual contra niños, niñas y adolescentes",2018,3,1,850,117.647058823529,0,444,0,1,406,246.305418719212
27235,73,73347,81,"Tasa de exámenes médico legales por presunto delito sexual contra niños, niñas y adolescentes",2018,4,8,808,990.09900990099,1,421,237.529691211401,7,387,1808.78552971576
27236,73,73349,81,"Tasa de exámenes médico legales por presunto delito sexual contra niños, niñas y adolescentes",2018,2,2,1880,106.382978723404,1,974,102.669404517454,1,906,110.37527593819
27237,73,73349,81,"Tasa de exámenes médico legales por presunto delito sexual contra niños, niñas y adolescentes",2018,4,7,2455,285.132382892057,2,1373,145.666423889294,5,1082,462.107208872458
27238,73,73349,121,Tasa de exámenes médico legales por presunto delito sexual cuando la víctima está entre 18 y 28 años,2018,5,3,5061,59.2768227622999,1,3049,32.797638570023,2,2012,99.403578528827
27239,73,73352,81,"Tasa de exámenes médico legales por presunto delito sexual contra niños, niñas y adolescentes",2018,3,1,1170,85.4700854700855,0,592,0,1,578,173.010380622837
27240,73,73352,81,"Tasa de exámenes médico legales por presunto delito sexual contra niños, niñas y adolescentes",2018,4,4,1066,375.234521575985,0,543,0,4,523,764.818355640535
27241,73,73408,81,"Tasa de exámenes médico legales por presunto delito sexual contra niños, niñas y adolescentes",2018,2,3,1389,215.982721382289,0,712,0,3,677,443.131462333826
27242,73,73408,81,"Tasa de exámenes médico legales por presunto delito sexual contra niños, niñas y adolescentes",2018,3,8,1698,471.142520612485,2,867,230.680507497117,6,831,722.02166064982
27243,73,73408,81,"Tasa de exámenes médico legales por presunto delito sexual contra niños, niñas y adolescentes",2018,4,9,1642,548.112058465286,0,836,0,9,806,1116.6253101737
27244,73,73411,81,"Tasa de exámenes médico legales por presunto delito sexual contra niños, niñas y adolescentes",2018,2,3,3609,83.1255195344971,0,1851,0,3,1758,170.648464163823
27245,73,73411,81,"Tasa de exámenes médico legales por presunto delito sexual contra niños, niñas y adolescentes",2018,3,8,4249,188.27959519887,2,2193,91.1992704058368,6,2056,291.828793774319
27246,73,73411,81,"Tasa de exámenes médico legales por presunto delito sexual contra niños, niñas y adolescentes",2018,4,15,4072,368.369351669941,1,2120,47.1698113207547,14,1952,717.213114754098
27247,73,73411,121,Tasa de exámenes médico legales por presunto delito sexual cuando la víctima está entre 18 y 28 años,2018,5,2,7291,27.4310794129749,0,3770,0,2,3521,56.8020448736155
27248,73,73443,81,"Tasa de exámenes médico legales por presunto delito sexual contra niños, niñas y adolescentes",2018,2,3,2772,108.225108225108,0,1428,0,3,1344,223.214285714286
27249,73,73443,81,"Tasa de exámenes médico legales por presunto delito sexual contra niños, niñas y adolescentes",2018,3,8,3407,234.810683886117,2,1748,114.41647597254,6,1659,361.663652802893
27250,73,73443,81,"Tasa de exámenes médico legales por presunto delito sexual contra niños, niñas y adolescentes",2018,4,13,3271,397.431977988383,3,1666,180.072028811525,10,1605,623.052959501558
27251,73,73443,121,Tasa de exámenes médico legales por presunto delito sexual cuando la víctima está entre 18 y 28 años,2018,5,2,5982,33.4336342360415,1,3007,33.255736614566,1,2975,33.6134453781513
27252,73,73449,81,"Tasa de exámenes médico legales por presunto delito sexual contra niños, niñas y adolescentes",2018,2,9,3154,285.351934051997,2,1623,123.228589032656,7,1531,457.217504898759
27253,73,73449,81,"Tasa de exámenes médico legales por presunto delito sexual contra niños, niñas y adolescentes",2018,3,18,3841,468.627961468368,1,2000,50,17,1841,923.411189570885
27254,73,73449,81,"Tasa de exámenes médico legales por presunto delito sexual contra niños, niñas y adolescentes",2018,4,36,4058,887.136520453425,0,2135,0,36,1923,1872.07488299532
27255,73,73449,121,Tasa de exámenes médico legales por presunto delito sexual cuando la víctima está entre 18 y 28 años,2018,5,8,6922,115.573533660792,1,3686,27.1296798697775,7,3236,216.316440049444
27256,73,73461,81,"Tasa de exámenes médico legales por presunto delito sexual contra niños, niñas y adolescentes",2018,2,1,533,187.617260787993,0,270,0,1,263,380.228136882129
27257,73,73461,81,"Tasa de exámenes médico legales por presunto delito sexual contra niños, niñas y adolescentes",2018,4,5,573,872.60034904014,0,300,0,5,273,1831.50183150183
27258,73,73483,81,"Tasa de exámenes médico legales por presunto delito sexual contra niños, niñas y adolescentes",2018,2,1,1781,56.1482313307131,0,917,0,1,864,115.740740740741
27259,73,73483,81,"Tasa de exámenes médico legales por presunto delito sexual contra niños, niñas y adolescentes",2018,3,1,2221,45.024763619991,0,1146,0,1,1075,93.0232558139535
27260,73,73504,81,"Tasa de exámenes médico legales por presunto delito sexual contra niños, niñas y adolescentes",2018,3,5,4099,121.980970968529,2,2074,96.4320154291225,3,2025,148.148148148148
27261,73,73504,81,"Tasa de exámenes médico legales por presunto delito sexual contra niños, niñas y adolescentes",2018,4,9,3576,251.677852348993,3,1818,165.016501650165,6,1758,341.296928327645
27262,73,73520,81,"Tasa de exámenes médico legales por presunto delito sexual contra niños, niñas y adolescentes",2018,2,1,845,118.343195266272,0,435,0,1,410,243.90243902439
27263,73,73520,81,"Tasa de exámenes médico legales por presunto delito sexual contra niños, niñas y adolescentes",2018,3,2,996,200.803212851406,0,517,0,2,479,417.536534446764
27264,73,73520,81,"Tasa de exámenes médico legales por presunto delito sexual contra niños, niñas y adolescentes",2018,4,6,970,618.556701030928,2,511,391.389432485323,4,459,871.459694989107
27265,73,73547,81,"Tasa de exámenes médico legales por presunto delito sexual contra niños, niñas y adolescentes",2018,3,1,671,149.03129657228,0,346,0,1,325,307.692307692308
27266,73,73555,81,"Tasa de exámenes médico legales por presunto delito sexual contra niños, niñas y adolescentes",2018,2,7,3719,188.222640494757,0,1895,0,7,1824,383.771929824561
27267,73,73555,81,"Tasa de exámenes médico legales por presunto delito sexual contra niños, niñas y adolescentes",2018,3,17,4051,419.649469266848,4,2092,191.204588910134,13,1959,663.603879530373
27268,73,73555,81,"Tasa de exámenes médico legales por presunto delito sexual contra niños, niñas y adolescentes",2018,4,24,3900,615.384615384615,0,2065,0,24,1835,1307.90190735695
27269,73,73563,81,"Tasa de exámenes médico legales por presunto delito sexual contra niños, niñas y adolescentes",2018,2,2,599,333.889816360601,0,309,0,2,290,689.655172413793
27270,73,73563,81,"Tasa de exámenes médico legales por presunto delito sexual contra niños, niñas y adolescentes",2018,3,2,745,268.456375838926,0,385,0,2,360,555.555555555556
27271,73,73563,81,"Tasa de exámenes médico legales por presunto delito sexual contra niños, niñas y adolescentes",2018,4,3,723,414.9377593361,0,374,0,3,349,859.598853868195
27272,73,73585,81,"Tasa de exámenes médico legales por presunto delito sexual contra niños, niñas y adolescentes",2018,2,1,2363,42.3190859077444,0,1217,0,1,1146,87.260034904014
27273,73,73585,81,"Tasa de exámenes médico legales por presunto delito sexual contra niños, niñas y adolescentes",2018,3,4,2942,135.961930659415,0,1518,0,4,1424,280.898876404494
27274,73,73585,81,"Tasa de exámenes médico legales por presunto delito sexual contra niños, niñas y adolescentes",2018,4,5,2858,174.947515745276,1,1479,67.6132521974307,4,1379,290.065264684554
27275,73,73616,81,"Tasa de exámenes médico legales por presunto delito sexual contra niños, niñas y adolescentes",2018,2,1,3116,32.0924261874198,0,1600,0,1,1516,65.9630606860158
27276,73,73616,81,"Tasa de exámenes médico legales por presunto delito sexual contra niños, niñas y adolescentes",2018,3,12,3411,351.802990325418,2,1762,113.507377979569,10,1649,606.428138265616
27277,73,73616,81,"Tasa de exámenes médico legales por presunto delito sexual contra niños, niñas y adolescentes",2018,4,16,3144,508.905852417303,1,1645,60.790273556231,15,1499,1000.66711140761
27278,73,73622,81,"Tasa de exámenes médico legales por presunto delito sexual contra niños, niñas y adolescentes",2018,2,1,586,170.648464163823,0,301,0,1,285,350.877192982456
27279,73,73622,81,"Tasa de exámenes médico legales por presunto delito sexual contra niños, niñas y adolescentes",2018,3,1,703,142.247510668563,0,366,0,1,337,296.73590504451
27280,73,73622,81,"Tasa de exámenes médico legales por presunto delito sexual contra niños, niñas y adolescentes",2018,4,1,678,147.492625368732,0,360,0,1,318,314.465408805031
27281,73,73624,81,"Tasa de exámenes médico legales por presunto delito sexual contra niños, niñas y adolescentes",2018,2,1,2416,41.3907284768212,0,1231,0,1,1185,84.3881856540084
27282,73,73624,81,"Tasa de exámenes médico legales por presunto delito sexual contra niños, niñas y adolescentes",2018,3,1,2584,38.6996904024768,1,1307,76.5110941086458,0,1277,0
27283,73,73624,81,"Tasa de exámenes médico legales por presunto delito sexual contra niños, niñas y adolescentes",2018,4,3,2255,133.037694013304,0,1147,0,3,1108,270.758122743682
27284,73,73671,81,"Tasa de exámenes médico legales por presunto delito sexual contra niños, niñas y adolescentes",2018,2,1,1206,82.9187396351576,0,619,0,1,587,170.357751277683
27285,73,73671,81,"Tasa de exámenes médico legales por presunto delito sexual contra niños, niñas y adolescentes",2018,3,2,1498,133.511348464619,0,784,0,2,714,280.112044817927
27286,73,73671,81,"Tasa de exámenes médico legales por presunto delito sexual contra niños, niñas y adolescentes",2018,4,5,1498,333.778371161549,0,785,0,5,713,701.262272089761
27287,73,73671,121,Tasa de exámenes médico legales por presunto delito sexual cuando la víctima está entre 18 y 28 años,2018,5,2,2443,81.8665575112566,0,1280,0,2,1163,171.969045571797
27288,73,73675,81,"Tasa de exámenes médico legales por presunto delito sexual contra niños, niñas y adolescentes",2018,2,2,1680,119.047619047619,0,854,0,2,826,242.130750605327
27289,73,73675,81,"Tasa de exámenes médico legales por presunto delito sexual contra niños, niñas y adolescentes",2018,3,5,1796,278.396436525612,1,910,109.89010989011,4,886,451.467268623025
27290,73,73675,81,"Tasa de exámenes médico legales por presunto delito sexual contra niños, niñas y adolescentes",2018,4,4,1567,255.264837268666,0,797,0,4,770,519.480519480519
27291,73,73678,81,"Tasa de exámenes médico legales por presunto delito sexual contra niños, niñas y adolescentes",2018,3,1,1960,51.0204081632653,1,995,100.502512562814,0,965,0
27292,73,73678,81,"Tasa de exámenes médico legales por presunto delito sexual contra niños, niñas y adolescentes",2018,4,1,1907,52.4383848977452,0,968,0,1,939,106.496272630458
27293,73,73770,81,"Tasa de exámenes médico legales por presunto delito sexual contra niños, niñas y adolescentes",2018,3,1,462,216.450216450216,1,234,427.350427350427,0,228,0
27294,73,73854,81,"Tasa de exámenes médico legales por presunto delito sexual contra niños, niñas y adolescentes",2018,3,4,788,507.614213197969,1,409,244.498777506112,3,379,791.55672823219
27295,73,73854,81,"Tasa de exámenes médico legales por presunto delito sexual contra niños, niñas y adolescentes",2018,4,1,715,139.86013986014,0,372,0,1,343,291.545189504373
27296,73,73854,121,Tasa de exámenes médico legales por presunto delito sexual cuando la víctima está entre 18 y 28 años,2018,5,1,1115,89.6860986547085,0,583,0,1,532,187.96992481203
27297,73,73861,81,"Tasa de exámenes médico legales por presunto delito sexual contra niños, niñas y adolescentes",2018,2,1,1790,55.8659217877095,0,934,0,1,856,116.822429906542
27298,73,73861,81,"Tasa de exámenes médico legales por presunto delito sexual contra niños, niñas y adolescentes",2018,4,2,2061,97.0402717127608,1,1087,91.9963201471941,1,974,102.669404517454
27299,73,73870,81,"Tasa de exámenes médico legales por presunto delito sexual contra niños, niñas y adolescentes",2018,4,1,1169,85.5431993156544,0,616,0,1,553,180.831826401447
27300,73,73873,81,"Tasa de exámenes médico legales por presunto delito sexual contra niños, niñas y adolescentes",2018,3,1,535,186.915887850467,0,277,0,1,258,387.596899224806
27301,73,73873,81,"Tasa de exámenes médico legales por presunto delito sexual contra niños, niñas y adolescentes",2018,4,2,515,388.349514563107,0,267,0,2,248,806.451612903226
27302,73,73873,81,"Tasa de exámenes médico legales por presunto delito sexual contra niños, niñas y adolescentes",2018,1,1,98,1020.40816326531,0,50,0,1,48,2083.33333333333
27303,76,76001,81,"Tasa de exámenes médico legales por presunto delito sexual contra niños, niñas y adolescentes",2018,2,253,177170,142.800699892758,61,90478,67.4197042374942,192,86692,221.473723065565
27304,76,76001,81,"Tasa de exámenes médico legales por presunto delito sexual contra niños, niñas y adolescentes",2018,3,382,215937,176.903448691053,57,109739,51.9414246530404,325,106198,306.032128665323
27305,76,76001,81,"Tasa de exámenes médico legales por presunto delito sexual contra niños, niñas y adolescentes",2018,4,443,228906,193.52922160188,49,115687,42.3556665831079,394,113219,347.998127522766
27306,76,76001,121,Tasa de exámenes médico legales por presunto delito sexual cuando la víctima está entre 18 y 28 años,2018,5,85,449075,18.9277960251628,8,227319,3.51928347388472,77,221756,34.722848536229
27307,76,76001,81,"Tasa de exámenes médico legales por presunto delito sexual contra niños, niñas y adolescentes",2018,1,1,35720,2.79955207166853,0,18293,0,1,17427,5.73822229873185
27308,76,76020,81,"Tasa de exámenes médico legales por presunto delito sexual contra niños, niñas y adolescentes",2018,2,2,2021,98.9609104403761,1,1031,96.9932104752667,1,990,101.010101010101
27309,76,76020,81,"Tasa de exámenes médico legales por presunto delito sexual contra niños, niñas y adolescentes",2018,4,1,2246,44.5235975066785,0,1136,0,1,1110,90.0900900900901
27310,76,76020,121,Tasa de exámenes médico legales por presunto delito sexual cuando la víctima está entre 18 y 28 años,2018,5,1,4241,23.5793444942231,0,2140,0,1,2101,47.5963826749167
27311,76,76036,81,"Tasa de exámenes médico legales por presunto delito sexual contra niños, niñas y adolescentes",2018,3,3,1519,197.498354180382,2,780,256.410256410256,1,739,135.31799729364
27312,76,76036,81,"Tasa de exámenes médico legales por presunto delito sexual contra niños, niñas y adolescentes",2018,4,1,1541,64.8929266709929,0,792,0,1,749,133.511348464619
27313,76,76041,81,"Tasa de exámenes médico legales por presunto delito sexual contra niños, niñas y adolescentes",2018,2,1,1789,55.8971492453885,0,915,0,1,874,114.41647597254
27314,76,76041,81,"Tasa de exámenes médico legales por presunto delito sexual contra niños, niñas y adolescentes",2018,4,1,1900,52.6315789473684,0,961,0,1,939,106.496272630458
27315,76,76041,121,Tasa de exámenes médico legales por presunto delito sexual cuando la víctima está entre 18 y 28 años,2018,5,1,3545,28.2087447108604,0,1831,0,1,1714,58.343057176196
27316,76,76054,81,"Tasa de exámenes médico legales por presunto delito sexual contra niños, niñas y adolescentes",2018,4,2,603,331.67495854063,0,318,0,2,285,701.754385964912
27317,76,76100,81,"Tasa de exámenes médico legales por presunto delito sexual contra niños, niñas y adolescentes",2018,3,2,1346,148.588410104012,0,692,0,2,654,305.810397553517
27318,76,76100,81,"Tasa de exámenes médico legales por presunto delito sexual contra niños, niñas y adolescentes",2018,4,7,1229,569.568755085435,4,650,615.384615384615,3,579,518.134715025907
27319,76,76109,81,"Tasa de exámenes médico legales por presunto delito sexual contra niños, niñas y adolescentes",2018,2,19,44178,43.0078319525556,3,22607,13.2702260361835,16,21571,74.1736590793194
27320,76,76109,81,"Tasa de exámenes médico legales por presunto delito sexual contra niños, niñas y adolescentes",2018,3,44,49252,89.3364736457403,7,25126,27.8595876781024,37,24126,153.361518693526
27321,76,76109,81,"Tasa de exámenes médico legales por presunto delito sexual contra niños, niñas y adolescentes",2018,4,50,47554,105.14362619338,4,24086,16.6071576849622,46,23468,196.011590250554
27322,76,76109,121,Tasa de exámenes médico legales por presunto delito sexual cuando la víctima está entre 18 y 28 años,2018,5,9,85391,10.5397524329262,0,42567,0,9,42824,21.0162525686531
27323,76,76111,81,"Tasa de exámenes médico legales por presunto delito sexual contra niños, niñas y adolescentes",2018,2,18,7661,234.956272027151,2,3940,50.761421319797,16,3721,429.991937651169
27324,76,76111,81,"Tasa de exámenes médico legales por presunto delito sexual contra niños, niñas y adolescentes",2018,3,37,9284,398.535114174925,9,4812,187.032418952618,28,4472,626.118067978533
27325,76,76111,81,"Tasa de exámenes médico legales por presunto delito sexual contra niños, niñas y adolescentes",2018,4,31,9498,326.384502000421,2,4981,40.1525798032524,29,4517,642.0190391853
27326,76,76111,121,Tasa de exámenes médico legales por presunto delito sexual cuando la víctima está entre 18 y 28 años,2018,5,10,19486,51.3188956173663,1,10230,9.77517106549365,9,9256,97.2342264477096
27327,76,76113,81,"Tasa de exámenes médico legales por presunto delito sexual contra niños, niñas y adolescentes",2018,3,2,1834,109.051254089422,1,966,103.51966873706,1,868,115.207373271889
27328,76,76113,81,"Tasa de exámenes médico legales por presunto delito sexual contra niños, niñas y adolescentes",2018,4,4,1812,220.75055187638,0,968,0,4,844,473.9336492891
27329,76,76122,81,"Tasa de exámenes médico legales por presunto delito sexual contra niños, niñas y adolescentes",2018,2,9,2306,390.286209887251,2,1184,168.918918918919,7,1122,623.885918003565
27330,76,76122,81,"Tasa de exámenes médico legales por presunto delito sexual contra niños, niñas y adolescentes",2018,3,13,2616,496.941896024465,2,1352,147.92899408284,11,1264,870.253164556962
27331,76,76122,81,"Tasa de exámenes médico legales por presunto delito sexual contra niños, niñas y adolescentes",2018,4,13,2592,501.543209876543,5,1339,373.412994772218,8,1253,638.467677573823
27332,76,76122,121,Tasa de exámenes médico legales por presunto delito sexual cuando la víctima está entre 18 y 28 años,2018,5,1,5345,18.7090739008419,0,2719,0,1,2626,38.0807311500381
27333,76,76126,81,"Tasa de exámenes médico legales por presunto delito sexual contra niños, niñas y adolescentes",2018,2,16,1201,1332.22314737719,8,615,1300.81300813008,8,586,1365.18771331058
27334,76,76126,81,"Tasa de exámenes médico legales por presunto delito sexual contra niños, niñas y adolescentes",2018,3,3,1365,219.78021978022,0,696,0,3,669,448.430493273543
27335,76,76126,81,"Tasa de exámenes médico legales por presunto delito sexual contra niños, niñas y adolescentes",2018,4,7,1286,544.323483670296,1,652,153.374233128834,6,634,946.372239747634
27336,76,76130,81,"Tasa de exámenes médico legales por presunto delito sexual contra niños, niñas y adolescentes",2018,2,3,6175,48.582995951417,2,3170,63.0914826498423,1,3005,33.2778702163062
27337,76,76130,81,"Tasa de exámenes médico legales por presunto delito sexual contra niños, niñas y adolescentes",2018,3,12,6983,171.845911499356,0,3609,0,12,3374,355.6609365738
27338,76,76130,81,"Tasa de exámenes médico legales por presunto delito sexual contra niños, niñas y adolescentes",2018,4,12,7013,171.11079423927,1,3653,27.3747604708459,11,3360,327.380952380952
27339,76,76130,121,Tasa de exámenes médico legales por presunto delito sexual cuando la víctima está entre 18 y 28 años,2018,5,3,15219,19.712201852947,0,7650,0,3,7569,39.6353547364249
27340,76,76147,81,"Tasa de exámenes médico legales por presunto delito sexual contra niños, niñas y adolescentes",2018,2,9,9859,91.2871487980525,2,5041,39.6746677246578,7,4818,145.288501452885
27341,76,76147,81,"Tasa de exámenes médico legales por presunto delito sexual contra niños, niñas y adolescentes",2018,3,20,11902,168.03898504453,3,6012,49.9001996007984,17,5890,288.624787775891
27342,76,76147,81,"Tasa de exámenes médico legales por presunto delito sexual contra niños, niñas y adolescentes",2018,4,14,11877,117.874884230024,2,5983,33.4280461307037,12,5894,203.596878181201
27343,76,76147,121,Tasa de exámenes médico legales por presunto delito sexual cuando la víctima está entre 18 y 28 años,2018,5,1,22648,4.41540091840339,1,11559,8.65126741067566,0,11089,0
27344,76,76233,81,"Tasa de exámenes médico legales por presunto delito sexual contra niños, niñas y adolescentes",2018,3,9,3241,277.692070348658,0,1662,0,9,1579,569.981000633312
27345,76,76233,81,"Tasa de exámenes médico legales por presunto delito sexual contra niños, niñas y adolescentes",2018,4,6,3029,198.085176625949,2,1550,129.032258064516,4,1479,270.453008789723
27346,76,76233,121,Tasa de exámenes médico legales por presunto delito sexual cuando la víctima está entre 18 y 28 años,2018,5,2,6279,31.8522057652492,0,3276,0,2,3003,66.6000666000666
27347,76,76248,81,"Tasa de exámenes médico legales por presunto delito sexual contra niños, niñas y adolescentes",2018,2,4,4294,93.1532370749884,0,2196,0,4,2098,190.657769304099
27348,76,76248,81,"Tasa de exámenes médico legales por presunto delito sexual contra niños, niñas y adolescentes",2018,3,11,5041,218.210672485618,2,2575,77.6699029126214,9,2466,364.963503649635
27349,76,76248,81,"Tasa de exámenes médico legales por presunto delito sexual contra niños, niñas y adolescentes",2018,4,7,4982,140.50582095544,1,2515,39.7614314115308,6,2467,243.210376976084
27350,76,76250,81,"Tasa de exámenes médico legales por presunto delito sexual contra niños, niñas y adolescentes",2018,2,1,765,130.718954248366,0,391,0,1,374,267.379679144385
27351,76,76250,81,"Tasa de exámenes médico legales por presunto delito sexual contra niños, niñas y adolescentes",2018,3,1,866,115.473441108545,0,442,0,1,424,235.849056603774
27352,76,76250,81,"Tasa de exámenes médico legales por presunto delito sexual contra niños, niñas y adolescentes",2018,4,4,805,496.894409937888,1,407,245.700245700246,3,398,753.768844221105
27353,76,76275,81,"Tasa de exámenes médico legales por presunto delito sexual contra niños, niñas y adolescentes",2018,2,3,5077,59.0900137876699,1,2606,38.3729854182655,2,2471,80.9388911371914
27354,76,76275,81,"Tasa de exámenes médico legales por presunto delito sexual contra niños, niñas y adolescentes",2018,3,5,5827,85.8074480864939,1,2987,33.478406427854,4,2840,140.845070422535
27355,76,76275,81,"Tasa de exámenes médico legales por presunto delito sexual contra niños, niñas y adolescentes",2018,4,4,5657,70.7088562842496,0,2895,0,4,2762,144.822592324403
27356,76,76275,121,Tasa de exámenes médico legales por presunto delito sexual cuando la víctima está entre 18 y 28 años,2018,5,1,10881,9.19033177097693,0,5465,0,1,5416,18.4638109305761
27357,76,76306,81,"Tasa de exámenes médico legales por presunto delito sexual contra niños, niñas y adolescentes",2018,2,1,1556,64.26735218509,0,794,0,1,762,131.233595800525
27358,76,76306,81,"Tasa de exámenes médico legales por presunto delito sexual contra niños, niñas y adolescentes",2018,3,1,1738,57.5373993095512,0,878,0,1,860,116.279069767442
27359,76,76306,81,"Tasa de exámenes médico legales por presunto delito sexual contra niños, niñas y adolescentes",2018,4,5,1637,305.43677458766,1,816,122.549019607843,4,821,487.21071863581
27360,76,76306,121,Tasa de exámenes médico legales por presunto delito sexual cuando la víctima está entre 18 y 28 años,2018,5,1,3604,27.7469478357381,0,1805,0,1,1799,55.5864369093941
27361,76,76318,81,"Tasa de exámenes médico legales por presunto delito sexual contra niños, niñas y adolescentes",2018,2,4,2678,149.365197908887,0,1359,0,4,1319,303.260045489007
27362,76,76318,81,"Tasa de exámenes médico legales por presunto delito sexual contra niños, niñas y adolescentes",2018,3,5,3104,161.082474226804,1,1571,63.6537237428389,4,1533,260.926288323549
27363,76,76318,81,"Tasa de exámenes médico legales por presunto delito sexual contra niños, niñas y adolescentes",2018,4,9,3050,295.081967213115,2,1558,128.369704749679,7,1492,469.16890080429
27364,76,76318,121,Tasa de exámenes médico legales por presunto delito sexual cuando la víctima está entre 18 y 28 años,2018,5,3,6220,48.2315112540193,0,3156,0,3,3064,97.911227154047
27365,76,76364,81,"Tasa de exámenes médico legales por presunto delito sexual contra niños, niñas y adolescentes",2018,2,12,10401,115.373521776752,4,5320,75.187969924812,8,5081,157.449320999803
27366,76,76364,81,"Tasa de exámenes médico legales por presunto delito sexual contra niños, niñas y adolescentes",2018,3,17,12148,139.940730984524,2,6247,32.0153673763406,15,5901,254.19420437214
27367,76,76364,81,"Tasa de exámenes médico legales por presunto delito sexual contra niños, niñas y adolescentes",2018,4,39,12362,315.482931564472,6,6363,94.2951438000943,33,5999,550.091681946991
27368,76,76364,121,Tasa de exámenes médico legales por presunto delito sexual cuando la víctima está entre 18 y 28 años,2018,5,8,24195,33.0646827856995,2,12208,16.3826998689384,6,11987,50.0542254108618
27369,76,76377,81,"Tasa de exámenes médico legales por presunto delito sexual contra niños, niñas y adolescentes",2018,2,1,869,115.074798619102,0,452,0,1,417,239.808153477218
27370,76,76377,81,"Tasa de exámenes médico legales por presunto delito sexual contra niños, niñas y adolescentes",2018,3,2,1019,196.270853778214,0,537,0,2,482,414.9377593361
27371,76,76377,81,"Tasa de exámenes médico legales por presunto delito sexual contra niños, niñas y adolescentes",2018,4,4,971,411.946446961895,0,511,0,4,460,869.565217391304
27372,76,76400,81,"Tasa de exámenes médico legales por presunto delito sexual contra niños, niñas y adolescentes",2018,2,3,3141,95.5109837631328,2,1598,125.156445556946,1,1543,64.8088139987038
27373,76,76400,81,"Tasa de exámenes médico legales por presunto delito sexual contra niños, niñas y adolescentes",2018,3,7,3668,190.839694656489,1,1888,52.9661016949153,6,1780,337.078651685393
27374,76,76400,81,"Tasa de exámenes médico legales por presunto delito sexual contra niños, niñas y adolescentes",2018,4,6,3564,168.350168350168,0,1844,0,6,1720,348.837209302326
27375,76,76400,121,Tasa de exámenes médico legales por presunto delito sexual cuando la víctima está entre 18 y 28 años,2018,5,2,7090,28.2087447108604,0,3600,0,2,3490,57.3065902578797
27376,76,76403,81,"Tasa de exámenes médico legales por presunto delito sexual contra niños, niñas y adolescentes",2018,4,1,1073,93.1966449207828,0,579,0,1,494,202.429149797571
27377,76,76403,121,Tasa de exámenes médico legales por presunto delito sexual cuando la víctima está entre 18 y 28 años,2018,5,1,2140,46.7289719626168,0,1134,0,1,1006,99.403578528827
27378,76,76497,81,"Tasa de exámenes médico legales por presunto delito sexual contra niños, niñas y adolescentes",2018,2,1,1465,68.259385665529,0,754,0,1,711,140.646976090014
27379,76,76497,81,"Tasa de exámenes médico legales por presunto delito sexual contra niños, niñas y adolescentes",2018,3,1,1615,61.9195046439629,0,836,0,1,779,128.369704749679
27380,76,76520,81,"Tasa de exámenes médico legales por presunto delito sexual contra niños, niñas y adolescentes",2018,2,28,20920,133.843212237094,4,10666,37.5023438964935,24,10254,234.055002925688
27381,76,76520,81,"Tasa de exámenes médico legales por presunto delito sexual contra niños, niñas y adolescentes",2018,3,48,25385,189.088044120544,5,12969,38.5534736679775,43,12416,346.327319587629
27382,76,76520,81,"Tasa de exámenes médico legales por presunto delito sexual contra niños, niñas y adolescentes",2018,4,42,26431,158.904316900609,3,13607,22.0474755640479,39,12824,304.117280099813
27383,76,76520,121,Tasa de exámenes médico legales por presunto delito sexual cuando la víctima está entre 18 y 28 años,2018,5,10,55452,18.033614657722,1,28292,3.53456807578114,9,27160,33.1369661266569
27384,76,76563,81,"Tasa de exámenes médico legales por presunto delito sexual contra niños, niñas y adolescentes",2018,2,2,5422,36.8867576540022,0,2779,0,2,2643,75.6715853197124
27385,76,76563,81,"Tasa de exámenes médico legales por presunto delito sexual contra niños, niñas y adolescentes",2018,3,1,6130,16.3132137030995,0,3147,0,1,2983,33.5232986925914
27386,76,76563,81,"Tasa de exámenes médico legales por presunto delito sexual contra niños, niñas y adolescentes",2018,4,4,5864,68.212824010914,1,3002,33.311125916056,3,2862,104.82180293501
27387,76,76563,121,Tasa de exámenes médico legales por presunto delito sexual cuando la víctima está entre 18 y 28 años,2018,5,2,10658,18.7652467629949,0,5344,0,2,5314,37.6364320662401
27388,76,76606,81,"Tasa de exámenes médico legales por presunto delito sexual contra niños, niñas y adolescentes",2018,2,2,1370,145.985401459854,1,702,142.450142450142,1,668,149.700598802395
27389,76,76606,81,"Tasa de exámenes médico legales por presunto delito sexual contra niños, niñas y adolescentes",2018,3,4,1555,257.234726688103,0,806,0,4,749,534.045393858478
27390,76,76606,81,"Tasa de exámenes médico legales por presunto delito sexual contra niños, niñas y adolescentes",2018,4,2,1503,133.067198935462,0,787,0,2,716,279.329608938547
27391,76,76606,121,Tasa de exámenes médico legales por presunto delito sexual cuando la víctima está entre 18 y 28 años,2018,5,1,2878,34.7463516330785,0,1469,0,1,1409,70.97232079489
27392,76,76616,81,"Tasa de exámenes médico legales por presunto delito sexual contra niños, niñas y adolescentes",2018,2,3,1134,264.550264550265,0,587,0,3,547,548.446069469835
27393,76,76616,81,"Tasa de exámenes médico legales por presunto delito sexual contra niños, niñas y adolescentes",2018,3,4,1303,306.983883346124,1,688,145.348837209302,3,615,487.80487804878
27394,76,76616,81,"Tasa de exámenes médico legales por presunto delito sexual contra niños, niñas y adolescentes",2018,4,3,1179,254.452926208651,1,623,160.513643659711,2,556,359.712230215827
27395,76,76616,121,Tasa de exámenes médico legales por presunto delito sexual cuando la víctima está entre 18 y 28 años,2018,5,1,2368,42.2297297297297,0,1224,0,1,1144,87.4125874125874
27396,76,76622,81,"Tasa de exámenes médico legales por presunto delito sexual contra niños, niñas y adolescentes",2018,2,4,2518,158.856235107228,1,1289,77.5795190069822,3,1229,244.100895036615
27397,76,76622,81,"Tasa de exámenes médico legales por presunto delito sexual contra niños, niñas y adolescentes",2018,3,7,2880,243.055555555556,2,1479,135.226504394861,5,1401,356.887937187723
27398,76,76622,81,"Tasa de exámenes médico legales por presunto delito sexual contra niños, niñas y adolescentes",2018,4,7,2807,249.376558603491,0,1452,0,7,1355,516.60516605166
27399,76,76622,121,Tasa de exámenes médico legales por presunto delito sexual cuando la víctima está entre 18 y 28 años,2018,5,1,5565,17.9694519317161,0,2793,0,1,2772,36.0750360750361
27400,76,76670,81,"Tasa de exámenes médico legales por presunto delito sexual contra niños, niñas y adolescentes",2018,2,1,1396,71.6332378223496,0,725,0,1,671,149.03129657228
27401,76,76670,81,"Tasa de exámenes médico legales por presunto delito sexual contra niños, niñas y adolescentes",2018,3,5,1605,311.526479750779,2,854,234.192037470726,3,751,399.467376830892
27402,76,76670,81,"Tasa de exámenes médico legales por presunto delito sexual contra niños, niñas y adolescentes",2018,4,4,1661,240.818783865141,0,902,0,4,759,527.009222661397
27403,76,76736,81,"Tasa de exámenes médico legales por presunto delito sexual contra niños, niñas y adolescentes",2018,2,8,3508,228.050171037628,1,1806,55.3709856035437,7,1702,411.280846063455
27404,76,76736,81,"Tasa de exámenes médico legales por presunto delito sexual contra niños, niñas y adolescentes",2018,3,7,4218,165.955429113324,1,2256,44.3262411347518,6,1962,305.810397553517
27405,76,76736,81,"Tasa de exámenes médico legales por presunto delito sexual contra niños, niñas y adolescentes",2018,4,10,4124,242.483026188167,1,2274,43.9753737906772,9,1850,486.486486486486
27406,76,76736,121,Tasa de exámenes médico legales por presunto delito sexual cuando la víctima está entre 18 y 28 años,2018,5,1,7741,12.9182276191707,0,4087,0,1,3654,27.3672687465791
27407,76,76823,81,"Tasa de exámenes médico legales por presunto delito sexual contra niños, niñas y adolescentes",2018,2,4,1487,268.997982515131,1,765,130.718954248366,3,722,415.512465373961
27408,76,76823,81,"Tasa de exámenes médico legales por presunto delito sexual contra niños, niñas y adolescentes",2018,3,1,1747,57.2409845449342,1,906,110.37527593819,0,841,0
27409,76,76823,81,"Tasa de exámenes médico legales por presunto delito sexual contra niños, niñas y adolescentes",2018,4,2,1688,118.483412322275,1,875,114.285714285714,1,813,123.0012300123
27410,76,76823,121,Tasa de exámenes médico legales por presunto delito sexual cuando la víctima está entre 18 y 28 años,2018,5,2,3170,63.0914826498423,0,1675,0,2,1495,133.779264214047
27411,76,76828,81,"Tasa de exámenes médico legales por presunto delito sexual contra niños, niñas y adolescentes",2018,2,1,1598,62.5782227784731,0,825,0,1,773,129.366106080207
27412,76,76834,81,"Tasa de exámenes médico legales por presunto delito sexual contra niños, niñas y adolescentes",2018,2,13,16344,79.5398923152227,4,8398,47.6303881876637,9,7946,113.264535615404
27413,76,76834,81,"Tasa de exámenes médico legales por presunto delito sexual contra niños, niñas y adolescentes",2018,3,23,19494,117.985021032112,3,10023,29.9311583358276,20,9471,211.17094287826
27414,76,76834,81,"Tasa de exámenes médico legales por presunto delito sexual contra niños, niñas y adolescentes",2018,4,28,19657,142.442895660579,3,10105,29.6882731321128,25,9552,261.725293132328
27415,76,76834,121,Tasa de exámenes médico legales por presunto delito sexual cuando la víctima está entre 18 y 28 años,2018,5,6,39647,15.1335536106137,0,20120,0,6,19527,30.7266861269012
27416,76,76863,81,"Tasa de exámenes médico legales por presunto delito sexual contra niños, niñas y adolescentes",2018,3,1,656,152.439024390244,0,335,0,1,321,311.526479750779
27417,76,76863,81,"Tasa de exámenes médico legales por presunto delito sexual contra niños, niñas y adolescentes",2018,4,2,602,332.225913621262,1,316,316.455696202532,1,286,349.65034965035
27418,76,76869,81,"Tasa de exámenes médico legales por presunto delito sexual contra niños, niñas y adolescentes",2018,2,4,856,467.289719626168,4,434,921.658986175115,0,422,0
27419,76,76869,81,"Tasa de exámenes médico legales por presunto delito sexual contra niños, niñas y adolescentes",2018,3,6,1007,595.829195630586,1,510,196.078431372549,5,497,1006.03621730382
27420,76,76869,121,Tasa de exámenes médico legales por presunto delito sexual cuando la víctima está entre 18 y 28 años,2018,5,1,1815,55.096418732782404,1,947,105.596620908131,0,868,0
27421,76,76890,81,"Tasa de exámenes médico legales por presunto delito sexual contra niños, niñas y adolescentes",2018,2,1,1227,81.4995925020375,1,635,157.48031496063,0,592,0
27422,76,76890,81,"Tasa de exámenes médico legales por presunto delito sexual contra niños, niñas y adolescentes",2018,3,6,1410,425.531914893617,2,740,270.27027027027,4,670,597.014925373134
27423,76,76890,81,"Tasa de exámenes médico legales por presunto delito sexual contra niños, niñas y adolescentes",2018,4,8,1414,565.770862800566,0,748,0,8,666,1201.2012012012
27424,76,76890,121,Tasa de exámenes médico legales por presunto delito sexual cuando la víctima está entre 18 y 28 años,2018,5,1,3096,32.2997416020672,0,1623,0,1,1473,67.8886625933469
27425,76,76892,81,"Tasa de exámenes médico legales por presunto delito sexual contra niños, niñas y adolescentes",2018,2,16,9700,164.948453608247,7,4968,140.901771336554,9,4732,190.194420963652
27426,76,76892,81,"Tasa de exámenes médico legales por presunto delito sexual contra niños, niñas y adolescentes",2018,3,34,11412,297.932001402033,8,5834,137.127185464518,26,5578,466.116887773396
27427,76,76892,81,"Tasa de exámenes médico legales por presunto delito sexual contra niños, niñas y adolescentes",2018,4,28,11613,241.109101868596,1,5977,16.7308014053873,27,5636,479.063165365507
27428,76,76892,121,Tasa de exámenes médico legales por presunto delito sexual cuando la víctima está entre 18 y 28 años,2018,5,5,23243,21.5118530310201,1,12114,8.25491167244511,4,11129,35.9421331656034
27429,76,76895,81,"Tasa de exámenes médico legales por presunto delito sexual contra niños, niñas y adolescentes",2018,2,4,3666,109.11074740862,1,1871,53.4473543559594,3,1795,167.130919220056
27430,76,76895,81,"Tasa de exámenes médico legales por presunto delito sexual contra niños, niñas y adolescentes",2018,3,15,4290,349.65034965035,7,2194,319.051959890611,8,2096,381.679389312977
27431,76,76895,81,"Tasa de exámenes médico legales por presunto delito sexual contra niños, niñas y adolescentes",2018,4,8,4233,188.991259154264,4,2137,187.178287318671,4,2096,190.839694656489
27432,76,76895,121,Tasa de exámenes médico legales por presunto delito sexual cuando la víctima está entre 18 y 28 años,2018,5,6,8236,72.8508984944148,0,4081,0,6,4155,144.404332129964
27433,8,8001,81,"Tasa de exámenes médico legales por presunto delito sexual contra niños, niñas y adolescentes",2018,2,102,94389,108.063439595716,30,48254,62.1710117295975,72,46135,156.063726021459
27434,8,8001,81,"Tasa de exámenes médico legales por presunto delito sexual contra niños, niñas y adolescentes",2018,3,205,116336,176.213725759868,35,59395,58.9275191514437,170,56941,298.554644280922
27435,8,8001,81,"Tasa de exámenes médico legales por presunto delito sexual contra niños, niñas y adolescentes",2018,4,279,119865,232.761857089225,28,61095,45.8302643424175,251,58770,427.088650672112
27436,8,8001,121,Tasa de exámenes médico legales por presunto delito sexual cuando la víctima está entre 18 y 28 años,2018,5,52,220300,23.604176123468,4,112366,3.55979566772867,48,107934,44.4716215465006
27437,8,8001,81,"Tasa de exámenes médico legales por presunto delito sexual contra niños, niñas y adolescentes",2018,1,1,18680,5.35331905781585,1,9563,10.4569695702186,0,9117,0
27438,8,8078,81,"Tasa de exámenes médico legales por presunto delito sexual contra niños, niñas y adolescentes",2018,2,2,5159,38.7672029463074,0,2633,0,2,2526,79.1765637371338
27439,8,8078,81,"Tasa de exámenes médico legales por presunto delito sexual contra niños, niñas y adolescentes",2018,3,10,6039,165.590329524756,2,3085,64.8298217179903,8,2954,270.8192281652
27440,8,8078,81,"Tasa de exámenes médico legales por presunto delito sexual contra niños, niñas y adolescentes",2018,4,9,5921,152.001351123121,0,3031,0,9,2890,311.418685121107
27441,8,8078,121,Tasa de exámenes médico legales por presunto delito sexual cuando la víctima está entre 18 y 28 años,2018,5,3,10669,28.1188490017809,0,5493,0,3,5176,57.9598145285935
27442,8,8137,81,"Tasa de exámenes médico legales por presunto delito sexual contra niños, niñas y adolescentes",2018,2,1,1694,59.0318772136954,0,870,0,1,824,121.359223300971
27443,8,8137,81,"Tasa de exámenes médico legales por presunto delito sexual contra niños, niñas y adolescentes",2018,3,2,2115,94.5626477541371,0,1092,0,2,1023,195.503421309873
27444,8,8137,81,"Tasa de exámenes médico legales por presunto delito sexual contra niños, niñas y adolescentes",2018,4,3,2046,146.627565982405,0,1061,0,3,985,304.568527918782
27445,8,8141,81,"Tasa de exámenes médico legales por presunto delito sexual contra niños, niñas y adolescentes",2018,3,4,1534,260.756192959583,1,823,121.506682867558,3,711,421.940928270042
27446,8,8141,81,"Tasa de exámenes médico legales por presunto delito sexual contra niños, niñas y adolescentes",2018,4,3,1507,199.07100199071,0,809,0,3,698,429.799426934097
27447,8,8296,81,"Tasa de exámenes médico legales por presunto delito sexual contra niños, niñas y adolescentes",2018,2,5,4529,110.39964672113,2,2324,86.0585197934596,3,2205,136.054421768707
27448,8,8296,81,"Tasa de exámenes médico legales por presunto delito sexual contra niños, niñas y adolescentes",2018,3,15,5333,281.267579223701,5,2756,181.422351233672,10,2577,388.048117966628
27449,8,8296,81,"Tasa de exámenes médico legales por presunto delito sexual contra niños, niñas y adolescentes",2018,4,10,5298,188.75047187618,2,2753,72.6480203414457,8,2545,314.34184675835
27450,8,8296,121,Tasa de exámenes médico legales por presunto delito sexual cuando la víctima está entre 18 y 28 años,2018,5,4,8975,44.5682451253482,0,4647,0,4,4328,92.4214417744917
27451,8,8372,81,"Tasa de exámenes médico legales por presunto delito sexual contra niños, niñas y adolescentes",2018,2,3,1566,191.570881226054,0,817,0,3,749,400.534045393858
27452,8,8372,81,"Tasa de exámenes médico legales por presunto delito sexual contra niños, niñas y adolescentes",2018,3,2,1787,111.919418019026,0,959,0,2,828,241.545893719807
27453,8,8372,81,"Tasa de exámenes médico legales por presunto delito sexual contra niños, niñas y adolescentes",2018,4,4,1788,223.713646532438,1,962,103.950103950104,3,826,363.19612590799
27454,8,8372,121,Tasa de exámenes médico legales por presunto delito sexual cuando la víctima está entre 18 y 28 años,2018,5,3,3288,91.2408759124088,0,1740,0,3,1548,193.798449612403
27455,8,8421,81,"Tasa de exámenes médico legales por presunto delito sexual contra niños, niñas y adolescentes",2018,4,5,2978,167.897918065816,0,1515,0,5,1463,341.763499658236
27456,8,8433,81,"Tasa de exámenes médico legales por presunto delito sexual contra niños, niñas y adolescentes",2018,2,10,12049,82.994439372562,3,6190,48.4652665589661,7,5859,119.4743130227
27457,8,8433,81,"Tasa de exámenes médico legales por presunto delito sexual contra niños, niñas y adolescentes",2018,3,19,13906,136.631669782828,2,7170,27.8940027894003,17,6736,252.375296912114
27458,8,8433,81,"Tasa de exámenes médico legales por presunto delito sexual contra niños, niñas y adolescentes",2018,4,41,13675,299.81718464351,6,7012,85.5675984027382,35,6663,525.288908899895
27459,8,8433,121,Tasa de exámenes médico legales por presunto delito sexual cuando la víctima está entre 18 y 28 años,2018,5,9,24389,36.9018819959818,2,12825,15.5945419103314,7,11564,60.5326876513317
27460,8,8436,81,"Tasa de exámenes médico legales por presunto delito sexual contra niños, niñas y adolescentes",2018,2,2,1353,147.819660014782,0,698,0,2,655,305.343511450382
27461,8,8436,81,"Tasa de exámenes médico legales por presunto delito sexual contra niños, niñas y adolescentes",2018,3,3,1503,199.600798403194,0,787,0,3,716,418.994413407821
27462,8,8436,81,"Tasa de exámenes médico legales por presunto delito sexual contra niños, niñas y adolescentes",2018,4,3,1417,211.714890613973,0,749,0,3,668,449.101796407186
27463,8,8520,81,"Tasa de exámenes médico legales por presunto delito sexual contra niños, niñas y adolescentes",2018,2,1,2269,44.0722785368004,0,1178,0,1,1091,91.6590284142988
27464,8,8520,81,"Tasa de exámenes médico legales por presunto delito sexual contra niños, niñas y adolescentes",2018,3,7,2693,259.93316004456,0,1414,0,7,1279,547.302580140735
27465,8,8520,81,"Tasa de exámenes médico legales por presunto delito sexual contra niños, niñas y adolescentes",2018,4,3,2736,109.649122807018,0,1432,0,3,1304,230.061349693252
27466,8,8549,81,"Tasa de exámenes médico legales por presunto delito sexual contra niños, niñas y adolescentes",2018,4,1,592,168.918918918919,0,290,0,1,302,331.12582781457
27467,8,8558,81,"Tasa de exámenes médico legales por presunto delito sexual contra niños, niñas y adolescentes",2018,2,1,1370,72.992700729927,0,705,0,1,665,150.375939849624
27468,8,8558,81,"Tasa de exámenes médico legales por presunto delito sexual contra niños, niñas y adolescentes",2018,3,3,1596,187.96992481203,1,828,120.772946859903,2,768,260.416666666667
27469,8,8558,81,"Tasa de exámenes médico legales por presunto delito sexual contra niños, niñas y adolescentes",2018,4,4,1564,255.754475703325,0,812,0,4,752,531.914893617021
27470,8,8560,81,"Tasa de exámenes médico legales por presunto delito sexual contra niños, niñas y adolescentes",2018,2,1,2424,41.2541254125413,1,1237,80.8407437348424,0,1187,0
27471,8,8560,81,"Tasa de exámenes médico legales por presunto delito sexual contra niños, niñas y adolescentes",2018,3,3,2786,107.681263460158,0,1431,0,3,1355,221.40221402214
27472,8,8560,81,"Tasa de exámenes médico legales por presunto delito sexual contra niños, niñas y adolescentes",2018,4,5,2604,192.012288786482,1,1350,74.0740740740741,4,1254,318.979266347687
27473,8,8573,81,"Tasa de exámenes médico legales por presunto delito sexual contra niños, niñas y adolescentes",2018,2,2,2087,95.831336847149,1,1083,92.3361034164358,1,1004,99.601593625498
27474,8,8573,81,"Tasa de exámenes médico legales por presunto delito sexual contra niños, niñas y adolescentes",2018,3,6,2480,241.935483870968,1,1305,76.6283524904215,5,1175,425.531914893617
27475,8,8573,81,"Tasa de exámenes médico legales por presunto delito sexual contra niños, niñas y adolescentes",2018,4,13,2560,507.8125,1,1375,72.7272727272727,12,1185,1012.6582278481
27476,8,8573,121,Tasa de exámenes médico legales por presunto delito sexual cuando la víctima está entre 18 y 28 años,2018,5,1,4920,20.3252032520325,0,2627,0,1,2293,43.6109899694723
27477,8,8606,81,"Tasa de exámenes médico legales por presunto delito sexual contra niños, niñas y adolescentes",2018,3,3,3297,90.9918107370337,2,1668,119.904076738609,1,1629,61.3873542050338
27478,8,8606,81,"Tasa de exámenes médico legales por presunto delito sexual contra niños, niñas y adolescentes",2018,4,2,3051,65.5522779416585,0,1543,0,2,1508,132.62599469496
27479,8,8606,121,Tasa de exámenes médico legales por presunto delito sexual cuando la víctima está entre 18 y 28 años,2018,5,2,5256,38.0517503805175,0,2667,0,2,2589,77.2499034376207
27480,8,8634,81,"Tasa de exámenes médico legales por presunto delito sexual contra niños, niñas y adolescentes",2018,2,2,2913,68.6577411603158,1,1475,67.7966101694915,1,1438,69.5410292072323
27481,8,8634,81,"Tasa de exámenes médico legales por presunto delito sexual contra niños, niñas y adolescentes",2018,3,3,3311,90.6070673512534,0,1672,0,3,1639,183.038438071995
27482,8,8634,81,"Tasa de exámenes médico legales por presunto delito sexual contra niños, niñas y adolescentes",2018,4,4,3349,119.438638399522,0,1716,0,4,1633,244.947948560931
27483,8,8634,121,Tasa de exámenes médico legales por presunto delito sexual cuando la víctima está entre 18 y 28 años,2018,5,1,6457,15.4870682979712,0,3437,0,1,3020,33.112582781457
27484,8,8638,81,"Tasa de exámenes médico legales por presunto delito sexual contra niños, niñas y adolescentes",2018,2,5,9862,50.6996552423443,2,5073,39.424403705894,3,4789,62.6435581541032
27485,8,8638,81,"Tasa de exámenes médico legales por presunto delito sexual contra niños, niñas y adolescentes",2018,3,15,11620,129.087779690189,1,6026,16.594756057086,14,5594,250.268144440472
27486,8,8638,81,"Tasa de exámenes médico legales por presunto delito sexual contra niños, niñas y adolescentes",2018,4,25,11180,223.613595706619,5,5803,86.1623298293986,20,5377,371.954621536173
27487,8,8675,81,"Tasa de exámenes médico legales por presunto delito sexual contra niños, niñas y adolescentes",2018,3,2,1369,146.09203798393,0,705,0,2,664,301.204819277108
27488,8,8675,121,Tasa de exámenes médico legales por presunto delito sexual cuando la víctima está entre 18 y 28 años,2018,5,1,2269,44.0722785368004,0,1183,0,1,1086,92.0810313075506
27489,8,8685,81,"Tasa de exámenes médico legales por presunto delito sexual contra niños, niñas y adolescentes",2018,2,4,2089,191.47917663954,1,1065,93.8967136150235,3,1024,292.96875
27490,8,8685,81,"Tasa de exámenes médico legales por presunto delito sexual contra niños, niñas y adolescentes",2018,3,8,2419,330.715171558495,2,1231,162.46953696182,6,1188,505.050505050505
27491,8,8685,81,"Tasa de exámenes médico legales por presunto delito sexual contra niños, niñas y adolescentes",2018,4,9,2488,361.736334405145,0,1267,0,9,1221,737.100737100737
27492,8,8758,81,"Tasa de exámenes médico legales por presunto delito sexual contra niños, niñas y adolescentes",2018,2,31,59501,52.0999647064755,5,30409,16.4425005754875,26,29092,89.3716485631789
27493,8,8758,81,"Tasa de exámenes médico legales por presunto delito sexual contra niños, niñas y adolescentes",2018,3,97,70619,137.356801993798,9,35973,25.0187640730548,88,34646,253.997575477689
27494,8,8758,81,"Tasa de exámenes médico legales por presunto delito sexual contra niños, niñas y adolescentes",2018,4,100,71385,140.085452125797,10,36306,27.5436566958629,90,35079,256.563756093389
27495,8,8758,121,Tasa de exámenes médico legales por presunto delito sexual cuando la víctima está entre 18 y 28 años,2018,5,13,127491,10.1967982053635,1,64976,1.53902979561684,12,62515,19.1953931056546
27496,8,8758,81,"Tasa de exámenes médico legales por presunto delito sexual contra niños, niñas y adolescentes",2018,1,1,12106,8.26036676028416,0,6195,0,1,5911,16.9176112332939
27497,8,8770,81,"Tasa de exámenes médico legales por presunto delito sexual contra niños, niñas y adolescentes",2018,2,1,723,138.312586445367,0,372,0,1,351,284.900284900285
27498,8,8832,81,"Tasa de exámenes médico legales por presunto delito sexual contra niños, niñas y adolescentes",2018,2,1,952,105.042016806723,0,487,0,1,465,215.05376344086
27499,8,8832,121,Tasa de exámenes médico legales por presunto delito sexual cuando la víctima está entre 18 y 28 años,2018,5,1,1957,51.0986203372509,0,1032,0,1,925,108.108108108108
27500,81,81001,81,"Tasa de exámenes médico legales por presunto delito sexual contra niños, niñas y adolescentes",2018,2,10,10908,91.6758342500917,1,5503,18.1719062329638,9,5405,166.512488436633
27501,81,81001,81,"Tasa de exámenes médico legales por presunto delito sexual contra niños, niñas y adolescentes",2018,3,28,13486,207.62271985763,3,6790,44.1826215022091,25,6696,373.357228195938
27502,81,81001,81,"Tasa de exámenes médico legales por presunto delito sexual contra niños, niñas y adolescentes",2018,4,37,12758,290.014108794482,2,6315,31.6706254948535,35,6443,543.225205649542
27503,81,81001,121,Tasa de exámenes médico legales por presunto delito sexual cuando la víctima está entre 18 y 28 años,2018,5,9,16416,54.8245614035088,0,7680,0,9,8736,103.021978021978
27504,81,81065,81,"Tasa de exámenes médico legales por presunto delito sexual contra niños, niñas y adolescentes",2018,2,5,5198,96.1908426317815,2,2630,76.0456273764259,3,2568,116.822429906542
27505,81,81065,81,"Tasa de exámenes médico legales por presunto delito sexual contra niños, niñas y adolescentes",2018,3,9,5973,150.678051230537,0,3032,0,9,2941,306.018361101666
27506,81,81065,81,"Tasa de exámenes médico legales por presunto delito sexual contra niños, niñas y adolescentes",2018,4,12,5695,210.711150131694,1,2905,34.4234079173838,11,2790,394.26523297491
27507,81,81065,121,Tasa de exámenes médico legales por presunto delito sexual cuando la víctima está entre 18 y 28 años,2018,5,4,8183,48.8818281803739,2,4066,49.1883915395967,2,4117,48.5790624240952
27508,81,81065,81,"Tasa de exámenes médico legales por presunto delito sexual contra niños, niñas y adolescentes",2018,1,1,1063,94.0733772342427,0,541,0,1,522,191.570881226054
27509,81,81220,81,"Tasa de exámenes médico legales por presunto delito sexual contra niños, niñas y adolescentes",2018,2,2,409,488.997555012225,0,209,0,2,200,1000
27510,81,81220,81,"Tasa de exámenes médico legales por presunto delito sexual contra niños, niñas y adolescentes",2018,3,4,459,871.459694989107,0,231,0,4,228,1754.38596491228
27511,81,81220,81,"Tasa de exámenes médico legales por presunto delito sexual contra niños, niñas y adolescentes",2018,4,8,433,1847.57505773672,0,215,0,8,218,3669.7247706422
27512,81,81300,81,"Tasa de exámenes médico legales por presunto delito sexual contra niños, niñas y adolescentes",2018,2,2,3313,60.3682463024449,1,1671,59.8444045481747,1,1642,60.9013398294762
27513,81,81300,81,"Tasa de exámenes médico legales por presunto delito sexual contra niños, niñas y adolescentes",2018,3,8,3751,213.27645961077,1,1875,53.3333333333333,7,1876,373.134328358209
27514,81,81300,81,"Tasa de exámenes médico legales por presunto delito sexual contra niños, niñas y adolescentes",2018,4,14,3530,396.600566572238,1,1742,57.4052812858783,13,1788,727.069351230425
27515,81,81591,81,"Tasa de exámenes médico legales por presunto delito sexual contra niños, niñas y adolescentes",2018,3,1,513,194.931773879142,0,258,0,1,255,392.156862745098
27516,81,81591,81,"Tasa de exámenes médico legales por presunto delito sexual contra niños, niñas y adolescentes",2018,4,1,528,189.393939393939,0,282,0,1,246,406.50406504065
27517,81,81591,121,Tasa de exámenes médico legales por presunto delito sexual cuando la víctima está entre 18 y 28 años,2018,5,1,875,114.285714285714,0,497,0,1,378,264.550264550265
27518,81,81736,81,"Tasa de exámenes médico legales por presunto delito sexual contra niños, niñas y adolescentes",2018,2,4,6095,65.6275635767022,0,3124,0,4,2971,134.6348030966
27519,81,81736,81,"Tasa de exámenes médico legales por presunto delito sexual contra niños, niñas y adolescentes",2018,3,15,6677,224.651789725925,2,3381,59.1540964211772,13,3296,394.417475728155
27520,81,81736,81,"Tasa de exámenes médico legales por presunto delito sexual contra niños, niñas y adolescentes",2018,4,19,6523,291.277019776177,1,3359,29.7707651086633,18,3164,568.90012642225
27521,81,81736,121,Tasa de exámenes médico legales por presunto delito sexual cuando la víctima está entre 18 y 28 años,2018,5,1,10434,9.58405213724363,0,5541,0,1,4893,20.4373594931535
27522,81,81794,81,"Tasa de exámenes médico legales por presunto delito sexual contra niños, niñas y adolescentes",2018,2,7,6504,107.626076260763,2,3359,59.5415302173266,5,3145,158.982511923688
27523,81,81794,81,"Tasa de exámenes médico legales por presunto delito sexual contra niños, niñas y adolescentes",2018,3,24,7301,328.722092863991,3,3820,78.5340314136126,21,3481,603.274920999713
27524,81,81794,81,"Tasa de exámenes médico legales por presunto delito sexual contra niños, niñas y adolescentes",2018,4,27,6911,390.681522210968,4,3637,109.980753368161,23,3274,702.504581551619
27525,81,81794,121,Tasa de exámenes médico legales por presunto delito sexual cuando la víctima está entre 18 y 28 años,2018,5,1,10919,9.15834783405074,0,5835,0,1,5084,19.669551534225
27526,85,85001,81,"Tasa de exámenes médico legales por presunto delito sexual contra niños, niñas y adolescentes",2018,2,18,13440,133.928571428571,4,6856,58.343057176196,14,6584,212.636695018226
27527,85,85001,81,"Tasa de exámenes médico legales por presunto delito sexual contra niños, niñas y adolescentes",2018,3,76,16902,449.650928884156,6,8660,69.284064665127,70,8242,849.308420286338
27528,85,85001,81,"Tasa de exámenes médico legales por presunto delito sexual contra niños, niñas y adolescentes",2018,4,76,17628,431.132289539369,3,8977,33.41873677175,73,8651,843.833082880592
27529,85,85001,121,Tasa de exámenes médico legales por presunto delito sexual cuando la víctima está entre 18 y 28 años,2018,5,13,30034,43.2842778184724,1,14964,6.68270515904838,12,15070,79.628400796284
27530,85,85010,81,"Tasa de exámenes médico legales por presunto delito sexual contra niños, niñas y adolescentes",2018,2,2,4085,48.9596083231334,0,2085,0,2,2000,100
27531,85,85010,81,"Tasa de exámenes médico legales por presunto delito sexual contra niños, niñas y adolescentes",2018,3,17,4874,348.789495281083,1,2483,40.2738622633911,16,2391,669.176076955249
27532,85,85010,81,"Tasa de exámenes médico legales por presunto delito sexual contra niños, niñas y adolescentes",2018,4,23,5010,459.081836327345,0,2503,0,23,2507,917.431192660551
27533,85,85010,121,Tasa de exámenes médico legales por presunto delito sexual cuando la víctima está entre 18 y 28 años,2018,5,2,9059,22.0774919969092,1,4408,22.6860254083485,1,4651,21.5007525263384
27534,85,85010,81,"Tasa de exámenes médico legales por presunto delito sexual contra niños, niñas y adolescentes",2018,1,2,824,242.718446601942,0,418,0,2,406,492.610837438424
27535,85,85125,81,"Tasa de exámenes médico legales por presunto delito sexual contra niños, niñas y adolescentes",2018,2,1,1541,64.8929266709929,0,806,0,1,735,136.054421768707
27536,85,85125,81,"Tasa de exámenes médico legales por presunto delito sexual contra niños, niñas y adolescentes",2018,3,4,1784,224.215246636771,1,959,104.275286757039,3,825,363.636363636364
27537,85,85125,81,"Tasa de exámenes médico legales por presunto delito sexual contra niños, niñas y adolescentes",2018,4,10,1664,600.961538461538,2,878,227.790432801822,8,786,1017.81170483461
27538,85,85125,121,Tasa de exámenes médico legales por presunto delito sexual cuando la víctima está entre 18 y 28 años,2018,5,2,2700,74.0740740740741,1,1385,72.202166064982,1,1315,76.0456273764259
27539,85,85139,81,"Tasa de exámenes médico legales por presunto delito sexual contra niños, niñas y adolescentes",2018,3,6,1274,470.957613814757,1,661,151.285930408472,5,613,815.660685154975
27540,85,85139,81,"Tasa de exámenes médico legales por presunto delito sexual contra niños, niñas y adolescentes",2018,4,5,1259,397.14058776807,1,669,149.476831091181,4,590,677.966101694915
27541,85,85162,81,"Tasa de exámenes médico legales por presunto delito sexual contra niños, niñas y adolescentes",2018,2,2,1517,131.8391562294,1,770,129.87012987013,1,747,133.868808567604
27542,85,85162,81,"Tasa de exámenes médico legales por presunto delito sexual contra niños, niñas y adolescentes",2018,3,12,1782,673.400673400673,5,889,562.429696287964,7,893,783.874580067189
27543,85,85162,81,"Tasa de exámenes médico legales por presunto delito sexual contra niños, niñas y adolescentes",2018,4,5,1766,283.12570781427,1,867,115.340253748558,4,899,444.938820912125
27544,85,85162,121,Tasa de exámenes médico legales por presunto delito sexual cuando la víctima está entre 18 y 28 años,2018,5,1,2993,33.4112930170398,0,1438,0,1,1555,64.3086816720257
27545,85,85225,81,"Tasa de exámenes médico legales por presunto delito sexual contra niños, niñas y adolescentes",2018,3,1,1161,86.1326442721791,0,587,0,1,574,174.216027874564
27546,85,85225,81,"Tasa de exámenes médico legales por presunto delito sexual contra niños, niñas y adolescentes",2018,4,2,1061,188.501413760603,0,515,0,2,546,366.300366300366
27547,85,85230,81,"Tasa de exámenes médico legales por presunto delito sexual contra niños, niñas y adolescentes",2018,3,15,1182,1269.03553299492,2,605,330.578512396694,13,577,2253.03292894281
27548,85,85230,81,"Tasa de exámenes médico legales por presunto delito sexual contra niños, niñas y adolescentes",2018,4,8,1068,749.063670411985,0,559,0,8,509,1571.70923379175
27549,85,85250,81,"Tasa de exámenes médico legales por presunto delito sexual contra niños, niñas y adolescentes",2018,2,15,2825,530.973451327434,2,1439,138.985406532314,13,1386,937.950937950938
27550,85,85250,81,"Tasa de exámenes médico legales por presunto delito sexual contra niños, niñas y adolescentes",2018,3,29,3403,852.189244784014,11,1753,627.49572162008,18,1650,1090.90909090909
27551,85,85250,81,"Tasa de exámenes médico legales por presunto delito sexual contra niños, niñas y adolescentes",2018,4,32,3230,990.712074303406,6,1664,360.576923076923,26,1566,1660.2809706258
27552,85,85250,121,Tasa de exámenes médico legales por presunto delito sexual cuando la víctima está entre 18 y 28 años,2018,5,6,5107,117.485803798708,0,2536,0,6,2571,233.372228704784
27553,85,85263,81,"Tasa de exámenes médico legales por presunto delito sexual contra niños, niñas y adolescentes",2018,2,1,869,115.074798619102,0,448,0,1,421,237.529691211401
27554,85,85263,81,"Tasa de exámenes médico legales por presunto delito sexual contra niños, niñas y adolescentes",2018,3,4,953,419.727177334732,0,499,0,4,454,881.057268722467
27555,85,85263,81,"Tasa de exámenes médico legales por presunto delito sexual contra niños, niñas y adolescentes",2018,4,4,905,441.988950276243,0,474,0,4,431,928.074245939675
27556,85,85263,121,Tasa de exámenes médico legales por presunto delito sexual cuando la víctima está entre 18 y 28 años,2018,5,3,1637,183.262064752596,0,841,0,3,796,376.884422110553
27557,85,85279,81,"Tasa de exámenes médico legales por presunto delito sexual contra niños, niñas y adolescentes",2018,2,1,544,183.823529411765,0,279,0,1,265,377.358490566038
27558,85,85279,81,"Tasa de exámenes médico legales por presunto delito sexual contra niños, niñas y adolescentes",2018,4,1,564,177.304964539007,1,285,350.877192982456,0,279,0
27559,85,85300,81,"Tasa de exámenes médico legales por presunto delito sexual contra niños, niñas y adolescentes",2018,2,1,284,352.112676056338,0,145,0,1,139,719.424460431655
27560,85,85300,81,"Tasa de exámenes médico legales por presunto delito sexual contra niños, niñas y adolescentes",2018,3,2,334,598.802395209581,0,166,0,2,168,1190.47619047619
27561,85,85300,81,"Tasa de exámenes médico legales por presunto delito sexual contra niños, niñas y adolescentes",2018,4,5,320,1562.5,0,156,0,5,164,3048.78048780488
27562,85,85315,81,"Tasa de exámenes médico legales por presunto delito sexual contra niños, niñas y adolescentes",2018,3,1,268,373.134328358209,0,137,0,1,131,763.358778625954
27563,85,85315,81,"Tasa de exámenes médico legales por presunto delito sexual contra niños, niñas y adolescentes",2018,4,1,251,398.406374501992,0,129,0,1,122,819.672131147541
27564,85,85325,81,"Tasa de exámenes médico legales por presunto delito sexual contra niños, niñas y adolescentes",2018,3,1,961,104.058272632674,0,515,0,1,446,224.215246636771
27565,85,85325,81,"Tasa de exámenes médico legales por presunto delito sexual contra niños, niñas y adolescentes",2018,4,2,902,221.729490022173,1,492,203.252032520325,1,410,243.90243902439
27566,85,85400,81,"Tasa de exámenes médico legales por presunto delito sexual contra niños, niñas y adolescentes",2018,3,1,1001,99.9000999000999,0,506,0,1,495,202.020202020202
27567,85,85400,81,"Tasa de exámenes médico legales por presunto delito sexual contra niños, niñas y adolescentes",2018,4,2,857,233.372228704784,0,440,0,2,417,479.616306954436
27568,85,85410,81,"Tasa de exámenes médico legales por presunto delito sexual contra niños, niñas y adolescentes",2018,2,3,2333,128.589798542649,0,1178,0,3,1155,259.74025974026
27569,85,85410,81,"Tasa de exámenes médico legales por presunto delito sexual contra niños, niñas y adolescentes",2018,3,6,2798,214.438884917798,1,1399,71.4796283059328,5,1399,357.398141529664
27570,85,85410,81,"Tasa de exámenes médico legales por presunto delito sexual contra niños, niñas y adolescentes",2018,4,2,2625,76.1904761904762,0,1428,0,2,1197,167.084377610693
27571,85,85410,121,Tasa de exámenes médico legales por presunto delito sexual cuando la víctima está entre 18 y 28 años,2018,5,6,5571,107.700592353258,0,3223,0,6,2348,255.536626916525
27572,85,85430,81,"Tasa de exámenes médico legales por presunto delito sexual contra niños, niñas y adolescentes",2018,3,3,2083,144.02304368699,0,1038,0,3,1045,287.081339712919
27573,85,85430,81,"Tasa de exámenes médico legales por presunto delito sexual contra niños, niñas y adolescentes",2018,4,9,1988,452.71629778672,1,980,102.040816326531,8,1008,793.650793650794
27574,85,85440,81,"Tasa de exámenes médico legales por presunto delito sexual contra niños, niñas y adolescentes",2018,2,6,2436,246.305418719212,2,1248,160.25641025641,4,1188,336.700336700337
27575,85,85440,81,"Tasa de exámenes médico legales por presunto delito sexual contra niños, niñas y adolescentes",2018,3,11,2877,382.342718109141,4,1477,270.8192281652,7,1400,500
27576,85,85440,81,"Tasa de exámenes médico legales por presunto delito sexual contra niños, niñas y adolescentes",2018,4,7,2911,240.467193404328,0,1490,0,7,1421,492.610837438424
27577,85,85440,121,Tasa de exámenes médico legales por presunto delito sexual cuando la víctima está entre 18 y 28 años,2018,5,6,5104,117.554858934169,0,2547,0,6,2557,234.649980445835
27578,86,86001,81,"Tasa de exámenes médico legales por presunto delito sexual contra niños, niñas y adolescentes",2018,2,9,4365,206.185567010309,4,2253,177.541056369285,5,2112,236.742424242424
27579,86,86001,81,"Tasa de exámenes médico legales por presunto delito sexual contra niños, niñas y adolescentes",2018,3,13,5335,243.673851921275,0,2768,0,13,2567,506.427736657577
27580,86,86001,81,"Tasa de exámenes médico legales por presunto delito sexual contra niños, niñas y adolescentes",2018,4,26,5139,505.935006810664,1,2630,38.0228136882129,25,2509,996.412913511359
27581,86,86001,121,Tasa de exámenes médico legales por presunto delito sexual cuando la víctima está entre 18 y 28 años,2018,5,4,8837,45.2642299422881,0,4372,0,4,4465,89.5856662933931
27582,86,86219,81,"Tasa de exámenes médico legales por presunto delito sexual contra niños, niñas y adolescentes",2018,3,1,578,173.010380622837,0,296,0,1,282,354.609929078014
27583,86,86219,121,Tasa de exámenes médico legales por presunto delito sexual cuando la víctima está entre 18 y 28 años,2018,5,1,1191,83.9630562552477,0,594,0,1,597,167.50418760469
27584,86,86320,81,"Tasa de exámenes médico legales por presunto delito sexual contra niños, niñas y adolescentes",2018,2,3,7201,41.6608804332732,0,3654,0,3,3547,84.5785170566676
27585,86,86320,81,"Tasa de exámenes médico legales por presunto delito sexual contra niños, niñas y adolescentes",2018,3,9,7898,113.95289946822,2,3979,50.2638853983413,7,3919,178.616994131156
27586,86,86320,81,"Tasa de exámenes médico legales por presunto delito sexual contra niños, niñas y adolescentes",2018,4,8,7807,102.472140386832,1,4003,24.981264051961,7,3804,184.016824395373
27587,86,86320,121,Tasa de exámenes médico legales por presunto delito sexual cuando la víctima está entre 18 y 28 años,2018,5,3,12117,24.7586036147561,0,6221,0,3,5896,50.8819538670285
27588,86,86568,81,"Tasa de exámenes médico legales por presunto delito sexual contra niños, niñas y adolescentes",2018,2,2,6764,29.5683027794205,0,3435,0,2,3329,60.0781015319916
27589,86,86568,81,"Tasa de exámenes médico legales por presunto delito sexual contra niños, niñas y adolescentes",2018,3,14,8025,174.454828660436,1,4072,24.5579567779961,13,3953,328.864153807235
27590,86,86568,81,"Tasa de exámenes médico legales por presunto delito sexual contra niños, niñas y adolescentes",2018,4,16,7827,204.420595374984,2,3952,50.6072874493927,14,3875,361.290322580645
27591,86,86568,121,Tasa de exámenes médico legales por presunto delito sexual cuando la víctima está entre 18 y 28 años,2018,5,5,13109,38.1417346860935,0,6530,0,5,6579,75.999392004864
27592,86,86569,81,"Tasa de exámenes médico legales por presunto delito sexual contra niños, niñas y adolescentes",2018,2,1,1587,63.0119722747322,1,806,124.069478908189,0,781,0
27593,86,86569,81,"Tasa de exámenes médico legales por presunto delito sexual contra niños, niñas y adolescentes",2018,3,8,1818,440.04400440044,2,913,219.058050383352,6,905,662.983425414365
27594,86,86569,81,"Tasa de exámenes médico legales por presunto delito sexual contra niños, niñas y adolescentes",2018,4,5,1795,278.551532033426,1,897,111.482720178372,4,898,445.43429844098
27595,86,86571,81,"Tasa de exámenes médico legales por presunto delito sexual contra niños, niñas y adolescentes",2018,3,2,3280,60.9756097560976,0,1708,0,2,1572,127.226463104326
27596,86,86571,81,"Tasa de exámenes médico legales por presunto delito sexual contra niños, niñas y adolescentes",2018,4,2,3208,62.3441396508728,0,1682,0,2,1526,131.061598951507
27597,86,86571,121,Tasa de exámenes médico legales por presunto delito sexual cuando la víctima está entre 18 y 28 años,2018,5,2,5153,38.8123423248593,0,2680,0,2,2473,80.8734330772341
27598,86,86573,81,"Tasa de exámenes médico legales por presunto delito sexual contra niños, niñas y adolescentes",2018,2,2,1640,121.951219512195,0,839,0,2,801,249.687890137328
27599,86,86573,81,"Tasa de exámenes médico legales por presunto delito sexual contra niños, niñas y adolescentes",2018,3,5,1950,256.410256410256,1,1007,99.304865938431,4,943,424.178154825027
27600,86,86573,81,"Tasa de exámenes médico legales por presunto delito sexual contra niños, niñas y adolescentes",2018,4,10,1888,529.661016949153,1,976,102.459016393443,9,912,986.842105263158
27601,86,86573,121,Tasa de exámenes médico legales por presunto delito sexual cuando la víctima está entre 18 y 28 años,2018,5,1,3204,31.210986267166,0,1650,0,1,1554,64.3500643500643
27602,86,86749,81,"Tasa de exámenes médico legales por presunto delito sexual contra niños, niñas y adolescentes",2018,3,1,1529,65.402223675605,0,784,0,1,745,134.228187919463
27603,86,86749,81,"Tasa de exámenes médico legales por presunto delito sexual contra niños, niñas y adolescentes",2018,4,1,1526,65.5307994757536,0,767,0,1,759,131.752305665349
27604,86,86757,81,"Tasa de exámenes médico legales por presunto delito sexual contra niños, niñas y adolescentes",2018,2,2,3636,55.005500550055,0,1842,0,2,1794,111.482720178372
27605,86,86757,81,"Tasa de exámenes médico legales por presunto delito sexual contra niños, niñas y adolescentes",2018,3,11,3990,275.68922305764403,0,2003,0,11,1987,553.598389531958
27606,86,86757,81,"Tasa de exámenes médico legales por presunto delito sexual contra niños, niñas y adolescentes",2018,4,2,3922,50.9943906170321,1,1996,50.1002004008016,1,1926,51.9210799584631
27607,86,86760,81,"Tasa de exámenes médico legales por presunto delito sexual contra niños, niñas y adolescentes",2018,3,1,1240,80.6451612903226,0,625,0,1,615,162.60162601626
27608,86,86865,81,"Tasa de exámenes médico legales por presunto delito sexual contra niños, niñas y adolescentes",2018,2,5,5667,88.2301041115229,0,2890,0,5,2777,180.050414115952
27609,86,86865,81,"Tasa de exámenes médico legales por presunto delito sexual contra niños, niñas y adolescentes",2018,3,17,6518,260.816201288739,2,3333,60.00600060006,15,3185,470.957613814757
27610,86,86865,81,"Tasa de exámenes médico legales por presunto delito sexual contra niños, niñas y adolescentes",2018,4,19,6764,280.898876404494,0,3426,0,19,3338,569.203115638107
27611,86,86865,121,Tasa de exámenes médico legales por presunto delito sexual cuando la víctima está entre 18 y 28 años,2018,5,5,11326,44.1462122549885,0,5775,0,5,5551,90.0738605656638
27612,86,86885,81,"Tasa de exámenes médico legales por presunto delito sexual contra niños, niñas y adolescentes",2018,3,4,2639,151.572565365669,0,1326,0,4,1313,304.645849200305
27613,86,86885,81,"Tasa de exámenes médico legales por presunto delito sexual contra niños, niñas y adolescentes",2018,4,3,2608,115.030674846626,0,1302,0,3,1306,229.709035222052
27614,86,86885,121,Tasa de exámenes médico legales por presunto delito sexual cuando la víctima está entre 18 y 28 años,2018,5,2,4711,42.4538314582891,1,2358,42.4088210347752,1,2353,42.4989375265618
27615,88,88001,81,"Tasa de exámenes médico legales por presunto delito sexual contra niños, niñas y adolescentes",2018,2,5,5987,83.5142809420411,1,3065,32.626427406199,4,2922,136.892539356605
27616,88,88001,81,"Tasa de exámenes médico legales por presunto delito sexual contra niños, niñas y adolescentes",2018,3,2,7035,28.4292821606254,0,3596,0,2,3439,58.1564408258215
27617,88,88001,81,"Tasa de exámenes médico legales por presunto delito sexual contra niños, niñas y adolescentes",2018,4,12,7065,169.851380042463,1,3600,27.7777777777778,11,3465,317.460317460317
27618,88,88001,121,Tasa de exámenes médico legales por presunto delito sexual cuando la víctima está entre 18 y 28 años,2018,5,3,13414,22.3646936036976,0,6859,0,3,6555,45.766590389016
27619,88,88564,81,"Tasa de exámenes médico legales por presunto delito sexual contra niños, niñas y adolescentes",2018,3,1,485,206.185567010309,0,250,0,1,235,425.531914893617
27620,91,91001,81,"Tasa de exámenes médico legales por presunto delito sexual contra niños, niñas y adolescentes",2018,2,17,4820,352.697095435685,5,2475,202.020202020202,12,2345,511.727078891258
27621,91,91001,81,"Tasa de exámenes médico legales por presunto delito sexual contra niños, niñas y adolescentes",2018,3,30,5564,539.180445722502,3,2847,105.374077976818,27,2717,993.743099006257
27622,91,91001,81,"Tasa de exámenes médico legales por presunto delito sexual contra niños, niñas y adolescentes",2018,4,46,5310,866.290018832392,6,2686,223.380491437081,40,2624,1524.39024390244
27623,91,91001,121,Tasa de exámenes médico legales por presunto delito sexual cuando la víctima está entre 18 y 28 años,2018,5,8,9522,84.0159630329763,1,4710,21.2314225053079,7,4812,145.46965918537
27624,91,91263,81,"Tasa de exámenes médico legales por presunto delito sexual contra niños, niñas y adolescentes",2018,3,2,812,246.305418719212,0,382,0,2,430,465.116279069767
27625,91,91405,81,"Tasa de exámenes médico legales por presunto delito sexual contra niños, niñas y adolescentes",2018,2,1,572,174.825174825175,0,287,0,1,285,350.877192982456
27626,91,91405,81,"Tasa de exámenes médico legales por presunto delito sexual contra niños, niñas y adolescentes",2018,3,1,626,159.744408945687,0,312,0,1,314,318.471337579618
27627,91,91405,81,"Tasa de exámenes médico legales por presunto delito sexual contra niños, niñas y adolescentes",2018,4,1,563,177.619893428064,0,288,0,1,275,363.636363636364
27628,91,91407,81,"Tasa de exámenes médico legales por presunto delito sexual contra niños, niñas y adolescentes",2018,4,1,801,124.843945068664,0,401,0,1,400,250
27629,91,91460,81,"Tasa de exámenes médico legales por presunto delito sexual contra niños, niñas y adolescentes",2018,2,1,209,478.468899521531,0,106,0,1,103,970.873786407767
27630,91,91536,81,"Tasa de exámenes médico legales por presunto delito sexual contra niños, niñas y adolescentes",2018,4,1,199,502.51256281407,0,95,0,1,104,961.538461538462
27631,91,91540,81,"Tasa de exámenes médico legales por presunto delito sexual contra niños, niñas y adolescentes",2018,3,1,1347,74.2390497401633,0,687,0,1,660,151.515151515152
27632,94,94001,81,"Tasa de exámenes médico legales por presunto delito sexual contra niños, niñas y adolescentes",2018,2,6,2373,252.844500632111,0,1231,0,6,1142,525.394045534151
27633,94,94001,81,"Tasa de exámenes médico legales por presunto delito sexual contra niños, niñas y adolescentes",2018,3,6,2727,220.02200220022,2,1409,141.94464158978,4,1318,303.490136570561
27634,94,94001,81,"Tasa de exámenes médico legales por presunto delito sexual contra niños, niñas y adolescentes",2018,4,21,2634,797.266514806378,1,1354,73.8552437223043,20,1280,1562.5
27635,94,94001,121,Tasa de exámenes médico legales por presunto delito sexual cuando la víctima está entre 18 y 28 años,2018,5,3,4846,61.9067271976888,0,2473,0,3,2373,126.422250316056
27636,94,94343,81,"Tasa de exámenes médico legales por presunto delito sexual contra niños, niñas y adolescentes",2018,4,4,669,597.907324364724,0,355,0,4,314,1273.88535031847
27637,94,94885,81,"Tasa de exámenes médico legales por presunto delito sexual contra niños, niñas y adolescentes",2018,4,1,63,1587.30158730159,0,37,0,1,26,3846.15384615385
27638,94,94887,81,"Tasa de exámenes médico legales por presunto delito sexual contra niños, niñas y adolescentes",2018,4,1,535,186.915887850467,0,254,0,1,281,355.871886120996
27639,95,95001,81,"Tasa de exámenes médico legales por presunto delito sexual contra niños, niñas y adolescentes",2018,2,4,8903,44.9286757272829,1,4557,21.944261575598,3,4346,69.0289921767142
27640,95,95001,81,"Tasa de exámenes médico legales por presunto delito sexual contra niños, niñas y adolescentes",2018,3,6,10169,59.0028518045039,4,5178,77.2499034376207,2,4991,40.0721298337007
27641,95,95001,81,"Tasa de exámenes médico legales por presunto delito sexual contra niños, niñas y adolescentes",2018,4,5,8963,55.7848934508535,0,4516,0,5,4447,112.435349673937
27642,95,95015,81,"Tasa de exámenes médico legales por presunto delito sexual contra niños, niñas y adolescentes",2018,2,1,1207,82.8500414250207,0,631,0,1,576,173.611111111111
27643,95,95015,81,"Tasa de exámenes médico legales por presunto delito sexual contra niños, niñas y adolescentes",2018,3,3,1163,257.953568357696,0,619,0,3,544,551.470588235294
27644,95,95015,81,"Tasa de exámenes médico legales por presunto delito sexual contra niños, niñas y adolescentes",2018,4,1,1027,97.3709834469328,1,555,180.18018018018,0,472,0
27645,95,95025,81,"Tasa de exámenes médico legales por presunto delito sexual contra niños, niñas y adolescentes",2018,3,1,3546,28.2007896221094,0,1741,0,1,1805,55.4016620498615
27646,95,95025,121,Tasa de exámenes médico legales por presunto delito sexual cuando la víctima está entre 18 y 28 años,2018,5,1,5449,18.3519911910442,0,2672,0,1,2777,36.0100828231905
27647,95,95200,81,"Tasa de exámenes médico legales por presunto delito sexual contra niños, niñas y adolescentes",2018,3,2,1634,122.399020807834,1,844,118.483412322275,1,790,126.582278481013
27648,95,95200,81,"Tasa de exámenes médico legales por presunto delito sexual contra niños, niñas y adolescentes",2018,4,2,1631,122.624156958921,0,847,0,2,784,255.102040816327
27649,97,97511,121,Tasa de exámenes médico legales por presunto delito sexual cuando la víctima está entre 18 y 28 años,2018,5,1,1529,65.402223675605,0,748,0,1,781,128.040973111396
27650,99,99001,81,"Tasa de exámenes médico legales por presunto delito sexual contra niños, niñas y adolescentes",2018,4,1,2239,44.6627958910228,0,1211,0,1,1028,97.2762645914397
27651,99,99524,81,"Tasa de exámenes médico legales por presunto delito sexual contra niños, niñas y adolescentes",2018,2,1,2146,46.5983224603914,0,1103,0,1,1043,95.8772770853308
27652,99,99524,81,"Tasa de exámenes médico legales por presunto delito sexual contra niños, niñas y adolescentes",2018,3,1,2458,40.6834825061025,0,1268,0,1,1190,84.0336134453782
27653,99,99524,81,"Tasa de exámenes médico legales por presunto delito sexual contra niños, niñas y adolescentes",2018,4,4,2137,187.178287318671,1,1093,91.4913083257091,3,1044,287.35632183908
27654,99,99624,81,"Tasa de exámenes médico legales por presunto delito sexual contra niños, niñas y adolescentes",2018,3,1,648,154.320987654321,0,341,0,1,307,325.732899022801
27655,99,99624,81,"Tasa de exámenes médico legales por presunto delito sexual contra niños, niñas y adolescentes",2018,4,1,557,179.533213644524,0,289,0,1,268,373.134328358209
27656,99,99773,81,"Tasa de exámenes médico legales por presunto delito sexual contra niños, niñas y adolescentes",2018,4,1,5713,17.5039383861369,0,2868,0,1,2845,35.1493848857645
