id,cdep,cmun,cindica,nomind,periodo,edadR,casos,poblacion,tasa,casosh,poblacionh,tasah,casosm,poblacionm,tasam
22860,11,11001,81,"Tasa de exámenes médico legales por presunto delito sexual contra niños, niñas y adolescentes",2017,2,690,606238,113.81668585605,164,311419,52.662168974918,526,294819,178.414552657732
22861,11,11001,81,"Tasa de exámenes médico legales por presunto delito sexual contra niños, niñas y adolescentes",2017,3,1163,720636,161.385220832709,221,369715,59.7757732307318,942,350921,268.43648570476
22862,11,11001,81,"Tasa de exámenes médico legales por presunto delito sexual contra niños, niñas y adolescentes",2017,4,1681,737316,227.989084734361,172,376018,45.7424910509603,1509,361298,417.660767565832
22863,11,11001,121,Tasa de exámenes médico legales por presunto delito sexual cuando la víctima está entre 18 y 28 años,2017,5,429,1452213,29.5411210338979,33,735175,4.48872717380216,396,717038,55.2271985585143
22864,11,11001,81,"Tasa de exámenes médico legales por presunto delito sexual contra niños, niñas y adolescentes",2017,1,5,122078,4.09574206654762,2,62733,3.18811470836721,3,59345,5.05518577807734
22865,13,13001,81,"Tasa de exámenes médico legales por presunto delito sexual contra niños, niñas y adolescentes",2017,2,70,81991,85.3752241099633,22,41841,52.5800052580005,48,40150,119.551681195517
22866,13,13001,81,"Tasa de exámenes médico legales por presunto delito sexual contra niños, niñas y adolescentes",2017,3,161,103271,155.900494814614,26,52379,49.6382137879685,135,50892,265.267625560009
22867,13,13001,81,"Tasa de exámenes médico legales por presunto delito sexual contra niños, niñas y adolescentes",2017,4,242,109556,220.891598817043,17,54955,30.9344008734419,225,54601,412.080364828483
22868,13,13001,121,Tasa de exámenes médico legales por presunto delito sexual cuando la víctima está entre 18 y 28 años,2017,5,51,195735,26.0556364472373,1,98835,1.01178732230485,50,96900,51.5995872033024
22869,13,13001,81,"Tasa de exámenes médico legales por presunto delito sexual contra niños, niñas y adolescentes",2017,1,1,16081,6.21851874883403,1,8192,12.20703125,0,7889,0
22870,13,13006,81,"Tasa de exámenes médico legales por presunto delito sexual contra niños, niñas y adolescentes",2017,4,1,2664,37.5375375375375,0,1367,0,1,1297,77.1010023130301
22871,13,13030,81,"Tasa de exámenes médico legales por presunto delito sexual contra niños, niñas y adolescentes",2017,2,1,1547,64.6412411118293,0,796,0,1,751,133.155792276964
22872,13,13030,81,"Tasa de exámenes médico legales por presunto delito sexual contra niños, niñas y adolescentes",2017,4,1,1558,64.1848523748395,0,815,0,1,743,134.589502018843
22873,13,13030,121,Tasa de exámenes médico legales por presunto delito sexual cuando la víctima está entre 18 y 28 años,2017,5,1,2727,36.6703337000367,0,1455,0,1,1272,78.6163522012579
22874,13,13042,81,"Tasa de exámenes médico legales por presunto delito sexual contra niños, niñas y adolescentes",2017,4,1,2583,38.7146728610143,0,1377,0,1,1206,82.9187396351576
22875,13,13052,81,"Tasa de exámenes médico legales por presunto delito sexual contra niños, niñas y adolescentes",2017,2,5,7526,66.436353972894,1,3849,25.980774227072,4,3677,108.784335055752
22876,13,13052,81,"Tasa de exámenes médico legales por presunto delito sexual contra niños, niñas y adolescentes",2017,3,7,9033,77.4936344514558,1,4594,21.767522855899,6,4439,135.165577832845
22877,13,13052,81,"Tasa de exámenes médico legales por presunto delito sexual contra niños, niñas y adolescentes",2017,4,15,9036,166.002656042497,1,4598,21.7485863418878,14,4438,315.457413249211
22878,13,13052,121,Tasa de exámenes médico legales por presunto delito sexual cuando la víctima está entre 18 y 28 años,2017,5,4,14975,26.7111853088481,0,7888,0,4,7087,56.4413715253281
22879,13,13062,81,"Tasa de exámenes médico legales por presunto delito sexual contra niños, niñas y adolescentes",2017,3,2,1277,156.617071260767,0,687,0,2,590,338.983050847458
22880,13,13074,81,"Tasa de exámenes médico legales por presunto delito sexual contra niños, niñas y adolescentes",2017,3,1,2589,38.6249517188104,0,1310,0,1,1279,78.1860828772479
22881,13,13074,81,"Tasa de exámenes médico legales por presunto delito sexual contra niños, niñas y adolescentes",2017,4,2,2342,85.397096498719,0,1192,0,2,1150,173.913043478261
22882,13,13074,121,Tasa de exámenes médico legales por presunto delito sexual cuando la víctima está entre 18 y 28 años,2017,5,1,3844,26.0145681581686,0,2074,0,1,1770,56.4971751412429
22883,13,13140,81,"Tasa de exámenes médico legales por presunto delito sexual contra niños, niñas y adolescentes",2017,3,1,3009,33.2336324360253,0,1618,0,1,1391,71.8907260963336
22884,13,13140,81,"Tasa de exámenes médico legales por presunto delito sexual contra niños, niñas y adolescentes",2017,4,6,2944,203.804347826087,0,1579,0,6,1365,439.56043956044
22885,13,13140,121,Tasa de exámenes médico legales por presunto delito sexual cuando la víctima está entre 18 y 28 años,2017,5,1,4721,21.1819529760644,0,2513,0,1,2208,45.2898550724638
22886,13,13188,81,"Tasa de exámenes médico legales por presunto delito sexual contra niños, niñas y adolescentes",2017,2,1,1156,86.5051903114187,1,592,168.918918918919,0,564,0
22887,13,13188,81,"Tasa de exámenes médico legales por presunto delito sexual contra niños, niñas y adolescentes",2017,3,1,1345,74.3494423791822,0,690,0,1,655,152.671755725191
22888,13,13188,81,"Tasa de exámenes médico legales por presunto delito sexual contra niños, niñas y adolescentes",2017,4,5,1303,383.729854182655,0,669,0,5,634,788.643533123028
22889,13,13212,81,"Tasa de exámenes médico legales por presunto delito sexual contra niños, niñas y adolescentes",2017,2,1,1525,65.5737704918033,0,785,0,1,740,135.135135135135
22890,13,13212,81,"Tasa de exámenes médico legales por presunto delito sexual contra niños, niñas y adolescentes",2017,3,1,1620,61.7283950617284,0,842,0,1,778,128.53470437018
22891,13,13212,81,"Tasa de exámenes médico legales por presunto delito sexual contra niños, niñas y adolescentes",2017,4,3,1509,198.807157057654,0,785,0,3,724,414.364640883978
22892,13,13222,81,"Tasa de exámenes médico legales por presunto delito sexual contra niños, niñas y adolescentes",2017,2,1,1485,67.340067340067307,0,769,0,1,716,139.664804469274
22893,13,13222,81,"Tasa de exámenes médico legales por presunto delito sexual contra niños, niñas y adolescentes",2017,3,2,1653,120.992135511192,1,873,114.54753722795,1,780,128.205128205128
22894,13,13222,81,"Tasa de exámenes médico legales por presunto delito sexual contra niños, niñas y adolescentes",2017,4,5,1623,308.071472581639,1,868,115.207373271889,4,755,529.801324503311
22895,13,13244,81,"Tasa de exámenes médico legales por presunto delito sexual contra niños, niñas y adolescentes",2017,2,7,9316,75.1395448690425,3,4756,63.0782169890664,4,4560,87.719298245614
22896,13,13244,81,"Tasa de exámenes médico legales por presunto delito sexual contra niños, niñas y adolescentes",2017,3,14,10162,137.768155874828,2,5279,37.8859632506156,12,4883,245.750563178374
22897,13,13244,81,"Tasa de exámenes médico legales por presunto delito sexual contra niños, niñas y adolescentes",2017,4,21,9351,224.574911774142,1,4870,20.5338809034908,20,4481,446.328944432046
22898,13,13244,121,Tasa de exámenes médico legales por presunto delito sexual cuando la víctima está entre 18 y 28 años,2017,5,6,15535,38.6224654007081,1,8141,12.2835032551284,5,7394,67.6223965377333
22899,13,13248,81,"Tasa de exámenes médico legales por presunto delito sexual contra niños, niñas y adolescentes",2017,3,1,833,120.048019207683,0,434,0,1,399,250.62656641604
22900,13,13268,81,"Tasa de exámenes médico legales por presunto delito sexual contra niños, niñas y adolescentes",2017,2,1,1251,79.9360511590727,0,642,0,1,609,164.203612479475
22901,13,13268,81,"Tasa de exámenes médico legales por presunto delito sexual contra niños, niñas y adolescentes",2017,3,7,1306,535.987748851455,0,679,0,7,627,1116.42743221691
22902,13,13268,81,"Tasa de exámenes médico legales por presunto delito sexual contra niños, niñas y adolescentes",2017,4,1,1211,82.5763831544178,0,648,0,1,563,177.619893428064
22903,13,13268,121,Tasa de exámenes médico legales por presunto delito sexual cuando la víctima está entre 18 y 28 años,2017,5,1,2072,48.2625482625483,0,1128,0,1,944,105.932203389831
22904,13,13300,81,"Tasa de exámenes médico legales por presunto delito sexual contra niños, niñas y adolescentes",2017,3,1,1719,58.173356602676,0,896,0,1,823,121.506682867558
22905,13,13300,81,"Tasa de exámenes médico legales por presunto delito sexual contra niños, niñas y adolescentes",2017,4,2,1525,131.147540983607,1,809,123.609394313968,1,716,139.664804469274
22906,13,13430,81,"Tasa de exámenes médico legales por presunto delito sexual contra niños, niñas y adolescentes",2017,2,16,12628,126.702565726956,3,6471,46.3606861381548,13,6157,211.141789832711
22907,13,13430,81,"Tasa de exámenes médico legales por presunto delito sexual contra niños, niñas y adolescentes",2017,3,30,14570,205.902539464653,8,7478,106.980476063118,22,7092,310.208685843204
22908,13,13430,81,"Tasa de exámenes médico legales por presunto delito sexual contra niños, niñas y adolescentes",2017,4,35,13843,252.835368056057,4,7103,56.3142334224975,31,6740,459.940652818991
22909,13,13430,121,Tasa de exámenes médico legales por presunto delito sexual cuando la víctima está entre 18 y 28 años,2017,5,7,24087,29.0613193839,1,12326,8.11293201362973,6,11761,51.0160700620696
22910,13,13430,81,"Tasa de exámenes médico legales por presunto delito sexual contra niños, niñas y adolescentes",2017,1,1,2537,39.4166338194718,0,1296,0,1,1241,80.58017727639
22911,13,13433,81,"Tasa de exámenes médico legales por presunto delito sexual contra niños, niñas y adolescentes",2017,4,7,2869,243.987452073893,0,1472,0,7,1397,501.073729420186
22912,13,13433,121,Tasa de exámenes médico legales por presunto delito sexual cuando la víctima está entre 18 y 28 años,2017,5,1,4858,20.5846027171676,0,2545,0,1,2313,43.2338953739732
22913,13,13440,81,"Tasa de exámenes médico legales por presunto delito sexual contra niños, niñas y adolescentes",2017,3,1,1264,79.1139240506329,0,644,0,1,620,161.290322580645
22914,13,13440,81,"Tasa de exámenes médico legales por presunto delito sexual contra niños, niñas y adolescentes",2017,4,3,1198,250.417362270451,0,608,0,3,590,508.474576271186
22915,13,13442,81,"Tasa de exámenes médico legales por presunto delito sexual contra niños, niñas y adolescentes",2017,2,1,5794,17.2592336900242,0,2977,0,1,2817,35.498757543486
22916,13,13442,81,"Tasa de exámenes médico legales por presunto delito sexual contra niños, niñas y adolescentes",2017,3,3,6278,47.7859190825104,2,3265,61.2557427258806,1,3013,33.1895121141719
22917,13,13442,81,"Tasa de exámenes médico legales por presunto delito sexual contra niños, niñas y adolescentes",2017,4,19,5839,325.398184620654,0,3051,0,19,2788,681.492109038737
22918,13,13442,121,Tasa de exámenes médico legales por presunto delito sexual cuando la víctima está entre 18 y 28 años,2017,5,4,9826,40.7083248524323,0,5125,0,4,4701,85.0882790895554
22919,13,13468,81,"Tasa de exámenes médico legales por presunto delito sexual contra niños, niñas y adolescentes",2017,2,1,5065,19.7433366238894,0,2586,0,1,2479,40.3388463089956
22920,13,13468,81,"Tasa de exámenes médico legales por presunto delito sexual contra niños, niñas y adolescentes",2017,3,4,5639,70.9345628657563,0,2878,0,4,2761,144.875045273452
22921,13,13468,81,"Tasa de exámenes médico legales por presunto delito sexual contra niños, niñas y adolescentes",2017,4,6,5326,112.654900488171,0,2690,0,6,2636,227.617602427921
22922,13,13473,81,"Tasa de exámenes médico legales por presunto delito sexual contra niños, niñas y adolescentes",2017,3,2,2813,71.0984713828653,0,1442,0,2,1371,145.878920495988
22923,13,13473,81,"Tasa de exámenes médico legales por presunto delito sexual contra niños, niñas y adolescentes",2017,4,1,2652,37.7073906485671,0,1367,0,1,1285,77.8210116731518
22924,13,13549,81,"Tasa de exámenes médico legales por presunto delito sexual contra niños, niñas y adolescentes",2017,3,1,3598,27.7932184546971,0,1865,0,1,1733,57.7034045008655
22925,13,13549,81,"Tasa de exámenes médico legales por presunto delito sexual contra niños, niñas y adolescentes",2017,4,1,3155,31.6957210776545,0,1662,0,1,1493,66.9792364367046
22926,13,13549,121,Tasa de exámenes médico legales por presunto delito sexual cuando la víctima está entre 18 y 28 años,2017,5,1,5115,19.5503421309873,0,2774,0,1,2341,42.7167876975651
22927,13,13600,81,"Tasa de exámenes médico legales por presunto delito sexual contra niños, niñas y adolescentes",2017,4,4,2344,170.648464163823,0,1185,0,4,1159,345.125107851596
22928,13,13620,81,"Tasa de exámenes médico legales por presunto delito sexual contra niños, niñas y adolescentes",2017,4,2,688,290.697674418605,0,360,0,2,328,609.756097560976
22929,13,13647,81,"Tasa de exámenes médico legales por presunto delito sexual contra niños, niñas y adolescentes",2017,3,2,2116,94.5179584120983,0,1068,0,2,1048,190.839694656489
22930,13,13650,81,"Tasa de exámenes médico legales por presunto delito sexual contra niños, niñas y adolescentes",2017,4,1,1632,61.2745098039216,1,856,116.822429906542,0,776,0
22931,13,13654,81,"Tasa de exámenes médico legales por presunto delito sexual contra niños, niñas y adolescentes",2017,2,1,2100,47.6190476190476,0,1076,0,1,1024,97.65625
22932,13,13654,81,"Tasa de exámenes médico legales por presunto delito sexual contra niños, niñas y adolescentes",2017,3,2,2292,87.260034904014,1,1188,84.1750841750842,1,1104,90.5797101449275
22933,13,13654,81,"Tasa de exámenes médico legales por presunto delito sexual contra niños, niñas y adolescentes",2017,4,6,2290,262.008733624454,1,1189,84.1042893187552,5,1101,454.132606721163
22934,13,13654,121,Tasa de exámenes médico legales por presunto delito sexual cuando la víctima está entre 18 y 28 años,2017,5,1,4328,23.1053604436229,0,2235,0,1,2093,47.7783086478739
22935,13,13655,81,"Tasa de exámenes médico legales por presunto delito sexual contra niños, niñas y adolescentes",2017,1,1,360,277.777777777778,0,183,0,1,177,564.971751412429
22936,13,13657,81,"Tasa de exámenes médico legales por presunto delito sexual contra niños, niñas y adolescentes",2017,2,1,3233,30.9310238168883,0,1647,0,1,1586,63.0517023959647
22937,13,13657,81,"Tasa de exámenes médico legales por presunto delito sexual contra niños, niñas y adolescentes",2017,3,1,3707,26.9759913676828,0,1923,0,1,1784,56.0538116591928
22938,13,13657,81,"Tasa de exámenes médico legales por presunto delito sexual contra niños, niñas y adolescentes",2017,4,6,3612,166.112956810631,0,1852,0,6,1760,340.909090909091
22939,13,13667,81,"Tasa de exámenes médico legales por presunto delito sexual contra niños, niñas y adolescentes",2017,2,2,2428,82.3723228995058,1,1229,81.366965012205,1,1199,83.4028356964137
22940,13,13667,81,"Tasa de exámenes médico legales por presunto delito sexual contra niños, niñas y adolescentes",2017,4,7,2190,319.634703196347,0,1110,0,7,1080,648.148148148148
22941,13,13667,121,Tasa de exámenes médico legales por presunto delito sexual cuando la víctima está entre 18 y 28 años,2017,5,2,3765,53.1208499335989,0,1916,0,2,1849,108.166576527853
22942,13,13670,81,"Tasa de exámenes médico legales por presunto delito sexual contra niños, niñas y adolescentes",2017,4,1,4070,24.5700245700246,0,1952,0,1,2118,47.2143531633617
22943,13,13673,81,"Tasa de exámenes médico legales por presunto delito sexual contra niños, niñas y adolescentes",2017,2,1,1535,65.1465798045603,0,776,0,1,759,131.752305665349
22944,13,13673,81,"Tasa de exámenes médico legales por presunto delito sexual contra niños, niñas y adolescentes",2017,3,1,1726,57.9374275782155,0,873,0,1,853,117.233294255569
22945,13,13673,81,"Tasa de exámenes médico legales por presunto delito sexual contra niños, niñas y adolescentes",2017,4,3,1554,193.050193050193,0,794,0,3,760,394.736842105263
22946,13,13683,81,"Tasa de exámenes médico legales por presunto delito sexual contra niños, niñas y adolescentes",2017,2,1,2584,38.6996904024768,0,1322,0,1,1262,79.2393026941363
22947,13,13683,81,"Tasa de exámenes médico legales por presunto delito sexual contra niños, niñas y adolescentes",2017,3,4,2998,133.422281521014,0,1542,0,4,1456,274.725274725275
22948,13,13683,81,"Tasa de exámenes médico legales por presunto delito sexual contra niños, niñas y adolescentes",2017,4,4,2923,136.84570646596,0,1507,0,4,1416,282.485875706215
22949,13,13683,121,Tasa de exámenes médico legales por presunto delito sexual cuando la víctima está entre 18 y 28 años,2017,5,3,4630,64.7948164146868,0,2440,0,3,2190,136.986301369863
22950,13,13744,81,"Tasa de exámenes médico legales por presunto delito sexual contra niños, niñas y adolescentes",2017,2,1,2636,37.9362670713202,0,1341,0,1,1295,77.2200772200772
22951,13,13760,81,"Tasa de exámenes médico legales por presunto delito sexual contra niños, niñas y adolescentes",2017,4,1,908,110.132158590308,0,460,0,1,448,223.214285714286
22952,13,13780,81,"Tasa de exámenes médico legales por presunto delito sexual contra niños, niñas y adolescentes",2017,2,1,1327,75.3579502637528,0,687,0,1,640,156.25
22953,13,13780,81,"Tasa de exámenes médico legales por presunto delito sexual contra niños, niñas y adolescentes",2017,3,1,1540,64.9350649350649,1,809,123.609394313968,0,731,0
22954,13,13810,81,"Tasa de exámenes médico legales por presunto delito sexual contra niños, niñas y adolescentes",2017,2,1,3333,30.00300030003,0,1701,0,1,1632,61.2745098039216
22955,13,13810,81,"Tasa de exámenes médico legales por presunto delito sexual contra niños, niñas y adolescentes",2017,3,3,3330,90.0900900900901,0,1692,0,3,1638,183.150183150183
22956,13,13810,121,Tasa de exámenes médico legales por presunto delito sexual cuando la víctima está entre 18 y 28 años,2017,5,2,4785,41.7972831765935,1,2577,38.8048117966628,1,2208,45.2898550724638
22957,13,13836,81,"Tasa de exámenes médico legales por presunto delito sexual contra niños, niñas y adolescentes",2017,2,4,6237,64.1333974667308,2,3190,62.6959247648903,2,3047,65.6383327863472
22958,13,13836,81,"Tasa de exámenes médico legales por presunto delito sexual contra niños, niñas y adolescentes",2017,3,14,7544,185.577942735949,4,3846,104.004160166407,10,3698,270.416441319632
22959,13,13836,81,"Tasa de exámenes médico legales por presunto delito sexual contra niños, niñas y adolescentes",2017,4,27,7964,339.025615268709,3,4029,74.4601638123604,24,3935,609.911054637865
22960,13,13836,121,Tasa de exámenes médico legales por presunto delito sexual cuando la víctima está entre 18 y 28 años,2017,5,2,14300,13.986013986014,0,7321,0,2,6979,28.6574007737498
22961,13,13838,81,"Tasa de exámenes médico legales por presunto delito sexual contra niños, niñas y adolescentes",2017,2,2,1668,119.904076738609,1,854,117.096018735363,1,814,122.850122850123
22962,13,13838,81,"Tasa de exámenes médico legales por presunto delito sexual contra niños, niñas y adolescentes",2017,3,1,2028,49.3096646942801,0,1042,0,1,986,101.419878296146
22963,13,13838,81,"Tasa de exámenes médico legales por presunto delito sexual contra niños, niñas y adolescentes",2017,4,4,1948,205.338809034908,0,1004,0,4,944,423.728813559322
22964,13,13873,81,"Tasa de exámenes médico legales por presunto delito sexual contra niños, niñas y adolescentes",2017,2,3,2033,147.56517461879,1,1040,96.1538461538462,2,993,201.409869083585
22965,13,13873,81,"Tasa de exámenes médico legales por presunto delito sexual contra niños, niñas y adolescentes",2017,3,4,2383,167.855644146034,0,1214,0,4,1169,342.172797262618
22966,13,13873,81,"Tasa de exámenes médico legales por presunto delito sexual contra niños, niñas y adolescentes",2017,4,6,2340,256.410256410256,1,1190,84.0336134453782,5,1150,434.782608695652
22967,13,13873,121,Tasa de exámenes médico legales por presunto delito sexual cuando la víctima está entre 18 y 28 años,2017,5,1,3870,25.8397932816537,0,1966,0,1,1904,52.5210084033613
22968,13,13894,81,"Tasa de exámenes médico legales por presunto delito sexual contra niños, niñas y adolescentes",2017,2,1,1363,73.3675715333822,0,698,0,1,665,150.375939849624
22969,13,13894,81,"Tasa de exámenes médico legales por presunto delito sexual contra niños, niñas y adolescentes",2017,3,2,1442,138.69625520111,0,751,0,2,691,289.435600578871
22970,13,13894,81,"Tasa de exámenes médico legales por presunto delito sexual contra niños, niñas y adolescentes",2017,4,1,1330,75.187969924812,0,699,0,1,631,158.478605388273
22971,15,15001,81,"Tasa de exámenes médico legales por presunto delito sexual contra niños, niñas y adolescentes",2017,2,26,14555,178.632772243215,9,7441,120.951485015455,17,7114,238.965420298004
22972,15,15001,81,"Tasa de exámenes médico legales por presunto delito sexual contra niños, niñas y adolescentes",2017,3,36,19474,184.861867104858,7,9833,71.1888538594529,29,9641,300.798672336895
22973,15,15001,81,"Tasa de exámenes médico legales por presunto delito sexual contra niños, niñas y adolescentes",2017,4,43,21626,198.834735965967,5,10874,45.9812396542211,38,10752,353.422619047619
22974,15,15001,121,Tasa de exámenes médico legales por presunto delito sexual cuando la víctima está entre 18 y 28 años,2017,5,14,35393,39.5558443760066,2,18443,10.8442227403351,12,16950,70.7964601769911
22975,15,15022,81,"Tasa de exámenes médico legales por presunto delito sexual contra niños, niñas y adolescentes",2017,3,2,166,1204.81927710843,0,85,0,2,81,2469.13580246914
22976,15,15022,81,"Tasa de exámenes médico legales por presunto delito sexual contra niños, niñas y adolescentes",2017,4,1,159,628.930817610063,0,80,0,1,79,1265.82278481013
22977,15,15047,81,"Tasa de exámenes médico legales por presunto delito sexual contra niños, niñas y adolescentes",2017,3,1,1872,53.4188034188034,0,963,0,1,909,110.01100110011
22978,15,15087,81,"Tasa de exámenes médico legales por presunto delito sexual contra niños, niñas y adolescentes",2017,3,1,711,140.646976090014,0,367,0,1,344,290.697674418605
22979,15,15087,81,"Tasa de exámenes médico legales por presunto delito sexual contra niños, niñas y adolescentes",2017,4,2,710,281.69014084507,0,369,0,2,341,586.510263929619
22980,15,15090,81,"Tasa de exámenes médico legales por presunto delito sexual contra niños, niñas y adolescentes",2017,4,1,265,377.358490566038,1,139,719.424460431655,0,126,0
22981,15,15104,81,"Tasa de exámenes médico legales por presunto delito sexual contra niños, niñas y adolescentes",2017,4,1,487,205.338809034908,0,252,0,1,235,425.531914893617
22982,15,15109,81,"Tasa de exámenes médico legales por presunto delito sexual contra niños, niñas y adolescentes",2017,4,1,631,158.478605388273,0,341,0,1,290,344.827586206897
22983,15,15131,81,"Tasa de exámenes médico legales por presunto delito sexual contra niños, niñas y adolescentes",2017,4,1,343,291.545189504373,0,179,0,1,164,609.756097560976
22984,15,15162,81,"Tasa de exámenes médico legales por presunto delito sexual contra niños, niñas y adolescentes",2017,4,4,352,1136.36363636364,0,188,0,4,164,2439.0243902439
22985,15,15162,121,Tasa de exámenes médico legales por presunto delito sexual cuando la víctima está entre 18 y 28 años,2017,5,1,553,180.831826401447,0,302,0,1,251,398.406374501992
22986,15,15172,81,"Tasa de exámenes médico legales por presunto delito sexual contra niños, niñas y adolescentes",2017,4,2,342,584.795321637427,0,178,0,2,164,1219.51219512195
22987,15,15176,81,"Tasa de exámenes médico legales por presunto delito sexual contra niños, niñas y adolescentes",2017,2,2,5657,35.3544281421248,1,2897,34.5184673800483,1,2760,36.231884057971
22988,15,15176,81,"Tasa de exámenes médico legales por presunto delito sexual contra niños, niñas y adolescentes",2017,3,11,7506,146.549427124967,1,3921,25.5036980362153,10,3585,278.940027894003
22989,15,15176,81,"Tasa de exámenes médico legales por presunto delito sexual contra niños, niñas y adolescentes",2017,4,18,8011,224.691049806516,1,4231,23.6350744504845,17,3780,449.73544973545
22990,15,15176,121,Tasa de exámenes médico legales por presunto delito sexual cuando la víctima está entre 18 y 28 años,2017,5,4,12399,32.2606661827567,1,6615,15.1171579743008,3,5784,51.8672199170124
22991,15,15183,81,"Tasa de exámenes médico legales por presunto delito sexual contra niños, niñas y adolescentes",2017,2,1,1094,91.4076782449726,0,565,0,1,529,189.035916824197
22992,15,15185,81,"Tasa de exámenes médico legales por presunto delito sexual contra niños, niñas y adolescentes",2017,3,1,563,177.619893428064,0,304,0,1,259,386.100386100386
22993,15,15187,81,"Tasa de exámenes médico legales por presunto delito sexual contra niños, niñas y adolescentes",2017,4,2,738,271.0027100271,0,390,0,2,348,574.712643678161
22994,15,15204,81,"Tasa de exámenes médico legales por presunto delito sexual contra niños, niñas y adolescentes",2017,3,2,1085,184.331797235023,0,553,0,2,532,375.93984962406
22995,15,15204,121,Tasa de exámenes médico legales por presunto delito sexual cuando la víctima está entre 18 y 28 años,2017,5,2,2187,91.4494741655235,0,1379,0,2,808,247.524752475248
22996,15,15212,81,"Tasa de exámenes médico legales por presunto delito sexual contra niños, niñas y adolescentes",2017,3,1,391,255.754475703325,0,211,0,1,180,555.555555555556
22997,15,15212,81,"Tasa de exámenes médico legales por presunto delito sexual contra niños, niñas y adolescentes",2017,4,1,377,265.25198938992,0,209,0,1,168,595.238095238095
22998,15,15215,81,"Tasa de exámenes médico legales por presunto delito sexual contra niños, niñas y adolescentes",2017,3,1,206,485.436893203883,0,103,0,1,103,970.873786407767
22999,15,15218,81,"Tasa de exámenes médico legales por presunto delito sexual contra niños, niñas y adolescentes",2017,4,1,275,363.636363636364,0,149,0,1,126,793.650793650794
23000,15,15223,81,"Tasa de exámenes médico legales por presunto delito sexual contra niños, niñas y adolescentes",2017,2,2,732,273.224043715847,0,375,0,2,357,560.224089635854
23001,15,15223,81,"Tasa de exámenes médico legales por presunto delito sexual contra niños, niñas y adolescentes",2017,3,1,881,113.507377979569,0,459,0,1,422,236.96682464455
23002,15,15223,81,"Tasa de exámenes médico legales por presunto delito sexual contra niños, niñas y adolescentes",2017,4,1,879,113.765642775882,0,463,0,1,416,240.384615384615
23003,15,15224,81,"Tasa de exámenes médico legales por presunto delito sexual contra niños, niñas y adolescentes",2017,4,1,568,176.056338028169,0,310,0,1,258,387.596899224806
23004,15,15232,81,"Tasa de exámenes médico legales por presunto delito sexual contra niños, niñas y adolescentes",2017,3,1,620,161.290322580645,0,329,0,1,291,343.642611683849
23005,15,15232,81,"Tasa de exámenes médico legales por presunto delito sexual contra niños, niñas y adolescentes",2017,4,1,620,161.290322580645,0,339,0,1,281,355.871886120996
23006,15,15238,81,"Tasa de exámenes médico legales por presunto delito sexual contra niños, niñas y adolescentes",2017,2,10,8918,112.13276519399,2,4549,43.965706748736,8,4369,183.108262760357
23007,15,15238,81,"Tasa de exámenes médico legales por presunto delito sexual contra niños, niñas y adolescentes",2017,3,19,11551,164.487923123539,5,5757,86.8507903421921,14,5794,241.629271660338
23008,15,15238,81,"Tasa de exámenes médico legales por presunto delito sexual contra niños, niñas y adolescentes",2017,4,59,12479,472.794294414617,5,6064,82.4538258575198,54,6415,841.777084957132
23009,15,15238,121,Tasa de exámenes médico legales por presunto delito sexual cuando la víctima está entre 18 y 28 años,2017,5,11,19471,56.4942735350008,0,9633,0,11,9838,111.811343769059
23010,15,15276,81,"Tasa de exámenes médico legales por presunto delito sexual contra niños, niñas y adolescentes",2017,4,1,418,239.234449760766,0,217,0,1,201,497.512437810945
23011,15,15293,81,"Tasa de exámenes médico legales por presunto delito sexual contra niños, niñas y adolescentes",2017,2,1,227,440.528634361234,0,118,0,1,109,917.431192660551
23012,15,15293,81,"Tasa de exámenes médico legales por presunto delito sexual contra niños, niñas y adolescentes",2017,3,2,282,709.219858156028,0,149,0,2,133,1503.75939849624
23013,15,15299,81,"Tasa de exámenes médico legales por presunto delito sexual contra niños, niñas y adolescentes",2017,2,2,1503,133.067198935462,1,765,130.718954248366,1,738,135.50135501355
23014,15,15299,81,"Tasa de exámenes médico legales por presunto delito sexual contra niños, niñas y adolescentes",2017,3,4,1879,212.879191059074,1,944,105.932203389831,3,935,320.855614973262
23015,15,15299,81,"Tasa de exámenes médico legales por presunto delito sexual contra niños, niñas y adolescentes",2017,4,7,1909,366.68412781561,0,950,0,7,959,729.92700729927
23016,15,15322,81,"Tasa de exámenes médico legales por presunto delito sexual contra niños, niñas y adolescentes",2017,2,1,680,147.058823529412,0,354,0,1,326,306.748466257669
23017,15,15322,81,"Tasa de exámenes médico legales por presunto delito sexual contra niños, niñas y adolescentes",2017,3,2,874,228.83295194508,0,469,0,2,405,493.827160493827
23018,15,15322,81,"Tasa de exámenes médico legales por presunto delito sexual contra niños, niñas y adolescentes",2017,4,3,903,332.225913621262,0,489,0,3,414,724.63768115942
23019,15,15325,81,"Tasa de exámenes médico legales por presunto delito sexual contra niños, niñas y adolescentes",2017,3,1,342,292.397660818713,0,179,0,1,163,613.496932515337
23020,15,15332,81,"Tasa de exámenes médico legales por presunto delito sexual contra niños, niñas y adolescentes",2017,4,1,925,108.108108108108,0,463,0,1,462,216.450216450216
23021,15,15367,81,"Tasa de exámenes médico legales por presunto delito sexual contra niños, niñas y adolescentes",2017,3,2,840,238.095238095238,0,433,0,2,407,491.400491400491
23022,15,15401,81,"Tasa de exámenes médico legales por presunto delito sexual contra niños, niñas y adolescentes",2017,4,1,182,549.450549450549,1,98,1020.40816326531,0,84,0
23023,15,15407,81,"Tasa de exámenes médico legales por presunto delito sexual contra niños, niñas y adolescentes",2017,3,2,1684,118.764845605701,0,893,0,2,791,252.844500632111
23024,15,15407,81,"Tasa de exámenes médico legales por presunto delito sexual contra niños, niñas y adolescentes",2017,4,3,1828,164.113785557987,0,993,0,3,835,359.281437125748
23025,15,15407,121,Tasa de exámenes médico legales por presunto delito sexual cuando la víctima está entre 18 y 28 años,2017,5,1,2960,33.7837837837838,0,1568,0,1,1392,71.8390804597701
23026,15,15442,81,"Tasa de exámenes médico legales por presunto delito sexual contra niños, niñas y adolescentes",2017,4,4,876,456.62100456621,0,463,0,4,413,968.523002421308
23027,15,15466,121,Tasa de exámenes médico legales por presunto delito sexual cuando la víctima está entre 18 y 28 años,2017,5,1,865,115.606936416185,0,456,0,1,409,244.498777506112
23028,15,15469,81,"Tasa de exámenes médico legales por presunto delito sexual contra niños, niñas y adolescentes",2017,2,1,1812,55.1876379690949,0,934,0,1,878,113.895216400911
23029,15,15469,81,"Tasa de exámenes médico legales por presunto delito sexual contra niños, niñas y adolescentes",2017,3,5,2161,231.3743637205,0,1114,0,5,1047,477.554918815664
23030,15,15469,81,"Tasa de exámenes médico legales por presunto delito sexual contra niños, niñas y adolescentes",2017,4,6,2101,285.5782960495,1,1079,92.678405931418,5,1022,489.236790606654
23031,15,15469,121,Tasa de exámenes médico legales por presunto delito sexual cuando la víctima está entre 18 y 28 años,2017,5,1,3537,28.2725473565168,0,1788,0,1,1749,57.1755288736421
23032,15,15476,81,"Tasa de exámenes médico legales por presunto delito sexual contra niños, niñas y adolescentes",2017,4,1,831,120.336943441637,0,446,0,1,385,259.74025974026
23033,15,15480,81,"Tasa de exámenes médico legales por presunto delito sexual contra niños, niñas y adolescentes",2017,2,1,811,123.304562268804,0,417,0,1,394,253.807106598985
23034,15,15480,81,"Tasa de exámenes médico legales por presunto delito sexual contra niños, niñas y adolescentes",2017,4,1,1049,95.3288846520496,0,559,0,1,490,204.081632653061
23035,15,15491,81,"Tasa de exámenes médico legales por presunto delito sexual contra niños, niñas y adolescentes",2017,2,1,1359,73.5835172921266,0,700,0,1,659,151.745068285281
23036,15,15491,81,"Tasa de exámenes médico legales por presunto delito sexual contra niños, niñas y adolescentes",2017,3,1,1825,54.7945205479452,0,946,0,1,879,113.765642775882
23037,15,15491,81,"Tasa de exámenes médico legales por presunto delito sexual contra niños, niñas y adolescentes",2017,4,3,1904,157.563025210084,0,978,0,3,926,323.974082073434
23038,15,15494,81,"Tasa de exámenes médico legales por presunto delito sexual contra niños, niñas y adolescentes",2017,4,1,716,139.664804469274,0,356,0,1,360,277.777777777778
23039,15,15500,81,"Tasa de exámenes médico legales por presunto delito sexual contra niños, niñas y adolescentes",2017,3,2,337,593.471810089021,0,175,0,2,162,1234.56790123457
23040,15,15500,81,"Tasa de exámenes médico legales por presunto delito sexual contra niños, niñas y adolescentes",2017,4,1,340,294.117647058824,0,180,0,1,160,625
23041,15,15507,81,"Tasa de exámenes médico legales por presunto delito sexual contra niños, niñas y adolescentes",2017,2,1,1180,84.7457627118644,0,604,0,1,576,173.611111111111
23042,15,15507,81,"Tasa de exámenes médico legales por presunto delito sexual contra niños, niñas y adolescentes",2017,3,1,1382,72.3589001447178,0,713,0,1,669,149.476831091181
23043,15,15516,81,"Tasa de exámenes médico legales por presunto delito sexual contra niños, niñas y adolescentes",2017,3,4,3237,123.571207908557,1,1654,60.459492140266,3,1583,189.513581806696
23044,15,15516,81,"Tasa de exámenes médico legales por presunto delito sexual contra niños, niñas y adolescentes",2017,4,8,3359,238.166120869306,0,1728,0,8,1631,490.496627835684
23045,15,15516,121,Tasa de exámenes médico legales por presunto delito sexual cuando la víctima está entre 18 y 28 años,2017,5,2,5174,38.6548125241593,0,2631,0,2,2543,78.6472670074715
23046,15,15518,81,"Tasa de exámenes médico legales por presunto delito sexual contra niños, niñas y adolescentes",2017,4,1,147,680.272108843537,0,79,0,1,68,1470.58823529412
23047,15,15531,81,"Tasa de exámenes médico legales por presunto delito sexual contra niños, niñas y adolescentes",2017,3,1,1290,77.5193798449612,1,691,144.717800289436,0,599,0
23048,15,15537,81,"Tasa de exámenes médico legales por presunto delito sexual contra niños, niñas y adolescentes",2017,4,1,514,194.552529182879,0,264,0,1,250,400
23049,15,15542,81,"Tasa de exámenes médico legales por presunto delito sexual contra niños, niñas y adolescentes",2017,4,2,802,249.376558603491,0,426,0,2,376,531.914893617021
23050,15,15572,81,"Tasa de exámenes médico legales por presunto delito sexual contra niños, niñas y adolescentes",2017,2,5,4890,102.249488752556,1,2514,39.7772474144789,4,2376,168.350168350168
23051,15,15572,81,"Tasa de exámenes médico legales por presunto delito sexual contra niños, niñas y adolescentes",2017,3,12,6405,187.353629976581,3,3259,92.0527769254373,9,3146,286.077558804832
23052,15,15572,81,"Tasa de exámenes médico legales por presunto delito sexual contra niños, niñas y adolescentes",2017,4,14,6468,216.450216450216,0,3324,0,14,3144,445.29262086514
23053,15,15572,121,Tasa de exámenes médico legales por presunto delito sexual cuando la víctima está entre 18 y 28 años,2017,5,1,9507,10.5185652676975,0,5110,0,1,4397,22.7427791676143
23054,15,15580,81,"Tasa de exámenes médico legales por presunto delito sexual contra niños, niñas y adolescentes",2017,4,1,826,121.065375302663,0,458,0,1,368,271.739130434783
23055,15,15600,81,"Tasa de exámenes médico legales por presunto delito sexual contra niños, niñas y adolescentes",2017,4,3,2105,142.517814726841,0,1166,0,3,939,319.488817891374
23056,15,15600,121,Tasa de exámenes médico legales por presunto delito sexual cuando la víctima está entre 18 y 28 años,2017,5,1,2589,38.6249517188104,0,1455,0,1,1134,88.1834215167548
23057,15,15632,81,"Tasa de exámenes médico legales por presunto delito sexual contra niños, niñas y adolescentes",2017,2,1,1131,88.4173297966401,0,584,0,1,547,182.815356489945
23058,15,15632,81,"Tasa de exámenes médico legales por presunto delito sexual contra niños, niñas y adolescentes",2017,3,3,1398,214.592274678112,0,739,0,3,659,455.235204855842
23059,15,15632,81,"Tasa de exámenes médico legales por presunto delito sexual contra niños, niñas y adolescentes",2017,4,2,1361,146.95077149155,1,727,137.551581843191,1,634,157.728706624606
23060,15,15646,81,"Tasa de exámenes médico legales por presunto delito sexual contra niños, niñas y adolescentes",2017,2,2,2080,96.1538461538462,0,1073,0,2,1007,198.609731876862
23061,15,15646,81,"Tasa de exámenes médico legales por presunto delito sexual contra niños, niñas y adolescentes",2017,3,3,2601,115.340253748558,0,1350,0,3,1251,239.808153477218
23062,15,15646,81,"Tasa de exámenes médico legales por presunto delito sexual contra niños, niñas y adolescentes",2017,4,6,2511,238.9486260454,0,1318,0,6,1193,502.933780385583
23063,15,15646,121,Tasa de exámenes médico legales por presunto delito sexual cuando la víctima está entre 18 y 28 años,2017,5,1,3521,28.4010224368077,0,1848,0,1,1673,59.7728631201434
23064,15,15660,81,"Tasa de exámenes médico legales por presunto delito sexual contra niños, niñas y adolescentes",2017,3,3,225,1333.33333333333,2,117,1709.40170940171,1,108,925.925925925926
23065,15,15664,81,"Tasa de exámenes médico legales por presunto delito sexual contra niños, niñas y adolescentes",2017,4,4,512,781.25,0,282,0,4,230,1739.13043478261
23066,15,15667,81,"Tasa de exámenes médico legales por presunto delito sexual contra niños, niñas y adolescentes",2017,3,1,525,190.47619047619,0,270,0,1,255,392.156862745098
23067,15,15667,81,"Tasa de exámenes médico legales por presunto delito sexual contra niños, niñas y adolescentes",2017,4,2,523,382.409177820268,0,274,0,2,249,803.212851405622
23068,15,15667,121,Tasa de exámenes médico legales por presunto delito sexual cuando la víctima está entre 18 y 28 años,2017,5,1,785,127.388535031847,0,427,0,1,358,279.329608938547
23069,15,15676,81,"Tasa de exámenes médico legales por presunto delito sexual contra niños, niñas y adolescentes",2017,2,1,416,240.384615384615,0,216,0,1,200,500
23070,15,15681,81,"Tasa de exámenes médico legales por presunto delito sexual contra niños, niñas y adolescentes",2017,3,3,1183,253.592561284869,2,623,321.027287319422,1,560,178.571428571429
23071,15,15681,81,"Tasa de exámenes médico legales por presunto delito sexual contra niños, niñas y adolescentes",2017,4,4,1142,350.262697022767,2,614,325.732899022801,2,528,378.787878787879
23072,15,15686,81,"Tasa de exámenes médico legales por presunto delito sexual contra niños, niñas y adolescentes",2017,3,1,890,112.359550561798,0,469,0,1,421,237.529691211401
23073,15,15686,81,"Tasa de exámenes médico legales por presunto delito sexual contra niños, niñas y adolescentes",2017,4,4,855,467.836257309942,0,454,0,4,401,997.506234413965
23074,15,15690,81,"Tasa de exámenes médico legales por presunto delito sexual contra niños, niñas y adolescentes",2017,4,1,424,235.849056603774,0,221,0,1,203,492.610837438424
23075,15,15693,81,"Tasa de exámenes médico legales por presunto delito sexual contra niños, niñas y adolescentes",2017,2,1,968,103.305785123967,0,502,0,1,466,214.592274678112
23076,15,15693,81,"Tasa de exámenes médico legales por presunto delito sexual contra niños, niñas y adolescentes",2017,3,2,999,200.2002002002,0,471,0,2,528,378.787878787879
23077,15,15693,81,"Tasa de exámenes médico legales por presunto delito sexual contra niños, niñas y adolescentes",2017,4,4,1358,294.550810014728,0,780,0,4,578,692.041522491349
23078,15,15693,121,Tasa de exámenes médico legales por presunto delito sexual cuando la víctima está entre 18 y 28 años,2017,5,1,2874,34.794711203897,0,1821,0,1,1053,94.9667616334283
23079,15,15740,81,"Tasa de exámenes médico legales por presunto delito sexual contra niños, niñas y adolescentes",2017,3,3,1098,273.224043715847,1,567,176.36684303351,2,531,376.647834274953
23080,15,15755,81,"Tasa de exámenes médico legales por presunto delito sexual contra niños, niñas y adolescentes",2017,3,1,739,135.31799729364,1,389,257.06940874036,0,350,0
23081,15,15755,81,"Tasa de exámenes médico legales por presunto delito sexual contra niños, niñas y adolescentes",2017,4,2,758,263.852242744063,0,407,0,2,351,569.80056980057
23082,15,15757,81,"Tasa de exámenes médico legales por presunto delito sexual contra niños, niñas y adolescentes",2017,3,1,803,124.53300124533,1,424,235.849056603774,0,379,0
23083,15,15759,81,"Tasa de exámenes médico legales por presunto delito sexual contra niños, niñas y adolescentes",2017,2,4,8066,49.5908752789487,0,4055,0,4,4011,99.725754176016
23084,15,15759,81,"Tasa de exámenes médico legales por presunto delito sexual contra niños, niñas y adolescentes",2017,3,7,10896,64.2437591776799,1,5446,18.3621006243114,6,5450,110.091743119266
23085,15,15759,81,"Tasa de exámenes médico legales por presunto delito sexual contra niños, niñas y adolescentes",2017,4,17,11692,145.398563120082,0,5852,0,17,5840,291.095890410959
23086,15,15759,121,Tasa de exámenes médico legales por presunto delito sexual cuando la víctima está entre 18 y 28 años,2017,5,2,18653,10.7221358494612,0,9562,0,2,9091,21.9997800022
23087,15,15762,81,"Tasa de exámenes médico legales por presunto delito sexual contra niños, niñas y adolescentes",2017,2,1,321,311.526479750779,0,167,0,1,154,649.350649350649
23088,15,15762,81,"Tasa de exámenes médico legales por presunto delito sexual contra niños, niñas y adolescentes",2017,3,1,384,260.416666666667,1,199,502.51256281407,0,185,0
23089,15,15762,81,"Tasa de exámenes médico legales por presunto delito sexual contra niños, niñas y adolescentes",2017,4,1,353,283.28611898017,0,186,0,1,167,598.802395209581
23090,15,15762,121,Tasa de exámenes médico legales por presunto delito sexual cuando la víctima está entre 18 y 28 años,2017,5,1,530,188.679245283019,0,277,0,1,253,395.256916996047
23091,15,15763,81,"Tasa de exámenes médico legales por presunto delito sexual contra niños, niñas y adolescentes",2017,3,1,986,101.419878296146,0,493,0,1,493,202.839756592292
23092,15,15763,81,"Tasa de exámenes médico legales por presunto delito sexual contra niños, niñas y adolescentes",2017,4,2,938,213.219616204691,2,472,423.728813559322,0,466,0
23093,15,15764,81,"Tasa de exámenes médico legales por presunto delito sexual contra niños, niñas y adolescentes",2017,2,1,518,193.050193050193,0,265,0,1,253,395.256916996047
23094,15,15764,81,"Tasa de exámenes médico legales por presunto delito sexual contra niños, niñas y adolescentes",2017,3,3,611,490.998363338789,0,314,0,3,297,1010.10101010101
23095,15,15764,81,"Tasa de exámenes médico legales por presunto delito sexual contra niños, niñas y adolescentes",2017,4,1,588,170.068027210884,0,305,0,1,283,353.356890459364
23096,15,15776,81,"Tasa de exámenes médico legales por presunto delito sexual contra niños, niñas y adolescentes",2017,3,1,600,166.666666666667,0,313,0,1,287,348.432055749129
23097,15,15776,81,"Tasa de exámenes médico legales por presunto delito sexual contra niños, niñas y adolescentes",2017,4,1,630,158.730158730159,0,328,0,1,302,331.12582781457
23098,15,15778,81,"Tasa de exámenes médico legales por presunto delito sexual contra niños, niñas y adolescentes",2017,4,1,362,276.243093922652,0,182,0,1,180,555.555555555556
23099,15,15798,81,"Tasa de exámenes médico legales por presunto delito sexual contra niños, niñas y adolescentes",2017,3,1,343,291.545189504373,0,183,0,1,160,625
23100,15,15798,81,"Tasa de exámenes médico legales por presunto delito sexual contra niños, niñas y adolescentes",2017,4,2,374,534.75935828877,0,206,0,2,168,1190.47619047619
23101,15,15806,81,"Tasa de exámenes médico legales por presunto delito sexual contra niños, niñas y adolescentes",2017,2,2,1201,166.527893422148,0,617,0,2,584,342.465753424658
23102,15,15806,81,"Tasa de exámenes médico legales por presunto delito sexual contra niños, niñas y adolescentes",2017,3,1,1570,63.6942675159236,1,811,123.304562268804,0,759,0
23103,15,15806,81,"Tasa de exámenes médico legales por presunto delito sexual contra niños, niñas y adolescentes",2017,4,1,1604,62.3441396508728,0,832,0,1,772,129.533678756477
23104,15,15806,121,Tasa de exámenes médico legales por presunto delito sexual cuando la víctima está entre 18 y 28 años,2017,5,1,2389,41.8585182084554,0,1273,0,1,1116,89.6057347670251
23105,15,15808,81,"Tasa de exámenes médico legales por presunto delito sexual contra niños, niñas y adolescentes",2017,3,1,334,299.40119760479,1,177,564.971751412429,0,157,0
23106,15,15808,81,"Tasa de exámenes médico legales por presunto delito sexual contra niños, niñas y adolescentes",2017,4,1,330,303.030303030303,1,177,564.971751412429,0,153,0
23107,15,15814,81,"Tasa de exámenes médico legales por presunto delito sexual contra niños, niñas y adolescentes",2017,2,1,925,108.108108108108,1,475,210.526315789474,0,450,0
23108,15,15814,81,"Tasa de exámenes médico legales por presunto delito sexual contra niños, niñas y adolescentes",2017,4,1,1149,87.0322019147084,0,607,0,1,542,184.50184501845
23109,15,15816,81,"Tasa de exámenes médico legales por presunto delito sexual contra niños, niñas y adolescentes",2017,4,1,550,181.818181818182,0,299,0,1,251,398.406374501992
23110,15,15822,81,"Tasa de exámenes médico legales por presunto delito sexual contra niños, niñas y adolescentes",2017,4,2,547,365.63071297989,0,294,0,2,253,790.513833992095
23111,15,15822,121,Tasa de exámenes médico legales por presunto delito sexual cuando la víctima está entre 18 y 28 años,2017,5,2,930,215.05376344086,0,520,0,2,410,487.80487804878
23112,15,15835,81,"Tasa de exámenes médico legales por presunto delito sexual contra niños, niñas y adolescentes",2017,2,1,485,206.185567010309,1,251,398.406374501992,0,234,0
23113,15,15837,81,"Tasa de exámenes médico legales por presunto delito sexual contra niños, niñas y adolescentes",2017,2,1,883,113.250283125708,1,463,215.982721382289,0,420,0
23114,15,15837,81,"Tasa de exámenes médico legales por presunto delito sexual contra niños, niñas y adolescentes",2017,3,1,1095,91.324200913242,0,575,0,1,520,192.307692307692
23115,15,15837,81,"Tasa de exámenes médico legales por presunto delito sexual contra niños, niñas y adolescentes",2017,4,3,1031,290.9796314258,0,534,0,3,497,603.621730382294
23116,15,15839,81,"Tasa de exámenes médico legales por presunto delito sexual contra niños, niñas y adolescentes",2017,3,1,147,680.272108843537,0,81,0,1,66,1515.15151515152
23117,15,15842,81,"Tasa de exámenes médico legales por presunto delito sexual contra niños, niñas y adolescentes",2017,2,1,1105,90.4977375565611,0,566,0,1,539,185.528756957328
23118,15,15861,81,"Tasa de exámenes médico legales por presunto delito sexual contra niños, niñas y adolescentes",2017,2,1,1513,66.0938532716457,0,777,0,1,736,135.869565217391
23119,15,15861,81,"Tasa de exámenes médico legales por presunto delito sexual contra niños, niñas y adolescentes",2017,3,1,1863,53.6768652710682,0,949,0,1,914,109.409190371991
23120,15,15861,81,"Tasa de exámenes médico legales por presunto delito sexual contra niños, niñas y adolescentes",2017,4,9,1869,481.540930979133,0,935,0,9,934,963.597430406852
23121,17,17001,81,"Tasa de exámenes médico legales por presunto delito sexual contra niños, niñas y adolescentes",2017,2,48,25224,190.294957183635,8,12895,62.039550213261,40,12329,324.438316165139
23122,17,17001,81,"Tasa de exámenes médico legales por presunto delito sexual contra niños, niñas y adolescentes",2017,3,74,32064,230.788423153693,14,16339,85.6845584185079,60,15725,381.558028616852
23123,17,17001,81,"Tasa de exámenes médico legales por presunto delito sexual contra niños, niñas y adolescentes",2017,4,121,34569,350.024588504151,26,17537,148.257968865827,95,17032,557.773602630343
23124,17,17001,121,Tasa de exámenes médico legales por presunto delito sexual cuando la víctima está entre 18 y 28 años,2017,5,22,72560,30.3197353914002,0,37522,0,22,35038,62.7889719732862
23125,17,17013,81,"Tasa de exámenes médico legales por presunto delito sexual contra niños, niñas y adolescentes",2017,4,1,2200,45.4545454545455,1,1126,88.809946714032,0,1074,0
23126,17,17042,81,"Tasa de exámenes médico legales por presunto delito sexual contra niños, niñas y adolescentes",2017,2,3,2709,110.741971207087,0,1386,0,3,1323,226.757369614512
23127,17,17042,81,"Tasa de exámenes médico legales por presunto delito sexual contra niños, niñas y adolescentes",2017,3,8,3358,238.237045860631,0,1676,0,8,1682,475.624256837099
23128,17,17042,81,"Tasa de exámenes médico legales por presunto delito sexual contra niños, niñas y adolescentes",2017,4,15,3207,467.726847521048,0,1581,0,15,1626,922.509225092251
23129,17,17042,121,Tasa de exámenes médico legales por presunto delito sexual cuando la víctima está entre 18 y 28 años,2017,5,2,5330,37.5234521575985,0,2670,0,2,2660,75.187969924812
23130,17,17050,81,"Tasa de exámenes médico legales por presunto delito sexual contra niños, niñas y adolescentes",2017,2,1,1028,97.2762645914397,0,524,0,1,504,198.412698412698
23131,17,17050,81,"Tasa de exámenes médico legales por presunto delito sexual contra niños, niñas y adolescentes",2017,4,1,1152,86.8055555555556,0,590,0,1,562,177.935943060498
23132,17,17088,81,"Tasa de exámenes médico legales por presunto delito sexual contra niños, niñas y adolescentes",2017,4,1,1066,93.8086303939963,0,562,0,1,504,198.412698412698
23133,17,17088,121,Tasa de exámenes médico legales por presunto delito sexual cuando la víctima está entre 18 y 28 años,2017,5,1,1896,52.7426160337553,0,988,0,1,908,110.132158590308
23134,17,17174,81,"Tasa de exámenes médico legales por presunto delito sexual contra niños, niñas y adolescentes",2017,2,4,4287,93.3053417308141,0,2190,0,4,2097,190.748688602766
23135,17,17174,81,"Tasa de exámenes médico legales por presunto delito sexual contra niños, niñas y adolescentes",2017,3,6,5288,113.464447806354,1,2687,37.2162262746558,5,2601,192.233756247597
23136,17,17174,81,"Tasa de exámenes médico legales por presunto delito sexual contra niños, niñas y adolescentes",2017,4,8,5212,153.491941673062,0,2622,0,8,2590,308.880308880309
23137,17,17174,121,Tasa de exámenes médico legales por presunto delito sexual cuando la víctima está entre 18 y 28 años,2017,5,1,9199,10.8707468203066,0,4529,0,1,4670,21.4132762312634
23138,17,17272,81,"Tasa de exámenes médico legales por presunto delito sexual contra niños, niñas y adolescentes",2017,3,1,1176,85.0340136054422,1,607,164.744645799012,0,569,0
23139,17,17380,81,"Tasa de exámenes médico legales por presunto delito sexual contra niños, niñas y adolescentes",2017,2,5,6969,71.7463050652891,2,3570,56.0224089635854,3,3399,88.261253309797
23140,17,17380,81,"Tasa de exámenes médico legales por presunto delito sexual contra niños, niñas y adolescentes",2017,3,14,8255,169.594185342217,4,4210,95.0118764845606,10,4045,247.218788627936
23141,17,17380,81,"Tasa de exámenes médico legales por presunto delito sexual contra niños, niñas y adolescentes",2017,4,16,7898,202.582932387946,2,4006,49.9251123315028,14,3892,359.712230215827
23142,17,17380,121,Tasa de exámenes médico legales por presunto delito sexual cuando la víctima está entre 18 y 28 años,2017,5,6,14570,41.1805078929307,0,7510,0,6,7060,84.985835694051
23143,17,17388,81,"Tasa de exámenes médico legales por presunto delito sexual contra niños, niñas y adolescentes",2017,2,2,469,426.439232409382,0,239,0,2,230,869.565217391304
23144,17,17388,81,"Tasa de exámenes médico legales por presunto delito sexual contra niños, niñas y adolescentes",2017,3,1,559,178.890876565295,0,288,0,1,271,369.0036900369
23145,17,17388,81,"Tasa de exámenes médico legales por presunto delito sexual contra niños, niñas y adolescentes",2017,4,1,522,191.570881226054,0,272,0,1,250,400
23146,17,17442,81,"Tasa de exámenes médico legales por presunto delito sexual contra niños, niñas y adolescentes",2017,3,1,1120,89.2857142857143,0,572,0,1,548,182.481751824818
23147,17,17446,81,"Tasa de exámenes médico legales por presunto delito sexual contra niños, niñas y adolescentes",2017,3,2,425,470.588235294118,0,218,0,2,207,966.183574879227
23148,17,17446,81,"Tasa de exámenes médico legales por presunto delito sexual contra niños, niñas y adolescentes",2017,4,1,391,255.754475703325,0,201,0,1,190,526.315789473684
23149,17,17486,81,"Tasa de exámenes médico legales por presunto delito sexual contra niños, niñas y adolescentes",2017,2,1,3206,31.1915159076731,1,1649,60.6428138265616,0,1557,0
23150,17,17486,81,"Tasa de exámenes médico legales por presunto delito sexual contra niños, niñas y adolescentes",2017,3,12,3865,310.478654592497,7,1999,350.175087543772,5,1866,267.952840300107
23151,17,17486,81,"Tasa de exámenes médico legales por presunto delito sexual contra niños, niñas y adolescentes",2017,4,11,3575,307.692307692308,2,1851,108.049702863317,9,1724,522.041763341067
23152,17,17495,81,"Tasa de exámenes médico legales por presunto delito sexual contra niños, niñas y adolescentes",2017,4,2,775,258.064516129032,0,416,0,2,359,557.103064066852
23153,17,17513,81,"Tasa de exámenes médico legales por presunto delito sexual contra niños, niñas y adolescentes",2017,4,1,1578,63.3713561470215,0,819,0,1,759,131.752305665349
23154,17,17524,81,"Tasa de exámenes médico legales por presunto delito sexual contra niños, niñas y adolescentes",2017,3,2,2016,99.2063492063492,0,1041,0,2,975,205.128205128205
23155,17,17524,81,"Tasa de exámenes médico legales por presunto delito sexual contra niños, niñas y adolescentes",2017,4,1,1896,52.7426160337553,0,987,0,1,909,110.01100110011
23156,17,17524,121,Tasa de exámenes médico legales por presunto delito sexual cuando la víctima está entre 18 y 28 años,2017,5,1,3286,30.4321363359708,0,1717,0,1,1569,63.7348629700446
23157,17,17541,81,"Tasa de exámenes médico legales por presunto delito sexual contra niños, niñas y adolescentes",2017,3,1,2959,33.7952010814464,0,1519,0,1,1440,69.4444444444444
23158,17,17614,81,"Tasa de exámenes médico legales por presunto delito sexual contra niños, niñas y adolescentes",2017,2,2,5241,38.1606563632894,0,2689,0,2,2552,78.3699059561128
23159,17,17614,81,"Tasa de exámenes médico legales por presunto delito sexual contra niños, niñas y adolescentes",2017,3,4,6139,65.1571917250366,1,3170,31.5457413249211,3,2969,101.044122600202
23160,17,17614,81,"Tasa de exámenes médico legales por presunto delito sexual contra niños, niñas y adolescentes",2017,4,3,5846,51.3171399247349,0,3043,0,3,2803,107.028184088477
23161,17,17614,121,Tasa de exámenes médico legales por presunto delito sexual cuando la víctima está entre 18 y 28 años,2017,5,1,10658,9.38262338149747,1,5372,18.6150409530901,0,5286,0
23162,17,17616,81,"Tasa de exámenes médico legales por presunto delito sexual contra niños, niñas y adolescentes",2017,2,1,864,115.740740740741,0,448,0,1,416,240.384615384615
23163,17,17653,81,"Tasa de exámenes médico legales por presunto delito sexual contra niños, niñas y adolescentes",2017,2,4,1506,265.604249667995,1,774,129.198966408269,3,732,409.83606557377
23164,17,17653,81,"Tasa de exámenes médico legales por presunto delito sexual contra niños, niñas y adolescentes",2017,3,4,1862,214.822771213749,1,962,103.950103950104,3,900,333.333333333333
23165,17,17653,81,"Tasa de exámenes médico legales por presunto delito sexual contra niños, niñas y adolescentes",2017,4,6,1768,339.366515837104,2,925,216.216216216216,4,843,474.495848161329
23166,17,17777,81,"Tasa de exámenes médico legales por presunto delito sexual contra niños, niñas y adolescentes",2017,2,1,2376,42.0875420875421,0,1212,0,1,1164,85.9106529209622
23167,17,17777,81,"Tasa de exámenes médico legales por presunto delito sexual contra niños, niñas y adolescentes",2017,3,1,2879,34.7342827370615,0,1464,0,1,1415,70.6713780918728
23168,17,17777,81,"Tasa de exámenes médico legales por presunto delito sexual contra niños, niñas y adolescentes",2017,4,9,2728,329.912023460411,0,1379,0,9,1349,667.160859896219
23169,17,17777,121,Tasa de exámenes médico legales por presunto delito sexual cuando la víctima está entre 18 y 28 años,2017,5,1,4937,20.2552157180474,0,2491,0,1,2446,40.8830744071954
23170,17,17867,81,"Tasa de exámenes médico legales por presunto delito sexual contra niños, niñas y adolescentes",2017,3,2,839,238.379022646007,0,431,0,2,408,490.196078431373
23171,17,17873,81,"Tasa de exámenes médico legales por presunto delito sexual contra niños, niñas y adolescentes",2017,2,3,4525,66.2983425414365,0,2337,0,3,2188,137.111517367459
23172,17,17873,81,"Tasa de exámenes médico legales por presunto delito sexual contra niños, niñas y adolescentes",2017,3,13,5544,234.487734487734,2,2859,69.9545295557887,11,2685,409.683426443203
23173,17,17873,81,"Tasa de exámenes médico legales por presunto delito sexual contra niños, niñas y adolescentes",2017,4,14,5486,255.1950419249,5,2824,177.053824362606,9,2662,338.09166040571
23174,17,17873,121,Tasa de exámenes médico legales por presunto delito sexual cuando la víctima está entre 18 y 28 años,2017,5,2,10855,18.4246890833717,0,5467,0,2,5388,37.1195248700817
23175,17,17877,81,"Tasa de exámenes médico legales por presunto delito sexual contra niños, niñas y adolescentes",2017,2,2,1149,174.064403829417,0,593,0,2,556,359.712230215827
23176,17,17877,81,"Tasa de exámenes médico legales por presunto delito sexual contra niños, niñas y adolescentes",2017,3,2,1361,146.95077149155,0,701,0,2,660,303.030303030303
23177,18,18001,81,"Tasa de exámenes médico legales por presunto delito sexual contra niños, niñas y adolescentes",2017,2,4,16841,23.7515586960394,0,8491,0,4,8350,47.9041916167665
23178,18,18001,81,"Tasa de exámenes médico legales por presunto delito sexual contra niños, niñas y adolescentes",2017,3,58,20147,287.884052216211,3,10135,29.600394671929,55,10012,549.340791050739
23179,18,18001,81,"Tasa de exámenes médico legales por presunto delito sexual contra niños, niñas y adolescentes",2017,4,48,20679,232.119541563905,5,10486,47.6826244516498,43,10193,421.8581379378
23180,18,18001,121,Tasa de exámenes médico legales por presunto delito sexual cuando la víctima está entre 18 y 28 años,2017,5,5,36140,13.8350857775318,0,18415,0,5,17725,28.2087447108604
23181,18,18094,81,"Tasa de exámenes médico legales por presunto delito sexual contra niños, niñas y adolescentes",2017,3,2,1767,113.186191284663,0,878,0,2,889,224.971878515186
23182,18,18094,81,"Tasa de exámenes médico legales por presunto delito sexual contra niños, niñas y adolescentes",2017,4,3,1606,186.799501867995,0,774,0,3,832,360.576923076923
23183,18,18150,81,"Tasa de exámenes médico legales por presunto delito sexual contra niños, niñas y adolescentes",2017,2,4,4477,89.3455438909984,1,2295,43.5729847494553,3,2182,137.488542621448
23184,18,18150,81,"Tasa de exámenes médico legales por presunto delito sexual contra niños, niñas y adolescentes",2017,3,10,5036,198.570293884035,3,2581,116.234017822549,7,2455,285.132382892057
23185,18,18150,81,"Tasa de exámenes médico legales por presunto delito sexual contra niños, niñas y adolescentes",2017,4,10,4656,214.776632302406,0,2337,0,10,2319,431.22035360069
23186,18,18150,121,Tasa de exámenes médico legales por presunto delito sexual cuando la víctima está entre 18 y 28 años,2017,5,2,6632,30.1568154402895,0,3246,0,2,3386,59.0667454223272
23187,18,18205,81,"Tasa de exámenes médico legales por presunto delito sexual contra niños, niñas y adolescentes",2017,3,1,1565,63.8977635782748,0,796,0,1,769,130.039011703511
23188,18,18247,81,"Tasa de exámenes médico legales por presunto delito sexual contra niños, niñas y adolescentes",2017,3,4,2678,149.365197908887,0,1377,0,4,1301,307.455803228286
23189,18,18247,81,"Tasa de exámenes médico legales por presunto delito sexual contra niños, niñas y adolescentes",2017,4,4,2649,151.000377500944,0,1362,0,4,1287,310.800310800311
23190,18,18247,121,Tasa de exámenes médico legales por presunto delito sexual cuando la víctima está entre 18 y 28 años,2017,5,2,4544,44.0140845070423,0,2306,0,2,2238,89.3655049151028
23191,18,18256,81,"Tasa de exámenes médico legales por presunto delito sexual contra niños, niñas y adolescentes",2017,2,1,2638,37.9075056861259,0,1356,0,1,1282,78.003120124805
23192,18,18256,81,"Tasa de exámenes médico legales por presunto delito sexual contra niños, niñas y adolescentes",2017,3,6,2913,205.973223480947,2,1497,133.600534402138,4,1416,282.485875706215
23193,18,18256,81,"Tasa de exámenes médico legales por presunto delito sexual contra niños, niñas y adolescentes",2017,4,5,2803,178.380306814128,1,1383,72.3065798987708,4,1420,281.69014084507
23194,18,18410,81,"Tasa de exámenes médico legales por presunto delito sexual contra niños, niñas y adolescentes",2017,3,2,3316,60.313630880579,0,1699,0,2,1617,123.685837971552
23195,18,18410,81,"Tasa de exámenes médico legales por presunto delito sexual contra niños, niñas y adolescentes",2017,4,4,3196,125.156445556946,0,1653,0,4,1543,259.235255994815
23196,18,18460,81,"Tasa de exámenes médico legales por presunto delito sexual contra niños, niñas y adolescentes",2017,4,2,1597,125.234815278647,0,811,0,2,786,254.452926208651
23197,18,18479,81,"Tasa de exámenes médico legales por presunto delito sexual contra niños, niñas y adolescentes",2017,3,1,524,190.839694656489,0,266,0,1,258,387.596899224806
23198,18,18479,81,"Tasa de exámenes médico legales por presunto delito sexual contra niños, niñas y adolescentes",2017,4,1,503,198.807157057654,0,257,0,1,246,406.50406504065
23199,18,18592,81,"Tasa de exámenes médico legales por presunto delito sexual contra niños, niñas y adolescentes",2017,2,4,3980,100.502512562814,2,2043,97.8952520802741,2,1937,103.252452245741
23200,18,18592,81,"Tasa de exámenes médico legales por presunto delito sexual contra niños, niñas y adolescentes",2017,3,5,4538,110.180696342001,2,2333,85.726532361766,3,2205,136.054421768707
23201,18,18592,81,"Tasa de exámenes médico legales por presunto delito sexual contra niños, niñas y adolescentes",2017,4,4,4344,92.0810313075506,0,2245,0,4,2099,190.566936636494
23202,18,18610,81,"Tasa de exámenes médico legales por presunto delito sexual contra niños, niñas y adolescentes",2017,3,3,2022,148.367952522255,0,1048,0,3,974,308.008213552361
23203,18,18753,81,"Tasa de exámenes médico legales por presunto delito sexual contra niños, niñas y adolescentes",2017,2,1,8255,12.1138703815869,0,4227,0,1,4028,24.8262164846077
23204,18,18753,81,"Tasa de exámenes médico legales por presunto delito sexual contra niños, niñas y adolescentes",2017,3,9,9395,95.7956359765833,3,4782,62.7352572145546,6,4613,130.067201387384
23205,18,18753,81,"Tasa de exámenes médico legales por presunto delito sexual contra niños, niñas y adolescentes",2017,4,15,9034,166.039406685853,0,4581,0,15,4453,336.851560745565
23206,18,18753,121,Tasa de exámenes médico legales por presunto delito sexual cuando la víctima está entre 18 y 28 años,2017,5,2,14498,13.7950062077528,0,7539,0,2,6959,28.7397614599799
23207,18,18756,81,"Tasa de exámenes médico legales por presunto delito sexual contra niños, niñas y adolescentes",2017,3,1,3286,30.4321363359708,1,1666,60.0240096038415,0,1620,0
23208,18,18756,81,"Tasa de exámenes médico legales por presunto delito sexual contra niños, niñas y adolescentes",2017,4,1,3156,31.6856780735108,0,1613,0,1,1543,64.8088139987038
23209,18,18785,81,"Tasa de exámenes médico legales por presunto delito sexual contra niños, niñas y adolescentes",2017,3,1,1217,82.1692686935086,0,625,0,1,592,168.918918918919
23210,18,18785,81,"Tasa de exámenes médico legales por presunto delito sexual contra niños, niñas y adolescentes",2017,4,2,1174,170.357751277683,1,608,164.473684210526,1,566,176.678445229682
23211,18,18860,81,"Tasa de exámenes médico legales por presunto delito sexual contra niños, niñas y adolescentes",2017,4,2,1502,133.155792276964,0,778,0,2,724,276.243093922652
23212,19,19001,81,"Tasa de exámenes médico legales por presunto delito sexual contra niños, niñas y adolescentes",2017,2,18,18457,97.523974643766607,6,9375,64,12,9082,132.129486897159
23213,19,19001,81,"Tasa de exámenes médico legales por presunto delito sexual contra niños, niñas y adolescentes",2017,3,71,23143,306.788229702286,15,11791,127.21567297091,56,11352,493.305144467935
23214,19,19001,81,"Tasa de exámenes médico legales por presunto delito sexual contra niños, niñas y adolescentes",2017,4,83,25792,321.805210918114,1,13084,7.64292265362274,82,12708,645.262826565943
23215,19,19001,121,Tasa de exámenes médico legales por presunto delito sexual cuando la víctima está entre 18 y 28 años,2017,5,35,51842,67.5128274372131,5,26057,19.1887016924435,30,25785,116.346713205352
23216,19,19001,81,"Tasa de exámenes médico legales por presunto delito sexual contra niños, niñas y adolescentes",2017,1,1,3689,27.1076172404446,0,1890,0,1,1799,55.5864369093941
23217,19,19050,81,"Tasa de exámenes médico legales por presunto delito sexual contra niños, niñas y adolescentes",2017,3,1,3072,32.5520833333333,0,1529,0,1,1543,64.8088139987038
23218,19,19050,81,"Tasa de exámenes médico legales por presunto delito sexual contra niños, niñas y adolescentes",2017,4,3,3060,98.0392156862745,0,1529,0,3,1531,195.950359242325
23219,19,19075,81,"Tasa de exámenes médico legales por presunto delito sexual contra niños, niñas y adolescentes",2017,4,1,2977,33.5908632851864,0,1554,0,1,1423,70.2740688685875
23220,19,19100,81,"Tasa de exámenes médico legales por presunto delito sexual contra niños, niñas y adolescentes",2017,2,1,3796,26.3435194942044,0,1935,0,1,1861,53.7345513164965
23221,19,19100,81,"Tasa de exámenes médico legales por presunto delito sexual contra niños, niñas y adolescentes",2017,3,2,4412,45.3309156844968,0,2261,0,2,2151,92.9800092980009
23222,19,19100,81,"Tasa de exámenes médico legales por presunto delito sexual contra niños, niñas y adolescentes",2017,4,2,4627,43.2245515452777,0,2402,0,2,2225,89.8876404494382
23223,19,19110,81,"Tasa de exámenes médico legales por presunto delito sexual contra niños, niñas y adolescentes",2017,4,1,3869,25.8464719565779,0,1969,0,1,1900,52.6315789473684
23224,19,19110,121,Tasa de exámenes médico legales por presunto delito sexual cuando la víctima está entre 18 y 28 años,2017,5,1,6845,14.609203798393,0,3544,0,1,3301,30.2938503483793
23225,19,19130,81,"Tasa de exámenes médico legales por presunto delito sexual contra niños, niñas y adolescentes",2017,3,4,4503,88.8296691094826,0,2335,0,4,2168,184.50184501845
23226,19,19130,81,"Tasa de exámenes médico legales por presunto delito sexual contra niños, niñas y adolescentes",2017,4,3,4444,67.5067506750675,0,2377,0,3,2067,145.137880986938
23227,19,19137,81,"Tasa de exámenes médico legales por presunto delito sexual contra niños, niñas y adolescentes",2017,3,1,4242,23.5737859500236,0,2136,0,1,2106,47.4833808167142
23228,19,19142,81,"Tasa de exámenes médico legales por presunto delito sexual contra niños, niñas y adolescentes",2017,2,2,1497,133.600534402138,0,760,0,2,737,271.370420624152
23229,19,19142,81,"Tasa de exámenes médico legales por presunto delito sexual contra niños, niñas y adolescentes",2017,4,1,1893,52.8262017960909,0,971,0,1,922,108.459869848156
23230,19,19212,81,"Tasa de exámenes médico legales por presunto delito sexual contra niños, niñas y adolescentes",2017,2,2,3184,62.8140703517588,0,1625,0,2,1559,128.287363694676
23231,19,19212,81,"Tasa de exámenes médico legales por presunto delito sexual contra niños, niñas y adolescentes",2017,3,4,3506,114.090131203651,1,1780,56.1797752808989,3,1726,173.812282734647
23232,19,19212,81,"Tasa de exámenes médico legales por presunto delito sexual contra niños, niñas y adolescentes",2017,4,1,3775,26.4900662251656,0,1926,0,1,1849,54.0832882639264
23233,19,19256,81,"Tasa de exámenes médico legales por presunto delito sexual contra niños, niñas y adolescentes",2017,3,1,5162,19.3723363037582,0,2677,0,1,2485,40.2414486921529
23234,19,19256,81,"Tasa de exámenes médico legales por presunto delito sexual contra niños, niñas y adolescentes",2017,4,2,4753,42.0786871449611,0,2475,0,2,2278,87.7963125548727
23235,19,19290,81,"Tasa de exámenes médico legales por presunto delito sexual contra niños, niñas y adolescentes",2017,4,1,635,157.48031496063,0,317,0,1,318,314.465408805031
23236,19,19318,81,"Tasa de exámenes médico legales por presunto delito sexual contra niños, niñas y adolescentes",2017,3,1,4612,21.6825672159584,1,2391,41.8235048097031,0,2221,0
23237,19,19318,81,"Tasa de exámenes médico legales por presunto delito sexual contra niños, niñas y adolescentes",2017,4,1,4469,22.3763705526964,0,2384,0,1,2085,47.9616306954436
23238,19,19355,81,"Tasa de exámenes médico legales por presunto delito sexual contra niños, niñas y adolescentes",2017,2,1,4025,24.8447204968944,0,2041,0,1,1984,50.4032258064516
23239,19,19355,81,"Tasa de exámenes médico legales por presunto delito sexual contra niños, niñas y adolescentes",2017,4,1,4054,24.6669955599408,0,2092,0,1,1962,50.9683995922528
23240,19,19364,121,Tasa de exámenes médico legales por presunto delito sexual cuando la víctima está entre 18 y 28 años,2017,5,1,3932,25.4323499491353,0,2015,0,1,1917,52.1648408972353
23241,19,19392,81,"Tasa de exámenes médico legales por presunto delito sexual contra niños, niñas y adolescentes",2017,2,1,831,120.336943441637,0,424,0,1,407,245.700245700246
23242,19,19392,81,"Tasa de exámenes médico legales por presunto delito sexual contra niños, niñas y adolescentes",2017,3,1,927,107.874865156419,0,480,0,1,447,223.713646532438
23243,19,19392,81,"Tasa de exámenes médico legales por presunto delito sexual contra niños, niñas y adolescentes",2017,4,1,988,101.214574898785,0,522,0,1,466,214.592274678112
23244,19,19397,81,"Tasa de exámenes médico legales por presunto delito sexual contra niños, niñas y adolescentes",2017,4,4,5127,78.0183343085625,0,2595,0,4,2532,157.977883096366
23245,19,19397,121,Tasa de exámenes médico legales por presunto delito sexual cuando la víctima está entre 18 y 28 años,2017,5,2,8276,24.1662638956017,0,4241,0,2,4035,49.5662949194548
23246,19,19418,81,"Tasa de exámenes médico legales por presunto delito sexual contra niños, niñas y adolescentes",2017,3,1,2729,36.6434591425431,0,1369,0,1,1360,73.5294117647059
23247,19,19418,81,"Tasa de exámenes médico legales por presunto delito sexual contra niños, niñas y adolescentes",2017,4,1,2796,35.7653791130186,0,1392,0,1,1404,71.2250712250712
23248,19,19450,81,"Tasa de exámenes médico legales por presunto delito sexual contra niños, niñas y adolescentes",2017,4,2,1957,102.197240674502,0,1017,0,2,940,212.765957446809
23249,19,19455,81,"Tasa de exámenes médico legales por presunto delito sexual contra niños, niñas y adolescentes",2017,2,1,4338,23.0520977408944,0,2221,0,1,2117,47.2366556447803
23250,19,19455,81,"Tasa de exámenes médico legales por presunto delito sexual contra niños, niñas y adolescentes",2017,3,4,4985,80.2407221664995,1,2513,39.7930760047752,3,2472,121.359223300971
23251,19,19455,81,"Tasa de exámenes médico legales por presunto delito sexual contra niños, niñas y adolescentes",2017,4,5,5043,99.147332936744,1,2574,38.8500388500388,4,2469,162.008910490077
23252,19,19513,81,"Tasa de exámenes médico legales por presunto delito sexual contra niños, niñas y adolescentes",2017,2,1,714,140.056022408964,0,364,0,1,350,285.714285714286
23253,19,19513,81,"Tasa de exámenes médico legales por presunto delito sexual contra niños, niñas y adolescentes",2017,4,2,869,230.149597238205,0,434,0,2,435,459.770114942529
23254,19,19513,121,Tasa de exámenes médico legales por presunto delito sexual cuando la víctima está entre 18 y 28 años,2017,5,2,1527,130.975769482646,0,770,0,2,757,264.200792602378
23255,19,19517,81,"Tasa de exámenes médico legales por presunto delito sexual contra niños, niñas y adolescentes",2017,3,1,4794,20.8594075928244,0,2472,0,1,2322,43.0663221360896
23256,19,19517,81,"Tasa de exámenes médico legales por presunto delito sexual contra niños, niñas y adolescentes",2017,4,1,4732,21.1327134404057,0,2451,0,1,2281,43.8404208680403
23257,19,19517,121,Tasa de exámenes médico legales por presunto delito sexual cuando la víctima está entre 18 y 28 años,2017,5,1,7465,13.3958472873409,1,3914,25.5493101686254,0,3551,0
23258,19,19532,81,"Tasa de exámenes médico legales por presunto delito sexual contra niños, niñas y adolescentes",2017,3,2,4084,48.9715964740451,1,2121,47.1475719000471,1,1963,50.9424350483953
23259,19,19532,81,"Tasa de exámenes médico legales por presunto delito sexual contra niños, niñas y adolescentes",2017,4,3,4374,68.5871056241427,0,2291,0,3,2083,144.02304368699
23260,19,19533,81,"Tasa de exámenes médico legales por presunto delito sexual contra niños, niñas y adolescentes",2017,3,1,884,113.122171945701,0,461,0,1,423,236.406619385343
23261,19,19548,81,"Tasa de exámenes médico legales por presunto delito sexual contra niños, niñas y adolescentes",2017,2,1,4148,24.1080038572806,1,2114,47.3036896877956,0,2034,0
23262,19,19548,81,"Tasa de exámenes médico legales por presunto delito sexual contra niños, niñas y adolescentes",2017,4,2,4862,41.1353352529823,1,2492,40.1284109149278,1,2370,42.1940928270042
23263,19,19548,121,Tasa de exámenes médico legales por presunto delito sexual cuando la víctima está entre 18 y 28 años,2017,5,1,8951,11.1719360965255,0,4531,0,1,4420,22.6244343891403
23264,19,19573,81,"Tasa de exámenes médico legales por presunto delito sexual contra niños, niñas y adolescentes",2017,2,3,3913,76.6675185279836,1,2000,50,2,1913,104.547830632514
23265,19,19573,81,"Tasa de exámenes médico legales por presunto delito sexual contra niños, niñas y adolescentes",2017,3,4,4596,87.0322019147084,0,2339,0,4,2257,177.226406734603
23266,19,19573,81,"Tasa de exámenes médico legales por presunto delito sexual contra niños, niñas y adolescentes",2017,4,8,4913,162.833299409729,1,2485,40.2414486921529,7,2428,288.30313014827
23267,19,19573,121,Tasa de exámenes médico legales por presunto delito sexual cuando la víctima está entre 18 y 28 años,2017,5,2,9502,21.0482003788676,0,4785,0,2,4717,42.3998304006784
23268,19,19585,81,"Tasa de exámenes médico legales por presunto delito sexual contra niños, niñas y adolescentes",2017,3,1,1687,59.2768227622999,0,864,0,1,823,121.506682867558
23269,19,19585,81,"Tasa de exámenes médico legales por presunto delito sexual contra niños, niñas y adolescentes",2017,4,1,1772,56.4334085778781,0,917,0,1,855,116.959064327485
23270,19,19622,81,"Tasa de exámenes médico legales por presunto delito sexual contra niños, niñas y adolescentes",2017,3,2,1259,158.856235107228,0,645,0,2,614,325.732899022801
23271,19,19622,81,"Tasa de exámenes médico legales por presunto delito sexual contra niños, niñas y adolescentes",2017,4,1,1298,77.0416024653313,0,674,0,1,624,160.25641025641
23272,19,19698,81,"Tasa de exámenes médico legales por presunto delito sexual contra niños, niñas y adolescentes",2017,2,5,8176,61.1545988258317,1,4143,24.1370987207338,4,4033,99.1817505578973
23273,19,19698,81,"Tasa de exámenes médico legales por presunto delito sexual contra niños, niñas y adolescentes",2017,3,16,9678,165.323413928498,6,4880,122.950819672131,10,4798,208.420175072947
23274,19,19698,81,"Tasa de exámenes médico legales por presunto delito sexual contra niños, niñas y adolescentes",2017,4,8,10356,77.2499034376207,0,5312,0,8,5044,158.604282315623
23275,19,19698,121,Tasa de exámenes médico legales por presunto delito sexual cuando la víctima está entre 18 y 28 años,2017,5,3,19682,15.2423534193679,0,9779,0,3,9903,30.2938503483793
23276,19,19701,81,"Tasa de exámenes médico legales por presunto delito sexual contra niños, niñas y adolescentes",2017,4,1,1293,77.3395204949729,0,660,0,1,633,157.977883096366
23277,19,19760,81,"Tasa de exámenes médico legales por presunto delito sexual contra niños, niñas y adolescentes",2017,3,1,1666,60.0240096038415,0,857,0,1,809,123.609394313968
23278,19,19760,121,Tasa de exámenes médico legales por presunto delito sexual cuando la víctima está entre 18 y 28 años,2017,5,1,3361,29.753049687593,0,1762,0,1,1599,62.5390869293308
23279,19,19780,81,"Tasa de exámenes médico legales por presunto delito sexual contra niños, niñas y adolescentes",2017,2,2,1995,100.250626566416,0,1015,0,2,980,204.081632653061
23280,19,19780,81,"Tasa de exámenes médico legales por presunto delito sexual contra niños, niñas y adolescentes",2017,3,4,2255,177.383592017738,1,1151,86.8809730668983,3,1104,271.739130434783
23281,19,19780,81,"Tasa de exámenes médico legales por presunto delito sexual contra niños, niñas y adolescentes",2017,4,2,2319,86.244070720138,0,1206,0,2,1113,179.694519317161
23282,19,19780,121,Tasa de exámenes médico legales por presunto delito sexual cuando la víctima está entre 18 y 28 años,2017,5,1,3806,26.2743037309511,0,2040,0,1,1766,56.6251415628539
23283,19,19807,81,"Tasa de exámenes médico legales por presunto delito sexual contra niños, niñas y adolescentes",2017,2,2,2679,74.6547219111609,1,1378,72.5689404934688,1,1301,76.8639508070715
23284,19,19807,81,"Tasa de exámenes médico legales por presunto delito sexual contra niños, niñas y adolescentes",2017,3,4,3202,124.921923797626,0,1669,0,4,1533,260.926288323549
23285,19,19807,81,"Tasa de exámenes médico legales por presunto delito sexual contra niños, niñas y adolescentes",2017,4,4,3322,120.409391932571,1,1758,56.8828213879408,3,1564,191.815856777494
23286,19,19807,121,Tasa de exámenes médico legales por presunto delito sexual cuando la víctima está entre 18 y 28 años,2017,5,2,6596,30.3214069132808,0,3472,0,2,3124,64.0204865556978
23287,19,19821,81,"Tasa de exámenes médico legales por presunto delito sexual contra niños, niñas y adolescentes",2017,3,1,3767,26.5463233342182,0,1918,0,1,1849,54.0832882639264
23288,19,19821,81,"Tasa de exámenes médico legales por presunto delito sexual contra niños, niñas y adolescentes",2017,4,1,3800,26.3157894736842,0,1954,0,1,1846,54.1711809317443
23289,19,19824,81,"Tasa de exámenes médico legales por presunto delito sexual contra niños, niñas y adolescentes",2017,4,1,2667,37.4953130858643,0,1359,0,1,1308,76.4525993883792
23290,19,19824,121,Tasa de exámenes médico legales por presunto delito sexual cuando la víctima está entre 18 y 28 años,2017,5,2,4082,48.9955903968643,0,2091,0,2,1991,100.452034153692
23291,19,19845,81,"Tasa de exámenes médico legales por presunto delito sexual contra niños, niñas y adolescentes",2017,3,3,1897,158.144438587243,1,964,103.734439834025,2,933,214.362272240086
23292,19,19845,81,"Tasa de exámenes médico legales por presunto delito sexual contra niños, niñas y adolescentes",2017,4,2,1976,101.214574898785,0,1007,0,2,969,206.398348813209
23293,19,19845,121,Tasa de exámenes médico legales por presunto delito sexual cuando la víctima está entre 18 y 28 años,2017,5,2,3326,60.1322910402886,0,1688,0,2,1638,122.100122100122
23294,20,20001,81,"Tasa de exámenes médico legales por presunto delito sexual contra niños, niñas y adolescentes",2017,2,42,44864,93.6162624821683,8,22854,35.0048131618097,34,22010,154.475238527942
23295,20,20001,81,"Tasa de exámenes médico legales por presunto delito sexual contra niños, niñas y adolescentes",2017,3,114,54773,208.131743742355,14,27684,50.5707267735876,100,27089,369.153530953524
23296,20,20001,81,"Tasa de exámenes médico legales por presunto delito sexual contra niños, niñas y adolescentes",2017,4,149,56112,265.540347875677,8,28494,28.0760861935846,141,27618,510.536606560939
23297,20,20001,121,Tasa de exámenes médico legales por presunto delito sexual cuando la víctima está entre 18 y 28 años,2017,5,22,95388,23.0636977397576,3,48577,6.17576219198386,19,46811,40.5887505073594
23298,20,20011,81,"Tasa de exámenes médico legales por presunto delito sexual contra niños, niñas y adolescentes",2017,2,9,9680,92.9752066115702,3,4921,60.9632188579557,6,4759,126.076906913217
23299,20,20011,81,"Tasa de exámenes médico legales por presunto delito sexual contra niños, niñas y adolescentes",2017,3,20,11455,174.596246180707,2,5830,34.3053173241852,18,5625,320
23300,20,20011,81,"Tasa de exámenes médico legales por presunto delito sexual contra niños, niñas y adolescentes",2017,4,19,11195,169.718624385887,1,5643,17.7210703526493,18,5552,324.207492795389
23301,20,20011,121,Tasa de exámenes médico legales por presunto delito sexual cuando la víctima está entre 18 y 28 años,2017,5,9,19349,46.5140317329061,1,9609,10.4069101883651,8,9740,82.135523613963
23302,20,20013,81,"Tasa de exámenes médico legales por presunto delito sexual contra niños, niñas y adolescentes",2017,2,6,5657,106.063284426374,2,2895,69.0846286701209,4,2762,144.822592324403
23303,20,20013,81,"Tasa de exámenes médico legales por presunto delito sexual contra niños, niñas y adolescentes",2017,3,6,6648,90.2527075812274,1,3399,29.4204177699323,5,3249,153.89350569406
23304,20,20013,81,"Tasa de exámenes médico legales por presunto delito sexual contra niños, niñas y adolescentes",2017,4,22,6367,345.531647557719,0,3259,0,22,3108,707.850707850708
23305,20,20013,121,Tasa de exámenes médico legales por presunto delito sexual cuando la víctima está entre 18 y 28 años,2017,5,6,9936,60.3864734299517,2,5126,39.0167772142021,4,4810,83.1600831600832
23306,20,20032,81,"Tasa de exámenes médico legales por presunto delito sexual contra niños, niñas y adolescentes",2017,2,1,2579,38.7747188832881,1,1330,75.187969924812,0,1249,0
23307,20,20032,81,"Tasa de exámenes médico legales por presunto delito sexual contra niños, niñas y adolescentes",2017,3,3,2895,103.626943005181,0,1515,0,3,1380,217.391304347826
23308,20,20032,81,"Tasa de exámenes médico legales por presunto delito sexual contra niños, niñas y adolescentes",2017,4,6,2522,237.906423473434,0,1325,0,6,1197,501.25313283208
23309,20,20032,121,Tasa de exámenes médico legales por presunto delito sexual cuando la víctima está entre 18 y 28 años,2017,5,1,3781,26.4480296217932,0,1958,0,1,1823,54.8546352166758
23310,20,20045,81,"Tasa de exámenes médico legales por presunto delito sexual contra niños, niñas y adolescentes",2017,2,2,1629,122.774708410068,0,849,0,2,780,256.410256410256
23311,20,20045,81,"Tasa de exámenes médico legales por presunto delito sexual contra niños, niñas y adolescentes",2017,3,2,1773,112.803158488438,1,943,106.044538706257,1,830,120.481927710843
23312,20,20045,81,"Tasa de exámenes médico legales por presunto delito sexual contra niños, niñas y adolescentes",2017,4,3,1744,172.018348623853,0,934,0,3,810,370.37037037037
23313,20,20045,121,Tasa de exámenes médico legales por presunto delito sexual cuando la víctima está entre 18 y 28 años,2017,5,1,2738,36.5230094959825,0,1466,0,1,1272,78.6163522012579
23314,20,20060,81,"Tasa de exámenes médico legales por presunto delito sexual contra niños, niñas y adolescentes",2017,2,7,4675,149.732620320856,1,2390,41.8410041841004,6,2285,262.582056892779
23315,20,20060,81,"Tasa de exámenes médico legales por presunto delito sexual contra niños, niñas y adolescentes",2017,3,8,5458,146.573836570172,4,2811,142.298114549982,4,2647,151.114469210427
23316,20,20060,81,"Tasa de exámenes médico legales por presunto delito sexual contra niños, niñas y adolescentes",2017,4,18,5079,354.400472533963,2,2627,76.1324704986677,16,2452,652.52854812398
23317,20,20060,121,Tasa de exámenes médico legales por presunto delito sexual cuando la víctima está entre 18 y 28 años,2017,5,2,7593,26.3400500460951,0,3922,0,2,3671,54.4810678289294
23318,20,20175,81,"Tasa de exámenes médico legales por presunto delito sexual contra niños, niñas y adolescentes",2017,4,1,4077,24.5278390973755,0,2200,0,1,1877,53.276505061268
23319,20,20178,81,"Tasa de exámenes médico legales por presunto delito sexual contra niños, niñas y adolescentes",2017,2,6,2201,272.603362108133,1,1126,88.809946714032,5,1075,465.116279069767
23320,20,20178,81,"Tasa de exámenes médico legales por presunto delito sexual contra niños, niñas y adolescentes",2017,3,3,2613,114.810562571757,0,1341,0,3,1272,235.849056603774
23321,20,20178,81,"Tasa de exámenes médico legales por presunto delito sexual contra niños, niñas y adolescentes",2017,4,4,2428,164.744645799012,0,1243,0,4,1185,337.552742616034
23322,20,20178,121,Tasa de exámenes médico legales por presunto delito sexual cuando la víctima está entre 18 y 28 años,2017,5,3,3721,80.6234883095942,1,1900,52.6315789473684,2,1821,109.829763866008
23323,20,20228,81,"Tasa de exámenes médico legales por presunto delito sexual contra niños, niñas y adolescentes",2017,2,2,2739,73.0193501277839,1,1398,71.5307582260372,1,1341,74.5712155108128
23324,20,20228,81,"Tasa de exámenes médico legales por presunto delito sexual contra niños, niñas y adolescentes",2017,3,6,3061,196.014374387455,1,1567,63.8162093171666,5,1494,334.672021419009
23325,20,20228,81,"Tasa de exámenes médico legales por presunto delito sexual contra niños, niñas y adolescentes",2017,4,11,2851,385.829533497019,0,1439,0,11,1412,779.036827195467
23326,20,20228,121,Tasa de exámenes médico legales por presunto delito sexual cuando la víctima está entre 18 y 28 años,2017,5,8,4643,172.302390695671,0,2306,0,8,2337,342.319212665811
23327,20,20238,81,"Tasa de exámenes médico legales por presunto delito sexual contra niños, niñas y adolescentes",2017,2,8,3191,250.705108116578,1,1632,61.2745098039216,7,1559,449.005772931366
23328,20,20238,81,"Tasa de exámenes médico legales por presunto delito sexual contra niños, niñas y adolescentes",2017,3,8,3554,225.098480585256,2,1812,110.37527593819,6,1742,344.43168771527
23329,20,20238,81,"Tasa de exámenes médico legales por presunto delito sexual contra niños, niñas y adolescentes",2017,4,3,3395,88.3652430044183,0,1720,0,3,1675,179.10447761194
23330,20,20250,81,"Tasa de exámenes médico legales por presunto delito sexual contra niños, niñas y adolescentes",2017,3,3,3243,92.5069380203515,0,1665,0,3,1578,190.114068441065
23331,20,20250,81,"Tasa de exámenes médico legales por presunto delito sexual contra niños, niñas y adolescentes",2017,4,3,3087,97.1817298347911,1,1565,63.8977635782748,2,1522,131.406044678055
23332,20,20295,81,"Tasa de exámenes médico legales por presunto delito sexual contra niños, niñas y adolescentes",2017,3,3,1840,163.04347826087,2,940,212.765957446809,1,900,111.111111111111
23333,20,20295,81,"Tasa de exámenes médico legales por presunto delito sexual contra niños, niñas y adolescentes",2017,4,1,1855,53.9083557951483,0,949,0,1,906,110.37527593819
23334,20,20295,121,Tasa de exámenes médico legales por presunto delito sexual cuando la víctima está entre 18 y 28 años,2017,5,1,3433,29.1290416545296,0,1795,0,1,1638,61.0500610500611
23335,20,20383,81,"Tasa de exámenes médico legales por presunto delito sexual contra niños, niñas y adolescentes",2017,2,2,1356,147.492625368732,1,696,143.67816091954,1,660,151.515151515152
23336,20,20383,81,"Tasa de exámenes médico legales por presunto delito sexual contra niños, niñas y adolescentes",2017,3,2,1654,120.918984280532,1,866,115.473441108545,1,788,126.903553299492
23337,20,20383,81,"Tasa de exámenes médico legales por presunto delito sexual contra niños, niñas y adolescentes",2017,4,3,1557,192.678227360308,1,827,120.918984280532,2,730,273.972602739726
23338,20,20400,81,"Tasa de exámenes médico legales por presunto delito sexual contra niños, niñas y adolescentes",2017,2,2,2461,81.2677773262901,0,1267,0,2,1194,167.50418760469
23339,20,20400,81,"Tasa de exámenes médico legales por presunto delito sexual contra niños, niñas y adolescentes",2017,3,9,2861,314.575323313527,2,1495,133.779264214047,7,1366,512.445095168375
23340,20,20400,81,"Tasa de exámenes médico legales por presunto delito sexual contra niños, niñas y adolescentes",2017,4,10,2699,370.507595405706,0,1436,0,10,1263,791.765637371338
23341,20,20400,121,Tasa de exámenes médico legales por presunto delito sexual cuando la víctima está entre 18 y 28 años,2017,5,1,4466,22.3914017017465,0,2367,0,1,2099,47.6417341591234
23342,20,20443,81,"Tasa de exámenes médico legales por presunto delito sexual contra niños, niñas y adolescentes",2017,2,1,1710,58.4795321637427,0,880,0,1,830,120.481927710843
23343,20,20443,81,"Tasa de exámenes médico legales por presunto delito sexual contra niños, niñas y adolescentes",2017,4,2,1958,102.145045965271,0,1014,0,2,944,211.864406779661
23344,20,20443,121,Tasa de exámenes médico legales por presunto delito sexual cuando la víctima está entre 18 y 28 años,2017,5,1,2873,34.8068221371389,0,1482,0,1,1391,71.8907260963336
23345,20,20550,81,"Tasa de exámenes médico legales por presunto delito sexual contra niños, niñas y adolescentes",2017,2,1,2068,48.3558994197292,0,1056,0,1,1012,98.8142292490118
23346,20,20550,81,"Tasa de exámenes médico legales por presunto delito sexual contra niños, niñas y adolescentes",2017,3,1,2421,41.3052457662123,0,1239,0,1,1182,84.6023688663282
23347,20,20550,81,"Tasa de exámenes médico legales por presunto delito sexual contra niños, niñas y adolescentes",2017,4,2,2252,88.809946714032,0,1151,0,2,1101,181.653042688465
23348,20,20550,121,Tasa de exámenes médico legales por presunto delito sexual cuando la víctima está entre 18 y 28 años,2017,5,1,3769,26.5322366675511,0,1891,0,1,1878,53.248136315229
23349,20,20570,81,"Tasa de exámenes médico legales por presunto delito sexual contra niños, niñas y adolescentes",2017,2,1,3214,31.1138767890479,1,1658,60.313630880579,0,1556,0
23350,20,20570,81,"Tasa de exámenes médico legales por presunto delito sexual contra niños, niñas y adolescentes",2017,3,2,3433,58.2580833090591,0,1802,0,2,1631,122.624156958921
23351,20,20570,81,"Tasa de exámenes médico legales por presunto delito sexual contra niños, niñas y adolescentes",2017,4,1,3359,29.7707651086633,0,1786,0,1,1573,63.5727908455181
23352,20,20614,81,"Tasa de exámenes médico legales por presunto delito sexual contra niños, niñas y adolescentes",2017,3,1,1459,68.5400959561343,1,753,132.802124833997,0,706,0
23353,20,20614,81,"Tasa de exámenes médico legales por presunto delito sexual contra niños, niñas y adolescentes",2017,4,1,1440,69.4444444444444,0,756,0,1,684,146.198830409357
23354,20,20621,81,"Tasa de exámenes médico legales por presunto delito sexual contra niños, niñas y adolescentes",2017,2,2,2576,77.639751552795,2,1325,150.943396226415,0,1251,0
23355,20,20621,81,"Tasa de exámenes médico legales por presunto delito sexual contra niños, niñas y adolescentes",2017,3,3,2998,100.066711140761,2,1549,129.11555842479,1,1449,69.0131124913734
23356,20,20621,81,"Tasa de exámenes médico legales por presunto delito sexual contra niños, niñas y adolescentes",2017,4,3,2956,101.48849797023,0,1524,0,3,1432,209.497206703911
23357,20,20710,81,"Tasa de exámenes médico legales por presunto delito sexual contra niños, niñas y adolescentes",2017,3,1,2975,33.6134453781513,1,1504,66.4893617021277,0,1471,0
23358,20,20710,81,"Tasa de exámenes médico legales por presunto delito sexual contra niños, niñas y adolescentes",2017,4,2,2817,70.997515086972,1,1412,70.8215297450425,1,1405,71.1743772241993
23359,20,20750,81,"Tasa de exámenes médico legales por presunto delito sexual contra niños, niñas y adolescentes",2017,2,2,1428,140.056022408964,1,733,136.425648021828,1,695,143.884892086331
23360,20,20750,81,"Tasa de exámenes médico legales por presunto delito sexual contra niños, niñas y adolescentes",2017,4,2,1640,121.951219512195,0,870,0,2,770,259.74025974026
23361,20,20770,81,"Tasa de exámenes médico legales por presunto delito sexual contra niños, niñas y adolescentes",2017,3,2,2277,87.8348704435661,0,1177,0,2,1100,181.818181818182
23362,20,20770,81,"Tasa de exámenes médico legales por presunto delito sexual contra niños, niñas y adolescentes",2017,4,5,2180,229.357798165138,0,1120,0,5,1060,471.698113207547
23363,20,20770,121,Tasa de exámenes médico legales por presunto delito sexual cuando la víctima está entre 18 y 28 años,2017,5,1,3942,25.3678335870117,0,2001,0,1,1941,51.5198351365276
23364,20,20787,81,"Tasa de exámenes médico legales por presunto delito sexual contra niños, niñas y adolescentes",2017,3,2,1814,110.253583241455,0,950,0,2,864,231.481481481481
23365,23,23001,81,"Tasa de exámenes médico legales por presunto delito sexual contra niños, niñas y adolescentes",2017,2,27,40377,66.8697525819154,8,20546,38.9370193711671,19,19831,95.8095910443245
23366,23,23001,81,"Tasa de exámenes médico legales por presunto delito sexual contra niños, niñas y adolescentes",2017,3,81,49399,163.970930585639,18,24920,72.23113964687,63,24479,257.363454389477
23367,23,23001,81,"Tasa de exámenes médico legales por presunto delito sexual contra niños, niñas y adolescentes",2017,4,141,49536,284.641472868217,20,24858,80.4569957357792,121,24678,490.315260555961
23368,23,23001,121,Tasa de exámenes médico legales por presunto delito sexual cuando la víctima está entre 18 y 28 años,2017,5,17,90229,18.8409491405202,2,45798,4.36700292589196,15,44431,33.7602124642704
23369,23,23068,81,"Tasa de exámenes médico legales por presunto delito sexual contra niños, niñas y adolescentes",2017,2,1,6150,16.260162601626,0,3165,0,1,2985,33.500837520938
23370,23,23068,81,"Tasa de exámenes médico legales por presunto delito sexual contra niños, niñas y adolescentes",2017,3,1,6843,14.6134736226801,0,3600,0,1,3243,30.8356460067838
23371,23,23068,81,"Tasa de exámenes médico legales por presunto delito sexual contra niños, niñas y adolescentes",2017,4,1,6402,15.6201187129022,1,3454,28.9519397799653,0,2948,0
23372,23,23079,81,"Tasa de exámenes médico legales por presunto delito sexual contra niños, niñas y adolescentes",2017,2,1,2567,38.9559797428905,0,1321,0,1,1246,80.2568218298555
23373,23,23090,81,"Tasa de exámenes médico legales por presunto delito sexual contra niños, niñas y adolescentes",2017,2,1,2644,37.821482602118,0,1374,0,1,1270,78.740157480315
23374,23,23090,81,"Tasa de exámenes médico legales por presunto delito sexual contra niños, niñas y adolescentes",2017,3,2,2772,72.1500721500721,0,1495,0,2,1277,156.617071260767
23375,23,23090,81,"Tasa de exámenes médico legales por presunto delito sexual contra niños, niñas y adolescentes",2017,4,3,2596,115.562403697997,0,1443,0,3,1153,260.1908065915
23376,23,23162,81,"Tasa de exámenes médico legales por presunto delito sexual contra niños, niñas y adolescentes",2017,2,3,8108,37.0004933399112,1,4141,24.1487563390485,2,3967,50.4159314343333
23377,23,23162,81,"Tasa de exámenes médico legales por presunto delito sexual contra niños, niñas y adolescentes",2017,3,9,9813,91.7150718434729,2,4931,40.5597241938755,7,4882,143.38385907415
23378,23,23162,81,"Tasa de exámenes médico legales por presunto delito sexual contra niños, niñas y adolescentes",2017,4,18,9813,183.430143686946,2,4864,41.1184210526316,16,4949,323.297635886038
23379,23,23162,121,Tasa de exámenes médico legales por presunto delito sexual cuando la víctima está entre 18 y 28 años,2017,5,5,17918,27.9049001004576,2,8975,22.2841225626741,3,8943,33.5457900033546
23380,23,23168,81,"Tasa de exámenes médico legales por presunto delito sexual contra niños, niñas y adolescentes",2017,3,6,1763,340.328984685196,0,914,0,6,849,706.713780918728
23381,23,23168,81,"Tasa de exámenes médico legales por presunto delito sexual contra niños, niñas y adolescentes",2017,4,1,1681,59.4883997620464,1,869,115.074798619102,0,812,0
23382,23,23182,81,"Tasa de exámenes médico legales por presunto delito sexual contra niños, niñas y adolescentes",2017,2,2,4369,45.7770656900893,1,2203,45.3926463912846,1,2166,46.1680517082179
23383,23,23182,81,"Tasa de exámenes médico legales por presunto delito sexual contra niños, niñas y adolescentes",2017,3,2,5109,39.1466040321002,0,2553,0,2,2556,78.2472613458529
23384,23,23182,81,"Tasa de exámenes médico legales por presunto delito sexual contra niños, niñas y adolescentes",2017,4,4,4907,81.5162013450173,1,2460,40.650406504065,3,2447,122.599100939926
23385,23,23182,121,Tasa de exámenes médico legales por presunto delito sexual cuando la víctima está entre 18 y 28 años,2017,5,3,9493,31.6022332244812,0,4862,0,3,4631,64.7808248758368
23386,23,23189,81,"Tasa de exámenes médico legales por presunto delito sexual contra niños, niñas y adolescentes",2017,2,1,6575,15.2091254752852,0,3381,0,1,3194,31.3087038196619
23387,23,23189,81,"Tasa de exámenes médico legales por presunto delito sexual contra niños, niñas y adolescentes",2017,3,6,7730,77.6196636481242,1,4001,24.9937515621095,5,3729,134.084204880665
23388,23,23189,81,"Tasa de exámenes médico legales por presunto delito sexual contra niños, niñas y adolescentes",2017,4,11,7483,146.999866363758,1,3864,25.879917184265,10,3619,276.319425255595
23389,23,23189,121,Tasa de exámenes médico legales por presunto delito sexual cuando la víctima está entre 18 y 28 años,2017,5,3,13097,22.9060090096969,0,6790,0,3,6307,47.5661962898367
23390,23,23300,81,"Tasa de exámenes médico legales por presunto delito sexual contra niños, niñas y adolescentes",2017,2,2,1310,152.671755725191,1,671,149.03129657228,1,639,156.494522691706
23391,23,23300,81,"Tasa de exámenes médico legales por presunto delito sexual contra niños, niñas y adolescentes",2017,3,3,1490,201.342281879195,0,767,0,3,723,414.9377593361
23392,23,23300,81,"Tasa de exámenes médico legales por presunto delito sexual contra niños, niñas y adolescentes",2017,4,3,1505,199.335548172757,0,773,0,3,732,409.83606557377
23393,23,23350,81,"Tasa de exámenes médico legales por presunto delito sexual contra niños, niñas y adolescentes",2017,3,1,2096,47.7099236641221,0,1056,0,1,1040,96.1538461538462
23394,23,23350,81,"Tasa de exámenes médico legales por presunto delito sexual contra niños, niñas y adolescentes",2017,4,1,1978,50.5561172901921,0,993,0,1,985,101.522842639594
23395,23,23417,81,"Tasa de exámenes médico legales por presunto delito sexual contra niños, niñas y adolescentes",2017,2,9,12064,74.6021220159151,2,6174,32.3939099449303,7,5890,118.845500848896
23396,23,23417,81,"Tasa de exámenes médico legales por presunto delito sexual contra niños, niñas y adolescentes",2017,3,14,14142,98.9958987413379,0,7276,0,14,6866,203.903291581707
23397,23,23417,81,"Tasa de exámenes médico legales por presunto delito sexual contra niños, niñas y adolescentes",2017,4,17,13342,127.417178833758,1,6810,14.6842878120411,16,6532,244.947948560931
23398,23,23417,121,Tasa de exámenes médico legales por presunto delito sexual cuando la víctima está entre 18 y 28 años,2017,5,3,23613,12.7048659636641,0,12110,0,3,11503,26.0801530035643
23399,23,23419,81,"Tasa de exámenes médico legales por presunto delito sexual contra niños, niñas y adolescentes",2017,3,2,3558,56.2113546936481,0,1822,0,2,1736,115.207373271889
23400,23,23419,81,"Tasa de exámenes médico legales por presunto delito sexual contra niños, niñas y adolescentes",2017,4,2,3235,61.8238021638331,0,1668,0,2,1567,127.632418634333
23401,23,23464,81,"Tasa de exámenes médico legales por presunto delito sexual contra niños, niñas y adolescentes",2017,4,3,1650,181.818181818182,0,842,0,3,808,371.287128712871
23402,23,23464,121,Tasa de exámenes médico legales por presunto delito sexual cuando la víctima está entre 18 y 28 años,2017,5,2,2903,68.8942473303479,0,1443,0,2,1460,136.986301369863
23403,23,23466,81,"Tasa de exámenes médico legales por presunto delito sexual contra niños, niñas y adolescentes",2017,2,6,9298,64.5300064530007,1,4731,21.137180300148,5,4567,109.481059776659
23404,23,23466,81,"Tasa de exámenes médico legales por presunto delito sexual contra niños, niñas y adolescentes",2017,3,16,10640,150.375939849624,4,5368,74.5156482861401,12,5272,227.617602427921
23405,23,23466,81,"Tasa de exámenes médico legales por presunto delito sexual contra niños, niñas y adolescentes",2017,4,22,10148,216.791486007095,1,5031,19.8767640628106,21,5117,410.396716826265
23406,23,23466,121,Tasa de exámenes médico legales por presunto delito sexual cuando la víctima está entre 18 y 28 años,2017,5,5,17813,28.0693875259642,1,8831,11.3237458951421,4,8982,44.5335114673792
23407,23,23500,81,"Tasa de exámenes médico legales por presunto delito sexual contra niños, niñas y adolescentes",2017,3,4,3852,103.842159916926,0,1988,0,4,1864,214.592274678112
23408,23,23500,81,"Tasa de exámenes médico legales por presunto delito sexual contra niños, niñas y adolescentes",2017,4,3,3439,87.2346612387322,0,1771,0,3,1668,179.856115107914
23409,23,23555,81,"Tasa de exámenes médico legales por presunto delito sexual contra niños, niñas y adolescentes",2017,2,7,6857,102.085460113752,2,3503,57.0939194975735,5,3354,149.075730471079
23410,23,23555,81,"Tasa de exámenes médico legales por presunto delito sexual contra niños, niñas y adolescentes",2017,3,7,8074,86.6980431013129,1,4111,24.3249817562637,6,3963,151.400454201363
23411,23,23555,81,"Tasa de exámenes médico legales por presunto delito sexual contra niños, niñas y adolescentes",2017,4,16,7684,208.224882873503,4,3907,102.380342974149,12,3777,317.712470214456
23412,23,23555,121,Tasa de exámenes médico legales por presunto delito sexual cuando la víctima está entre 18 y 28 años,2017,5,2,13849,14.4414759188389,0,7067,0,2,6782,29.4898260100265
23413,23,23570,81,"Tasa de exámenes médico legales por presunto delito sexual contra niños, niñas y adolescentes",2017,3,2,5080,39.3700787401575,1,2610,38.3141762452107,1,2470,40.4858299595142
23414,23,23570,81,"Tasa de exámenes médico legales por presunto delito sexual contra niños, niñas y adolescentes",2017,4,2,4668,42.8449014567267,0,2414,0,2,2254,88.7311446317658
23415,23,23574,81,"Tasa de exámenes médico legales por presunto delito sexual contra niños, niñas y adolescentes",2017,2,1,3861,25.9000259000259,1,1986,50.3524672708963,0,1875,0
23416,23,23574,81,"Tasa de exámenes médico legales por presunto delito sexual contra niños, niñas y adolescentes",2017,3,4,4161,96.1307378034126,1,2179,45.8926112895824,3,1982,151.362260343088
23417,23,23574,81,"Tasa de exámenes médico legales por presunto delito sexual contra niños, niñas y adolescentes",2017,4,11,3774,291.467938526762,4,2013,198.708395429707,7,1761,397.501419647927
23418,23,23580,81,"Tasa de exámenes médico legales por presunto delito sexual contra niños, niñas y adolescentes",2017,2,2,6220,32.1543408360129,0,3193,0,2,3027,66.0720185001652
23419,23,23580,81,"Tasa de exámenes médico legales por presunto delito sexual contra niños, niñas y adolescentes",2017,3,3,6922,43.3400751227969,1,3571,28.0033604032484,2,3351,59.6836765144733
23420,23,23580,81,"Tasa de exámenes médico legales por presunto delito sexual contra niños, niñas y adolescentes",2017,4,1,6444,15.5183116076971,0,3328,0,1,3116,32.0924261874198
23421,23,23586,81,"Tasa de exámenes médico legales por presunto delito sexual contra niños, niñas y adolescentes",2017,3,1,1851,54.0248514316586,0,964,0,1,887,112.739571589628
23422,23,23586,81,"Tasa de exámenes médico legales por presunto delito sexual contra niños, niñas y adolescentes",2017,4,4,1765,226.628895184136,0,918,0,4,847,472.255017709563
23423,23,23660,81,"Tasa de exámenes médico legales por presunto delito sexual contra niños, niñas y adolescentes",2017,3,1,9956,10.0441944556047,0,5073,0,1,4883,20.4792135981978
23424,23,23660,81,"Tasa de exámenes médico legales por presunto delito sexual contra niños, niñas y adolescentes",2017,4,11,9677,113.671592435672,0,4917,0,11,4760,231.09243697479
23425,23,23670,81,"Tasa de exámenes médico legales por presunto delito sexual contra niños, niñas y adolescentes",2017,2,2,5809,34.4293337923911,0,2903,0,2,2906,68.8231245698555
23426,23,23670,81,"Tasa de exámenes médico legales por presunto delito sexual contra niños, niñas y adolescentes",2017,3,1,6000,16.6666666666667,0,3052,0,1,2948,33.921302578019
23427,23,23670,81,"Tasa de exámenes médico legales por presunto delito sexual contra niños, niñas y adolescentes",2017,4,6,5549,108.127590556857,0,2902,0,6,2647,226.67170381564
23428,23,23672,81,"Tasa de exámenes médico legales por presunto delito sexual contra niños, niñas y adolescentes",2017,2,1,3266,30.6184935701163,0,1661,0,1,1605,62.3052959501558
23429,23,23672,81,"Tasa de exámenes médico legales por presunto delito sexual contra niños, niñas y adolescentes",2017,3,4,3730,107.238605898123,2,1890,105.820105820106,2,1840,108.695652173913
23430,23,23672,81,"Tasa de exámenes médico legales por presunto delito sexual contra niños, niñas y adolescentes",2017,4,6,3576,167.785234899329,0,1828,0,6,1748,343.24942791762
23431,23,23672,121,Tasa de exámenes médico legales por presunto delito sexual cuando la víctima está entre 18 y 28 años,2017,5,1,6668,14.99700059988,0,3422,0,1,3246,30.8071472581639
23432,23,23675,81,"Tasa de exámenes médico legales por presunto delito sexual contra niños, niñas y adolescentes",2017,2,1,3874,25.8131130614352,0,1990,0,1,1884,53.0785562632696
23433,23,23675,81,"Tasa de exámenes médico legales por presunto delito sexual contra niños, niñas y adolescentes",2017,4,10,3863,258.866166192079,0,2041,0,10,1822,548.847420417124
23434,23,23678,81,"Tasa de exámenes médico legales por presunto delito sexual contra niños, niñas y adolescentes",2017,3,2,3382,59.1366055588409,0,1719,0,2,1663,120.264582080577
23435,23,23678,81,"Tasa de exámenes médico legales por presunto delito sexual contra niños, niñas y adolescentes",2017,4,4,3120,128.205128205128,0,1585,0,4,1535,260.586319218241
23436,23,23682,81,"Tasa de exámenes médico legales por presunto delito sexual contra niños, niñas y adolescentes",2017,4,5,1390,359.712230215827,0,735,0,5,655,763.358778625954
23437,23,23686,81,"Tasa de exámenes médico legales por presunto delito sexual contra niños, niñas y adolescentes",2017,3,5,4721,105.909764880322,2,2418,82.7129859387924,3,2303,130.264871906209
23438,23,23686,81,"Tasa de exámenes médico legales por presunto delito sexual contra niños, niñas y adolescentes",2017,4,5,4674,106.974753958066,0,2372,0,5,2302,217.202432667246
23439,23,23686,121,Tasa de exámenes médico legales por presunto delito sexual cuando la víctima está entre 18 y 28 años,2017,5,2,8487,23.5654530458348,0,4303,0,2,4184,47.8011472275335
23440,23,23807,81,"Tasa de exámenes médico legales por presunto delito sexual contra niños, niñas y adolescentes",2017,2,1,13136,7.61266747868453,0,6700,0,1,6436,15.5376009944065
23441,23,23807,81,"Tasa de exámenes médico legales por presunto delito sexual contra niños, niñas y adolescentes",2017,3,4,14413,27.7527232359675,3,7356,40.7830342577488,1,7057,14.1703273345614
23442,23,23807,81,"Tasa de exámenes médico legales por presunto delito sexual contra niños, niñas y adolescentes",2017,4,1,13276,7.53238927387767,0,6779,0,1,6497,15.3917192550408
23443,23,23815,81,"Tasa de exámenes médico legales por presunto delito sexual contra niños, niñas y adolescentes",2017,2,1,5856,17.0765027322404,0,3020,0,1,2836,35.2609308885755
23444,23,23815,81,"Tasa de exámenes médico legales por presunto delito sexual contra niños, niñas y adolescentes",2017,3,8,6275,127.490039840637,1,3199,31.2597686777118,7,3076,227.568270481144
23445,23,23815,81,"Tasa de exámenes médico legales por presunto delito sexual contra niños, niñas y adolescentes",2017,4,7,5439,128.700128700129,0,2761,0,7,2678,261.389096340553
23446,23,23815,121,Tasa de exámenes médico legales por presunto delito sexual cuando la víctima está entre 18 y 28 años,2017,5,1,7839,12.7567291746396,0,4188,0,1,3651,27.3897562311695
23447,23,23855,81,"Tasa de exámenes médico legales por presunto delito sexual contra niños, niñas y adolescentes",2017,4,1,5464,18.3016105417277,0,2847,0,1,2617,38.2116927779901
23448,23,23855,121,Tasa de exámenes médico legales por presunto delito sexual cuando la víctima está entre 18 y 28 años,2017,5,1,9067,11.0290062865336,0,4731,0,1,4336,23.0627306273063
23449,25,25001,81,"Tasa de exámenes médico legales por presunto delito sexual contra niños, niñas y adolescentes",2017,3,3,1050,285.714285714286,1,546,183.150183150183,2,504,396.825396825397
23450,25,25001,81,"Tasa de exámenes médico legales por presunto delito sexual contra niños, niñas y adolescentes",2017,4,1,1009,99.1080277502478,0,518,0,1,491,203.665987780041
23451,25,25001,121,Tasa de exámenes médico legales por presunto delito sexual cuando la víctima está entre 18 y 28 años,2017,5,1,1865,53.6193029490617,0,953,0,1,912,109.649122807018
23452,25,25019,81,"Tasa de exámenes médico legales por presunto delito sexual contra niños, niñas y adolescentes",2017,3,2,611,327.332242225859,2,305,655.737704918033,0,306,0
23453,25,25019,81,"Tasa de exámenes médico legales por presunto delito sexual contra niños, niñas y adolescentes",2017,4,2,604,331.12582781457,0,294,0,2,310,645.161290322581
23454,25,25035,81,"Tasa de exámenes médico legales por presunto delito sexual contra niños, niñas y adolescentes",2017,2,1,1116,89.6057347670251,0,568,0,1,548,182.481751824818
23455,25,25035,81,"Tasa de exámenes médico legales por presunto delito sexual contra niños, niñas y adolescentes",2017,3,1,1230,81.3008130081301,1,623,160.513643659711,0,607,0
23456,25,25035,81,"Tasa de exámenes médico legales por presunto delito sexual contra niños, niñas y adolescentes",2017,4,5,1260,396.825396825397,0,640,0,5,620,806.451612903226
23457,25,25035,121,Tasa de exámenes médico legales por presunto delito sexual cuando la víctima está entre 18 y 28 años,2017,5,1,2787,35.880875493362,0,1421,0,1,1366,73.2064421669107
23458,25,25040,81,"Tasa de exámenes médico legales por presunto delito sexual contra niños, niñas y adolescentes",2017,2,3,1004,298.804780876494,2,513,389.863547758285,1,491,203.665987780041
23459,25,25040,81,"Tasa de exámenes médico legales por presunto delito sexual contra niños, niñas y adolescentes",2017,3,1,1189,84.1042893187552,0,608,0,1,581,172.117039586919
23460,25,25040,81,"Tasa de exámenes médico legales por presunto delito sexual contra niños, niñas y adolescentes",2017,4,9,1083,831.024930747922,0,564,0,9,519,1734.10404624277
23461,25,25040,121,Tasa de exámenes médico legales por presunto delito sexual cuando la víctima está entre 18 y 28 años,2017,5,1,2084,47.9846449136276,0,1109,0,1,975,102.564102564103
23462,25,25053,81,"Tasa de exámenes médico legales por presunto delito sexual contra niños, niñas y adolescentes",2017,3,2,1469,136.147038801906,0,751,0,2,718,278.551532033426
23463,25,25053,81,"Tasa de exámenes médico legales por presunto delito sexual contra niños, niñas y adolescentes",2017,4,1,1424,70.2247191011236,0,717,0,1,707,141.442715700141
23464,25,25095,121,Tasa de exámenes médico legales por presunto delito sexual cuando la víctima está entre 18 y 28 años,2017,5,1,526,190.114068441065,0,285,0,1,241,414.9377593361
23465,25,25099,81,"Tasa de exámenes médico legales por presunto delito sexual contra niños, niñas y adolescentes",2017,2,1,1317,75.9301442672741,0,671,0,1,646,154.798761609907
23466,25,25099,81,"Tasa de exámenes médico legales por presunto delito sexual contra niños, niñas y adolescentes",2017,4,2,1467,136.332651670075,0,745,0,2,722,277.008310249307
23467,25,25123,81,"Tasa de exámenes médico legales por presunto delito sexual contra niños, niñas y adolescentes",2017,2,1,1050,95.2380952380952,1,535,186.915887850467,0,515,0
23468,25,25123,81,"Tasa de exámenes médico legales por presunto delito sexual contra niños, niñas y adolescentes",2017,3,2,1255,159.362549800797,0,633,0,2,622,321.543408360129
23469,25,25123,81,"Tasa de exámenes médico legales por presunto delito sexual contra niños, niñas y adolescentes",2017,4,7,1205,580.912863070539,1,612,163.398692810458,6,593,1011.80438448567
23470,25,25126,81,"Tasa de exámenes médico legales por presunto delito sexual contra niños, niñas y adolescentes",2017,2,6,4900,122.448979591837,2,2503,79.9041150619257,4,2397,166.875260742595
23471,25,25126,81,"Tasa de exámenes médico legales por presunto delito sexual contra niños, niñas y adolescentes",2017,3,13,6245,208.166533226581,2,3267,61.2182430364249,11,2978,369.375419744795
23472,25,25126,81,"Tasa de exámenes médico legales por presunto delito sexual contra niños, niñas y adolescentes",2017,4,20,6390,312.989045383412,3,3365,89.1530460624071,17,3025,561.98347107438
23473,25,25126,121,Tasa de exámenes médico legales por presunto delito sexual cuando la víctima está entre 18 y 28 años,2017,5,2,11535,17.3385348938015,0,5951,0,2,5584,35.8166189111748
23474,25,25126,81,"Tasa de exámenes médico legales por presunto delito sexual contra niños, niñas y adolescentes",2017,1,1,963,103.842159916926,0,499,0,1,464,215.51724137931
23475,25,25148,81,"Tasa de exámenes médico legales por presunto delito sexual contra niños, niñas y adolescentes",2017,3,2,1690,118.343195266272,0,874,0,2,816,245.098039215686
23476,25,25148,81,"Tasa de exámenes médico legales por presunto delito sexual contra niños, niñas y adolescentes",2017,4,5,1630,306.748466257669,0,854,0,5,776,644.329896907216
23477,25,25151,81,"Tasa de exámenes médico legales por presunto delito sexual contra niños, niñas y adolescentes",2017,2,3,1483,202.292650033715,0,758,0,3,725,413.793103448276
23478,25,25151,81,"Tasa de exámenes médico legales por presunto delito sexual contra niños, niñas y adolescentes",2017,3,1,1761,56.785917092561,0,902,0,1,859,116.414435389988
23479,25,25151,81,"Tasa de exámenes médico legales por presunto delito sexual contra niños, niñas y adolescentes",2017,4,7,1715,408.163265306122,0,886,0,7,829,844.390832328106
23480,25,25151,121,Tasa de exámenes médico legales por presunto delito sexual cuando la víctima está entre 18 y 28 años,2017,5,1,3231,30.9501702259362,0,1688,0,1,1543,64.8088139987038
23481,25,25154,81,"Tasa de exámenes médico legales por presunto delito sexual contra niños, niñas y adolescentes",2017,2,1,778,128.53470437018,0,403,0,1,375,266.666666666667
23482,25,25154,81,"Tasa de exámenes médico legales por presunto delito sexual contra niños, niñas y adolescentes",2017,3,1,916,109.170305676856,1,481,207.900207900208,0,435,0
23483,25,25154,81,"Tasa de exámenes médico legales por presunto delito sexual contra niños, niñas y adolescentes",2017,4,2,901,221.975582685905,0,477,0,2,424,471.698113207547
23484,25,25168,121,Tasa de exámenes médico legales por presunto delito sexual cuando la víctima está entre 18 y 28 años,2017,5,1,781,128.040973111396,0,413,0,1,368,271.739130434783
23485,25,25175,81,"Tasa de exámenes médico legales por presunto delito sexual contra niños, niñas y adolescentes",2017,2,8,10466,76.4379896808714,1,5341,18.723085564501,7,5125,136.585365853659
23486,25,25175,81,"Tasa de exámenes médico legales por presunto delito sexual contra niños, niñas y adolescentes",2017,3,9,12945,69.5249130938586,0,6613,0,9,6332,142.135186355022
23487,25,25175,81,"Tasa de exámenes médico legales por presunto delito sexual contra niños, niñas y adolescentes",2017,4,18,13107,137.331197070268,4,6565,60.9291698400609,14,6542,214.001834301437
23488,25,25175,121,Tasa de exámenes médico legales por presunto delito sexual cuando la víctima está entre 18 y 28 años,2017,5,4,24707,16.1897437973044,0,12254,0,4,12453,32.1207741106561
23489,25,25175,81,"Tasa de exámenes médico legales por presunto delito sexual contra niños, niñas y adolescentes",2017,1,1,2077,48.1463649494463,0,1070,0,1,1007,99.304865938431
23490,25,25178,81,"Tasa de exámenes médico legales por presunto delito sexual contra niños, niñas y adolescentes",2017,3,1,960,104.166666666667,0,504,0,1,456,219.298245614035
23491,25,25178,81,"Tasa de exámenes médico legales por presunto delito sexual contra niños, niñas y adolescentes",2017,4,3,905,331.491712707182,0,476,0,3,429,699.300699300699
23492,25,25178,121,Tasa de exámenes médico legales por presunto delito sexual cuando la víctima está entre 18 y 28 años,2017,5,1,1487,67.2494956287828,0,784,0,1,703,142.247510668563
23493,25,25181,81,"Tasa de exámenes médico legales por presunto delito sexual contra niños, niñas y adolescentes",2017,3,2,1202,166.389351081531,0,612,0,2,590,338.983050847458
23494,25,25181,81,"Tasa de exámenes médico legales por presunto delito sexual contra niños, niñas y adolescentes",2017,4,4,1106,361.663652802893,1,567,176.36684303351,3,539,556.586270871985
23495,25,25181,121,Tasa de exámenes médico legales por presunto delito sexual cuando la víctima está entre 18 y 28 años,2017,5,1,1854,53.9374325782093,0,972,0,1,882,113.378684807256
23496,25,25183,81,"Tasa de exámenes médico legales por presunto delito sexual contra niños, niñas y adolescentes",2017,2,2,2461,81.2677773262901,1,1259,79.428117553614,1,1202,83.1946755407654
23497,25,25183,81,"Tasa de exámenes médico legales por presunto delito sexual contra niños, niñas y adolescentes",2017,3,3,2811,106.723585912487,0,1427,0,3,1384,216.763005780347
23498,25,25183,81,"Tasa de exámenes médico legales por presunto delito sexual contra niños, niñas y adolescentes",2017,4,10,2676,373.692077727952,0,1352,0,10,1324,755.287009063444
23499,25,25200,81,"Tasa de exámenes médico legales por presunto delito sexual contra niños, niñas y adolescentes",2017,3,4,2468,162.074554294976,1,1219,82.0344544708778,3,1249,240.192153722978
23500,25,25200,81,"Tasa de exámenes médico legales por presunto delito sexual contra niños, niñas y adolescentes",2017,4,2,2501,79.968012794882,1,1256,79.6178343949045,1,1245,80.3212851405623
23501,25,25214,81,"Tasa de exámenes médico legales por presunto delito sexual contra niños, niñas y adolescentes",2017,2,1,2146,46.5983224603914,1,1100,90.9090909090909,0,1046,0
23502,25,25214,81,"Tasa de exámenes médico legales por presunto delito sexual contra niños, niñas y adolescentes",2017,4,1,2645,37.8071833648393,0,1326,0,1,1319,75.8150113722517
23503,25,25214,121,Tasa de exámenes médico legales por presunto delito sexual cuando la víctima está entre 18 y 28 años,2017,5,2,4992,40.0641025641026,0,2487,0,2,2505,79.8403193612774
23504,25,25224,81,"Tasa de exámenes médico legales por presunto delito sexual contra niños, niñas y adolescentes",2017,3,2,1011,197.82393669634,1,523,191.204588910134,1,488,204.918032786885
23505,25,25224,81,"Tasa de exámenes médico legales por presunto delito sexual contra niños, niñas y adolescentes",2017,4,1,921,108.5776330076,0,480,0,1,441,226.757369614512
23506,25,25245,81,"Tasa de exámenes médico legales por presunto delito sexual contra niños, niñas y adolescentes",2017,2,2,1711,116.890707188778,0,878,0,2,833,240.096038415366
23507,25,25245,81,"Tasa de exámenes médico legales por presunto delito sexual contra niños, niñas y adolescentes",2017,3,9,2101,428.36744407425,3,1062,282.485875706215,6,1039,577.478344562079
23508,25,25245,81,"Tasa de exámenes médico legales por presunto delito sexual contra niños, niñas y adolescentes",2017,4,15,2147,698.649278062413,3,1087,275.988960441582,12,1060,1132.07547169811
23509,25,25245,121,Tasa de exámenes médico legales por presunto delito sexual cuando la víctima está entre 18 y 28 años,2017,5,2,4069,49.1521258294421,0,2048,0,2,2021,98.9609104403761
23510,25,25258,81,"Tasa de exámenes médico legales por presunto delito sexual contra niños, niñas y adolescentes",2017,3,1,433,230.94688221709,0,227,0,1,206,485.436893203883
23511,25,25258,81,"Tasa de exámenes médico legales por presunto delito sexual contra niños, niñas y adolescentes",2017,4,1,420,238.095238095238,0,219,0,1,201,497.512437810945
23512,25,25260,81,"Tasa de exámenes médico legales por presunto delito sexual contra niños, niñas y adolescentes",2017,3,3,2151,139.470013947001,0,1089,0,3,1062,282.485875706215
23513,25,25260,81,"Tasa de exámenes médico legales por presunto delito sexual contra niños, niñas y adolescentes",2017,4,5,2183,229.042601923958,0,1089,0,5,1094,457.038391224863
23514,25,25269,81,"Tasa de exámenes médico legales por presunto delito sexual contra niños, niñas y adolescentes",2017,2,15,12019,124.802396206007,4,6169,64.8403306856865,11,5850,188.034188034188
23515,25,25269,81,"Tasa de exámenes médico legales por presunto delito sexual contra niños, niñas y adolescentes",2017,3,29,14820,195.681511470985,11,7572,145.27205493925,18,7248,248.344370860927
23516,25,25269,81,"Tasa de exámenes médico legales por presunto delito sexual contra niños, niñas y adolescentes",2017,4,34,14813,229.528117194356,0,7616,0,34,7197,472.41906349868
23517,25,25269,121,Tasa de exámenes médico legales por presunto delito sexual cuando la víctima está entre 18 y 28 años,2017,5,7,25905,27.0218104613009,0,13172,0,7,12733,54.9752611324904
23518,25,25279,81,"Tasa de exámenes médico legales por presunto delito sexual contra niños, niñas y adolescentes",2017,2,1,1027,97.3709834469328,0,533,0,1,494,202.429149797571
23519,25,25281,81,"Tasa de exámenes médico legales por presunto delito sexual contra niños, niñas y adolescentes",2017,3,4,874,457.66590389016,1,445,224.719101123596,3,429,699.300699300699
23520,25,25281,81,"Tasa de exámenes médico legales por presunto delito sexual contra niños, niñas y adolescentes",2017,4,3,884,339.366515837104,0,459,0,3,425,705.882352941176
23521,25,25281,121,Tasa de exámenes médico legales por presunto delito sexual cuando la víctima está entre 18 y 28 años,2017,5,1,1566,63.8569604086846,0,820,0,1,746,134.048257372654
23522,25,25286,81,"Tasa de exámenes médico legales por presunto delito sexual contra niños, niñas y adolescentes",2017,2,9,6711,134.108180599017,1,3436,29.1036088474971,8,3275,244.274809160305
23523,25,25286,81,"Tasa de exámenes médico legales por presunto delito sexual contra niños, niñas y adolescentes",2017,3,10,8021,124.672734073058,3,3994,75.1126690035053,7,4027,173.826669977651
23524,25,25286,81,"Tasa de exámenes médico legales por presunto delito sexual contra niños, niñas y adolescentes",2017,4,14,8126,172.286487816884,0,3993,0,14,4133,338.736994918945
23525,25,25286,121,Tasa de exámenes médico legales por presunto delito sexual cuando la víctima está entre 18 y 28 años,2017,5,3,15247,19.6760018364268,1,7298,13.7023842148534,2,7949,25.160397534281
23526,25,25288,81,"Tasa de exámenes médico legales por presunto delito sexual contra niños, niñas y adolescentes",2017,4,5,594,841.750841750842,1,310,322.58064516129,4,284,1408.45070422535
23527,25,25288,121,Tasa de exámenes médico legales por presunto delito sexual cuando la víctima está entre 18 y 28 años,2017,5,1,1132,88.339222614841,0,602,0,1,530,188.679245283019
23528,25,25290,81,"Tasa de exámenes médico legales por presunto delito sexual contra niños, niñas y adolescentes",2017,2,11,10731,102.506756127108,1,5453,18.3385292499542,10,5278,189.465706707086
23529,25,25290,81,"Tasa de exámenes médico legales por presunto delito sexual contra niños, niñas y adolescentes",2017,3,30,12975,231.21387283237,6,6697,89.592354785725,24,6278,382.287352660083
23530,25,25290,81,"Tasa de exámenes médico legales por presunto delito sexual contra niños, niñas y adolescentes",2017,4,32,12215,261.972984036021,5,5991,83.4585211150058,27,6224,433.804627249357
23531,25,25290,121,Tasa de exámenes médico legales por presunto delito sexual cuando la víctima está entre 18 y 28 años,2017,5,4,25454,15.7146224561955,2,12972,15.4178230033919,2,12482,16.0230732254446
23532,25,25293,81,"Tasa de exámenes médico legales por presunto delito sexual contra niños, niñas y adolescentes",2017,3,1,735,136.054421768707,0,377,0,1,358,279.329608938547
23533,25,25295,81,"Tasa de exámenes médico legales por presunto delito sexual contra niños, niñas y adolescentes",2017,2,2,1698,117.785630153121,0,869,0,2,829,241.254523522316
23534,25,25295,81,"Tasa de exámenes médico legales por presunto delito sexual contra niños, niñas y adolescentes",2017,3,1,1964,50.9164969450102,0,1007,0,1,957,104.493207941484
23535,25,25295,81,"Tasa de exámenes médico legales por presunto delito sexual contra niños, niñas y adolescentes",2017,4,2,1897,105.429625724829,0,968,0,2,929,215.285252960172
23536,25,25295,121,Tasa de exámenes médico legales por presunto delito sexual cuando la víctima está entre 18 y 28 años,2017,5,1,3048,32.8083989501312,0,1480,0,1,1568,63.7755102040816
23537,25,25307,81,"Tasa de exámenes médico legales por presunto delito sexual contra niños, niñas y adolescentes",2017,2,16,7736,206.825232678387,5,3894,128.402670775552,11,3842,286.309213951067
23538,25,25307,81,"Tasa de exámenes médico legales por presunto delito sexual contra niños, niñas y adolescentes",2017,3,22,9432,233.248515691264,0,4621,0,22,4811,457.285387653294
23539,25,25307,81,"Tasa de exámenes médico legales por presunto delito sexual contra niños, niñas y adolescentes",2017,4,27,9509,283.941529077716,1,4572,21.8722659667542,26,4937,526.635608669232
23540,25,25307,121,Tasa de exámenes médico legales por presunto delito sexual cuando la víctima está entre 18 y 28 años,2017,5,9,19418,46.3487485837882,1,9451,10.5808909110147,8,9967,80.2648740844788
23541,25,25312,81,"Tasa de exámenes médico legales por presunto delito sexual contra niños, niñas y adolescentes",2017,3,1,1068,93.6329588014981,0,534,0,1,534,187.265917602996
23542,25,25312,81,"Tasa de exámenes médico legales por presunto delito sexual contra niños, niñas y adolescentes",2017,4,1,979,102.145045965271,0,487,0,1,492,203.252032520325
23543,25,25317,81,"Tasa de exámenes médico legales por presunto delito sexual contra niños, niñas y adolescentes",2017,2,2,1030,194.174757281553,1,523,191.204588910134,1,507,197.23865877712
23544,25,25317,81,"Tasa de exámenes médico legales por presunto delito sexual contra niños, niñas y adolescentes",2017,3,2,1174,170.357751277683,0,593,0,2,581,344.234079173838
23545,25,25317,81,"Tasa de exámenes médico legales por presunto delito sexual contra niños, niñas y adolescentes",2017,4,4,1114,359.066427289048,0,571,0,4,543,736.648250460405
23546,25,25320,81,"Tasa de exámenes médico legales por presunto delito sexual contra niños, niñas y adolescentes",2017,2,3,3797,79.0097445351593,0,1946,0,3,1851,162.074554294976
23547,25,25320,81,"Tasa de exámenes médico legales por presunto delito sexual contra niños, niñas y adolescentes",2017,3,3,4485,66.8896321070234,0,2288,0,3,2197,136.549840691853
23548,25,25320,81,"Tasa de exámenes médico legales por presunto delito sexual contra niños, niñas y adolescentes",2017,4,5,4228,118.259224219489,0,2126,0,5,2102,237.868696479543
23549,25,25320,121,Tasa de exámenes médico legales por presunto delito sexual cuando la víctima está entre 18 y 28 años,2017,5,2,7145,27.9916025192442,2,3509,56.9962952408094,0,3636,0
23550,25,25322,81,"Tasa de exámenes médico legales por presunto delito sexual contra niños, niñas y adolescentes",2017,4,1,1740,57.4712643678161,0,905,0,1,835,119.760479041916
23551,25,25324,81,"Tasa de exámenes médico legales por presunto delito sexual contra niños, niñas y adolescentes",2017,2,2,261,766.283524904215,2,135,1481.48148148148,0,126,0
23552,25,25326,81,"Tasa de exámenes médico legales por presunto delito sexual contra niños, niñas y adolescentes",2017,4,2,718,278.551532033426,1,371,269.541778975741,1,347,288.184438040346
23553,25,25328,81,"Tasa de exámenes médico legales por presunto delito sexual contra niños, niñas y adolescentes",2017,2,3,329,911.854103343465,0,169,0,3,160,1875
23554,25,25328,81,"Tasa de exámenes médico legales por presunto delito sexual contra niños, niñas y adolescentes",2017,3,1,387,258.397932816537,0,203,0,1,184,543.478260869565
23555,25,25328,81,"Tasa de exámenes médico legales por presunto delito sexual contra niños, niñas y adolescentes",2017,4,1,394,253.807106598985,0,209,0,1,185,540.540540540541
23556,25,25335,81,"Tasa de exámenes médico legales por presunto delito sexual contra niños, niñas y adolescentes",2017,2,1,413,242.130750605327,1,212,471.698113207547,0,201,0
23557,25,25335,81,"Tasa de exámenes médico legales por presunto delito sexual contra niños, niñas y adolescentes",2017,3,3,457,656.455142231947,0,233,0,3,224,1339.28571428571
23558,25,25335,81,"Tasa de exámenes médico legales por presunto delito sexual contra niños, niñas y adolescentes",2017,4,1,456,219.298245614035,0,221,0,1,235,425.531914893617
23559,25,25339,81,"Tasa de exámenes médico legales por presunto delito sexual contra niños, niñas y adolescentes",2017,2,2,414,483.091787439613,0,210,0,2,204,980.392156862745
23560,25,25339,81,"Tasa de exámenes médico legales por presunto delito sexual contra niños, niñas y adolescentes",2017,3,5,432,1157.40740740741,0,218,0,5,214,2336.44859813084
23561,25,25339,81,"Tasa de exámenes médico legales por presunto delito sexual contra niños, niñas y adolescentes",2017,4,4,428,934.579439252336,0,211,0,4,217,1843.31797235023
23562,25,25377,81,"Tasa de exámenes médico legales por presunto delito sexual contra niños, niñas y adolescentes",2017,2,1,2249,44.4642063139173,1,1155,86.5800865800866,0,1094,0
23563,25,25377,121,Tasa de exámenes médico legales por presunto delito sexual cuando la víctima está entre 18 y 28 años,2017,5,2,5377,37.1954621536173,0,2790,0,2,2587,77.3096250483185
23564,25,25386,81,"Tasa de exámenes médico legales por presunto delito sexual contra niños, niñas y adolescentes",2017,2,2,2506,79.8084596967279,0,1286,0,2,1220,163.934426229508
23565,25,25386,81,"Tasa de exámenes médico legales por presunto delito sexual contra niños, niñas y adolescentes",2017,3,9,3079,292.302695680416,3,1555,192.926045016077,6,1524,393.700787401575
23566,25,25386,81,"Tasa de exámenes médico legales por presunto delito sexual contra niños, niñas y adolescentes",2017,4,13,3143,413.617562838053,1,1592,62.8140703517588,12,1551,773.694390715667
23567,25,25386,121,Tasa de exámenes médico legales por presunto delito sexual cuando la víctima está entre 18 y 28 años,2017,5,3,5958,50.3524672708963,0,3000,0,3,2958,101.419878296146
23568,25,25394,81,"Tasa de exámenes médico legales por presunto delito sexual contra niños, niñas y adolescentes",2017,2,1,923,108.342361863489,0,471,0,1,452,221.238938053097
23569,25,25394,81,"Tasa de exámenes médico legales por presunto delito sexual contra niños, niñas y adolescentes",2017,3,1,1050,95.2380952380952,1,537,186.219739292365,0,513,0
23570,25,25394,81,"Tasa de exámenes médico legales por presunto delito sexual contra niños, niñas y adolescentes",2017,4,2,1051,190.294957183635,0,529,0,2,522,383.141762452107
23571,25,25398,81,"Tasa de exámenes médico legales por presunto delito sexual contra niños, niñas y adolescentes",2017,3,1,675,148.148148148148,0,345,0,1,330,303.030303030303
23572,25,25398,81,"Tasa de exámenes médico legales por presunto delito sexual contra niños, niñas y adolescentes",2017,4,2,678,294.985250737463,1,341,293.255131964809,1,337,296.73590504451
23573,25,25398,121,Tasa de exámenes médico legales por presunto delito sexual cuando la víctima está entre 18 y 28 años,2017,5,2,1396,143.266475644699,0,701,0,2,695,287.769784172662
23574,25,25402,81,"Tasa de exámenes médico legales por presunto delito sexual contra niños, niñas y adolescentes",2017,2,3,1219,246.103363412633,1,621,161.030595813205,2,598,334.448160535117
23575,25,25402,81,"Tasa de exámenes médico legales por presunto delito sexual contra niños, niñas y adolescentes",2017,3,3,1386,216.450216450216,1,709,141.043723554302,2,677,295.420974889217
23576,25,25402,81,"Tasa de exámenes médico legales por presunto delito sexual contra niños, niñas y adolescentes",2017,4,7,1389,503.959683225342,0,699,0,7,690,1014.49275362319
23577,25,25402,121,Tasa de exámenes médico legales por presunto delito sexual cuando la víctima está entre 18 y 28 años,2017,5,3,2855,105.07880910683,0,1431,0,3,1424,210.674157303371
23578,25,25407,81,"Tasa de exámenes médico legales por presunto delito sexual contra niños, niñas y adolescentes",2017,2,2,1044,191.570881226054,0,538,0,2,506,395.256916996047
23579,25,25407,81,"Tasa de exámenes médico legales por presunto delito sexual contra niños, niñas y adolescentes",2017,3,1,1125,88.8888888888889,0,585,0,1,540,185.185185185185
23580,25,25407,81,"Tasa de exámenes médico legales por presunto delito sexual contra niños, niñas y adolescentes",2017,4,4,1082,369.685767097967,0,561,0,4,521,767.754318618042
23581,25,25426,81,"Tasa de exámenes médico legales por presunto delito sexual contra niños, niñas y adolescentes",2017,2,1,591,169.204737732656,0,299,0,1,292,342.465753424658
23582,25,25426,81,"Tasa de exámenes médico legales por presunto delito sexual contra niños, niñas y adolescentes",2017,3,2,623,321.027287319422,0,307,0,2,316,632.911392405063
23583,25,25426,81,"Tasa de exámenes médico legales por presunto delito sexual contra niños, niñas y adolescentes",2017,4,2,592,337.837837837838,0,276,0,2,316,632.911392405063
23584,25,25430,81,"Tasa de exámenes médico legales por presunto delito sexual contra niños, niñas y adolescentes",2017,2,4,7147,55.9675388274801,0,3668,0,4,3479,114.975567691865
23585,25,25430,81,"Tasa de exámenes médico legales por presunto delito sexual contra niños, niñas y adolescentes",2017,3,9,8806,102.203043379514,0,4444,0,9,4362,206.327372764787
23586,25,25430,81,"Tasa de exámenes médico legales por presunto delito sexual contra niños, niñas y adolescentes",2017,4,11,8820,124.716553287982,1,4490,22.271714922049,10,4330,230.94688221709
23587,25,25430,121,Tasa de exámenes médico legales por presunto delito sexual cuando la víctima está entre 18 y 28 años,2017,5,3,15583,19.251748700507,0,7890,0,3,7693,38.9964903158716
23588,25,25436,81,"Tasa de exámenes médico legales por presunto delito sexual contra niños, niñas y adolescentes",2017,4,2,533,375.234521575985,0,273,0,2,260,769.230769230769
23589,25,25438,81,"Tasa de exámenes médico legales por presunto delito sexual contra niños, niñas y adolescentes",2017,3,1,1233,81.10300081103,0,651,0,1,582,171.821305841924
23590,25,25438,81,"Tasa de exámenes médico legales por presunto delito sexual contra niños, niñas y adolescentes",2017,4,4,1151,347.523892267593,0,617,0,4,534,749.063670411985
23591,25,25473,81,"Tasa de exámenes médico legales por presunto delito sexual contra niños, niñas y adolescentes",2017,2,3,7774,38.5901723694366,2,3974,50.3271263210871,1,3800,26.3157894736842
23592,25,25473,81,"Tasa de exámenes médico legales por presunto delito sexual contra niños, niñas y adolescentes",2017,3,8,9177,87.17445788384,1,4709,21.2359311955829,7,4468,156.669650850492
23593,25,25473,81,"Tasa de exámenes médico legales por presunto delito sexual contra niños, niñas y adolescentes",2017,4,11,9680,113.636363636364,0,5020,0,11,4660,236.051502145923
23594,25,25473,121,Tasa de exámenes médico legales por presunto delito sexual cuando la víctima está entre 18 y 28 años,2017,5,2,17562,11.3882245757886,0,8810,0,2,8752,22.8519195612431
23595,25,25483,81,"Tasa de exámenes médico legales por presunto delito sexual contra niños, niñas y adolescentes",2017,4,1,237,421.940928270042,0,121,0,1,116,862.068965517241
23596,25,25486,81,"Tasa de exámenes médico legales por presunto delito sexual contra niños, niñas y adolescentes",2017,3,4,1697,235.710076605775,0,853,0,4,844,473.9336492891
23597,25,25486,81,"Tasa de exámenes médico legales por presunto delito sexual contra niños, niñas y adolescentes",2017,4,5,1654,302.29746070133,1,846,118.203309692671,4,808,495.049504950495
23598,25,25488,81,"Tasa de exámenes médico legales por presunto delito sexual contra niños, niñas y adolescentes",2017,3,7,1492,469.16890080429,0,728,0,7,764,916.230366492147
23599,25,25488,121,Tasa de exámenes médico legales por presunto delito sexual cuando la víctima está entre 18 y 28 años,2017,5,2,7300,27.3972602739726,1,6014,16.627868307283,1,1286,77.7604976671851
23600,25,25489,81,"Tasa de exámenes médico legales por presunto delito sexual contra niños, niñas y adolescentes",2017,3,1,765,130.718954248366,0,383,0,1,382,261.780104712042
23601,25,25513,81,"Tasa de exámenes médico legales por presunto delito sexual contra niños, niñas y adolescentes",2017,2,3,2452,122.349102773246,0,1251,0,3,1201,249.791840133222
23602,25,25513,81,"Tasa de exámenes médico legales por presunto delito sexual contra niños, niñas y adolescentes",2017,3,3,2934,102.249488752556,0,1450,0,3,1484,202.156334231806
23603,25,25513,81,"Tasa de exámenes médico legales por presunto delito sexual contra niños, niñas y adolescentes",2017,4,4,2972,134.589502018843,1,1493,66.9792364367046,3,1479,202.839756592292
23604,25,25513,121,Tasa de exámenes médico legales por presunto delito sexual cuando la víctima está entre 18 y 28 años,2017,5,1,5414,18.470631695604,0,2773,0,1,2641,37.8644452858766
23605,25,25518,81,"Tasa de exámenes médico legales por presunto delito sexual contra niños, niñas y adolescentes",2017,3,1,423,236.406619385343,0,218,0,1,205,487.80487804878
23606,25,25518,121,Tasa de exámenes médico legales por presunto delito sexual cuando la víctima está entre 18 y 28 años,2017,5,1,701,142.65335235378,0,304,0,1,397,251.889168765743
23607,25,25524,81,"Tasa de exámenes médico legales por presunto delito sexual contra niños, niñas y adolescentes",2017,4,1,568,176.056338028169,0,307,0,1,261,383.141762452107
23608,25,25530,81,"Tasa de exámenes médico legales por presunto delito sexual contra niños, niñas y adolescentes",2017,2,1,817,122.399020807834,0,418,0,1,399,250.62656641604
23609,25,25530,81,"Tasa de exámenes médico legales por presunto delito sexual contra niños, niñas y adolescentes",2017,3,3,896,334.821428571429,0,453,0,3,443,677.200902934537
23610,25,25530,81,"Tasa de exámenes médico legales por presunto delito sexual contra niños, niñas y adolescentes",2017,4,3,838,357.99522673031,0,422,0,3,416,721.153846153846
23611,25,25535,81,"Tasa de exámenes médico legales por presunto delito sexual contra niños, niñas y adolescentes",2017,2,1,1210,82.6446280991735,0,617,0,1,593,168.634064080944
23612,25,25535,81,"Tasa de exámenes médico legales por presunto delito sexual contra niños, niñas y adolescentes",2017,3,2,1461,136.892539356605,0,730,0,2,731,273.59781121751
23613,25,25535,81,"Tasa de exámenes médico legales por presunto delito sexual contra niños, niñas y adolescentes",2017,4,2,1336,149.700598802395,0,665,0,2,671,298.06259314456
23614,25,25572,81,"Tasa de exámenes médico legales por presunto delito sexual contra niños, niñas y adolescentes",2017,3,1,2181,45.8505272810637,0,1122,0,1,1059,94.4287063267233
23615,25,25572,81,"Tasa de exámenes médico legales por presunto delito sexual contra niños, niñas y adolescentes",2017,4,4,2191,182.565038795071,0,1111,0,4,1080,370.37037037037
23616,25,25594,81,"Tasa de exámenes médico legales por presunto delito sexual contra niños, niñas y adolescentes",2017,4,1,648,154.320987654321,0,358,0,1,290,344.827586206897
23617,25,25596,81,"Tasa de exámenes médico legales por presunto delito sexual contra niños, niñas y adolescentes",2017,2,1,897,111.482720178372,1,459,217.864923747277,0,438,0
23618,25,25596,81,"Tasa de exámenes médico legales por presunto delito sexual contra niños, niñas y adolescentes",2017,4,1,946,105.708245243129,0,501,0,1,445,224.719101123596
23619,25,25599,81,"Tasa de exámenes médico legales por presunto delito sexual contra niños, niñas y adolescentes",2017,4,3,712,421.348314606742,0,358,0,3,354,847.457627118644
23620,25,25612,81,"Tasa de exámenes médico legales por presunto delito sexual contra niños, niñas y adolescentes",2017,2,1,789,126.742712294043,0,399,0,1,390,256.410256410256
23621,25,25612,81,"Tasa de exámenes médico legales por presunto delito sexual contra niños, niñas y adolescentes",2017,3,2,891,224.466891133558,1,436,229.357798165138,1,455,219.78021978022
23622,25,25612,121,Tasa de exámenes médico legales por presunto delito sexual cuando la víctima está entre 18 y 28 años,2017,5,2,1819,109.950522264981,0,868,0,2,951,210.304942166141
23623,25,25645,81,"Tasa de exámenes médico legales por presunto delito sexual contra niños, niñas y adolescentes",2017,2,2,1025,195.121951219512,0,527,0,2,498,401.606425702811
23624,25,25645,81,"Tasa de exámenes médico legales por presunto delito sexual contra niños, niñas y adolescentes",2017,3,3,1258,238.473767885533,1,635,157.48031496063,2,623,321.027287319422
23625,25,25645,81,"Tasa de exámenes médico legales por presunto delito sexual contra niños, niñas y adolescentes",2017,4,5,1285,389.105058365759,0,651,0,5,634,788.643533123028
23626,25,25649,81,"Tasa de exámenes médico legales por presunto delito sexual contra niños, niñas y adolescentes",2017,2,1,994,100.603621730382,0,507,0,1,487,205.338809034908
23627,25,25649,81,"Tasa de exámenes médico legales por presunto delito sexual contra niños, niñas y adolescentes",2017,4,2,1089,183.654729109275,1,552,181.159420289855,1,537,186.219739292365
23628,25,25658,81,"Tasa de exámenes médico legales por presunto delito sexual contra niños, niñas y adolescentes",2017,2,1,953,104.931794333683,0,498,0,1,455,219.78021978022
23629,25,25658,81,"Tasa de exámenes médico legales por presunto delito sexual contra niños, niñas y adolescentes",2017,3,5,1129,442.869796279894,0,593,0,5,536,932.835820895522
23630,25,25658,81,"Tasa de exámenes médico legales por presunto delito sexual contra niños, niñas y adolescentes",2017,4,5,1064,469.924812030075,0,559,0,5,505,990.09900990099
23631,25,25658,121,Tasa de exámenes médico legales por presunto delito sexual cuando la víctima está entre 18 y 28 años,2017,5,1,1748,57.20823798627,0,921,0,1,827,120.918984280532
23632,25,25662,81,"Tasa de exámenes médico legales por presunto delito sexual contra niños, niñas y adolescentes",2017,3,1,1003,99.7008973080758,0,495,0,1,508,196.850393700787
23633,25,25662,81,"Tasa de exámenes médico legales por presunto delito sexual contra niños, niñas y adolescentes",2017,4,2,991,201.816347124117,0,486,0,2,505,396.039603960396
23634,25,25718,81,"Tasa de exámenes médico legales por presunto delito sexual contra niños, niñas y adolescentes",2017,3,1,1017,98.3284169124877,0,523,0,1,494,202.429149797571
23635,25,25718,81,"Tasa de exámenes médico legales por presunto delito sexual contra niños, niñas y adolescentes",2017,4,3,1013,296.150049358342,1,515,194.174757281553,2,498,401.606425702811
23636,25,25736,81,"Tasa de exámenes médico legales por presunto delito sexual contra niños, niñas y adolescentes",2017,2,2,1415,141.342756183746,0,730,0,2,685,291.970802919708
23637,25,25736,81,"Tasa de exámenes médico legales por presunto delito sexual contra niños, niñas y adolescentes",2017,3,1,1681,59.4883997620464,0,860,0,1,821,121.802679658952
23638,25,25736,81,"Tasa de exámenes médico legales por presunto delito sexual contra niños, niñas y adolescentes",2017,4,2,1666,120.048019207683,0,835,0,2,831,240.673886883273
23639,25,25736,121,Tasa de exámenes médico legales por presunto delito sexual cuando la víctima está entre 18 y 28 años,2017,5,2,2949,67.8195998643608,0,1502,0,2,1447,138.217000691085
23640,25,25740,81,"Tasa de exámenes médico legales por presunto delito sexual contra niños, niñas y adolescentes",2017,2,6,3438,174.520069808028,2,1753,114.090131203651,4,1685,237.388724035608
23641,25,25740,81,"Tasa de exámenes médico legales por presunto delito sexual contra niños, niñas y adolescentes",2017,3,2,4014,49.825610363727,0,2041,0,2,1973,101.36847440446
23642,25,25740,81,"Tasa de exámenes médico legales por presunto delito sexual contra niños, niñas y adolescentes",2017,4,9,4305,209.059233449477,0,2200,0,9,2105,427.553444180523
23643,25,25743,81,"Tasa de exámenes médico legales por presunto delito sexual contra niños, niñas y adolescentes",2017,2,3,1866,160.771704180064,1,958,104.384133611691,2,908,220.264317180617
23644,25,25743,81,"Tasa de exámenes médico legales por presunto delito sexual contra niños, niñas y adolescentes",2017,3,4,2143,186.654223051797,1,1104,90.5797101449275,3,1039,288.739172281039
23645,25,25743,81,"Tasa de exámenes médico legales por presunto delito sexual contra niños, niñas y adolescentes",2017,4,9,2231,403.406544150605,1,1146,87.260034904014,8,1085,737.327188940092
23646,25,25743,121,Tasa de exámenes médico legales por presunto delito sexual cuando la víctima está entre 18 y 28 años,2017,5,3,4121,72.7978645959719,1,2049,48.8042947779405,2,2072,96.5250965250965
23647,25,25745,81,"Tasa de exámenes médico legales por presunto delito sexual contra niños, niñas y adolescentes",2017,2,2,1364,146.627565982405,0,699,0,2,665,300.751879699248
23648,25,25745,81,"Tasa de exámenes médico legales por presunto delito sexual contra niños, niñas y adolescentes",2017,3,2,1586,126.103404791929,0,799,0,2,787,254.129606099111
23649,25,25745,81,"Tasa de exámenes médico legales por presunto delito sexual contra niños, niñas y adolescentes",2017,4,4,1511,264.725347452019,0,754,0,4,757,528.401585204756
23650,25,25745,121,Tasa de exámenes médico legales por presunto delito sexual cuando la víctima está entre 18 y 28 años,2017,5,1,2645,37.8071833648393,0,1345,0,1,1300,76.9230769230769
23651,25,25754,81,"Tasa de exámenes médico legales por presunto delito sexual contra niños, niñas y adolescentes",2017,2,74,48829,151.549284236826,18,25000,72,56,23829,235.007763649335
23652,25,25754,81,"Tasa de exámenes médico legales por presunto delito sexual contra niños, niñas y adolescentes",2017,3,115,57359,200.491640370299,13,29301,44.3670864475615,102,28058,363.532682300948
23653,25,25754,81,"Tasa de exámenes médico legales por presunto delito sexual contra niños, niñas y adolescentes",2017,4,115,57515,199.947839693993,9,29330,30.6853051483123,106,28185,376.086570871031
23654,25,25754,121,Tasa de exámenes médico legales por presunto delito sexual cuando la víctima está entre 18 y 28 años,2017,5,21,105910,19.8281559814937,1,52949,1.88860979433039,20,52961,37.7636373935537
23655,25,25758,81,"Tasa de exámenes médico legales por presunto delito sexual contra niños, niñas y adolescentes",2017,3,2,2912,68.6813186813187,0,1480,0,2,1432,139.664804469274
23656,25,25758,81,"Tasa de exámenes médico legales por presunto delito sexual contra niños, niñas y adolescentes",2017,4,2,2977,67.1817265703729,0,1519,0,2,1458,137.174211248285
23657,25,25758,121,Tasa de exámenes médico legales por presunto delito sexual cuando la víctima está entre 18 y 28 años,2017,5,1,5356,18.6706497386109,0,2709,0,1,2647,37.7786173026067
23658,25,25769,81,"Tasa de exámenes médico legales por presunto delito sexual contra niños, niñas y adolescentes",2017,4,1,1640,60.9756097560976,0,838,0,1,802,124.688279301746
23659,25,25772,81,"Tasa de exámenes médico legales por presunto delito sexual contra niños, niñas y adolescentes",2017,2,2,2087,95.831336847149,1,1057,94.6073793755913,1,1030,97.0873786407767
23660,25,25772,81,"Tasa de exámenes médico legales por presunto delito sexual contra niños, niñas y adolescentes",2017,4,10,2326,429.922613929493,2,1132,176.678445229682,8,1194,670.01675041876
23661,25,25772,121,Tasa de exámenes médico legales por presunto delito sexual cuando la víctima está entre 18 y 28 años,2017,5,1,3709,26.9614451334592,0,1810,0,1,1899,52.6592943654555
23662,25,25777,81,"Tasa de exámenes médico legales por presunto delito sexual contra niños, niñas y adolescentes",2017,3,1,647,154.559505409583,1,322,310.55900621118,0,325,0
23663,25,25779,81,"Tasa de exámenes médico legales por presunto delito sexual contra niños, niñas y adolescentes",2017,4,2,1532,130.548302872063,0,785,0,2,747,267.737617135207
23664,25,25785,81,"Tasa de exámenes médico legales por presunto delito sexual contra niños, niñas y adolescentes",2017,3,1,2881,34.7101700798334,1,1476,67.7506775067751,0,1405,0
23665,25,25785,81,"Tasa de exámenes médico legales por presunto delito sexual contra niños, niñas y adolescentes",2017,4,2,3067,65.21030322791,0,1562,0,2,1505,132.890365448505
23666,25,25793,81,"Tasa de exámenes médico legales por presunto delito sexual contra niños, niñas y adolescentes",2017,3,2,1074,186.219739292365,0,570,0,2,504,396.825396825397
23667,25,25793,81,"Tasa de exámenes médico legales por presunto delito sexual contra niños, niñas y adolescentes",2017,4,1,976,102.459016393443,0,529,0,1,447,223.713646532438
23668,25,25797,81,"Tasa de exámenes médico legales por presunto delito sexual contra niños, niñas y adolescentes",2017,2,2,1032,193.798449612403,0,523,0,2,509,392.927308447937
23669,25,25797,81,"Tasa de exámenes médico legales por presunto delito sexual contra niños, niñas y adolescentes",2017,3,4,1190,336.134453781513,2,592,337.837837837838,2,598,334.448160535117
23670,25,25797,81,"Tasa de exámenes médico legales por presunto delito sexual contra niños, niñas y adolescentes",2017,4,1,1197,83.5421888053467,0,584,0,1,613,163.132137030995
23671,25,25797,81,"Tasa de exámenes médico legales por presunto delito sexual contra niños, niñas y adolescentes",2017,1,1,215,465.116279069767,0,110,0,1,105,952.380952380953
23672,25,25799,81,"Tasa de exámenes médico legales por presunto delito sexual contra niños, niñas y adolescentes",2017,2,2,1832,109.170305676856,0,941,0,2,891,224.466891133558
23673,25,25799,81,"Tasa de exámenes médico legales por presunto delito sexual contra niños, niñas y adolescentes",2017,3,5,2149,232.666356444858,2,1098,182.149362477231,3,1051,285.442435775452
23674,25,25799,81,"Tasa de exámenes médico legales por presunto delito sexual contra niños, niñas y adolescentes",2017,4,7,2243,312.082032991529,0,1136,0,7,1107,632.339656729901
23675,25,25805,81,"Tasa de exámenes médico legales por presunto delito sexual contra niños, niñas y adolescentes",2017,3,1,566,176.678445229682,0,281,0,1,285,350.877192982456
23676,25,25807,81,"Tasa de exámenes médico legales por presunto delito sexual contra niños, niñas y adolescentes",2017,4,1,333,300.3003003003,1,168,595.238095238095,0,165,0
23677,25,25815,81,"Tasa de exámenes médico legales por presunto delito sexual contra niños, niñas y adolescentes",2017,3,2,1798,111.234705228031,0,929,0,2,869,230.149597238205
23678,25,25815,81,"Tasa de exámenes médico legales por presunto delito sexual contra niños, niñas y adolescentes",2017,4,6,1736,345.622119815668,2,896,223.214285714286,4,840,476.190476190476
23679,25,25817,81,"Tasa de exámenes médico legales por presunto delito sexual contra niños, niñas y adolescentes",2017,4,1,4076,24.5338567222767,0,2072,0,1,2004,49.9001996007984
23680,25,25823,81,"Tasa de exámenes médico legales por presunto delito sexual contra niños, niñas y adolescentes",2017,3,1,512,195.3125,0,270,0,1,242,413.223140495868
23681,25,25823,81,"Tasa de exámenes médico legales por presunto delito sexual contra niños, niñas y adolescentes",2017,4,1,466,214.592274678112,0,247,0,1,219,456.62100456621
23682,25,25841,81,"Tasa de exámenes médico legales por presunto delito sexual contra niños, niñas y adolescentes",2017,3,1,574,174.216027874564,0,308,0,1,266,375.93984962406
23683,25,25841,81,"Tasa de exámenes médico legales por presunto delito sexual contra niños, niñas y adolescentes",2017,4,1,547,182.815356489945,0,295,0,1,252,396.825396825397
23684,25,25843,81,"Tasa de exámenes médico legales por presunto delito sexual contra niños, niñas y adolescentes",2017,2,3,3772,79.5334040296925,0,1916,0,3,1856,161.637931034483
23685,25,25843,81,"Tasa de exámenes médico legales por presunto delito sexual contra niños, niñas y adolescentes",2017,3,10,4357,229.515721826945,0,2178,0,10,2179,458.926112895824
23686,25,25843,81,"Tasa de exámenes médico legales por presunto delito sexual contra niños, niñas y adolescentes",2017,4,19,4243,447.796370492576,1,2086,47.9386385426654,18,2157,834.492350486787
23687,25,25843,121,Tasa de exámenes médico legales por presunto delito sexual cuando la víctima está entre 18 y 28 años,2017,5,4,7743,51.6595634766886,1,3711,26.9469145782808,3,4032,74.4047619047619
23688,25,25845,81,"Tasa de exámenes médico legales por presunto delito sexual contra niños, niñas y adolescentes",2017,3,1,972,102.880658436214,0,496,0,1,476,210.084033613445
23689,25,25845,81,"Tasa de exámenes médico legales por presunto delito sexual contra niños, niñas y adolescentes",2017,4,2,952,210.084033613445,0,487,0,2,465,430.10752688172
23690,25,25845,121,Tasa de exámenes médico legales por presunto delito sexual cuando la víctima está entre 18 y 28 años,2017,5,1,1781,56.1482313307131,0,909,0,1,872,114.678899082569
23691,25,25851,81,"Tasa de exámenes médico legales por presunto delito sexual contra niños, niñas y adolescentes",2017,3,2,513,389.863547758285,1,279,358.4229390681,1,234,427.350427350427
23692,25,25851,81,"Tasa de exámenes médico legales por presunto delito sexual contra niños, niñas y adolescentes",2017,4,7,481,1455.30145530146,2,254,787.40157480315,5,227,2202.64317180617
23693,25,25851,121,Tasa de exámenes médico legales por presunto delito sexual cuando la víctima está entre 18 y 28 años,2017,5,1,980,102.040816326531,1,484,206.611570247934,0,496,0
23694,25,25862,81,"Tasa de exámenes médico legales por presunto delito sexual contra niños, niñas y adolescentes",2017,4,1,762,131.233595800525,0,369,0,1,393,254.452926208651
23695,25,25862,121,Tasa de exámenes médico legales por presunto delito sexual cuando la víctima está entre 18 y 28 años,2017,5,1,1506,66.4010624169987,0,730,0,1,776,128.865979381443
23696,25,25867,81,"Tasa de exámenes médico legales por presunto delito sexual contra niños, niñas y adolescentes",2017,3,3,422,710.900473933649,0,208,0,3,214,1401.8691588785
23697,25,25867,81,"Tasa de exámenes médico legales por presunto delito sexual contra niños, niñas y adolescentes",2017,4,3,403,744.416873449131,0,188,0,3,215,1395.3488372093
23698,25,25873,81,"Tasa de exámenes médico legales por presunto delito sexual contra niños, niñas y adolescentes",2017,2,4,2218,180.34265103697,0,1137,0,4,1081,370.027752081406
23699,25,25873,81,"Tasa de exámenes médico legales por presunto delito sexual contra niños, niñas y adolescentes",2017,3,3,2544,117.924528301887,3,1321,227.100681302044,0,1223,0
23700,25,25873,81,"Tasa de exámenes médico legales por presunto delito sexual contra niños, niñas y adolescentes",2017,4,6,2442,245.700245700246,1,1291,77.4593338497289,5,1151,434.404865334492
23701,25,25873,81,"Tasa de exámenes médico legales por presunto delito sexual contra niños, niñas y adolescentes",2017,1,1,460,217.391304347826,0,237,0,1,223,448.430493273543
23702,25,25875,81,"Tasa de exámenes médico legales por presunto delito sexual contra niños, niñas y adolescentes",2017,2,5,2168,230.627306273063,1,1108,90.2527075812274,4,1060,377.358490566038
23703,25,25875,81,"Tasa de exámenes médico legales por presunto delito sexual contra niños, niñas y adolescentes",2017,3,10,2572,388.802488335925,1,1300,76.9230769230769,9,1272,707.547169811321
23704,25,25875,81,"Tasa de exámenes médico legales por presunto delito sexual contra niños, niñas y adolescentes",2017,4,19,2563,741.31876706984,2,1305,153.256704980843,17,1258,1351.35135135135
23705,25,25875,121,Tasa de exámenes médico legales por presunto delito sexual cuando la víctima está entre 18 y 28 años,2017,5,4,4840,82.6446280991735,0,2478,0,4,2362,169.348010160881
23706,25,25878,81,"Tasa de exámenes médico legales por presunto delito sexual contra niños, niñas y adolescentes",2017,2,4,1099,363.967242948135,2,567,352.733686067019,2,532,375.93984962406
23707,25,25878,81,"Tasa de exámenes médico legales por presunto delito sexual contra niños, niñas y adolescentes",2017,3,1,1292,77.3993808049536,1,662,151.057401812689,0,630,0
23708,25,25878,81,"Tasa de exámenes médico legales por presunto delito sexual contra niños, niñas y adolescentes",2017,4,2,1296,154.320987654321,0,662,0,2,634,315.457413249211
23709,25,25885,81,"Tasa de exámenes médico legales por presunto delito sexual contra niños, niñas y adolescentes",2017,2,2,1683,118.83541295306,0,876,0,2,807,247.831474597274
23710,25,25885,81,"Tasa de exámenes médico legales por presunto delito sexual contra niños, niñas y adolescentes",2017,3,1,1855,53.9083557951483,0,983,0,1,872,114.678899082569
23711,25,25885,81,"Tasa de exámenes médico legales por presunto delito sexual contra niños, niñas y adolescentes",2017,4,3,1749,171.526586620926,1,913,109.529025191676,2,836,239.234449760766
23712,25,25898,81,"Tasa de exámenes médico legales por presunto delito sexual contra niños, niñas y adolescentes",2017,3,1,683,146.412884333821,0,342,0,1,341,293.255131964809
23713,25,25898,81,"Tasa de exámenes médico legales por presunto delito sexual contra niños, niñas y adolescentes",2017,4,1,626,159.744408945687,0,312,0,1,314,318.471337579618
23714,25,25899,81,"Tasa de exámenes médico legales por presunto delito sexual contra niños, niñas y adolescentes",2017,2,11,10705,102.755721625409,1,5472,18.2748538011696,10,5233,191.094974202178
23715,25,25899,81,"Tasa de exámenes médico legales por presunto delito sexual contra niños, niñas y adolescentes",2017,3,18,13099,137.415069852661,3,6722,44.6295745313895,15,6377,235.22032303591
23716,25,25899,81,"Tasa de exámenes médico legales por presunto delito sexual contra niños, niñas y adolescentes",2017,4,26,13255,196.15239532252,6,6706,89.4721145243066,20,6549,305.39013589861
23717,25,25899,121,Tasa de exámenes médico legales por presunto delito sexual cuando la víctima está entre 18 y 28 años,2017,5,6,23820,25.1889168765743,0,11910,0,6,11910,50.3778337531486
23718,27,27001,81,"Tasa de exámenes médico legales por presunto delito sexual contra niños, niñas y adolescentes",2017,2,23,14481,158.828810165044,6,7367,81.4442785394326,17,7114,238.965420298004
23719,27,27001,81,"Tasa de exámenes médico legales por presunto delito sexual contra niños, niñas y adolescentes",2017,3,33,17192,191.949744067008,6,8756,68.5244403837369,27,8436,320.056899004267
23720,27,27001,81,"Tasa de exámenes médico legales por presunto delito sexual contra niños, niñas y adolescentes",2017,4,40,15846,252.429635239177,0,8100,0,40,7746,516.395558998193
23721,27,27001,121,Tasa de exámenes médico legales por presunto delito sexual cuando la víctima está entre 18 y 28 años,2017,5,19,25579,74.2796825520935,0,13265,0,19,12314,154.295923339289
23722,27,27001,81,"Tasa de exámenes médico legales por presunto delito sexual contra niños, niñas y adolescentes",2017,1,1,2834,35.2858151023289,0,1446,0,1,1388,72.0461095100865
23723,27,27025,81,"Tasa de exámenes médico legales por presunto delito sexual contra niños, niñas y adolescentes",2017,4,1,5855,17.0794192997438,0,3029,0,1,2826,35.3857041755131
23724,27,27050,81,"Tasa de exámenes médico legales por presunto delito sexual contra niños, niñas y adolescentes",2017,3,2,1562,128.040973111396,0,800,0,2,762,262.46719160105
23725,27,27050,81,"Tasa de exámenes médico legales por presunto delito sexual contra niños, niñas y adolescentes",2017,4,3,1408,213.068181818182,0,727,0,3,681,440.528634361234
23726,27,27050,121,Tasa de exámenes médico legales por presunto delito sexual cuando la víctima está entre 18 y 28 años,2017,5,2,2184,91.5750915750916,0,1132,0,2,1052,190.114068441065
23727,27,27073,121,Tasa de exámenes médico legales por presunto delito sexual cuando la víctima está entre 18 y 28 años,2017,5,1,1670,59.8802395209581,0,867,0,1,803,124.53300124533
23728,27,27077,81,"Tasa de exámenes médico legales por presunto delito sexual contra niños, niñas y adolescentes",2017,3,3,2851,105.226236408278,0,1486,0,3,1365,219.78021978022
23729,27,27077,81,"Tasa de exámenes médico legales por presunto delito sexual contra niños, niñas y adolescentes",2017,4,1,2643,37.8357926598562,0,1401,0,1,1242,80.5152979066023
23730,27,27099,81,"Tasa de exámenes médico legales por presunto delito sexual contra niños, niñas y adolescentes",2017,4,1,1366,73.2064421669107,0,702,0,1,664,150.602409638554
23731,27,27135,81,"Tasa de exámenes médico legales por presunto delito sexual contra niños, niñas y adolescentes",2017,3,1,1143,87.4890638670166,0,581,0,1,562,177.935943060498
23732,27,27160,81,"Tasa de exámenes médico legales por presunto delito sexual contra niños, niñas y adolescentes",2017,2,1,966,103.51966873706,0,492,0,1,474,210.970464135021
23733,27,27160,81,"Tasa de exámenes médico legales por presunto delito sexual contra niños, niñas y adolescentes",2017,4,1,1194,83.7520938023451,0,637,0,1,557,179.533213644524
23734,27,27205,81,"Tasa de exámenes médico legales por presunto delito sexual contra niños, niñas y adolescentes",2017,3,2,2104,95.0570342205323,0,1030,0,2,1074,186.219739292365
23735,27,27205,81,"Tasa de exámenes médico legales por presunto delito sexual contra niños, niñas y adolescentes",2017,4,2,2067,96.7585873246251,0,984,0,2,1083,184.672206832872
23736,27,27205,121,Tasa de exámenes médico legales por presunto delito sexual cuando la víctima está entre 18 y 28 años,2017,5,1,3644,27.4423710208562,0,1805,0,1,1839,54.3773790103317
23737,27,27361,81,"Tasa de exámenes médico legales por presunto delito sexual contra niños, niñas y adolescentes",2017,2,3,3076,97.5292587776333,0,1543,0,3,1533,195.694716242661
23738,27,27361,81,"Tasa de exámenes médico legales por presunto delito sexual contra niños, niñas y adolescentes",2017,4,10,3166,315.855969677827,1,1543,64.8088139987038,9,1623,554.52865064695
23739,27,27372,81,"Tasa de exámenes médico legales por presunto delito sexual contra niños, niñas y adolescentes",2017,2,1,421,237.529691211401,0,212,0,1,209,478.468899521531
23740,27,27372,81,"Tasa de exámenes médico legales por presunto delito sexual contra niños, niñas y adolescentes",2017,3,2,496,403.225806451613,0,246,0,2,250,800
23741,27,27372,81,"Tasa de exámenes médico legales por presunto delito sexual contra niños, niñas y adolescentes",2017,4,1,433,230.94688221709,0,212,0,1,221,452.488687782805
23742,27,27413,81,"Tasa de exámenes médico legales por presunto delito sexual contra niños, niñas y adolescentes",2017,2,1,1408,71.0227272727273,0,696,0,1,712,140.449438202247
23743,27,27450,81,"Tasa de exámenes médico legales por presunto delito sexual contra niños, niñas y adolescentes",2017,2,1,2238,44.6827524575514,0,1134,0,1,1104,90.5797101449275
23744,27,27450,81,"Tasa de exámenes médico legales por presunto delito sexual contra niños, niñas y adolescentes",2017,3,1,2504,39.936102236421704,0,1271,0,1,1233,81.10300081103
23745,27,27491,81,"Tasa de exámenes médico legales por presunto delito sexual contra niños, niñas y adolescentes",2017,4,1,1078,92.7643784786642,0,559,0,1,519,192.678227360308
23746,27,27495,121,Tasa de exámenes médico legales por presunto delito sexual cuando la víctima está entre 18 y 28 años,2017,5,1,1806,55.3709856035437,1,933,107.181136120043,0,873,0
23747,27,27580,81,"Tasa de exámenes médico legales por presunto delito sexual contra niños, niñas y adolescentes",2017,4,1,1354,73.8552437223043,0,666,0,1,688,145.348837209302
23748,27,27600,81,"Tasa de exámenes médico legales por presunto delito sexual contra niños, niñas y adolescentes",2017,2,1,1146,87.260034904014,0,581,0,1,565,176.991150442478
23749,27,27600,81,"Tasa de exámenes médico legales por presunto delito sexual contra niños, niñas y adolescentes",2017,4,1,1172,85.3242320819113,0,599,0,1,573,174.520069808028
23750,27,27615,81,"Tasa de exámenes médico legales por presunto delito sexual contra niños, niñas y adolescentes",2017,3,1,4501,22.2172850477672,0,2277,0,1,2224,44.9640287769784
23751,27,27660,81,"Tasa de exámenes médico legales por presunto delito sexual contra niños, niñas y adolescentes",2017,3,1,745,134.228187919463,0,361,0,1,384,260.416666666667
23752,27,27787,81,"Tasa de exámenes médico legales por presunto delito sexual contra niños, niñas y adolescentes",2017,3,5,2913,171.64435290079,0,1456,0,5,1457,343.170899107756
23753,27,27787,81,"Tasa de exámenes médico legales por presunto delito sexual contra niños, niñas y adolescentes",2017,4,2,2585,77.3694390715667,0,1286,0,2,1299,153.964588144727
23754,27,27787,121,Tasa de exámenes médico legales por presunto delito sexual cuando la víctima está entre 18 y 28 años,2017,5,1,4279,23.3699462491236,0,2117,0,1,2162,46.2534690101758
23755,27,27800,81,"Tasa de exámenes médico legales por presunto delito sexual contra niños, niñas y adolescentes",2017,2,1,1769,56.5291124929339,0,902,0,1,867,115.340253748558
23756,27,27810,81,"Tasa de exámenes médico legales por presunto delito sexual contra niños, niñas y adolescentes",2017,3,1,1523,65.6598818122127,1,778,128.53470437018,0,745,0
23757,27,27810,81,"Tasa de exámenes médico legales por presunto delito sexual contra niños, niñas y adolescentes",2017,4,1,1370,72.992700729927,0,703,0,1,667,149.925037481259
23758,27,27810,121,Tasa de exámenes médico legales por presunto delito sexual cuando la víctima está entre 18 y 28 años,2017,5,1,2122,47.1253534401508,0,1110,0,1,1012,98.8142292490118
23759,41,41001,81,"Tasa de exámenes médico legales por presunto delito sexual contra niños, niñas y adolescentes",2017,2,51,25747,198.081329863673,11,13087,84.0528769007412,40,12660,315.955766192733
23760,41,41001,81,"Tasa de exámenes médico legales por presunto delito sexual contra niños, niñas y adolescentes",2017,3,88,32942,267.136178738389,13,16687,77.9049559537364,75,16255,461.39649338665
23761,41,41001,81,"Tasa de exámenes médico legales por presunto delito sexual contra niños, niñas y adolescentes",2017,4,96,34614,277.344427110418,15,17253,86.9414014953921,81,17361,466.56298600311
23762,41,41001,121,Tasa de exámenes médico legales por presunto delito sexual cuando la víctima está entre 18 y 28 años,2017,5,22,67924,32.3891408044285,2,33523,5.96605315753363,20,34401,58.1378448300921
23763,41,41006,81,"Tasa de exámenes médico legales por presunto delito sexual contra niños, niñas y adolescentes",2017,2,3,4215,71.1743772241993,0,2161,0,3,2054,146.056475170399
23764,41,41006,81,"Tasa de exámenes médico legales por presunto delito sexual contra niños, niñas y adolescentes",2017,3,6,4642,129.2546316243,2,2381,83.9983200335993,4,2261,176.912870411322
23765,41,41006,81,"Tasa de exámenes médico legales por presunto delito sexual contra niños, niñas y adolescentes",2017,4,6,4474,134.108180599017,0,2278,0,6,2196,273.224043715847
23766,41,41006,121,Tasa de exámenes médico legales por presunto delito sexual cuando la víctima está entre 18 y 28 años,2017,5,1,7005,14.2755174875089,0,3575,0,1,3430,29.1545189504373
23767,41,41013,81,"Tasa de exámenes médico legales por presunto delito sexual contra niños, niñas y adolescentes",2017,4,1,1113,89.8472596585804,0,589,0,1,524,190.839694656489
23768,41,41016,81,"Tasa de exámenes médico legales por presunto delito sexual contra niños, niñas y adolescentes",2017,4,7,3274,213.805742211362,3,1677,178.890876565295,4,1597,250.469630557295
23769,41,41020,81,"Tasa de exámenes médico legales por presunto delito sexual contra niños, niñas y adolescentes",2017,3,5,2924,170.998632010944,0,1515,0,5,1409,354.86160397445
23770,41,41020,81,"Tasa de exámenes médico legales por presunto delito sexual contra niños, niñas y adolescentes",2017,4,5,2720,183.823529411765,0,1409,0,5,1311,381.3882532418
23771,41,41020,121,Tasa de exámenes médico legales por presunto delito sexual cuando la víctima está entre 18 y 28 años,2017,5,1,4527,22.0896841175171,0,2313,0,1,2214,45.16711833785
23772,41,41078,81,"Tasa de exámenes médico legales por presunto delito sexual contra niños, niñas y adolescentes",2017,2,1,970,103.092783505155,0,495,0,1,475,210.526315789474
23773,41,41078,81,"Tasa de exámenes médico legales por presunto delito sexual contra niños, niñas y adolescentes",2017,3,1,1104,90.5797101449275,0,576,0,1,528,189.393939393939
23774,41,41132,81,"Tasa de exámenes médico legales por presunto delito sexual contra niños, niñas y adolescentes",2017,4,1,3801,26.3088660878716,0,1919,0,1,1882,53.134962805526
23775,41,41132,121,Tasa de exámenes médico legales por presunto delito sexual cuando la víctima está entre 18 y 28 años,2017,5,2,6594,30.3306035790112,0,3217,0,2,3377,59.2241634586911
23776,41,41206,81,"Tasa de exámenes médico legales por presunto delito sexual contra niños, niñas y adolescentes",2017,3,2,1441,138.792505204719,0,752,0,2,689,290.275761973875
23777,41,41206,81,"Tasa de exámenes médico legales por presunto delito sexual contra niños, niñas y adolescentes",2017,4,3,1403,213.827512473272,0,742,0,3,661,453.857791225416
23778,41,41244,81,"Tasa de exámenes médico legales por presunto delito sexual contra niños, niñas y adolescentes",2017,2,3,489,613.496932515337,1,247,404.858299595142,2,242,826.446280991736
23779,41,41298,81,"Tasa de exámenes médico legales por presunto delito sexual contra niños, niñas y adolescentes",2017,2,1,10121,9.88044659618615,0,5196,0,1,4925,20.3045685279188
23780,41,41298,81,"Tasa de exámenes médico legales por presunto delito sexual contra niños, niñas y adolescentes",2017,3,4,11441,34.9619788480028,0,5879,0,4,5562,71.9165767709457
23781,41,41298,81,"Tasa de exámenes médico legales por presunto delito sexual contra niños, niñas y adolescentes",2017,4,9,11531,78.0504726389732,0,6065,0,9,5466,164.654226125137
23782,41,41298,121,Tasa de exámenes médico legales por presunto delito sexual cuando la víctima está entre 18 y 28 años,2017,5,1,20235,4.94193229552755,0,11443,0,1,8792,11.3739763421292
23783,41,41306,81,"Tasa de exámenes médico legales por presunto delito sexual contra niños, niñas y adolescentes",2017,2,2,3599,55.5709919422062,0,1849,0,2,1750,114.285714285714
23784,41,41306,81,"Tasa de exámenes médico legales por presunto delito sexual contra niños, niñas y adolescentes",2017,4,1,3959,25.2589037635767,0,2002,0,1,1957,51.0986203372509
23785,41,41319,81,"Tasa de exámenes médico legales por presunto delito sexual contra niños, niñas y adolescentes",2017,3,1,2857,35.0017500875044,0,1459,0,1,1398,71.5307582260372
23786,41,41319,81,"Tasa de exámenes médico legales por presunto delito sexual contra niños, niñas y adolescentes",2017,4,1,2663,37.5516334960571,0,1369,0,1,1294,77.2797527047913
23787,41,41357,81,"Tasa de exámenes médico legales por presunto delito sexual contra niños, niñas y adolescentes",2017,3,2,1438,139.082058414465,0,759,0,2,679,294.550810014728
23788,41,41357,81,"Tasa de exámenes médico legales por presunto delito sexual contra niños, niñas y adolescentes",2017,4,3,1384,216.763005780347,0,742,0,3,642,467.289719626168
23789,41,41359,81,"Tasa de exámenes médico legales por presunto delito sexual contra niños, niñas y adolescentes",2017,2,3,2938,102.11027910143,1,1501,66.6222518321119,2,1437,139.178844815588
23790,41,41359,81,"Tasa de exámenes médico legales por presunto delito sexual contra niños, niñas y adolescentes",2017,3,10,3258,306.936771025169,2,1662,120.336943441637,8,1596,501.25313283208
23791,41,41359,81,"Tasa de exámenes médico legales por presunto delito sexual contra niños, niñas y adolescentes",2017,4,11,3243,339.192106074622,0,1684,0,11,1559,705.580500320718
23792,41,41359,121,Tasa de exámenes médico legales por presunto delito sexual cuando la víctima está entre 18 y 28 años,2017,5,2,5705,35.056967572305,0,2926,0,2,2779,71.9683339330694
23793,41,41378,81,"Tasa de exámenes médico legales por presunto delito sexual contra niños, niñas y adolescentes",2017,2,1,1713,58.3771161704612,0,869,0,1,844,118.483412322275
23794,41,41378,81,"Tasa de exámenes médico legales por presunto delito sexual contra niños, niñas y adolescentes",2017,3,5,1855,269.541778975741,3,939,319.488817891374,2,916,218.340611353712
23795,41,41378,81,"Tasa de exámenes médico legales por presunto delito sexual contra niños, niñas y adolescentes",2017,4,2,1776,112.612612612613,1,901,110.987791342952,1,875,114.285714285714
23796,41,41378,121,Tasa de exámenes médico legales por presunto delito sexual cuando la víctima está entre 18 y 28 años,2017,5,2,2973,67.272115708039,0,1481,0,2,1492,134.048257372654
23797,41,41396,81,"Tasa de exámenes médico legales por presunto delito sexual contra niños, niñas y adolescentes",2017,2,1,7206,13.8773244518457,0,3685,0,1,3521,28.4010224368077
23798,41,41396,81,"Tasa de exámenes médico legales por presunto delito sexual contra niños, niñas y adolescentes",2017,3,3,8219,36.5007908504684,0,4218,0,3,4001,74.9812546863284
23799,41,41396,81,"Tasa de exámenes médico legales por presunto delito sexual contra niños, niñas y adolescentes",2017,4,14,8101,172.818170596223,2,4197,47.6530855372885,12,3904,307.377049180328
23800,41,41396,121,Tasa de exámenes médico legales por presunto delito sexual cuando la víctima está entre 18 y 28 años,2017,5,2,13133,15.2288129140333,0,6746,0,2,6387,31.3136057617035
23801,41,41483,81,"Tasa de exámenes médico legales por presunto delito sexual contra niños, niñas y adolescentes",2017,3,2,796,251.256281407035,0,419,0,2,377,530.503978779841
23802,41,41483,81,"Tasa de exámenes médico legales por presunto delito sexual contra niños, niñas y adolescentes",2017,4,1,770,129.87012987013,0,408,0,1,362,276.243093922652
23803,41,41503,81,"Tasa de exámenes médico legales por presunto delito sexual contra niños, niñas y adolescentes",2017,4,3,1988,150.905432595573,0,1027,0,3,961,312.174817898023
23804,41,41518,121,Tasa de exámenes médico legales por presunto delito sexual cuando la víctima está entre 18 y 28 años,2017,5,1,1087,91.9963201471941,0,551,0,1,536,186.567164179104
23805,41,41524,81,"Tasa de exámenes médico legales por presunto delito sexual contra niños, niñas y adolescentes",2017,2,4,3170,126.182965299685,2,1613,123.992560446373,2,1557,128.452151573539
23806,41,41524,81,"Tasa de exámenes médico legales por presunto delito sexual contra niños, niñas y adolescentes",2017,3,3,3793,79.093066174532,0,1933,0,3,1860,161.290322580645
23807,41,41524,81,"Tasa de exámenes médico legales por presunto delito sexual contra niños, niñas y adolescentes",2017,4,11,3732,294.748124330118,1,1915,52.2193211488251,10,1817,550.357732526142
23808,41,41524,121,Tasa de exámenes médico legales por presunto delito sexual cuando la víctima está entre 18 y 28 años,2017,5,1,6382,15.6690692572861,0,3290,0,1,3092,32.3415265200518
23809,41,41530,81,"Tasa de exámenes médico legales por presunto delito sexual contra niños, niñas y adolescentes",2017,2,1,1285,77.8210116731518,0,674,0,1,611,163.66612111293
23810,41,41530,81,"Tasa de exámenes médico legales por presunto delito sexual contra niños, niñas y adolescentes",2017,3,5,1441,346.981263011797,1,770,129.87012987013,4,671,596.125186289121
23811,41,41530,81,"Tasa de exámenes médico legales por presunto delito sexual contra niños, niñas y adolescentes",2017,4,4,1416,282.485875706215,0,752,0,4,664,602.409638554217
23812,41,41530,121,Tasa de exámenes médico legales por presunto delito sexual cuando la víctima está entre 18 y 28 años,2017,5,1,2483,40.2738622633911,0,1272,0,1,1211,82.5763831544178
23813,41,41548,81,"Tasa de exámenes médico legales por presunto delito sexual contra niños, niñas y adolescentes",2017,2,1,1517,65.9195781147001,0,781,0,1,736,135.869565217391
23814,41,41548,81,"Tasa de exámenes médico legales por presunto delito sexual contra niños, niñas y adolescentes",2017,3,3,1595,188.087774294671,1,833,120.048019207683,2,762,262.46719160105
23815,41,41548,81,"Tasa de exámenes médico legales por presunto delito sexual contra niños, niñas y adolescentes",2017,4,1,1504,66.4893617021277,0,779,0,1,725,137.931034482759
23816,41,41548,121,Tasa de exámenes médico legales por presunto delito sexual cuando la víctima está entre 18 y 28 años,2017,5,1,2793,35.8037952022914,0,1460,0,1,1333,75.0187546886722
23817,41,41551,81,"Tasa de exámenes médico legales por presunto delito sexual contra niños, niñas y adolescentes",2017,2,14,13091,106.943701779849,2,6673,29.9715270493032,12,6418,186.974135244625
23818,41,41551,81,"Tasa de exámenes médico legales por presunto delito sexual contra niños, niñas y adolescentes",2017,3,24,15347,156.382354857627,6,7763,77.289707587273,18,7584,237.341772151899
23819,41,41551,81,"Tasa de exámenes médico legales por presunto delito sexual contra niños, niñas y adolescentes",2017,4,34,15488,219.52479338843,2,7831,25.5395224109309,32,7657,417.918244743372
23820,41,41551,121,Tasa de exámenes médico legales por presunto delito sexual cuando la víctima está entre 18 y 28 años,2017,5,6,26763,22.4190113216007,2,13305,15.0319428786171,4,13458,29.7220983801456
23821,41,41615,81,"Tasa de exámenes médico legales por presunto delito sexual contra niños, niñas y adolescentes",2017,2,2,1753,114.090131203651,0,892,0,2,861,232.288037166086
23822,41,41615,81,"Tasa de exámenes médico legales por presunto delito sexual contra niños, niñas y adolescentes",2017,3,7,2076,337.18689788054,1,1059,94.4287063267233,6,1017,589.970501474926
23823,41,41615,81,"Tasa de exámenes médico legales por presunto delito sexual contra niños, niñas y adolescentes",2017,4,7,1967,355.871886120996,1,992,100.806451612903,6,975,615.384615384615
23824,41,41615,121,Tasa de exámenes médico legales por presunto delito sexual cuando la víctima está entre 18 y 28 años,2017,5,1,3598,27.7932184546971,0,1798,0,1,1800,55.5555555555556
23825,41,41660,81,"Tasa de exámenes médico legales por presunto delito sexual contra niños, niñas y adolescentes",2017,2,2,1446,138.312586445367,0,746,0,2,700,285.714285714286
23826,41,41660,81,"Tasa de exámenes médico legales por presunto delito sexual contra niños, niñas y adolescentes",2017,3,1,1573,63.5727908455181,0,822,0,1,751,133.155792276964
23827,41,41660,81,"Tasa de exámenes médico legales por presunto delito sexual contra niños, niñas y adolescentes",2017,4,6,1481,405.131667792032,0,772,0,6,709,846.262341325811
23828,41,41660,121,Tasa de exámenes médico legales por presunto delito sexual cuando la víctima está entre 18 y 28 años,2017,5,1,2319,43.122035360069,0,1189,0,1,1130,88.4955752212389
23829,41,41668,81,"Tasa de exámenes médico legales por presunto delito sexual contra niños, niñas y adolescentes",2017,2,1,3197,31.2793243665937,0,1621,0,1,1576,63.4517766497462
23830,41,41668,81,"Tasa de exámenes médico legales por presunto delito sexual contra niños, niñas y adolescentes",2017,3,9,3726,241.545893719807,2,1891,105.764145954521,7,1835,381.471389645777
23831,41,41668,81,"Tasa de exámenes médico legales por presunto delito sexual contra niños, niñas y adolescentes",2017,4,11,3692,297.941495124594,0,1870,0,11,1822,603.732162458836
23832,41,41668,121,Tasa de exámenes médico legales por presunto delito sexual cuando la víctima está entre 18 y 28 años,2017,5,2,6968,28.7026406429392,1,3593,27.8318953520735,1,3375,29.6296296296296
23833,41,41676,81,"Tasa de exámenes médico legales por presunto delito sexual contra niños, niñas y adolescentes",2017,4,2,1359,147.167034584253,0,725,0,2,634,315.457413249211
23834,41,41770,81,"Tasa de exámenes médico legales por presunto delito sexual contra niños, niñas y adolescentes",2017,3,1,2564,39.0015600624025,0,1314,0,1,1250,80
23835,41,41770,81,"Tasa de exámenes médico legales por presunto delito sexual contra niños, niñas y adolescentes",2017,4,1,2395,41.7536534446764,0,1238,0,1,1157,86.4304235090752
23836,41,41791,81,"Tasa de exámenes médico legales por presunto delito sexual contra niños, niñas y adolescentes",2017,4,2,2228,89.7666068222621,0,1147,0,2,1081,185.013876040703
23837,41,41791,121,Tasa de exámenes médico legales por presunto delito sexual cuando la víctima está entre 18 y 28 años,2017,5,1,3516,28.4414106939704,0,1834,0,1,1682,59.4530321046373
23838,41,41797,81,"Tasa de exámenes médico legales por presunto delito sexual contra niños, niñas y adolescentes",2017,2,1,910,109.89010989011,0,471,0,1,439,227.790432801822
23839,41,41797,81,"Tasa de exámenes médico legales por presunto delito sexual contra niños, niñas y adolescentes",2017,3,2,1081,185.013876040703,0,563,0,2,518,386.100386100386
23840,41,41797,81,"Tasa de exámenes médico legales por presunto delito sexual contra niños, niñas y adolescentes",2017,4,2,1042,191.938579654511,0,544,0,2,498,401.606425702811
23841,41,41797,81,"Tasa de exámenes médico legales por presunto delito sexual contra niños, niñas y adolescentes",2017,1,1,186,537.634408602151,1,96,1041.66666666667,0,90,0
23842,41,41799,81,"Tasa de exámenes médico legales por presunto delito sexual contra niños, niñas y adolescentes",2017,3,1,1911,52.3286237571952,0,976,0,1,935,106.951871657754
23843,41,41801,81,"Tasa de exámenes médico legales por presunto delito sexual contra niños, niñas y adolescentes",2017,4,1,1020,98.0392156862745,0,555,0,1,465,215.05376344086
23844,41,41807,81,"Tasa de exámenes médico legales por presunto delito sexual contra niños, niñas y adolescentes",2017,2,1,2094,47.7554918815664,0,1069,0,1,1025,97.5609756097561
23845,41,41807,81,"Tasa de exámenes médico legales por presunto delito sexual contra niños, niñas y adolescentes",2017,4,2,2443,81.8665575112566,0,1224,0,2,1219,164.068908941756
23846,41,41807,121,Tasa de exámenes médico legales por presunto delito sexual cuando la víctima está entre 18 y 28 años,2017,5,1,4208,23.7642585551331,0,2116,0,1,2092,47.8011472275335
23847,41,41872,81,"Tasa de exámenes médico legales por presunto delito sexual contra niños, niñas y adolescentes",2017,4,2,866,230.94688221709,1,444,225.225225225225,1,422,236.96682464455
23848,41,41872,121,Tasa de exámenes médico legales por presunto delito sexual cuando la víctima está entre 18 y 28 años,2017,5,1,1429,69.9790062981106,0,726,0,1,703,142.247510668563
23849,41,41885,81,"Tasa de exámenes médico legales por presunto delito sexual contra niños, niñas y adolescentes",2017,4,1,917,109.051254089422,0,459,0,1,458,218.340611353712
23850,44,44001,81,"Tasa de exámenes médico legales por presunto delito sexual contra niños, niñas y adolescentes",2017,2,12,35580,33.7268128161889,2,18235,10.9679188374006,10,17345,57.6535024502739
23851,44,44001,81,"Tasa de exámenes médico legales por presunto delito sexual contra niños, niñas y adolescentes",2017,3,33,40214,82.0609737902223,9,20622,43.6427116671516,24,19592,122.498979175174
23852,44,44001,81,"Tasa de exámenes médico legales por presunto delito sexual contra niños, niñas y adolescentes",2017,4,60,34447,174.180625308445,0,17511,0,60,16936,354.274917335853
23853,44,44001,121,Tasa de exámenes médico legales por presunto delito sexual cuando la víctima está entre 18 y 28 años,2017,5,12,50656,23.689197725837,0,24968,0,12,25688,46.7144191840548
23854,44,44035,81,"Tasa de exámenes médico legales por presunto delito sexual contra niños, niñas y adolescentes",2017,3,3,3691,81.2787862367922,2,1920,104.166666666667,1,1771,56.4652738565782
23855,44,44035,81,"Tasa de exámenes médico legales por presunto delito sexual contra niños, niñas y adolescentes",2017,4,6,3405,176.211453744493,1,1778,56.2429696287964,5,1627,307.314074984634
23856,44,44078,81,"Tasa de exámenes médico legales por presunto delito sexual contra niños, niñas y adolescentes",2017,2,2,4614,43.3463372345037,0,2334,0,2,2280,87.719298245614
23857,44,44078,81,"Tasa de exámenes médico legales por presunto delito sexual contra niños, niñas y adolescentes",2017,3,3,5089,58.9506779327962,0,2566,0,3,2523,118.906064209275
23858,44,44078,81,"Tasa de exámenes médico legales por presunto delito sexual contra niños, niñas y adolescentes",2017,4,3,4617,64.9772579597141,0,2341,0,3,2276,131.810193321617
23859,44,44090,81,"Tasa de exámenes médico legales por presunto delito sexual contra niños, niñas y adolescentes",2017,2,1,4761,21.0039907582441,0,2440,0,1,2321,43.0848772081
23860,44,44090,81,"Tasa de exámenes médico legales por presunto delito sexual contra niños, niñas y adolescentes",2017,3,2,4876,41.0172272354389,0,2521,0,2,2355,84.9256900212314
23861,44,44090,81,"Tasa de exámenes médico legales por presunto delito sexual contra niños, niñas y adolescentes",2017,4,6,4435,135.287485907554,0,2326,0,6,2109,284.495021337127
23862,44,44098,81,"Tasa de exámenes médico legales por presunto delito sexual contra niños, niñas y adolescentes",2017,2,5,1924,259.87525987526,0,986,0,5,938,533.049040511727
23863,44,44098,81,"Tasa de exámenes médico legales por presunto delito sexual contra niños, niñas y adolescentes",2017,3,1,2103,47.5511174512601,0,1065,0,1,1038,96.3391136801541
23864,44,44098,81,"Tasa de exámenes médico legales por presunto delito sexual contra niños, niñas y adolescentes",2017,4,4,2069,193.330111164814,0,1094,0,4,975,410.25641025641
23865,44,44110,81,"Tasa de exámenes médico legales por presunto delito sexual contra niños, niñas y adolescentes",2017,2,1,909,110.01100110011,1,465,215.05376344086,0,444,0
23866,44,44110,81,"Tasa de exámenes médico legales por presunto delito sexual contra niños, niñas y adolescentes",2017,3,1,962,103.950103950104,0,497,0,1,465,215.05376344086
23867,44,44279,81,"Tasa de exámenes médico legales por presunto delito sexual contra niños, niñas y adolescentes",2017,2,2,3865,51.7464424320828,1,1965,50.8905852417303,1,1900,52.6315789473684
23868,44,44279,81,"Tasa de exámenes médico legales por presunto delito sexual contra niños, niñas y adolescentes",2017,3,5,4279,116.849731245618,0,2159,0,5,2120,235.849056603774
23869,44,44279,81,"Tasa de exámenes médico legales por presunto delito sexual contra niños, niñas y adolescentes",2017,4,5,3723,134.30029546065,0,1879,0,5,1844,271.14967462039
23870,44,44378,81,"Tasa de exámenes médico legales por presunto delito sexual contra niños, niñas y adolescentes",2017,2,1,3366,29.708853238265,0,1730,0,1,1636,61.1246943765281
23871,44,44378,81,"Tasa de exámenes médico legales por presunto delito sexual contra niños, niñas y adolescentes",2017,3,1,3553,28.1452293836195,0,1836,0,1,1717,58.24111822947
23872,44,44378,81,"Tasa de exámenes médico legales por presunto delito sexual contra niños, niñas y adolescentes",2017,4,5,3220,155.27950310559,1,1666,60.0240096038415,4,1554,257.400257400257
23873,44,44420,81,"Tasa de exámenes médico legales por presunto delito sexual contra niños, niñas y adolescentes",2017,3,1,355,281.69014084507,1,193,518.134715025907,0,162,0
23874,44,44420,121,Tasa de exámenes médico legales por presunto delito sexual cuando la víctima está entre 18 y 28 años,2017,5,2,625,320,0,336,0,2,289,692.041522491349
23875,44,44430,81,"Tasa de exámenes médico legales por presunto delito sexual contra niños, niñas y adolescentes",2017,2,12,19315,62.1278798860989,4,9869,40.5309555172763,8,9446,84.6919330933729
23876,44,44430,81,"Tasa de exámenes médico legales por presunto delito sexual contra niños, niñas y adolescentes",2017,3,28,22915,122.190704778529,7,11705,59.8035027765912,21,11210,187.332738626227
23877,44,44430,81,"Tasa de exámenes médico legales por presunto delito sexual contra niños, niñas y adolescentes",2017,4,40,20621,193.977013723874,3,10453,28.6998947670525,37,10168,363.886703383163
23878,44,44430,121,Tasa de exámenes médico legales por presunto delito sexual cuando la víctima está entre 18 y 28 años,2017,5,6,29434,20.3845892505266,0,14899,0,6,14535,41.2796697626419
23879,44,44560,81,"Tasa de exámenes médico legales por presunto delito sexual contra niños, niñas y adolescentes",2017,2,3,16017,18.7300992695261,0,8135,0,3,7882,38.0614057345851
23880,44,44560,81,"Tasa de exámenes médico legales por presunto delito sexual contra niños, niñas y adolescentes",2017,3,3,16208,18.5093780848963,0,8150,0,3,8058,37.2300819061802
23881,44,44560,81,"Tasa de exámenes médico legales por presunto delito sexual contra niños, niñas y adolescentes",2017,4,4,14523,27.5425187633409,0,7204,0,4,7319,54.6522749009427
23882,44,44650,81,"Tasa de exámenes médico legales por presunto delito sexual contra niños, niñas y adolescentes",2017,2,2,4157,48.1116189559779,1,2157,46.3606861381548,1,2000,50
23883,44,44650,81,"Tasa de exámenes médico legales por presunto delito sexual contra niños, niñas y adolescentes",2017,3,5,4572,109.361329833771,1,2402,41.6319733555371,4,2170,184.331797235023
23884,44,44650,81,"Tasa de exámenes médico legales por presunto delito sexual contra niños, niñas y adolescentes",2017,4,4,4022,99.4530084535057,0,2095,0,4,1927,207.576543850545
23885,44,44650,121,Tasa de exámenes médico legales por presunto delito sexual cuando la víctima está entre 18 y 28 años,2017,5,2,7319,27.3261374504714,0,3696,0,2,3623,55.2028705492686
23886,44,44847,81,"Tasa de exámenes médico legales por presunto delito sexual contra niños, niñas y adolescentes",2017,2,2,26333,7.59503284851707,1,13369,7.47999102401077,1,12964,7.71366862079605
23887,44,44847,81,"Tasa de exámenes médico legales por presunto delito sexual contra niños, niñas y adolescentes",2017,3,3,26855,11.171104077453,1,13520,7.39644970414201,2,13335,14.9981252343457
23888,44,44847,81,"Tasa de exámenes médico legales por presunto delito sexual contra niños, niñas y adolescentes",2017,4,4,24127,16.578936461226,0,12074,0,4,12053,33.1867584833651
23889,44,44847,121,Tasa de exámenes médico legales por presunto delito sexual cuando la víctima está entre 18 y 28 años,2017,5,1,37979,2.6330340451302,0,18735,0,1,19244,5.19642485969653
23890,44,44855,81,"Tasa de exámenes médico legales por presunto delito sexual contra niños, niñas y adolescentes",2017,4,4,1904,210.084033613445,0,964,0,4,940,425.531914893617
23891,44,44874,81,"Tasa de exámenes médico legales por presunto delito sexual contra niños, niñas y adolescentes",2017,2,1,2953,33.8638672536404,0,1509,0,1,1444,69.2520775623269
23892,44,44874,81,"Tasa de exámenes médico legales por presunto delito sexual contra niños, niñas y adolescentes",2017,3,2,3148,63.5324015247776,0,1614,0,2,1534,130.378096479791
23893,44,44874,81,"Tasa de exámenes médico legales por presunto delito sexual contra niños, niñas y adolescentes",2017,4,2,2773,72.1240533717995,0,1424,0,2,1349,148.257968865827
23894,47,47001,81,"Tasa de exámenes médico legales por presunto delito sexual contra niños, niñas y adolescentes",2017,2,32,47016,68.0619363620895,11,24054,45.730439843685,21,22962,91.4554481316958
23895,47,47001,81,"Tasa de exámenes médico legales por presunto delito sexual contra niños, niñas y adolescentes",2017,3,83,58783,141.197284929316,12,29779,40.2968534873569,71,29004,244.793821541856
23896,47,47001,81,"Tasa de exámenes médico legales por presunto delito sexual contra niños, niñas y adolescentes",2017,4,120,61636,194.691414108638,7,30853,22.6882312903121,113,30783,367.085729136212
23897,47,47001,121,Tasa de exámenes médico legales por presunto delito sexual cuando la víctima está entre 18 y 28 años,2017,5,31,96252,32.2071229688734,3,48776,6.15056585205839,28,47476,58.9771674109023
23898,47,47001,81,"Tasa de exámenes médico legales por presunto delito sexual contra niños, niñas y adolescentes",2017,1,2,9236,21.654395842356,0,4732,0,2,4504,44.404973357016
23899,47,47030,81,"Tasa de exámenes médico legales por presunto delito sexual contra niños, niñas y adolescentes",2017,2,1,1688,59.2417061611374,0,862,0,1,826,121.065375302663
23900,47,47030,81,"Tasa de exámenes médico legales por presunto delito sexual contra niños, niñas y adolescentes",2017,3,1,1959,51.0464522715671,0,998,0,1,961,104.058272632674
23901,47,47030,81,"Tasa de exámenes médico legales por presunto delito sexual contra niños, niñas y adolescentes",2017,4,1,1761,56.785917092561,0,900,0,1,861,116.144018583043
23902,47,47030,121,Tasa de exámenes médico legales por presunto delito sexual cuando la víctima está entre 18 y 28 años,2017,5,2,2344,85.3242320819113,1,1248,80.1282051282051,1,1096,91.2408759124088
23903,47,47053,81,"Tasa de exámenes médico legales por presunto delito sexual contra niños, niñas y adolescentes",2017,2,2,5033,39.7377309755613,2,2577,77.6096235933256,0,2456,0
23904,47,47053,81,"Tasa de exámenes médico legales por presunto delito sexual contra niños, niñas y adolescentes",2017,3,3,5610,53.475935828877,1,2882,34.6981263011797,2,2728,73.3137829912023
23905,47,47053,81,"Tasa de exámenes médico legales por presunto delito sexual contra niños, niñas y adolescentes",2017,4,5,5305,94.2507068803016,0,2735,0,5,2570,194.552529182879
23906,47,47053,121,Tasa de exámenes médico legales por presunto delito sexual cuando la víctima está entre 18 y 28 años,2017,5,4,7705,51.9143413367943,0,3961,0,4,3744,106.837606837607
23907,47,47058,81,"Tasa de exámenes médico legales por presunto delito sexual contra niños, niñas y adolescentes",2017,2,2,3465,57.7200577200577,0,1779,0,2,1686,118.623962040332
23908,47,47058,81,"Tasa de exámenes médico legales por presunto delito sexual contra niños, niñas y adolescentes",2017,3,1,4096,24.4140625,0,2146,0,1,1950,51.2820512820513
23909,47,47058,81,"Tasa de exámenes médico legales por presunto delito sexual contra niños, niñas y adolescentes",2017,4,6,3872,154.95867768595,0,2078,0,6,1794,334.448160535117
23910,47,47058,121,Tasa de exámenes médico legales por presunto delito sexual cuando la víctima está entre 18 y 28 años,2017,5,1,5942,16.8293503870751,0,3203,0,1,2739,36.5096750638919
23911,47,47170,81,"Tasa de exámenes médico legales por presunto delito sexual contra niños, niñas y adolescentes",2017,3,1,2371,42.1762969211303,0,1202,0,1,1169,85.5431993156544
23912,47,47189,81,"Tasa de exámenes médico legales por presunto delito sexual contra niños, niñas y adolescentes",2017,2,1,10995,9.09504320145521,1,5645,17.7147918511957,0,5350,0
23913,47,47189,81,"Tasa de exámenes médico legales por presunto delito sexual contra niños, niñas y adolescentes",2017,3,5,12868,38.8560770904569,1,6662,15.0105073551486,4,6206,64.4537544311956
23914,47,47189,81,"Tasa de exámenes médico legales por presunto delito sexual contra niños, niñas y adolescentes",2017,4,11,13063,84.207303069739,0,6815,0,11,6248,176.056338028169
23915,47,47189,121,Tasa de exámenes médico legales por presunto delito sexual cuando la víctima está entre 18 y 28 años,2017,5,3,19805,15.1476899772785,0,10168,0,3,9637,31.1300197156792
23916,47,47205,81,"Tasa de exámenes médico legales por presunto delito sexual contra niños, niñas y adolescentes",2017,3,1,987,101.317122593718,1,512,195.3125,0,475,0
23917,47,47245,81,"Tasa de exámenes médico legales por presunto delito sexual contra niños, niñas y adolescentes",2017,2,2,6733,29.7044408139017,1,3448,29.0023201856148,1,3285,30.441400304414
23918,47,47245,81,"Tasa de exámenes médico legales por presunto delito sexual contra niños, niñas y adolescentes",2017,3,9,7599,118.436636399526,3,3899,76.9428058476532,6,3700,162.162162162162
23919,47,47245,81,"Tasa de exámenes médico legales por presunto delito sexual contra niños, niñas y adolescentes",2017,4,21,7051,297.830095021983,1,3622,27.6090557702927,20,3429,583.260425780111
23920,47,47245,121,Tasa de exámenes médico legales por presunto delito sexual cuando la víctima está entre 18 y 28 años,2017,5,1,11281,8.86446237035724,0,5864,0,1,5417,18.4604024367731
23921,47,47268,81,"Tasa de exámenes médico legales por presunto delito sexual contra niños, niñas y adolescentes",2017,4,3,2997,100.1001001001,1,1601,62.4609618988132,2,1396,143.266475644699
23922,47,47288,81,"Tasa de exámenes médico legales por presunto delito sexual contra niños, niñas y adolescentes",2017,3,4,7957,50.2702023375644,2,4039,49.5172072295123,2,3918,51.0464522715671
23923,47,47288,81,"Tasa de exámenes médico legales por presunto delito sexual contra niños, niñas y adolescentes",2017,4,9,7562,119.016133298069,0,3832,0,9,3730,241.286863270778
23924,47,47318,81,"Tasa de exámenes médico legales por presunto delito sexual contra niños, niñas y adolescentes",2017,3,2,3544,56.4334085778781,0,1837,0,2,1707,117.164616285882
23925,47,47318,81,"Tasa de exámenes médico legales por presunto delito sexual contra niños, niñas y adolescentes",2017,4,3,3287,91.2686340127776,0,1743,0,3,1544,194.300518134715
23926,47,47318,121,Tasa de exámenes médico legales por presunto delito sexual cuando la víctima está entre 18 y 28 años,2017,5,1,5667,17.6460208223046,0,3097,0,1,2570,38.9105058365759
23927,47,47460,81,"Tasa de exámenes médico legales por presunto delito sexual contra niños, niñas y adolescentes",2017,3,6,2612,229.709035222052,1,1369,73.0460189919649,5,1243,402.252614641995
23928,47,47460,81,"Tasa de exámenes médico legales por presunto delito sexual contra niños, niñas y adolescentes",2017,4,5,2471,202.347227842979,0,1325,0,5,1146,436.30017452007
23929,47,47541,81,"Tasa de exámenes médico legales por presunto delito sexual contra niños, niñas y adolescentes",2017,4,1,939,106.496272630458,0,486,0,1,453,220.75055187638
23930,47,47551,81,"Tasa de exámenes médico legales por presunto delito sexual contra niños, niñas y adolescentes",2017,3,1,3835,26.0756192959583,0,1989,0,1,1846,54.1711809317443
23931,47,47551,81,"Tasa de exámenes médico legales por presunto delito sexual contra niños, niñas y adolescentes",2017,4,8,3744,213.675213675214,0,1968,0,8,1776,450.45045045045
23932,47,47555,81,"Tasa de exámenes médico legales por presunto delito sexual contra niños, niñas y adolescentes",2017,2,2,6815,29.3470286133529,0,3476,0,2,3339,59.8981731057203
23933,47,47555,81,"Tasa de exámenes médico legales por presunto delito sexual contra niños, niñas y adolescentes",2017,3,3,8024,37.3878364905284,1,4115,24.3013365735115,2,3909,51.1639805576874
23934,47,47555,81,"Tasa de exámenes médico legales por presunto delito sexual contra niños, niñas y adolescentes",2017,4,14,7564,185.087255420412,2,3926,50.9424350483953,12,3638,329.851566794942
23935,47,47555,121,Tasa de exámenes médico legales por presunto delito sexual cuando la víctima está entre 18 y 28 años,2017,5,2,11380,17.5746924428823,0,5928,0,2,5452,36.6837857666911
23936,47,47570,81,"Tasa de exámenes médico legales por presunto delito sexual contra niños, niñas y adolescentes",2017,4,1,4509,22.1778664892437,0,2309,0,1,2200,45.4545454545455
23937,47,47570,121,Tasa de exámenes médico legales por presunto delito sexual cuando la víctima está entre 18 y 28 años,2017,5,1,5865,17.0502983802217,0,3072,0,1,2793,35.8037952022914
23938,47,47660,81,"Tasa de exámenes médico legales por presunto delito sexual contra niños, niñas y adolescentes",2017,3,2,2591,77.1902740254728,0,1315,0,2,1276,156.739811912226
23939,47,47660,81,"Tasa de exámenes médico legales por presunto delito sexual contra niños, niñas y adolescentes",2017,4,4,2379,168.137873055906,0,1245,0,4,1134,352.733686067019
23940,47,47675,81,"Tasa de exámenes médico legales por presunto delito sexual contra niños, niñas y adolescentes",2017,3,1,726,137.741046831956,0,363,0,1,363,275.482093663912
23941,47,47692,81,"Tasa de exámenes médico legales por presunto delito sexual contra niños, niñas y adolescentes",2017,3,1,2235,44.7427293064877,0,1151,0,1,1084,92.2509225092251
23942,47,47745,81,"Tasa de exámenes médico legales por presunto delito sexual contra niños, niñas y adolescentes",2017,2,1,3575,27.972027972028,1,1830,54.6448087431694,0,1745,0
23943,47,47745,81,"Tasa de exámenes médico legales por presunto delito sexual contra niños, niñas y adolescentes",2017,4,2,4101,48.7685930260912,0,2112,0,2,1989,100.553041729512
23944,47,47798,81,"Tasa de exámenes médico legales por presunto delito sexual contra niños, niñas y adolescentes",2017,3,4,1656,241.545893719807,1,855,116.959064327485,3,801,374.531835205993
23945,47,47798,81,"Tasa de exámenes médico legales por presunto delito sexual contra niños, niñas y adolescentes",2017,4,1,1519,65.8327847267939,0,774,0,1,745,134.228187919463
23946,47,47960,81,"Tasa de exámenes médico legales por presunto delito sexual contra niños, niñas y adolescentes",2017,2,1,925,108.108108108108,0,473,0,1,452,221.238938053097
23947,47,47960,81,"Tasa de exámenes médico legales por presunto delito sexual contra niños, niñas y adolescentes",2017,4,3,1041,288.184438040346,0,540,0,3,501,598.802395209581
23948,47,47980,81,"Tasa de exámenes médico legales por presunto delito sexual contra niños, niñas y adolescentes",2017,2,2,7902,25.3100480890914,0,4056,0,2,3846,52.0020800832033
23949,47,47980,81,"Tasa de exámenes médico legales por presunto delito sexual contra niños, niñas y adolescentes",2017,3,5,9265,53.9665407447383,0,4796,0,5,4469,111.881852763482
23950,47,47980,81,"Tasa de exámenes médico legales por presunto delito sexual contra niños, niñas y adolescentes",2017,4,7,8799,79.5544948289578,0,4596,0,7,4203,166.547704020937
23951,47,47980,121,Tasa de exámenes médico legales por presunto delito sexual cuando la víctima está entre 18 y 28 años,2017,5,2,12190,16.4068908941756,0,6398,0,2,5792,34.5303867403315
23952,5,5001,81,"Tasa de exámenes médico legales por presunto delito sexual contra niños, niñas y adolescentes",2017,2,307,146748,209.20216970589,70,74941,93.4068133598431,237,71807,330.051387747713
23953,5,5001,81,"Tasa de exámenes médico legales por presunto delito sexual contra niños, niñas y adolescentes",2017,3,417,181194,230.140070863274,107,92588,115.56573206031,310,88606,349.86344039907
23954,5,5001,81,"Tasa de exámenes médico legales por presunto delito sexual contra niños, niñas y adolescentes",2017,4,446,192866,231.248638951396,51,98747,51.64713864725,395,94119,419.681467078911
23955,5,5001,121,Tasa de exámenes médico legales por presunto delito sexual cuando la víctima está entre 18 y 28 años,2017,5,123,421125,29.2074799643811,8,212529,3.76419218083179,115,208596,55.1304914763466
23956,5,5001,81,"Tasa de exámenes médico legales por presunto delito sexual contra niños, niñas y adolescentes",2017,1,4,28844,13.8677021217584,0,14794,0,4,14050,28.4697508896797
23957,5,5002,81,"Tasa de exámenes médico legales por presunto delito sexual contra niños, niñas y adolescentes",2017,2,2,1690,118.343195266272,0,870,0,2,820,243.90243902439
23958,5,5002,81,"Tasa de exámenes médico legales por presunto delito sexual contra niños, niñas y adolescentes",2017,3,6,1906,314.795383001049,3,986,304.259634888438,3,920,326.086956521739
23959,5,5002,81,"Tasa de exámenes médico legales por presunto delito sexual contra niños, niñas y adolescentes",2017,4,8,1809,442.233278054174,1,939,106.496272630458,7,870,804.597701149425
23960,5,5002,121,Tasa de exámenes médico legales por presunto delito sexual cuando la víctima está entre 18 y 28 años,2017,5,1,3346,29.8864315600717,0,1764,0,1,1582,63.2111251580278
23961,5,5002,81,"Tasa de exámenes médico legales por presunto delito sexual contra niños, niñas y adolescentes",2017,1,1,350,285.714285714286,0,179,0,1,171,584.795321637427
23962,5,5004,81,"Tasa de exámenes médico legales por presunto delito sexual contra niños, niñas y adolescentes",2017,3,1,188,531.914893617021,0,98,0,1,90,1111.11111111111
23963,5,5021,81,"Tasa de exámenes médico legales por presunto delito sexual contra niños, niñas y adolescentes",2017,3,1,275,363.636363636364,0,140,0,1,135,740.740740740741
23964,5,5030,81,"Tasa de exámenes médico legales por presunto delito sexual contra niños, niñas y adolescentes",2017,2,6,2771,216.52832912306,2,1427,140.154169586545,4,1344,297.619047619048
23965,5,5030,81,"Tasa de exámenes médico legales por presunto delito sexual contra niños, niñas y adolescentes",2017,3,9,3352,268.496420047733,4,1745,229.226361031519,5,1607,311.138767890479
23966,5,5030,81,"Tasa de exámenes médico legales por presunto delito sexual contra niños, niñas y adolescentes",2017,4,15,3173,472.738733060195,1,1630,61.3496932515337,14,1543,907.323395981854
23967,5,5030,121,Tasa de exámenes médico legales por presunto delito sexual cuando la víctima está entre 18 y 28 años,2017,5,2,6113,32.7171601504989,0,3179,0,2,2934,68.1663258350375
23968,5,5031,81,"Tasa de exámenes médico legales por presunto delito sexual contra niños, niñas y adolescentes",2017,2,1,2428,41.1861614497529,1,1242,80.5152979066023,0,1186,0
23969,5,5031,81,"Tasa de exámenes médico legales por presunto delito sexual contra niños, niñas y adolescentes",2017,3,4,2664,150.15015015015,2,1368,146.198830409357,2,1296,154.320987654321
23970,5,5031,81,"Tasa de exámenes médico legales por presunto delito sexual contra niños, niñas y adolescentes",2017,4,5,2499,200.080032012805,0,1282,0,5,1217,410.846343467543
23971,5,5031,121,Tasa de exámenes médico legales por presunto delito sexual cuando la víctima está entre 18 y 28 años,2017,5,1,4525,22.0994475138122,0,2322,0,1,2203,45.3926463912846
23972,5,5034,81,"Tasa de exámenes médico legales por presunto delito sexual contra niños, niñas y adolescentes",2017,2,5,4346,115.048320294524,1,2211,45.2284034373587,4,2135,187.353629976581
23973,5,5034,81,"Tasa de exámenes médico legales por presunto delito sexual contra niños, niñas y adolescentes",2017,3,8,5191,154.112887690233,0,2660,0,8,2531,316.080600553141
23974,5,5034,81,"Tasa de exámenes médico legales por presunto delito sexual contra niños, niñas y adolescentes",2017,4,10,4950,202.020202020202,2,2570,77.8210116731518,8,2380,336.134453781513
23975,5,5034,121,Tasa de exámenes médico legales por presunto delito sexual cuando la víctima está entre 18 y 28 años,2017,5,1,9335,10.7123727905731,0,4790,0,1,4545,22.002200220022
23976,5,5036,81,"Tasa de exámenes médico legales por presunto delito sexual contra niños, niñas y adolescentes",2017,3,1,874,114.41647597254,1,455,219.78021978022,0,419,0
23977,5,5036,81,"Tasa de exámenes médico legales por presunto delito sexual contra niños, niñas y adolescentes",2017,4,1,847,118.063754427391,0,443,0,1,404,247.524752475248
23978,5,5038,81,"Tasa de exámenes médico legales por presunto delito sexual contra niños, niñas y adolescentes",2017,3,3,1280,234375,1,675,148.148148148148,2,605,330.578512396694
23979,5,5038,81,"Tasa de exámenes médico legales por presunto delito sexual contra niños, niñas y adolescentes",2017,4,2,1355,147.60147601476,0,714,0,2,641,312.01248049922
23980,5,5038,121,Tasa de exámenes médico legales por presunto delito sexual cuando la víctima está entre 18 y 28 años,2017,5,2,2274,87.9507475813544,1,1188,84.1750841750842,1,1086,92.0810313075506
23981,5,5040,81,"Tasa de exámenes médico legales por presunto delito sexual contra niños, niñas y adolescentes",2017,2,1,1763,56.7214974475326,1,904,110.619469026549,0,859,0
23982,5,5040,81,"Tasa de exámenes médico legales por presunto delito sexual contra niños, niñas y adolescentes",2017,3,5,2013,248.385494287134,2,1045,191.387559808612,3,968,309.917355371901
23983,5,5040,81,"Tasa de exámenes médico legales por presunto delito sexual contra niños, niñas y adolescentes",2017,4,12,1884,636.942675159236,0,997,0,12,887,1352.87485907554
23984,5,5042,81,"Tasa de exámenes médico legales por presunto delito sexual contra niños, niñas y adolescentes",2017,2,5,2573,194.325689856199,2,1328,150.602409638554,3,1245,240.963855421687
23985,5,5042,81,"Tasa de exámenes médico legales por presunto delito sexual contra niños, niñas y adolescentes",2017,3,13,2931,443.534629819174,2,1530,130.718954248366,11,1401,785.153461812991
23986,5,5042,81,"Tasa de exámenes médico legales por presunto delito sexual contra niños, niñas y adolescentes",2017,4,5,2664,187.687687687688,0,1390,0,5,1274,392.464678178964
23987,5,5042,121,Tasa de exámenes médico legales por presunto delito sexual cuando la víctima está entre 18 y 28 años,2017,5,5,4934,101.337657073368,1,2596,38.5208012326656,4,2338,171.086398631309
23988,5,5044,81,"Tasa de exámenes médico legales por presunto delito sexual contra niños, niñas y adolescentes",2017,3,1,869,115.074798619102,0,465,0,1,404,247.524752475248
23989,5,5045,81,"Tasa de exámenes médico legales por presunto delito sexual contra niños, niñas y adolescentes",2017,2,1,22867,4.37311409454673,0,11716,0,1,11151,8.96780557797507
23990,5,5045,81,"Tasa de exámenes médico legales por presunto delito sexual contra niños, niñas y adolescentes",2017,4,2,24165,8.27643285743844,0,12291,0,2,11874,16.8435236651508
23991,5,5045,121,Tasa de exámenes médico legales por presunto delito sexual cuando la víctima está entre 18 y 28 años,2017,5,1,41286,2.42212856658431,0,20763,0,1,20523,4.87258198119183
23992,5,5051,81,"Tasa de exámenes médico legales por presunto delito sexual contra niños, niñas y adolescentes",2017,4,9,5648,159.348441926346,0,2877,0,9,2771,324.79249368459
23993,5,5055,81,"Tasa de exámenes médico legales por presunto delito sexual contra niños, niñas y adolescentes",2017,2,1,976,102.459016393443,0,505,0,1,471,212.314225053079
23994,5,5055,81,"Tasa de exámenes médico legales por presunto delito sexual contra niños, niñas y adolescentes",2017,3,1,1081,92.5069380203515,1,577,173.310225303293,0,504,0
23995,5,5079,81,"Tasa de exámenes médico legales por presunto delito sexual contra niños, niñas y adolescentes",2017,2,8,4745,168.598524762908,0,2427,0,8,2318,345.125107851596
23996,5,5079,81,"Tasa de exámenes médico legales por presunto delito sexual contra niños, niñas y adolescentes",2017,3,14,5676,246.652572233968,3,2908,103.163686382393,11,2768,397.398843930636
23997,5,5079,81,"Tasa de exámenes médico legales por presunto delito sexual contra niños, niñas y adolescentes",2017,4,3,5551,54.0443163393983,1,2835,35.2733686067019,2,2716,73.6377025036819
23998,5,5079,121,Tasa de exámenes médico legales por presunto delito sexual cuando la víctima está entre 18 y 28 años,2017,5,4,10310,38.7972841901067,0,5231,0,4,5079,78.755660563103
23999,5,5079,81,"Tasa de exámenes médico legales por presunto delito sexual contra niños, niñas y adolescentes",2017,1,1,970,103.092783505155,0,496,0,1,474,210.970464135021
24000,5,5086,81,"Tasa de exámenes médico legales por presunto delito sexual contra niños, niñas y adolescentes",2017,2,1,735,136.054421768707,1,381,262.46719160105,0,354,0
24001,5,5086,81,"Tasa de exámenes médico legales por presunto delito sexual contra niños, niñas y adolescentes",2017,3,1,822,121.654501216545,1,431,232.018561484919,0,391,0
24002,5,5088,81,"Tasa de exámenes médico legales por presunto delito sexual contra niños, niñas y adolescentes",2017,2,40,38436,104.069101883651,16,19635,81.4871403106697,24,18801,127.65278442636
24003,5,5088,81,"Tasa de exámenes médico legales por presunto delito sexual contra niños, niñas y adolescentes",2017,3,66,46064,143.278916290379,18,23349,77.0910959784145,48,22715,211.314109619194
24004,5,5088,81,"Tasa de exámenes médico legales por presunto delito sexual contra niños, niñas y adolescentes",2017,4,78,47900,162.839248434238,5,23822,20.9890017630761,73,24078,303.18132735277
24005,5,5088,121,Tasa de exámenes médico legales por presunto delito sexual cuando la víctima está entre 18 y 28 años,2017,5,14,98466,14.2181057420836,1,48843,2.04737628728784,13,49623,26.1975293714608
24006,5,5088,81,"Tasa de exámenes médico legales por presunto delito sexual contra niños, niñas y adolescentes",2017,1,2,7832,25.5362614913177,0,4017,0,2,3815,52.4246395806029
24007,5,5091,81,"Tasa de exámenes médico legales por presunto delito sexual contra niños, niñas y adolescentes",2017,4,1,1028,97.2762645914397,0,540,0,1,488,204.918032786885
24008,5,5093,81,"Tasa de exámenes médico legales por presunto delito sexual contra niños, niñas y adolescentes",2017,3,1,2143,46.6635557629491,0,1065,0,1,1078,92.7643784786642
24009,5,5093,81,"Tasa de exámenes médico legales por presunto delito sexual contra niños, niñas y adolescentes",2017,4,2,1980,101.010101010101,0,988,0,2,992,201.612903225806
24010,5,5101,81,"Tasa de exámenes médico legales por presunto delito sexual contra niños, niñas y adolescentes",2017,2,1,2574,38.8500388500388,0,1315,0,1,1259,79.428117553614
24011,5,5101,81,"Tasa de exámenes médico legales por presunto delito sexual contra niños, niñas y adolescentes",2017,3,2,3016,66.3129973474801,0,1545,0,2,1471,135.961930659415
24012,5,5101,81,"Tasa de exámenes médico legales por presunto delito sexual contra niños, niñas y adolescentes",2017,4,8,2933,272.758267984998,0,1508,0,8,1425,561.40350877193
24013,5,5107,81,"Tasa de exámenes médico legales por presunto delito sexual contra niños, niñas y adolescentes",2017,3,3,1078,278.293135435993,1,551,181.488203266788,2,527,379.506641366224
24014,5,5107,81,"Tasa de exámenes médico legales por presunto delito sexual contra niños, niñas y adolescentes",2017,4,7,997,702.106318956871,0,511,0,7,486,1440.329218107
24015,5,5113,81,"Tasa de exámenes médico legales por presunto delito sexual contra niños, niñas y adolescentes",2017,4,3,725,413.793103448276,0,394,0,3,331,906.344410876133
24016,5,5120,81,"Tasa de exámenes médico legales por presunto delito sexual contra niños, niñas y adolescentes",2017,3,3,5736,52.3012552301255,1,2937,34.0483486550902,2,2799,71.4540907466952
24017,5,5120,81,"Tasa de exámenes médico legales por presunto delito sexual contra niños, niñas y adolescentes",2017,4,4,5287,75.6572725553244,0,2720,0,4,2567,155.823918971562
24018,5,5125,81,"Tasa de exámenes médico legales por presunto delito sexual contra niños, niñas y adolescentes",2017,3,1,965,103.626943005181,0,516,0,1,449,222.71714922049
24019,5,5129,81,"Tasa de exámenes médico legales por presunto delito sexual contra niños, niñas y adolescentes",2017,2,6,5672,105.782792665726,4,2899,137.978613314936,2,2773,72.1240533717995
24020,5,5129,81,"Tasa de exámenes médico legales por presunto delito sexual contra niños, niñas y adolescentes",2017,3,6,7158,83.8222967309304,0,3658,0,6,3500,171.428571428571
24021,5,5129,81,"Tasa de exámenes médico legales por presunto delito sexual contra niños, niñas y adolescentes",2017,4,12,7423,161.6597063182,1,3791,26.3782643102084,11,3632,302.863436123348
24022,5,5129,121,Tasa de exámenes médico legales por presunto delito sexual cuando la víctima está entre 18 y 28 años,2017,5,2,14964,13.3654103180968,0,7545,0,2,7419,26.9578110257447
24023,5,5134,81,"Tasa de exámenes médico legales por presunto delito sexual contra niños, niñas y adolescentes",2017,3,2,1030,194.174757281553,1,535,186.915887850467,1,495,202.020202020202
24024,5,5138,81,"Tasa de exámenes médico legales por presunto delito sexual contra niños, niñas y adolescentes",2017,2,1,1923,52.0020800832033,0,976,0,1,947,105.596620908131
24025,5,5138,81,"Tasa de exámenes médico legales por presunto delito sexual contra niños, niñas y adolescentes",2017,3,1,2119,47.192071731949,0,1070,0,1,1049,95.3288846520496
24026,5,5138,81,"Tasa de exámenes médico legales por presunto delito sexual contra niños, niñas y adolescentes",2017,4,3,1907,157.315154693235,0,961,0,3,946,317.124735729387
24027,5,5138,121,Tasa de exámenes médico legales por presunto delito sexual cuando la víctima está entre 18 y 28 años,2017,5,1,3199,31.2597686777118,0,1621,0,1,1578,63.3713561470215
24028,5,5142,81,"Tasa de exámenes médico legales por presunto delito sexual contra niños, niñas y adolescentes",2017,2,1,442,226.244343891403,1,226,442.477876106195,0,216,0
24029,5,5142,81,"Tasa de exámenes médico legales por presunto delito sexual contra niños, niñas y adolescentes",2017,4,1,482,207.46887966805,0,249,0,1,233,429.184549356223
24030,5,5147,81,"Tasa de exámenes médico legales por presunto delito sexual contra niños, niñas y adolescentes",2017,4,2,7217,27.7123458500762,0,3599,0,2,3618,55.2791597567717
24031,5,5148,81,"Tasa de exámenes médico legales por presunto delito sexual contra niños, niñas y adolescentes",2017,2,1,4835,20.6825232678387,0,2482,0,1,2353,42.4989375265618
24032,5,5148,81,"Tasa de exámenes médico legales por presunto delito sexual contra niños, niñas y adolescentes",2017,3,4,5660,70.6713780918728,0,2908,0,4,2752,145.348837209302
24033,5,5148,81,"Tasa de exámenes médico legales por presunto delito sexual contra niños, niñas y adolescentes",2017,4,6,5366,111.815132314573,1,2767,36.1402240693892,5,2599,192.381685263563
24034,5,5148,121,Tasa de exámenes médico legales por presunto delito sexual cuando la víctima está entre 18 y 28 años,2017,5,2,10126,19.7511356903022,0,5203,0,2,4923,40.6256347755434
24035,5,5154,81,"Tasa de exámenes médico legales por presunto delito sexual contra niños, niñas y adolescentes",2017,2,3,12594,23.8208670795617,0,6429,0,3,6165,48.661800486618
24036,5,5154,81,"Tasa de exámenes médico legales por presunto delito sexual contra niños, niñas y adolescentes",2017,3,15,14107,106.330190685475,1,7151,13.984058173682,14,6956,201.265094882116
24037,5,5154,81,"Tasa de exámenes médico legales por presunto delito sexual contra niños, niñas y adolescentes",2017,4,30,13953,215.007525263384,6,6996,85.7632933104631,24,6957,344.976282880552
24038,5,5154,121,Tasa de exámenes médico legales por presunto delito sexual cuando la víctima está entre 18 y 28 años,2017,5,9,25005,35.9928014397121,0,12122,0,9,12883,69.8595047737328
24039,5,5172,81,"Tasa de exámenes médico legales por presunto delito sexual contra niños, niñas y adolescentes",2017,2,1,9573,10.4460461715241,0,4881,0,1,4692,21.3128729752771
24040,5,5172,81,"Tasa de exámenes médico legales por presunto delito sexual contra niños, niñas y adolescentes",2017,3,2,10514,19.0222560395663,0,5299,0,2,5215,38.3509108341323
24041,5,5172,81,"Tasa de exámenes médico legales por presunto delito sexual contra niños, niñas y adolescentes",2017,4,3,9900,30.3030303030303,1,4919,20.329335230738,2,4981,40.1525798032524
24042,5,5172,121,Tasa de exámenes médico legales por presunto delito sexual cuando la víctima está entre 18 y 28 años,2017,5,1,17225,5.8055152394775,0,8436,0,1,8789,11.3778586869951
24043,5,5190,81,"Tasa de exámenes médico legales por presunto delito sexual contra niños, niñas y adolescentes",2017,3,1,893,111.982082866741,1,461,216.919739696312,0,432,0
24044,5,5190,81,"Tasa de exámenes médico legales por presunto delito sexual contra niños, niñas y adolescentes",2017,4,6,859,698.48661233993,1,448,223.214285714286,5,411,1216.54501216545
24045,5,5197,81,"Tasa de exámenes médico legales por presunto delito sexual contra niños, niñas y adolescentes",2017,4,1,1356,73.7463126843658,0,684,0,1,672,148.809523809524
24046,5,5197,121,Tasa de exámenes médico legales por presunto delito sexual cuando la víctima está entre 18 y 28 años,2017,5,1,2418,41.3564929693962,0,1199,0,1,1219,82.0344544708778
24047,5,5206,81,"Tasa de exámenes médico legales por presunto delito sexual contra niños, niñas y adolescentes",2017,3,1,280,357.142857142857,0,144,0,1,136,735.294117647059
24048,5,5206,81,"Tasa de exámenes médico legales por presunto delito sexual contra niños, niñas y adolescentes",2017,4,1,267,374.531835205993,0,138,0,1,129,775.193798449612
24049,5,5209,81,"Tasa de exámenes médico legales por presunto delito sexual contra niños, niñas y adolescentes",2017,2,2,2114,94.6073793755913,0,1094,0,2,1020,196.078431372549
24050,5,5209,81,"Tasa de exámenes médico legales por presunto delito sexual contra niños, niñas y adolescentes",2017,3,9,2514,357.99522673031,1,1314,76.103500761035,8,1200,666.666666666667
24051,5,5209,81,"Tasa de exámenes médico legales por presunto delito sexual contra niños, niñas y adolescentes",2017,4,14,2355,594.47983014862,2,1233,162.20600162206,12,1122,1069.51871657754
24052,5,5209,121,Tasa de exámenes médico legales por presunto delito sexual cuando la víctima está entre 18 y 28 años,2017,5,1,4134,24.1896468311563,0,2157,0,1,1977,50.5816894284269
24053,5,5212,81,"Tasa de exámenes médico legales por presunto delito sexual contra niños, niñas y adolescentes",2017,2,7,4815,145.379023883697,1,2440,40.9836065573771,6,2375,252.631578947368
24054,5,5212,81,"Tasa de exámenes médico legales por presunto delito sexual contra niños, niñas y adolescentes",2017,3,16,6008,266.311584553928,0,3096,0,16,2912,549.450549450549
24055,5,5212,81,"Tasa de exámenes médico legales por presunto delito sexual contra niños, niñas y adolescentes",2017,4,25,6547,381.854284405071,1,3381,29.5770482105886,24,3166,758.054327226785
24056,5,5212,121,Tasa de exámenes médico legales por presunto delito sexual cuando la víctima está entre 18 y 28 años,2017,5,2,13319,15.0161423530295,0,6766,0,2,6553,30.5203723485427
24057,5,5234,81,"Tasa de exámenes médico legales por presunto delito sexual contra niños, niñas y adolescentes",2017,3,6,2715,220.994475138122,1,1417,70.5716302046577,5,1298,385.208012326656
24058,5,5234,81,"Tasa de exámenes médico legales por presunto delito sexual contra niños, niñas y adolescentes",2017,4,3,2786,107.681263460158,1,1495,66.8896321070234,2,1291,154.918667699458
24059,5,5234,121,Tasa de exámenes médico legales por presunto delito sexual cuando la víctima está entre 18 y 28 años,2017,5,2,4461,44.8329970858552,0,2409,0,2,2052,97.4658869395711
24060,5,5237,121,Tasa de exámenes médico legales por presunto delito sexual cuando la víctima está entre 18 y 28 años,2017,5,2,4932,40.551500405515,0,2404,0,2,2528,79.1139240506329
24061,5,5240,81,"Tasa de exámenes médico legales por presunto delito sexual contra niños, niñas y adolescentes",2017,2,2,1188,168.350168350168,0,605,0,2,583,343.053173241853
24062,5,5240,81,"Tasa de exámenes médico legales por presunto delito sexual contra niños, niñas y adolescentes",2017,3,4,1373,291.332847778587,3,701,427.960057061341,1,672,148.809523809524
24063,5,5240,81,"Tasa de exámenes médico legales por presunto delito sexual contra niños, niñas y adolescentes",2017,4,6,1300,461.538461538462,0,670,0,6,630,952.380952380953
24064,5,5250,81,"Tasa de exámenes médico legales por presunto delito sexual contra niños, niñas y adolescentes",2017,2,2,5558,35.9841669665347,0,2853,0,2,2705,73.9371534195933
24065,5,5250,81,"Tasa de exámenes médico legales por presunto delito sexual contra niños, niñas y adolescentes",2017,3,3,6268,47.8621569878749,1,3230,30.9597523219814,2,3038,65.8327847267939
24066,5,5250,81,"Tasa de exámenes médico legales por presunto delito sexual contra niños, niñas y adolescentes",2017,4,4,6081,65.7786548265088,0,3153,0,4,2928,136.612021857924
24067,5,5250,121,Tasa de exámenes médico legales por presunto delito sexual cuando la víctima está entre 18 y 28 años,2017,5,1,10985,9.10332271279017,0,5785,0,1,5200,19.2307692307692
24068,5,5264,81,"Tasa de exámenes médico legales por presunto delito sexual contra niños, niñas y adolescentes",2017,4,4,1093,365.965233302836,0,566,0,4,527,759.013282732448
24069,5,5266,81,"Tasa de exámenes médico legales por presunto delito sexual contra niños, niñas y adolescentes",2017,2,12,16375,73.2824427480916,6,8365,71.7274357441721,6,8010,74.9063670411985
24070,5,5266,81,"Tasa de exámenes médico legales por presunto delito sexual contra niños, niñas y adolescentes",2017,3,16,20450,78.239608801956,8,10485,76.2994754411063,8,9965,80.2809834420472
24071,5,5266,81,"Tasa de exámenes médico legales por presunto delito sexual contra niños, niñas y adolescentes",2017,4,10,21513,46.4835215915958,0,11051,0,10,10462,95.5840183521315
24072,5,5266,121,Tasa de exámenes médico legales por presunto delito sexual cuando la víctima está entre 18 y 28 años,2017,5,9,42005,21.42602071182,0,21314,0,9,20691,43.4971726837756
24073,5,5282,81,"Tasa de exámenes médico legales por presunto delito sexual contra niños, niñas y adolescentes",2017,2,2,1793,111.54489682097,1,913,109.529025191676,1,880,113.636363636364
24074,5,5282,81,"Tasa de exámenes médico legales por presunto delito sexual contra niños, niñas y adolescentes",2017,3,1,2204,45.3720508166969,0,1126,0,1,1078,92.7643784786642
24075,5,5282,81,"Tasa de exámenes médico legales por presunto delito sexual contra niños, niñas y adolescentes",2017,4,8,2182,366.636113657195,4,1115,358.744394618834,4,1067,374.882849109653
24076,5,5306,81,"Tasa de exámenes médico legales por presunto delito sexual contra niños, niñas y adolescentes",2017,3,3,461,650.759219088937,0,236,0,3,225,1333.33333333333
24077,5,5306,81,"Tasa de exámenes médico legales por presunto delito sexual contra niños, niñas y adolescentes",2017,4,1,430,232.558139534884,0,223,0,1,207,483.091787439613
24078,5,5308,81,"Tasa de exámenes médico legales por presunto delito sexual contra niños, niñas y adolescentes",2017,2,4,4754,84.1396718552798,0,2423,0,4,2331,171.600171600172
24079,5,5308,81,"Tasa de exámenes médico legales por presunto delito sexual contra niños, niñas y adolescentes",2017,3,3,5814,51.5995872033024,2,2928,68.3060109289618,1,2886,34.6500346500346
24080,5,5308,81,"Tasa de exámenes médico legales por presunto delito sexual contra niños, niñas y adolescentes",2017,4,3,6027,49.7760079641613,1,3050,32.7868852459016,2,2977,67.1817265703729
24081,5,5308,121,Tasa de exámenes médico legales por presunto delito sexual cuando la víctima está entre 18 y 28 años,2017,5,2,11508,17.3792144595064,1,5826,17.164435290079,1,5682,17.5994368180218
24082,5,5310,81,"Tasa de exámenes médico legales por presunto delito sexual contra niños, niñas y adolescentes",2017,2,1,1137,87.9507475813544,0,572,0,1,565,176.991150442478
24083,5,5310,81,"Tasa de exámenes médico legales por presunto delito sexual contra niños, niñas y adolescentes",2017,3,1,1282,78.003120124805,0,649,0,1,633,157.977883096366
24084,5,5310,81,"Tasa de exámenes médico legales por presunto delito sexual contra niños, niñas y adolescentes",2017,4,1,1290,77.5193798449612,0,666,0,1,624,160.25641025641
24085,5,5310,121,Tasa de exámenes médico legales por presunto delito sexual cuando la víctima está entre 18 y 28 años,2017,5,1,2414,41.4250207125104,0,1277,0,1,1137,87.9507475813544
24086,5,5313,81,"Tasa de exámenes médico legales por presunto delito sexual contra niños, niñas y adolescentes",2017,2,2,902,221.729490022173,1,465,215.05376344086,1,437,228.83295194508
24087,5,5313,81,"Tasa de exámenes médico legales por presunto delito sexual contra niños, niñas y adolescentes",2017,3,2,1006,198.807157057654,1,517,193.423597678917,1,489,204.498977505112
24088,5,5318,81,"Tasa de exámenes médico legales por presunto delito sexual contra niños, niñas y adolescentes",2017,2,8,4623,173.047804455981,1,2365,42.2832980972516,7,2258,310.008857395926
24089,5,5318,81,"Tasa de exámenes médico legales por presunto delito sexual contra niños, niñas y adolescentes",2017,3,8,5479,146.012045993794,3,2798,107.219442458899,5,2681,186.497575531518
24090,5,5318,81,"Tasa de exámenes médico legales por presunto delito sexual contra niños, niñas y adolescentes",2017,4,13,5285,245.979186376537,3,2727,110.01100110011,10,2558,390.930414386239
24091,5,5318,121,Tasa de exámenes médico legales por presunto delito sexual cuando la víctima está entre 18 y 28 años,2017,5,2,9769,20.472924557273,0,4975,0,2,4794,41.7188151856487
24092,5,5321,81,"Tasa de exámenes médico legales por presunto delito sexual contra niños, niñas y adolescentes",2017,2,1,425,235.294117647059,0,215,0,1,210,476.190476190476
24093,5,5321,81,"Tasa de exámenes médico legales por presunto delito sexual contra niños, niñas y adolescentes",2017,4,4,508,787.40157480315,0,264,0,4,244,1639.34426229508
24094,5,5321,121,Tasa de exámenes médico legales por presunto delito sexual cuando la víctima está entre 18 y 28 años,2017,5,1,944,105.932203389831,0,482,0,1,462,216.450216450216
24095,5,5347,81,"Tasa de exámenes médico legales por presunto delito sexual contra niños, niñas y adolescentes",2017,3,2,668,299.40119760479,0,355,0,2,313,638.977635782748
24096,5,5347,81,"Tasa de exámenes médico legales por presunto delito sexual contra niños, niñas y adolescentes",2017,4,1,615,162.60162601626,0,331,0,1,284,352.112676056338
24097,5,5353,81,"Tasa de exámenes médico legales por presunto delito sexual contra niños, niñas y adolescentes",2017,2,1,398,251.256281407035,0,204,0,1,194,515.463917525773
24098,5,5353,81,"Tasa de exámenes médico legales por presunto delito sexual contra niños, niñas y adolescentes",2017,4,1,457,218.818380743982,0,234,0,1,223,448.430493273543
24099,5,5360,81,"Tasa de exámenes médico legales por presunto delito sexual contra niños, niñas y adolescentes",2017,2,23,20529,112.036631107214,7,10550,66.3507109004739,16,9979,160.336707084878
24100,5,5360,81,"Tasa de exámenes médico legales por presunto delito sexual contra niños, niñas y adolescentes",2017,3,32,24756,129.261593149136,6,12576,47.7099236641221,26,12180,213.464696223317
24101,5,5360,81,"Tasa de exámenes médico legales por presunto delito sexual contra niños, niñas y adolescentes",2017,4,31,26582,116.620269355203,3,13305,22.5479143179256,28,13277,210.891014536416
24102,5,5360,121,Tasa de exámenes médico legales por presunto delito sexual cuando la víctima está entre 18 y 28 años,2017,5,12,54567,21.9913134311947,2,27906,7.16691750877947,10,26661,37.5079704437193
24103,5,5361,81,"Tasa de exámenes médico legales por presunto delito sexual contra niños, niñas y adolescentes",2017,2,3,2705,110.90573012939,0,1367,0,3,1338,224.215246636771
24104,5,5361,81,"Tasa de exámenes médico legales por presunto delito sexual contra niños, niñas y adolescentes",2017,3,6,2880,208.333333333333,0,1463,0,6,1417,423.429781227946
24105,5,5361,81,"Tasa de exámenes médico legales por presunto delito sexual contra niños, niñas y adolescentes",2017,4,12,2524,475.435816164818,0,1285,0,12,1239,968.523002421308
24106,5,5361,121,Tasa de exámenes médico legales por presunto delito sexual cuando la víctima está entre 18 y 28 años,2017,5,3,3796,79.0305584826133,0,1954,0,3,1842,162.866449511401
24107,5,5364,81,"Tasa de exámenes médico legales por presunto delito sexual contra niños, niñas y adolescentes",2017,2,1,1295,77.2200772200772,0,668,0,1,627,159.489633173844
24108,5,5364,81,"Tasa de exámenes médico legales por presunto delito sexual contra niños, niñas y adolescentes",2017,3,1,1531,65.3167864141084,0,793,0,1,738,135.50135501355
24109,5,5364,81,"Tasa de exámenes médico legales por presunto delito sexual contra niños, niñas y adolescentes",2017,4,1,1431,69.8812019566736,0,747,0,1,684,146.198830409357
24110,5,5364,121,Tasa de exámenes médico legales por presunto delito sexual cuando la víctima está entre 18 y 28 años,2017,5,2,2537,78.8332676389436,0,1316,0,2,1221,163.800163800164
24111,5,5368,81,"Tasa de exámenes médico legales por presunto delito sexual contra niños, niñas y adolescentes",2017,2,1,1038,96.3391136801541,1,527,189.753320683112,0,511,0
24112,5,5368,81,"Tasa de exámenes médico legales por presunto delito sexual contra niños, niñas y adolescentes",2017,3,3,1236,242.718446601942,0,630,0,3,606,495.049504950495
24113,5,5368,81,"Tasa de exámenes médico legales por presunto delito sexual contra niños, niñas y adolescentes",2017,4,2,1204,166.112956810631,0,608,0,2,596,335.570469798658
24114,5,5376,81,"Tasa de exámenes médico legales por presunto delito sexual contra niños, niñas y adolescentes",2017,2,8,4572,174.978127734033,3,2327,128.921357971637,5,2245,222.71714922049
24115,5,5376,81,"Tasa de exámenes médico legales por presunto delito sexual contra niños, niñas y adolescentes",2017,3,7,5569,125.695816124978,0,2858,0,7,2711,258.207303578015
24116,5,5376,81,"Tasa de exámenes médico legales por presunto delito sexual contra niños, niñas y adolescentes",2017,4,13,5644,230.333097094259,1,2865,34.9040139616056,12,2779,431.810003598417
24117,5,5376,121,Tasa de exámenes médico legales por presunto delito sexual cuando la víctima está entre 18 y 28 años,2017,5,1,11162,8.95896792689482,0,5630,0,1,5532,18.0766449746927
24118,5,5380,81,"Tasa de exámenes médico legales por presunto delito sexual contra niños, niñas y adolescentes",2017,2,3,5120,58.59375,0,2642,0,3,2478,121.065375302663
24119,5,5380,81,"Tasa de exámenes médico legales por presunto delito sexual contra niños, niñas y adolescentes",2017,3,8,6213,128.762272654112,2,3182,62.8535512256443,6,3031,197.954470471791
24120,5,5380,81,"Tasa de exámenes médico legales por presunto delito sexual contra niños, niñas y adolescentes",2017,4,10,6493,154.012012937009,3,3277,91.547146780592,7,3216,217.661691542289
24121,5,5380,121,Tasa de exámenes médico legales por presunto delito sexual cuando la víctima está entre 18 y 28 años,2017,5,3,12956,23.1552948440877,1,6543,15.2835090936879,2,6413,31.1866521128957
24122,5,5390,81,"Tasa de exámenes médico legales por presunto delito sexual contra niños, niñas y adolescentes",2017,3,4,704,568.181818181818,1,361,277.008310249307,3,343,874.63556851312
24123,5,5390,81,"Tasa de exámenes médico legales por presunto delito sexual contra niños, niñas y adolescentes",2017,4,1,668,149.700598802395,0,339,0,1,329,303.951367781155
24124,5,5411,81,"Tasa de exámenes médico legales por presunto delito sexual contra niños, niñas y adolescentes",2017,3,2,897,222.965440356745,0,478,0,2,419,477.326968973747
24125,5,5411,81,"Tasa de exámenes médico legales por presunto delito sexual contra niños, niñas y adolescentes",2017,4,1,979,102.145045965271,0,525,0,1,454,220.264317180617
24126,5,5425,121,Tasa de exámenes médico legales por presunto delito sexual cuando la víctima está entre 18 y 28 años,2017,5,1,1232,81.1688311688312,0,652,0,1,580,172.413793103448
24127,5,5440,81,"Tasa de exámenes médico legales por presunto delito sexual contra niños, niñas y adolescentes",2017,2,3,5383,55.7310050157905,1,2726,36.6837857666911,2,2657,75.2728641324802
24128,5,5440,81,"Tasa de exámenes médico legales por presunto delito sexual contra niños, niñas y adolescentes",2017,3,9,6569,137.007154818085,0,3344,0,9,3225,279.06976744186
24129,5,5440,81,"Tasa de exámenes médico legales por presunto delito sexual contra niños, niñas y adolescentes",2017,4,12,6192,193.798449612403,2,3202,62.4609618988132,10,2990,334.448160535117
24130,5,5440,121,Tasa de exámenes médico legales por presunto delito sexual cuando la víctima está entre 18 y 28 años,2017,5,5,11458,43.6376330947809,1,5856,17.0765027322404,4,5602,71.4030703320243
24131,5,5480,81,"Tasa de exámenes médico legales por presunto delito sexual contra niños, niñas y adolescentes",2017,3,3,2612,114.854517611026,1,1340,74.6268656716418,2,1272,157.232704402516
24132,5,5480,81,"Tasa de exámenes médico legales por presunto delito sexual contra niños, niñas y adolescentes",2017,4,1,2544,39.3081761006289,0,1306,0,1,1238,80.7754442649435
24133,5,5480,121,Tasa de exámenes médico legales por presunto delito sexual cuando la víctima está entre 18 y 28 años,2017,5,1,4641,21.5470803706098,0,2379,0,1,2262,44.2086648983201
24134,5,5490,81,"Tasa de exámenes médico legales por presunto delito sexual contra niños, niñas y adolescentes",2017,2,2,7921,25.2493372048984,0,4053,0,2,3868,51.7063081695967
24135,5,5490,81,"Tasa de exámenes médico legales por presunto delito sexual contra niños, niñas y adolescentes",2017,3,8,8595,93.0773705642816,1,4391,22.7738556137554,7,4204,166.50808753568
24136,5,5490,81,"Tasa de exámenes médico legales por presunto delito sexual contra niños, niñas y adolescentes",2017,4,13,8311,156.419203465287,1,4226,23.6630383341221,12,4085,293.7576499388
24137,5,5495,81,"Tasa de exámenes médico legales por presunto delito sexual contra niños, niñas y adolescentes",2017,4,1,3308,30.229746070133,0,1662,0,1,1646,60.7533414337788
24138,5,5501,81,"Tasa de exámenes médico legales por presunto delito sexual contra niños, niñas y adolescentes",2017,3,3,372,806.451612903226,0,196,0,3,176,1704.54545454545
24139,5,5541,81,"Tasa de exámenes médico legales por presunto delito sexual contra niños, niñas y adolescentes",2017,2,3,1540,194.805194805195,0,781,0,3,759,395.256916996047
24140,5,5541,81,"Tasa de exámenes médico legales por presunto delito sexual contra niños, niñas y adolescentes",2017,3,4,1725,231.884057971014,2,872,229.357798165138,2,853,234.466588511137
24141,5,5541,81,"Tasa de exámenes médico legales por presunto delito sexual contra niños, niñas y adolescentes",2017,4,3,1696,176.88679245283,0,861,0,3,835,359.281437125748
24142,5,5541,121,Tasa de exámenes médico legales por presunto delito sexual cuando la víctima está entre 18 y 28 años,2017,5,1,3137,31.8775900541919,0,1582,0,1,1555,64.3086816720257
24143,5,5576,81,"Tasa de exámenes médico legales por presunto delito sexual contra niños, niñas y adolescentes",2017,2,1,674,148.367952522255,0,344,0,1,330,303.030303030303
24144,5,5579,81,"Tasa de exámenes médico legales por presunto delito sexual contra niños, niñas y adolescentes",2017,2,5,4328,115.526802218115,1,2214,45.16711833785,4,2114,189.214758751183
24145,5,5579,81,"Tasa de exámenes médico legales por presunto delito sexual contra niños, niñas y adolescentes",2017,3,13,5190,250.481695568401,0,2639,0,13,2551,509.604076832615
24146,5,5579,81,"Tasa de exámenes médico legales por presunto delito sexual contra niños, niñas y adolescentes",2017,4,10,5097,196.193839513439,1,2575,38.8349514563107,9,2522,356.859635210151
24147,5,5579,121,Tasa de exámenes médico legales por presunto delito sexual cuando la víctima está entre 18 y 28 años,2017,5,2,9912,20.1775625504439,1,4913,20.3541624262162,1,4999,20.00400080016
24148,5,5591,81,"Tasa de exámenes médico legales por presunto delito sexual contra niños, niñas y adolescentes",2017,2,1,2172,46.0405156537753,0,1115,0,1,1057,94.6073793755913
24149,5,5591,81,"Tasa de exámenes médico legales por presunto delito sexual contra niños, niñas y adolescentes",2017,3,4,2388,167.50418760469,0,1251,0,4,1137,351.802990325418
24150,5,5591,81,"Tasa de exámenes médico legales por presunto delito sexual contra niños, niñas y adolescentes",2017,4,5,2331,214.500214500214,1,1243,80.450522928399,4,1088,367.647058823529
24151,5,5591,121,Tasa de exámenes médico legales por presunto delito sexual cuando la víctima está entre 18 y 28 años,2017,5,1,4245,23.5571260306243,0,2254,0,1,1991,50.2260170768458
24152,5,5604,81,"Tasa de exámenes médico legales por presunto delito sexual contra niños, niñas y adolescentes",2017,3,2,3593,55.663790704147,0,1873,0,2,1720,116.279069767442
24153,5,5604,81,"Tasa de exámenes médico legales por presunto delito sexual contra niños, niñas y adolescentes",2017,4,6,3605,166.435506241331,1,1891,52.8820729772607,5,1714,291.71528588098
24154,5,5607,81,"Tasa de exámenes médico legales por presunto delito sexual contra niños, niñas y adolescentes",2017,2,2,1643,121.728545343883,0,842,0,2,801,249.687890137328
24155,5,5607,81,"Tasa de exámenes médico legales por presunto delito sexual contra niños, niñas y adolescentes",2017,4,3,2006,149.551345962114,0,1039,0,3,967,310.23784901758
24156,5,5615,81,"Tasa de exámenes médico legales por presunto delito sexual contra niños, niñas y adolescentes",2017,2,10,10064,99.3640699523052,2,5180,38.6100386100386,8,4884,163.800163800164
24157,5,5615,81,"Tasa de exámenes médico legales por presunto delito sexual contra niños, niñas y adolescentes",2017,3,11,12340,89.1410048622366,1,6319,15.8252888115208,10,6021,166.08536787909
24158,5,5615,81,"Tasa de exámenes médico legales por presunto delito sexual contra niños, niñas y adolescentes",2017,4,19,12499,152.012160972878,1,6363,15.7158573000157,18,6136,293.350717079531
24159,5,5615,121,Tasa de exámenes médico legales por presunto delito sexual cuando la víctima está entre 18 y 28 años,2017,5,4,24428,16.3746520386442,0,12565,0,4,11863,33.7182837393577
24160,5,5628,81,"Tasa de exámenes médico legales por presunto delito sexual contra niños, niñas y adolescentes",2017,3,1,1072,93.2835820895522,1,555,180.18018018018,0,517,0
24161,5,5628,81,"Tasa de exámenes médico legales por presunto delito sexual contra niños, niñas y adolescentes",2017,4,2,975,205.128205128205,0,507,0,2,468,427.350427350427
24162,5,5628,121,Tasa de exámenes médico legales por presunto delito sexual cuando la víctima está entre 18 y 28 años,2017,5,1,1661,60.2046959662854,0,873,0,1,788,126.903553299492
24163,5,5631,81,"Tasa de exámenes médico legales por presunto delito sexual contra niños, niñas y adolescentes",2017,2,3,2862,104.82180293501,1,1452,68.870523415978,2,1410,141.843971631206
24164,5,5631,81,"Tasa de exámenes médico legales por presunto delito sexual contra niños, niñas y adolescentes",2017,3,7,3498,200.114351057747,2,1763,113.442994895065,5,1735,288.184438040346
24165,5,5631,81,"Tasa de exámenes médico legales por presunto delito sexual contra niños, niñas y adolescentes",2017,4,4,4062,98.4736582964057,1,2036,49.1159135559921,3,2026,148.075024679171
24166,5,5631,121,Tasa de exámenes médico legales por presunto delito sexual cuando la víctima está entre 18 y 28 años,2017,5,2,10185,19.6367206676485,0,5061,0,2,5124,39.032006245121
24167,5,5642,81,"Tasa de exámenes médico legales por presunto delito sexual contra niños, niñas y adolescentes",2017,2,2,1799,111.172873818788,0,927,0,2,872,229.357798165138
24168,5,5642,81,"Tasa de exámenes médico legales por presunto delito sexual contra niños, niñas y adolescentes",2017,3,5,2116,236.294896030246,2,1103,181.323662737987,3,1013,296.150049358342
24169,5,5642,81,"Tasa de exámenes médico legales por presunto delito sexual contra niños, niñas y adolescentes",2017,4,5,1977,252.908447142135,0,1043,0,5,934,535.331905781585
24170,5,5647,81,"Tasa de exámenes médico legales por presunto delito sexual contra niños, niñas y adolescentes",2017,3,1,692,144.508670520231,0,360,0,1,332,301.204819277108
24171,5,5649,81,"Tasa de exámenes médico legales por presunto delito sexual contra niños, niñas y adolescentes",2017,2,3,1463,205.058099794942,1,754,132.62599469496,2,709,282.087447108604
24172,5,5649,81,"Tasa de exámenes médico legales por presunto delito sexual contra niños, niñas y adolescentes",2017,3,3,1770,169.491525423729,0,921,0,3,849,353.356890459364
24173,5,5649,81,"Tasa de exámenes médico legales por presunto delito sexual contra niños, niñas y adolescentes",2017,4,5,1565,319.488817891374,0,821,0,5,744,672.043010752688
24174,5,5649,121,Tasa de exámenes médico legales por presunto delito sexual cuando la víctima está entre 18 y 28 años,2017,5,2,2638,75.8150113722517,0,1397,0,2,1241,161.16035455278
24175,5,5656,81,"Tasa de exámenes médico legales por presunto delito sexual contra niños, niñas y adolescentes",2017,4,3,1370,218.978102189781,0,704,0,3,666,450.45045045045
24176,5,5656,121,Tasa de exámenes médico legales por presunto delito sexual cuando la víctima está entre 18 y 28 años,2017,5,1,2494,40.0962309542903,0,1298,0,1,1196,83.6120401337793
24177,5,5659,81,"Tasa de exámenes médico legales por presunto delito sexual contra niños, niñas y adolescentes",2017,4,1,3263,30.6466441924609,0,1683,0,1,1580,63.2911392405063
24178,5,5660,81,"Tasa de exámenes médico legales por presunto delito sexual contra niños, niñas y adolescentes",2017,2,2,1040,192.307692307692,0,538,0,2,502,398.406374501992
24179,5,5664,81,"Tasa de exámenes médico legales por presunto delito sexual contra niños, niñas y adolescentes",2017,2,2,2614,76.5110941086458,0,1333,0,2,1281,156.128024980484
24180,5,5664,81,"Tasa de exámenes médico legales por presunto delito sexual contra niños, niñas y adolescentes",2017,3,2,3220,62.111801242236,1,1625,61.5384615384615,1,1595,62.6959247648903
24181,5,5664,81,"Tasa de exámenes médico legales por presunto delito sexual contra niños, niñas y adolescentes",2017,4,3,3115,96.3081861958267,0,1602,0,3,1513,198.281559814937
24182,5,5665,81,"Tasa de exámenes médico legales por presunto delito sexual contra niños, niñas y adolescentes",2017,4,1,3810,26.246719160105,0,1959,0,1,1851,54.0248514316586
24183,5,5667,81,"Tasa de exámenes médico legales por presunto delito sexual contra niños, niñas y adolescentes",2017,3,1,1179,84.8176420695505,1,624,160.25641025641,0,555,0
24184,5,5667,81,"Tasa de exámenes médico legales por presunto delito sexual contra niños, niñas y adolescentes",2017,4,4,1181,338.696020321761,2,624,320.51282051282,2,557,359.066427289048
24185,5,5667,121,Tasa de exámenes médico legales por presunto delito sexual cuando la víctima está entre 18 y 28 años,2017,5,1,2324,43.0292598967298,0,1188,0,1,1136,88.0281690140845
24186,5,5670,81,"Tasa de exámenes médico legales por presunto delito sexual contra niños, niñas y adolescentes",2017,2,4,1683,237.67082590612,1,861,116.144018583043,3,822,364.963503649635
24187,5,5670,81,"Tasa de exámenes médico legales por presunto delito sexual contra niños, niñas y adolescentes",2017,3,2,1954,102.354145342886,0,999,0,2,955,209.424083769634
24188,5,5670,81,"Tasa de exámenes médico legales por presunto delito sexual contra niños, niñas y adolescentes",2017,4,10,1764,566.893424036281,2,901,221.975582685905,8,863,926.998841251448
24189,5,5670,121,Tasa de exámenes médico legales por presunto delito sexual cuando la víctima está entre 18 y 28 años,2017,5,1,3027,33.0360092500826,0,1530,0,1,1497,66.8002672010688
24190,5,5674,81,"Tasa de exámenes médico legales por presunto delito sexual contra niños, niñas y adolescentes",2017,3,1,1655,60.4229607250755,0,858,0,1,797,125.470514429109
24191,5,5674,81,"Tasa de exámenes médico legales por presunto delito sexual contra niños, niñas y adolescentes",2017,4,2,1647,121.432908318154,1,850,117.647058823529,1,797,125.470514429109
24192,5,5674,81,"Tasa de exámenes médico legales por presunto delito sexual contra niños, niñas y adolescentes",2017,1,2,267,749.063670411985,0,137,0,2,130,1538.46153846154
24193,5,5679,81,"Tasa de exámenes médico legales por presunto delito sexual contra niños, niñas y adolescentes",2017,2,2,1980,101.010101010101,0,1006,0,2,974,205.338809034908
24194,5,5679,81,"Tasa de exámenes médico legales por presunto delito sexual contra niños, niñas y adolescentes",2017,3,4,2373,168.563000421408,0,1213,0,4,1160,344.827586206897
24195,5,5679,81,"Tasa de exámenes médico legales por presunto delito sexual contra niños, niñas y adolescentes",2017,4,4,2252,177.619893428064,1,1150,86.9565217391304,3,1102,272.232304900181
24196,5,5679,121,Tasa de exámenes médico legales por presunto delito sexual cuando la víctima está entre 18 y 28 años,2017,5,1,4218,23.7079184447606,0,2109,0,1,2109,47.4158368895211
24197,5,5686,81,"Tasa de exámenes médico legales por presunto delito sexual contra niños, niñas y adolescentes",2017,2,2,3281,60.9570252971655,0,1679,0,2,1602,124.843945068664
24198,5,5686,81,"Tasa de exámenes médico legales por presunto delito sexual contra niños, niñas y adolescentes",2017,3,4,3974,100.654252642174,0,2015,0,4,1959,204.185809086269
24199,5,5686,81,"Tasa de exámenes médico legales por presunto delito sexual contra niños, niñas y adolescentes",2017,4,11,4059,271.0027100271,1,2124,47.0809792843691,10,1935,516.795865633075
24200,5,5686,121,Tasa de exámenes médico legales por presunto delito sexual cuando la víctima está entre 18 y 28 años,2017,5,3,7587,39.5413206801107,1,3971,25.182573659028,2,3616,55.3097345132743
24201,5,5690,81,"Tasa de exámenes médico legales por presunto delito sexual contra niños, niñas y adolescentes",2017,2,2,982,203.665987780041,0,507,0,2,475,421.052631578947
24202,5,5690,81,"Tasa de exámenes médico legales por presunto delito sexual contra niños, niñas y adolescentes",2017,3,4,1185,337.552742616034,0,610,0,4,575,695.652173913043
24203,5,5697,81,"Tasa de exámenes médico legales por presunto delito sexual contra niños, niñas y adolescentes",2017,2,5,2222,225.022502250225,1,1131,88.4173297966401,4,1091,366.636113657195
24204,5,5697,81,"Tasa de exámenes médico legales por presunto delito sexual contra niños, niñas y adolescentes",2017,3,14,2633,531.712875047474,1,1351,74.019245003701,13,1282,1014.04056162246
24205,5,5697,81,"Tasa de exámenes médico legales por presunto delito sexual contra niños, niñas y adolescentes",2017,4,7,2653,263.852242744063,2,1379,145.032632342277,5,1274,392.464678178964
24206,5,5697,121,Tasa de exámenes médico legales por presunto delito sexual cuando la víctima está entre 18 y 28 años,2017,5,1,5104,19.5924764890282,0,2615,0,1,2489,40.1767778224186
24207,5,5736,81,"Tasa de exámenes médico legales por presunto delito sexual contra niños, niñas y adolescentes",2017,3,2,4886,40.9332787556283,0,2527,0,2,2359,84.7816871555744
24208,5,5736,81,"Tasa de exámenes médico legales por presunto delito sexual contra niños, niñas y adolescentes",2017,4,4,4856,82.3723228995058,0,2519,0,4,2337,171.159606332905
24209,5,5736,121,Tasa de exámenes médico legales por presunto delito sexual cuando la víctima está entre 18 y 28 años,2017,5,4,8915,44.8681996634885,0,4637,0,4,4278,93.5016362786349
24210,5,5756,81,"Tasa de exámenes médico legales por presunto delito sexual contra niños, niñas y adolescentes",2017,2,3,3017,99.4365263506795,1,1539,64.9772579597141,2,1478,135.31799729364
24211,5,5756,81,"Tasa de exámenes médico legales por presunto delito sexual contra niños, niñas y adolescentes",2017,3,11,3808,288.865546218487,0,1946,0,11,1862,590.762620837809
24212,5,5756,81,"Tasa de exámenes médico legales por presunto delito sexual contra niños, niñas y adolescentes",2017,4,11,3652,301.204819277108,0,1867,0,11,1785,616.24649859944
24213,5,5756,121,Tasa de exámenes médico legales por presunto delito sexual cuando la víctima está entre 18 y 28 años,2017,5,2,7163,27.9212620410443,0,3622,0,2,3541,56.4812199943519
24214,5,5761,81,"Tasa de exámenes médico legales por presunto delito sexual contra niños, niñas y adolescentes",2017,4,2,1569,127.469725940089,0,838,0,2,731,273.59781121751
24215,5,5761,121,Tasa de exámenes médico legales por presunto delito sexual cuando la víctima está entre 18 y 28 años,2017,5,1,2969,33.6813742000674,0,1603,0,1,1366,73.2064421669107
24216,5,5790,81,"Tasa de exámenes médico legales por presunto delito sexual contra niños, niñas y adolescentes",2017,2,1,5833,17.1438367906738,1,2976,33.6021505376344,0,2857,0
24217,5,5790,81,"Tasa de exámenes médico legales por presunto delito sexual contra niños, niñas y adolescentes",2017,3,2,6478,30.8737264587836,1,3318,30.1386377335744,1,3160,31.6455696202532
24218,5,5790,81,"Tasa de exámenes médico legales por presunto delito sexual contra niños, niñas y adolescentes",2017,4,1,5973,16.7420056922819,0,3073,0,1,2900,34.4827586206897
24219,5,5790,81,"Tasa de exámenes médico legales por presunto delito sexual contra niños, niñas y adolescentes",2017,1,1,1237,80.8407437348424,0,629,0,1,608,164.473684210526
24220,5,5792,81,"Tasa de exámenes médico legales por presunto delito sexual contra niños, niñas y adolescentes",2017,4,1,884,113.122171945701,0,463,0,1,421,237.529691211401
24221,5,5809,81,"Tasa de exámenes médico legales por presunto delito sexual contra niños, niñas y adolescentes",2017,3,2,1387,144.196106705119,0,719,0,2,668,299.40119760479
24222,5,5809,81,"Tasa de exámenes médico legales por presunto delito sexual contra niños, niñas y adolescentes",2017,4,3,1342,223.54694485842,0,699,0,3,643,466.56298600311
24223,5,5809,121,Tasa de exámenes médico legales por presunto delito sexual cuando la víctima está entre 18 y 28 años,2017,5,1,2569,38.9256520046711,0,1330,0,1,1239,80.7102502017756
24224,5,5819,81,"Tasa de exámenes médico legales por presunto delito sexual contra niños, niñas y adolescentes",2017,4,3,721,416.088765603329,0,371,0,3,350,857.142857142857
24225,5,5819,121,Tasa de exámenes médico legales por presunto delito sexual cuando la víctima está entre 18 y 28 años,2017,5,2,1172,170.648464163823,1,610,163.934426229508,1,562,177.935943060498
24226,5,5837,81,"Tasa de exámenes médico legales por presunto delito sexual contra niños, niñas y adolescentes",2017,2,4,20409,19.5991964329463,0,10477,0,4,9932,40.2738622633911
24227,5,5837,81,"Tasa de exámenes médico legales por presunto delito sexual contra niños, niñas y adolescentes",2017,3,16,22331,71.6492767901124,6,11596,51.7419799931011,10,10735,93.1532370749884
24228,5,5837,81,"Tasa de exámenes médico legales por presunto delito sexual contra niños, niñas y adolescentes",2017,4,25,21634,115.558842562633,0,10746,0,25,10888,229.610580455547
24229,5,5837,121,Tasa de exámenes médico legales por presunto delito sexual cuando la víctima está entre 18 y 28 años,2017,5,4,36848,10.8554059921841,1,18627,5.36855102807752,3,18221,16.4645189616377
24230,5,5842,81,"Tasa de exámenes médico legales por presunto delito sexual contra niños, niñas y adolescentes",2017,3,2,943,212.089077412513,1,506,197.628458498024,1,437,228.83295194508
24231,5,5842,81,"Tasa de exámenes médico legales por presunto delito sexual contra niños, niñas y adolescentes",2017,4,3,910,329.67032967033,1,494,202.429149797571,2,416,480.769230769231
24232,5,5847,81,"Tasa de exámenes médico legales por presunto delito sexual contra niños, niñas y adolescentes",2017,2,1,4682,21.3583938487826,0,2402,0,1,2280,43.859649122807
24233,5,5847,81,"Tasa de exámenes médico legales por presunto delito sexual contra niños, niñas y adolescentes",2017,3,3,5414,55.411895086812,1,2828,35.3606789250354,2,2586,77.3395204949729
24234,5,5847,81,"Tasa de exámenes médico legales por presunto delito sexual contra niños, niñas y adolescentes",2017,4,12,5064,236.96682464455,3,2719,110.334681868334,9,2345,383.795309168444
24235,5,5847,121,Tasa de exámenes médico legales por presunto delito sexual cuando la víctima está entre 18 y 28 años,2017,5,2,8323,24.0297969482158,0,4457,0,2,3866,51.7330574236937
24236,5,5854,81,"Tasa de exámenes médico legales por presunto delito sexual contra niños, niñas y adolescentes",2017,4,2,2867,69.759330310429,0,1483,0,2,1384,144.508670520231
24237,5,5856,81,"Tasa de exámenes médico legales por presunto delito sexual contra niños, niñas y adolescentes",2017,3,1,694,144.092219020173,0,365,0,1,329,303.951367781155
24238,5,5858,81,"Tasa de exámenes médico legales por presunto delito sexual contra niños, niñas y adolescentes",2017,2,1,1008,99.2063492063492,0,520,0,1,488,204.918032786885
24239,5,5858,81,"Tasa de exámenes médico legales por presunto delito sexual contra niños, niñas y adolescentes",2017,3,1,1179,84.8176420695505,0,604,0,1,575,173.913043478261
24240,5,5858,121,Tasa de exámenes médico legales por presunto delito sexual cuando la víctima está entre 18 y 28 años,2017,5,2,1615,123.839009287926,0,787,0,2,828,241.545893719807
24241,5,5861,81,"Tasa de exámenes médico legales por presunto delito sexual contra niños, niñas y adolescentes",2017,2,1,1056,94.6969696969697,1,541,184.842883548983,0,515,0
24242,5,5861,81,"Tasa de exámenes médico legales por presunto delito sexual contra niños, niñas y adolescentes",2017,3,7,1238,565.428109854604,2,644,310.55900621118,5,594,841.750841750842
24243,5,5861,81,"Tasa de exámenes médico legales por presunto delito sexual contra niños, niñas y adolescentes",2017,4,4,1227,325.99837000815,0,649,0,4,578,692.041522491349
24244,5,5873,81,"Tasa de exámenes médico legales por presunto delito sexual contra niños, niñas y adolescentes",2017,2,2,577,346.620450606586,1,295,338.983050847458,1,282,354.609929078014
24245,5,5873,81,"Tasa de exámenes médico legales por presunto delito sexual contra niños, niñas y adolescentes",2017,3,2,617,324.149108589951,0,317,0,2,300,666.666666666667
24246,5,5887,81,"Tasa de exámenes médico legales por presunto delito sexual contra niños, niñas y adolescentes",2017,2,1,4998,20.0080032012805,0,2560,0,1,2438,41.0172272354389
24247,5,5887,81,"Tasa de exámenes médico legales por presunto delito sexual contra niños, niñas y adolescentes",2017,3,3,5954,50.3862949277796,1,3045,32.8407224958949,2,2909,68.7521485046408
24248,5,5887,81,"Tasa de exámenes médico legales por presunto delito sexual contra niños, niñas y adolescentes",2017,4,6,5508,108.932461873638,1,2820,35.4609929078014,5,2688,186.011904761905
24249,5,5887,121,Tasa de exámenes médico legales por presunto delito sexual cuando la víctima está entre 18 y 28 años,2017,5,1,9811,10.1926409132606,0,4937,0,1,4874,20.5170291341814
24250,5,5890,81,"Tasa de exámenes médico legales por presunto delito sexual contra niños, niñas y adolescentes",2017,2,2,2434,82.1692686935086,0,1243,0,2,1191,167.926112510495
24251,5,5890,81,"Tasa de exámenes médico legales por presunto delito sexual contra niños, niñas y adolescentes",2017,3,1,2938,34.0367597004765,1,1505,66.4451827242525,0,1433,0
24252,5,5890,81,"Tasa de exámenes médico legales por presunto delito sexual contra niños, niñas y adolescentes",2017,4,2,2684,74.5156482861401,0,1381,0,2,1303,153.491941673062
24253,5,5893,81,"Tasa de exámenes médico legales por presunto delito sexual contra niños, niñas y adolescentes",2017,2,1,1922,52.0291363163372,0,987,0,1,935,106.951871657754
24254,5,5893,81,"Tasa de exámenes médico legales por presunto delito sexual contra niños, niñas y adolescentes",2017,4,3,2158,139.017608897127,0,1111,0,3,1047,286.532951289398
24255,5,5895,81,"Tasa de exámenes médico legales por presunto delito sexual contra niños, niñas y adolescentes",2017,2,1,3485,28.6944045911047,1,1790,55.8659217877095,0,1695,0
24256,5,5895,81,"Tasa de exámenes médico legales por presunto delito sexual contra niños, niñas y adolescentes",2017,4,1,3812,26.2329485834208,0,1977,0,1,1835,54.4959128065395
24257,50,50001,81,"Tasa de exámenes médico legales por presunto delito sexual contra niños, niñas y adolescentes",2017,2,95,43583,217.974898469587,25,22258,112.319166142511,70,21325,328.253223915592
24258,50,50001,81,"Tasa de exámenes médico legales por presunto delito sexual contra niños, niñas y adolescentes",2017,3,200,53067,376.882054760963,32,26944,118.764845605701,168,26123,643.111434368181
24259,50,50001,81,"Tasa de exámenes médico legales por presunto delito sexual contra niños, niñas y adolescentes",2017,4,216,53298,405.268490374873,27,26852,100.551169372859,189,26446,714.663843303335
24260,50,50001,121,Tasa de exámenes médico legales por presunto delito sexual cuando la víctima está entre 18 y 28 años,2017,5,41,96862,42.3282608246784,6,46862,12.8035508514361,35,50000,70
24261,50,50001,81,"Tasa de exámenes médico legales por presunto delito sexual contra niños, niñas y adolescentes",2017,1,4,8534,46.8713381767049,2,4370,45.766590389016,2,4164,48.030739673391
24262,50,50006,81,"Tasa de exámenes médico legales por presunto delito sexual contra niños, niñas y adolescentes",2017,2,14,6549,213.773095129027,4,3318,120.554550934298,10,3231,309.501702259362
24263,50,50006,81,"Tasa de exámenes médico legales por presunto delito sexual contra niños, niñas y adolescentes",2017,3,22,7633,288.222193108869,7,3809,183.775269099501,15,3824,392.259414225941
24264,50,50006,81,"Tasa de exámenes médico legales por presunto delito sexual contra niños, niñas y adolescentes",2017,4,33,7325,450.511945392491,2,3631,55.0812448361333,31,3694,839.19870059556
24265,50,50006,121,Tasa de exámenes médico legales por presunto delito sexual cuando la víctima está entre 18 y 28 años,2017,5,5,13518,36.9877200769345,1,6583,15.1906425641805,4,6935,57.6784426820476
24266,50,50110,81,"Tasa de exámenes médico legales por presunto delito sexual contra niños, niñas y adolescentes",2017,2,1,504,198.412698412698,0,259,0,1,245,408.163265306122
24267,50,50110,81,"Tasa de exámenes médico legales por presunto delito sexual contra niños, niñas y adolescentes",2017,3,3,530,566.037735849057,0,269,0,3,261,1149.42528735632
24268,50,50110,81,"Tasa de exámenes médico legales por presunto delito sexual contra niños, niñas y adolescentes",2017,4,3,505,594.059405940594,0,253,0,3,252,1190.47619047619
24269,50,50124,81,"Tasa de exámenes médico legales por presunto delito sexual contra niños, niñas y adolescentes",2017,3,3,493,608.519269776876,1,259,386.100386100386,2,234,854.700854700855
24270,50,50124,81,"Tasa de exámenes médico legales por presunto delito sexual contra niños, niñas y adolescentes",2017,4,4,456,877.19298245614,0,242,0,4,214,1869.15887850467
24271,50,50124,121,Tasa de exámenes médico legales por presunto delito sexual cuando la víctima está entre 18 y 28 años,2017,5,2,830,240.963855421687,0,423,0,2,407,491.400491400491
24272,50,50150,81,"Tasa de exámenes médico legales por presunto delito sexual contra niños, niñas y adolescentes",2017,2,1,1021,97.9431929480901,0,524,0,1,497,201.207243460765
24273,50,50150,81,"Tasa de exámenes médico legales por presunto delito sexual contra niños, niñas y adolescentes",2017,3,5,1141,438.212094653812,1,582,171.821305841924,4,559,715.563506261181
24274,50,50150,81,"Tasa de exámenes médico legales por presunto delito sexual contra niños, niñas y adolescentes",2017,4,1,1085,92.1658986175115,0,541,0,1,544,183.823529411765
24275,50,50223,81,"Tasa de exámenes médico legales por presunto delito sexual contra niños, niñas y adolescentes",2017,4,1,631,158.478605388273,0,322,0,1,309,323.624595469256
24276,50,50226,81,"Tasa de exámenes médico legales por presunto delito sexual contra niños, niñas y adolescentes",2017,2,3,1892,158.562367864693,0,974,0,3,918,326.797385620915
24277,50,50226,81,"Tasa de exámenes médico legales por presunto delito sexual contra niños, niñas y adolescentes",2017,3,3,2348,127.768313458262,0,1195,0,3,1153,260.1908065915
24278,50,50226,81,"Tasa de exámenes médico legales por presunto delito sexual contra niños, niñas y adolescentes",2017,4,6,2082,288.184438040346,0,1042,0,6,1040,576.923076923077
24279,50,50245,81,"Tasa de exámenes médico legales por presunto delito sexual contra niños, niñas y adolescentes",2017,4,1,250,400,0,132,0,1,118,847.457627118644
24280,50,50251,81,"Tasa de exámenes médico legales por presunto delito sexual contra niños, niñas y adolescentes",2017,3,4,734,544.959128065395,1,381,262.46719160105,3,353,849.85835694051
24281,50,50251,81,"Tasa de exámenes médico legales por presunto delito sexual contra niños, niñas y adolescentes",2017,4,4,653,612.557427258806,0,339,0,4,314,1273.88535031847
24282,50,50270,81,"Tasa de exámenes médico legales por presunto delito sexual contra niños, niñas y adolescentes",2017,4,2,423,472.813238770686,1,231,432.900432900433,1,192,520.833333333333
24283,50,50270,121,Tasa de exámenes médico legales por presunto delito sexual cuando la víctima está entre 18 y 28 años,2017,5,1,659,151.745068285281,0,363,0,1,296,337.837837837838
24284,50,50287,81,"Tasa de exámenes médico legales por presunto delito sexual contra niños, niñas y adolescentes",2017,2,1,1442,69.3481276005548,1,732,136.612021857924,0,710,0
24285,50,50287,81,"Tasa de exámenes médico legales por presunto delito sexual contra niños, niñas y adolescentes",2017,3,7,1662,421.179302045728,3,839,357.568533969011,4,823,486.026731470231
24286,50,50287,81,"Tasa de exámenes médico legales por presunto delito sexual contra niños, niñas y adolescentes",2017,4,9,1605,560.747663551402,0,819,0,9,786,1145.03816793893
24287,50,50287,121,Tasa de exámenes médico legales por presunto delito sexual cuando la víctima está entre 18 y 28 años,2017,5,1,2642,37.8501135503407,0,1344,0,1,1298,77.0416024653313
24288,50,50313,81,"Tasa de exámenes médico legales por presunto delito sexual contra niños, niñas y adolescentes",2017,2,2,6681,29.9356383774884,0,3398,0,2,3283,60.9198903441974
24289,50,50313,81,"Tasa de exámenes médico legales por presunto delito sexual contra niños, niñas y adolescentes",2017,3,12,7391,162.359626572859,0,3739,0,12,3652,328.587075575027
24290,50,50313,81,"Tasa de exámenes médico legales por presunto delito sexual contra niños, niñas y adolescentes",2017,4,16,6852,233.508464681845,0,3452,0,16,3400,470.588235294118
24291,50,50318,81,"Tasa de exámenes médico legales por presunto delito sexual contra niños, niñas y adolescentes",2017,2,1,829,120.627261761158,0,429,0,1,400,250
24292,50,50318,81,"Tasa de exámenes médico legales por presunto delito sexual contra niños, niñas y adolescentes",2017,4,3,926,323.974082073434,0,470,0,3,456,657.894736842105
24293,50,50325,81,"Tasa de exámenes médico legales por presunto delito sexual contra niños, niñas y adolescentes",2017,3,1,2021,49.480455220188,0,1034,0,1,987,101.317122593718
24294,50,50325,81,"Tasa de exámenes médico legales por presunto delito sexual contra niños, niñas y adolescentes",2017,4,1,1915,52.2193211488251,0,962,0,1,953,104.931794333683
24295,50,50330,81,"Tasa de exámenes médico legales por presunto delito sexual contra niños, niñas y adolescentes",2017,3,1,1466,68.212824010914,0,764,0,1,702,142.450142450142
24296,50,50330,121,Tasa de exámenes médico legales por presunto delito sexual cuando la víctima está entre 18 y 28 años,2017,5,2,2223,89.9685110211426,0,1077,0,2,1146,174.520069808028
24297,50,50350,81,"Tasa de exámenes médico legales por presunto delito sexual contra niños, niñas y adolescentes",2017,2,2,3912,51.1247443762781,0,1998,0,2,1914,104.493207941484
24298,50,50350,81,"Tasa de exámenes médico legales por presunto delito sexual contra niños, niñas y adolescentes",2017,3,6,4522,132.684652808492,1,2319,43.122035360069,5,2203,226.963231956423
24299,50,50350,81,"Tasa de exámenes médico legales por presunto delito sexual contra niños, niñas y adolescentes",2017,4,8,4206,190.20446980504,1,2175,45.9770114942529,7,2031,344.65780403742
24300,50,50370,81,"Tasa de exámenes médico legales por presunto delito sexual contra niños, niñas y adolescentes",2017,3,1,2034,49.1642084562439,0,1036,0,1,998,100.200400801603
24301,50,50370,81,"Tasa de exámenes médico legales por presunto delito sexual contra niños, niñas y adolescentes",2017,4,2,1876,106.609808102345,0,969,0,2,907,220.507166482911
24302,50,50400,81,"Tasa de exámenes médico legales por presunto delito sexual contra niños, niñas y adolescentes",2017,2,3,979,306.435137895812,2,511,391.389432485323,1,468,213.675213675214
24303,50,50400,81,"Tasa de exámenes médico legales por presunto delito sexual contra niños, niñas y adolescentes",2017,3,3,1124,266.903914590747,0,603,0,3,521,575.815738963532
24304,50,50400,81,"Tasa de exámenes médico legales por presunto delito sexual contra niños, niñas y adolescentes",2017,4,4,1060,377.358490566038,1,583,171.526586620926,3,477,628.930817610063
24305,50,50400,121,Tasa de exámenes médico legales por presunto delito sexual cuando la víctima está entre 18 y 28 años,2017,5,1,1903,52.5486074619023,0,1025,0,1,878,113.895216400911
24306,50,50450,81,"Tasa de exámenes médico legales por presunto delito sexual contra niños, niñas y adolescentes",2017,3,2,2634,75.9301442672741,0,1362,0,2,1272,157.232704402516
24307,50,50450,81,"Tasa de exámenes médico legales por presunto delito sexual contra niños, niñas y adolescentes",2017,4,2,2477,80.742834073476,0,1300,0,2,1177,169.923534409516
24308,50,50450,81,"Tasa de exámenes médico legales por presunto delito sexual contra niños, niñas y adolescentes",2017,1,1,477,209.643605870021,1,244,409.83606557377,0,233,0
24309,50,50568,81,"Tasa de exámenes médico legales por presunto delito sexual contra niños, niñas y adolescentes",2017,2,2,2635,75.9013282732448,0,1364,0,2,1271,157.3564122738
24310,50,50568,81,"Tasa de exámenes médico legales por presunto delito sexual contra niños, niñas y adolescentes",2017,3,11,2884,381.414701803051,0,1498,0,11,1386,793.650793650794
24311,50,50568,81,"Tasa de exámenes médico legales por presunto delito sexual contra niños, niñas y adolescentes",2017,4,5,2532,197.472353870458,0,1293,0,5,1239,403.551251008878
24312,50,50573,81,"Tasa de exámenes médico legales por presunto delito sexual contra niños, niñas y adolescentes",2017,2,11,3419,321.731500438725,1,1765,56.657223796034,10,1654,604.59492140266
24313,50,50573,81,"Tasa de exámenes médico legales por presunto delito sexual contra niños, niñas y adolescentes",2017,3,13,4155,312.876052948255,4,2187,182.898948331047,9,1968,457.317073170732
24314,50,50573,81,"Tasa de exámenes médico legales por presunto delito sexual contra niños, niñas y adolescentes",2017,4,15,3945,380.228136882129,0,2141,0,15,1804,831.485587583148
24315,50,50573,121,Tasa de exámenes médico legales por presunto delito sexual cuando la víctima está entre 18 y 28 años,2017,5,2,6558,30.4971027752364,0,3508,0,2,3050,65.5737704918033
24316,50,50577,81,"Tasa de exámenes médico legales por presunto delito sexual contra niños, niñas y adolescentes",2017,2,1,1016,98.4251968503937,0,527,0,1,489,204.498977505112
24317,50,50577,81,"Tasa de exámenes médico legales por presunto delito sexual contra niños, niñas y adolescentes",2017,3,6,1207,497.100248550124,2,633,315.955766192733,4,574,696.864111498258
24318,50,50577,81,"Tasa de exámenes médico legales por presunto delito sexual contra niños, niñas y adolescentes",2017,4,9,1140,789.473684210526,0,608,0,9,532,1691.72932330827
24319,50,50577,121,Tasa de exámenes médico legales por presunto delito sexual cuando la víctima está entre 18 y 28 años,2017,5,1,1812,55.1876379690949,0,1004,0,1,808,123.762376237624
24320,50,50590,81,"Tasa de exámenes médico legales por presunto delito sexual contra niños, niñas y adolescentes",2017,3,1,2496,40.0641025641026,0,1361,0,1,1135,88.1057268722467
24321,50,50590,81,"Tasa de exámenes médico legales por presunto delito sexual contra niños, niñas y adolescentes",2017,4,1,2300,43.4782608695652,0,1311,0,1,989,101.112234580384
24322,50,50606,81,"Tasa de exámenes médico legales por presunto delito sexual contra niños, niñas y adolescentes",2017,2,1,1012,98.8142292490118,0,518,0,1,494,202.429149797571
24323,50,50606,81,"Tasa de exámenes médico legales por presunto delito sexual contra niños, niñas y adolescentes",2017,3,2,1191,167.926112510495,0,609,0,2,582,343.642611683849
24324,50,50606,81,"Tasa de exámenes médico legales por presunto delito sexual contra niños, niñas y adolescentes",2017,4,3,1126,266.429840142096,0,566,0,3,560,535.714285714286
24325,50,50606,121,Tasa de exámenes médico legales por presunto delito sexual cuando la víctima está entre 18 y 28 años,2017,5,2,1904,105.042016806723,0,903,0,2,1001,199.8001998002
24326,50,50680,81,"Tasa de exámenes médico legales por presunto delito sexual contra niños, niñas y adolescentes",2017,2,2,1206,165.837479270315,0,617,0,2,589,339.55857385399
24327,50,50680,81,"Tasa de exámenes médico legales por presunto delito sexual contra niños, niñas y adolescentes",2017,3,6,1331,450.788880540947,1,683,146.412884333821,5,648,771.604938271605
24328,50,50680,81,"Tasa de exámenes médico legales por presunto delito sexual contra niños, niñas y adolescentes",2017,4,6,1208,496.688741721854,0,622,0,6,586,1023.89078498294
24329,50,50680,121,Tasa de exámenes médico legales por presunto delito sexual cuando la víctima está entre 18 y 28 años,2017,5,2,1966,101.729399796541,0,1022,0,2,944,211.864406779661
24330,50,50683,81,"Tasa de exámenes médico legales por presunto delito sexual contra niños, niñas y adolescentes",2017,3,5,1252,399.361022364217,2,648,308.641975308642,3,604,496.688741721854
24331,50,50683,81,"Tasa de exámenes médico legales por presunto delito sexual contra niños, niñas y adolescentes",2017,4,2,1053,189.933523266857,0,545,0,2,508,393.700787401575
24332,50,50689,81,"Tasa de exámenes médico legales por presunto delito sexual contra niños, niñas y adolescentes",2017,2,4,2431,164.541341011929,1,1240,80.6451612903226,3,1191,251.889168765743
24333,50,50689,81,"Tasa de exámenes médico legales por presunto delito sexual contra niños, niñas y adolescentes",2017,3,5,2931,170.590242238144,1,1504,66.4893617021277,4,1427,280.30833917309
24334,50,50689,81,"Tasa de exámenes médico legales por presunto delito sexual contra niños, niñas y adolescentes",2017,4,8,2658,300.978179082017,0,1356,0,8,1302,614.439324116743
24335,50,50689,121,Tasa de exámenes médico legales por presunto delito sexual cuando la víctima está entre 18 y 28 años,2017,5,4,4349,91.9751667049897,1,2104,47.5285171102662,3,2245,133.630289532294
24336,50,50711,81,"Tasa de exámenes médico legales por presunto delito sexual contra niños, niñas y adolescentes",2017,3,1,3325,30.0751879699248,0,1703,0,1,1622,61.652281134402
24337,50,50711,81,"Tasa de exámenes médico legales por presunto delito sexual contra niños, niñas y adolescentes",2017,4,2,3068,65.1890482398957,0,1580,0,2,1488,134.408602150538
24338,52,52001,81,"Tasa de exámenes médico legales por presunto delito sexual contra niños, niñas y adolescentes",2017,2,9,31165,28.8785496550618,2,15943,12.5446904597629,7,15222,45.9860727893838
24339,52,52001,81,"Tasa de exámenes médico legales por presunto delito sexual contra niños, niñas y adolescentes",2017,3,14,39700,35.264483627204,1,20178,4.95589255624938,13,19522,66.5915377522795
24340,52,52001,81,"Tasa de exámenes médico legales por presunto delito sexual contra niños, niñas y adolescentes",2017,4,37,43876,84.3285623119701,1,21859,4.5747746923464,36,22017,163.510014988418
24341,52,52001,121,Tasa de exámenes médico legales por presunto delito sexual cuando la víctima está entre 18 y 28 años,2017,5,34,84322,40.3216242498992,4,43003,9.30167662721206,30,41319,72.6058229870036
24342,52,52022,81,"Tasa de exámenes médico legales por presunto delito sexual contra niños, niñas y adolescentes",2017,4,1,552,181.159420289855,0,275,0,1,277,361.01083032491
24343,52,52036,81,"Tasa de exámenes médico legales por presunto delito sexual contra niños, niñas y adolescentes",2017,3,1,615,162.60162601626,0,313,0,1,302,331.12582781457
24344,52,52036,81,"Tasa de exámenes médico legales por presunto delito sexual contra niños, niñas y adolescentes",2017,4,1,672,148.809523809524,0,351,0,1,321,311.526479750779
24345,52,52079,81,"Tasa de exámenes médico legales por presunto delito sexual contra niños, niñas y adolescentes",2017,4,2,5693,35.1308624626735,0,2859,0,2,2834,70.5716302046577
24346,52,52083,81,"Tasa de exámenes médico legales por presunto delito sexual contra niños, niñas y adolescentes",2017,4,1,667,149.925037481259,0,340,0,1,327,305.810397553517
24347,52,52240,81,"Tasa de exámenes médico legales por presunto delito sexual contra niños, niñas y adolescentes",2017,4,1,1527,65.4878847413229,0,751,0,1,776,128.865979381443
24348,52,52256,81,"Tasa de exámenes médico legales por presunto delito sexual contra niños, niñas y adolescentes",2017,4,1,1118,89.4454382826476,0,596,0,1,522,191.570881226054
24349,52,52260,81,"Tasa de exámenes médico legales por presunto delito sexual contra niños, niñas y adolescentes",2017,3,1,1188,84.1750841750842,0,606,0,1,582,171.821305841924
24350,52,52354,81,"Tasa de exámenes médico legales por presunto delito sexual contra niños, niñas y adolescentes",2017,4,1,612,163.398692810458,0,300,0,1,312,320.51282051282
24351,52,52354,121,Tasa de exámenes médico legales por presunto delito sexual cuando la víctima está entre 18 y 28 años,2017,5,1,1019,98.135426889107,0,521,0,1,498,200.803212851406
24352,52,52356,81,"Tasa de exámenes médico legales por presunto delito sexual contra niños, niñas y adolescentes",2017,2,2,12188,16.4095831965868,0,6250,0,2,5938,33.6813742000674
24353,52,52356,81,"Tasa de exámenes médico legales por presunto delito sexual contra niños, niñas y adolescentes",2017,3,3,15338,19.5592645716521,0,7868,0,3,7470,40.1606425702811
24354,52,52356,81,"Tasa de exámenes médico legales por presunto delito sexual contra niños, niñas y adolescentes",2017,4,10,15861,63.047727129437,1,7915,12.6342387871131,9,7946,113.264535615404
24355,52,52356,121,Tasa de exámenes médico legales por presunto delito sexual cuando la víctima está entre 18 y 28 años,2017,5,2,26096,7.66400980993256,0,13311,0,2,12785,15.6433320297223
24356,52,52378,81,"Tasa de exámenes médico legales por presunto delito sexual contra niños, niñas y adolescentes",2017,4,1,1803,55.4631170271769,0,972,0,1,831,120.336943441637
24357,52,52381,81,"Tasa de exámenes médico legales por presunto delito sexual contra niños, niñas y adolescentes",2017,3,1,917,109.051254089422,0,460,0,1,457,218.818380743982
24358,52,52399,81,"Tasa de exámenes médico legales por presunto delito sexual contra niños, niñas y adolescentes",2017,4,2,2593,77.1307365985345,0,1308,0,2,1285,155.642023346304
24359,52,52411,81,"Tasa de exámenes médico legales por presunto delito sexual contra niños, niñas y adolescentes",2017,4,1,985,101.522842639594,0,495,0,1,490,204.081632653061
24360,52,52411,121,Tasa de exámenes médico legales por presunto delito sexual cuando la víctima está entre 18 y 28 años,2017,5,1,1634,61.1995104039168,0,853,0,1,781,128.040973111396
24361,52,52418,81,"Tasa de exámenes médico legales por presunto delito sexual contra niños, niñas y adolescentes",2017,3,1,3288,30.4136253041363,0,1703,0,1,1585,63.0914826498423
24362,52,52435,121,Tasa de exámenes médico legales por presunto delito sexual cuando la víctima está entre 18 y 28 años,2017,5,1,1428,70.0280112044818,0,767,0,1,661,151.285930408472
24363,52,52480,121,Tasa de exámenes médico legales por presunto delito sexual cuando la víctima está entre 18 y 28 años,2017,5,1,931,107.411385606874,0,480,0,1,451,221.729490022173
24364,52,52540,121,Tasa de exámenes médico legales por presunto delito sexual cuando la víctima está entre 18 y 28 años,2017,5,3,3450,86.9565217391304,0,1853,0,3,1597,187.852222917971
24365,52,52612,121,Tasa de exámenes médico legales por presunto delito sexual cuando la víctima está entre 18 y 28 años,2017,5,1,4049,24.6974561620153,0,2111,0,1,1938,51.5995872033024
24366,52,52696,121,Tasa de exámenes médico legales por presunto delito sexual cuando la víctima está entre 18 y 28 años,2017,5,1,2988,33.4672021419009,0,1565,0,1,1423,70.2740688685875
24367,52,52788,81,"Tasa de exámenes médico legales por presunto delito sexual contra niños, niñas y adolescentes",2017,3,1,901,110.987791342952,0,456,0,1,445,224.719101123596
24368,52,52835,81,"Tasa de exámenes médico legales por presunto delito sexual contra niños, niñas y adolescentes",2017,2,1,25412,3.9351487486227,0,13001,0,1,12411,8.05736846345983
24369,52,52835,81,"Tasa de exámenes médico legales por presunto delito sexual contra niños, niñas y adolescentes",2017,3,7,28764,24.3359755249618,2,14663,13.6397735797586,5,14101,35.458478122119
24370,52,52835,81,"Tasa de exámenes médico legales por presunto delito sexual contra niños, niñas y adolescentes",2017,4,6,26696,22.4752771950854,2,13486,14.830194275545,4,13210,30.2800908402725
24371,52,52835,121,Tasa de exámenes médico legales por presunto delito sexual cuando la víctima está entre 18 y 28 años,2017,5,4,41188,9.71156647567253,0,20777,0,4,20411,19.597275978639
24372,52,52838,81,"Tasa de exámenes médico legales por presunto delito sexual contra niños, niñas y adolescentes",2017,3,1,3979,25.1319426991706,1,2031,49.2368291482029,0,1948,0
24373,52,52838,81,"Tasa de exámenes médico legales por presunto delito sexual contra niños, niñas y adolescentes",2017,4,4,4137,96.688421561518,0,2110,0,4,2027,197.335964479526
24374,52,52838,121,Tasa de exámenes médico legales por presunto delito sexual cuando la víctima está entre 18 y 28 años,2017,5,6,7642,78.5134781470819,2,3954,50.5816894284269,4,3688,108.459869848156
24375,54,54001,81,"Tasa de exámenes médico legales por presunto delito sexual contra niños, niñas y adolescentes",2017,2,41,55907,73.3360759833295,11,28536,38.5477992710962,30,27371,109.605056446604
24376,54,54001,81,"Tasa de exámenes médico legales por presunto delito sexual contra niños, niñas y adolescentes",2017,3,85,68010,124.981620349949,15,34376,43.6350942518036,70,33634,208.122732948802
24377,54,54001,81,"Tasa de exámenes médico legales por presunto delito sexual contra niños, niñas y adolescentes",2017,4,117,73377,159.450509015086,19,36942,51.4319744464295,98,36435,268.972142170989
24378,54,54001,121,Tasa de exámenes médico legales por presunto delito sexual cuando la víctima está entre 18 y 28 años,2017,5,19,132378,14.3528380848782,1,66839,1.49613249749398,18,65539,27.4645630845756
24379,54,54003,81,"Tasa de exámenes médico legales por presunto delito sexual contra niños, niñas y adolescentes",2017,2,2,4174,47.9156684235745,0,2123,0,2,2051,97.5134080936129
24380,54,54003,81,"Tasa de exámenes médico legales por presunto delito sexual contra niños, niñas y adolescentes",2017,3,3,4662,64.3500643500643,1,2349,42.571306939123,2,2313,86.4677907479464
24381,54,54003,81,"Tasa de exámenes médico legales por presunto delito sexual contra niños, niñas y adolescentes",2017,4,4,4525,88.3977900552486,0,2276,0,4,2249,177.856825255669
24382,54,54051,81,"Tasa de exámenes médico legales por presunto delito sexual contra niños, niñas y adolescentes",2017,4,2,996,200.803212851406,0,535,0,2,461,433.839479392625
24383,54,54099,81,"Tasa de exámenes médico legales por presunto delito sexual contra niños, niñas y adolescentes",2017,3,1,765,130.718954248366,1,393,254.452926208651,0,372,0
24384,54,54099,81,"Tasa de exámenes médico legales por presunto delito sexual contra niños, niñas y adolescentes",2017,4,4,779,513.478818998716,0,412,0,4,367,1089.91825613079
24385,54,54099,121,Tasa de exámenes médico legales por presunto delito sexual cuando la víctima está entre 18 y 28 años,2017,5,2,1315,152.091254752852,0,678,0,2,637,313.971742543171
24386,54,54109,81,"Tasa de exámenes médico legales por presunto delito sexual contra niños, niñas y adolescentes",2017,4,2,548,364.963503649635,0,285,0,2,263,760.456273764259
24387,54,54125,81,"Tasa de exámenes médico legales por presunto delito sexual contra niños, niñas y adolescentes",2017,3,2,205,975.609756097561,0,104,0,2,101,1980.19801980198
24388,54,54125,81,"Tasa de exámenes médico legales por presunto delito sexual contra niños, niñas y adolescentes",2017,4,3,191,1570.68062827225,0,97,0,3,94,3191.48936170213
24389,54,54128,81,"Tasa de exámenes médico legales por presunto delito sexual contra niños, niñas y adolescentes",2017,4,1,1276,78.3699059561128,0,672,0,1,604,165.562913907285
24390,54,54172,81,"Tasa de exámenes médico legales por presunto delito sexual contra niños, niñas y adolescentes",2017,3,7,1796,389.755011135858,3,911,329.308452250274,4,885,451.977401129944
24391,54,54172,81,"Tasa de exámenes médico legales por presunto delito sexual contra niños, niñas y adolescentes",2017,4,6,1784,336.322869955157,1,906,110.37527593819,5,878,569.476082004556
24392,54,54174,81,"Tasa de exámenes médico legales por presunto delito sexual contra niños, niñas y adolescentes",2017,2,1,1050,95.2380952380952,0,540,0,1,510,196.078431372549
24393,54,54174,81,"Tasa de exámenes médico legales por presunto delito sexual contra niños, niñas y adolescentes",2017,3,2,1174,170.357751277683,0,614,0,2,560,357.142857142857
24394,54,54174,81,"Tasa de exámenes médico legales por presunto delito sexual contra niños, niñas y adolescentes",2017,4,1,1247,80.1924619085806,0,657,0,1,590,169.491525423729
24395,54,54174,121,Tasa de exámenes médico legales por presunto delito sexual cuando la víctima está entre 18 y 28 años,2017,5,1,2109,47.4158368895211,0,1113,0,1,996,100.401606425703
24396,54,54206,81,"Tasa de exámenes médico legales por presunto delito sexual contra niños, niñas y adolescentes",2017,4,1,1469,68.073519400953,1,766,130.548302872063,0,703,0
24397,54,54223,81,"Tasa de exámenes médico legales por presunto delito sexual contra niños, niñas y adolescentes",2017,3,1,994,100.603621730382,0,522,0,1,472,211.864406779661
24398,54,54223,81,"Tasa de exámenes médico legales por presunto delito sexual contra niños, niñas y adolescentes",2017,4,2,932,214.592274678112,0,493,0,2,439,455.580865603645
24399,54,54245,81,"Tasa de exámenes médico legales por presunto delito sexual contra niños, niñas y adolescentes",2017,4,1,1689,59.206631142688,0,883,0,1,806,124.069478908189
24400,54,54250,81,"Tasa de exámenes médico legales por presunto delito sexual contra niños, niñas y adolescentes",2017,2,1,1441,69.3962526023595,1,740,135.135135135135,0,701,0
24401,54,54250,81,"Tasa de exámenes médico legales por presunto delito sexual contra niños, niñas y adolescentes",2017,3,2,1509,132.538104705103,0,772,0,2,737,271.370420624152
24402,54,54250,81,"Tasa de exámenes médico legales por presunto delito sexual contra niños, niñas y adolescentes",2017,4,2,1495,133.779264214047,0,777,0,2,718,278.551532033426
24403,54,54261,81,"Tasa de exámenes médico legales por presunto delito sexual contra niños, niñas y adolescentes",2017,3,4,2796,143.061516452074,4,1434,278.940027894003,0,1362,0
24404,54,54261,81,"Tasa de exámenes médico legales por presunto delito sexual contra niños, niñas y adolescentes",2017,4,5,2783,179.662234998203,0,1445,0,5,1338,373.692077727952
24405,54,54261,121,Tasa de exámenes médico legales por presunto delito sexual cuando la víctima está entre 18 y 28 años,2017,5,1,4805,20.811654526534898,0,2497,0,1,2308,43.3275563258232
24406,54,54313,81,"Tasa de exámenes médico legales por presunto delito sexual contra niños, niñas y adolescentes",2017,4,2,613,326.26427406199,0,320,0,2,293,682.59385665529
24407,54,54344,81,"Tasa de exámenes médico legales por presunto delito sexual contra niños, niñas y adolescentes",2017,4,1,1403,71.2758374910905,0,712,0,1,691,144.717800289436
24408,54,54347,81,"Tasa de exámenes médico legales por presunto delito sexual contra niños, niñas y adolescentes",2017,4,1,405,246.913580246914,0,223,0,1,182,549.450549450549
24409,54,54377,81,"Tasa de exámenes médico legales por presunto delito sexual contra niños, niñas y adolescentes",2017,3,1,677,147.710487444609,1,363,275.482093663912,0,314,0
24410,54,54385,81,"Tasa de exámenes médico legales por presunto delito sexual contra niños, niñas y adolescentes",2017,3,2,1711,116.890707188778,0,879,0,2,832,240.384615384615
24411,54,54385,81,"Tasa de exámenes médico legales por presunto delito sexual contra niños, niñas y adolescentes",2017,4,1,1663,60.1322910402886,0,862,0,1,801,124.843945068664
24412,54,54398,81,"Tasa de exámenes médico legales por presunto delito sexual contra niños, niñas y adolescentes",2017,2,2,785,254.777070063694,2,400,500,0,385,0
24413,54,54398,81,"Tasa de exámenes médico legales por presunto delito sexual contra niños, niñas y adolescentes",2017,4,4,893,447.928331466965,0,444,0,4,449,890.86859688196
24414,54,54398,121,Tasa de exámenes médico legales por presunto delito sexual cuando la víctima está entre 18 y 28 años,2017,5,1,1414,70.7213578500707,0,723,0,1,691,144.717800289436
24415,54,54405,81,"Tasa de exámenes médico legales por presunto delito sexual contra niños, niñas y adolescentes",2017,2,5,6277,79.6558865700175,1,3209,31.1623558741041,4,3068,130.378096479791
24416,54,54405,81,"Tasa de exámenes médico legales por presunto delito sexual contra niños, niñas y adolescentes",2017,3,7,7697,90.9445238404573,1,3861,25.9000259000259,6,3836,156.412930135558
24417,54,54405,81,"Tasa de exámenes médico legales por presunto delito sexual contra niños, niñas y adolescentes",2017,4,10,8220,121.654501216545,1,4115,24.3013365735115,9,4105,219.244823386114
24418,54,54480,81,"Tasa de exámenes médico legales por presunto delito sexual contra niños, niñas y adolescentes",2017,4,1,419,238.663484486874,0,212,0,1,207,483.091787439613
24419,54,54498,81,"Tasa de exámenes médico legales por presunto delito sexual contra niños, niñas y adolescentes",2017,2,4,8742,45.7561198810341,1,4442,22.5123818099955,3,4300,69.7674418604651
24420,54,54498,81,"Tasa de exámenes médico legales por presunto delito sexual contra niños, niñas y adolescentes",2017,3,9,10956,82.1467688937568,1,5549,18.0212650928095,8,5407,147.956352875902
24421,54,54498,81,"Tasa de exámenes médico legales por presunto delito sexual contra niños, niñas y adolescentes",2017,4,15,10781,139.133661070402,1,5640,17.7304964539007,14,5141,272.320560202295
24422,54,54498,121,Tasa de exámenes médico legales por presunto delito sexual cuando la víctima está entre 18 y 28 años,2017,5,1,16316,6.12895317479774,0,8340,0,1,7976,12.5376128385155
24423,54,54518,81,"Tasa de exámenes médico legales por presunto delito sexual contra niños, niñas y adolescentes",2017,2,5,4040,123.762376237624,0,2054,0,5,1986,251.762336354481
24424,54,54518,81,"Tasa de exámenes médico legales por presunto delito sexual contra niños, niñas y adolescentes",2017,3,2,5200,38.4615384615385,0,2638,0,2,2562,78.064012490242
24425,54,54518,81,"Tasa de exámenes médico legales por presunto delito sexual contra niños, niñas y adolescentes",2017,4,9,7517,119.728615139018,1,3731,26.8024658268561,8,3786,211.304807184363
24426,54,54518,121,Tasa de exámenes médico legales por presunto delito sexual cuando la víctima está entre 18 y 28 años,2017,5,7,14810,47.2653612424038,2,7607,26.291573550677,5,7203,69.415521310565
24427,54,54518,81,"Tasa de exámenes médico legales por presunto delito sexual contra niños, niñas y adolescentes",2017,1,1,853,117.233294255569,0,440,0,1,413,242.130750605327
24428,54,54520,81,"Tasa de exámenes médico legales por presunto delito sexual contra niños, niñas y adolescentes",2017,2,2,468,427.350427350427,0,240,0,2,228,877.19298245614
24429,54,54520,81,"Tasa de exámenes médico legales por presunto delito sexual contra niños, niñas y adolescentes",2017,3,3,532,563.90977443609,1,269,371.747211895911,2,263,760.456273764259
24430,54,54520,81,"Tasa de exámenes médico legales por presunto delito sexual contra niños, niñas y adolescentes",2017,4,3,531,564.971751412429,0,270,0,3,261,1149.42528735632
24431,54,54553,81,"Tasa de exámenes médico legales por presunto delito sexual contra niños, niñas y adolescentes",2017,2,2,960,208.333333333333,1,496,201.612903225806,1,464,215.51724137931
24432,54,54553,81,"Tasa de exámenes médico legales por presunto delito sexual contra niños, niñas y adolescentes",2017,3,3,1179,254.452926208651,0,607,0,3,572,524.475524475524
24433,54,54599,81,"Tasa de exámenes médico legales por presunto delito sexual contra niños, niñas y adolescentes",2017,4,2,701,285.306704707561,0,352,0,2,349,573.065902578797
24434,54,54660,81,"Tasa de exámenes médico legales por presunto delito sexual contra niños, niñas y adolescentes",2017,3,1,991,100.908173562059,1,503,198.807157057654,0,488,0
24435,54,54670,81,"Tasa de exámenes médico legales por presunto delito sexual contra niños, niñas y adolescentes",2017,4,1,1838,54.4069640914037,0,966,0,1,872,114.678899082569
24436,54,54673,81,"Tasa de exámenes médico legales por presunto delito sexual contra niños, niñas y adolescentes",2017,4,1,644,155.27950310559,0,326,0,1,318,314.465408805031
24437,54,54673,121,Tasa de exámenes médico legales por presunto delito sexual cuando la víctima está entre 18 y 28 años,2017,5,2,1040,192.307692307692,0,509,0,2,531,376.647834274953
24438,54,54680,81,"Tasa de exámenes médico legales por presunto delito sexual contra niños, niñas y adolescentes",2017,3,1,315,317.460317460317,0,164,0,1,151,662.251655629139
24439,54,54720,81,"Tasa de exámenes médico legales por presunto delito sexual contra niños, niñas y adolescentes",2017,2,1,2743,36.456434560700004,0,1418,0,1,1325,75.4716981132075
24440,54,54720,81,"Tasa de exámenes médico legales por presunto delito sexual contra niños, niñas y adolescentes",2017,3,3,3017,99.4365263506795,1,1582,63.2111251580278,2,1435,139.372822299652
24441,54,54720,81,"Tasa de exámenes médico legales por presunto delito sexual contra niños, niñas y adolescentes",2017,4,5,2747,182.01674554059,3,1485,202.020202020202,2,1262,158.478605388273
24442,54,54720,121,Tasa de exámenes médico legales por presunto delito sexual cuando la víctima está entre 18 y 28 años,2017,5,2,4358,45.8926112895824,0,2391,0,2,1967,101.677681748856
24443,54,54743,81,"Tasa de exámenes médico legales por presunto delito sexual contra niños, niñas y adolescentes",2017,2,1,439,227.790432801822,0,226,0,1,213,469.483568075117
24444,54,54743,81,"Tasa de exámenes médico legales por presunto delito sexual contra niños, niñas y adolescentes",2017,1,1,91,1098.9010989011,0,46,0,1,45,2222.22222222222
24445,54,54800,81,"Tasa de exámenes médico legales por presunto delito sexual contra niños, niñas y adolescentes",2017,3,1,3268,30.5997552019584,0,1658,0,1,1610,62.111801242236
24446,54,54800,81,"Tasa de exámenes médico legales por presunto delito sexual contra niños, niñas y adolescentes",2017,4,1,3024,33.0687830687831,0,1563,0,1,1461,68.4462696783025
24447,54,54810,81,"Tasa de exámenes médico legales por presunto delito sexual contra niños, niñas y adolescentes",2017,2,1,4685,21.3447171824973,0,2408,0,1,2277,43.9174352217831
24448,54,54810,81,"Tasa de exámenes médico legales por presunto delito sexual contra niños, niñas y adolescentes",2017,3,2,5129,38.9939559368298,1,2671,37.4391613627855,1,2458,40.6834825061025
24449,54,54820,81,"Tasa de exámenes médico legales por presunto delito sexual contra niños, niñas y adolescentes",2017,2,2,1697,117.855038302887,0,868,0,2,829,241.254523522316
24450,54,54820,81,"Tasa de exámenes médico legales por presunto delito sexual contra niños, niñas y adolescentes",2017,3,3,1915,156.657963446475,0,969,0,3,946,317.124735729387
24451,54,54820,81,"Tasa de exámenes médico legales por presunto delito sexual contra niños, niñas y adolescentes",2017,4,2,1929,103.680663556247,0,978,0,2,951,210.304942166141
24452,54,54820,121,Tasa de exámenes médico legales por presunto delito sexual cuando la víctima está entre 18 y 28 años,2017,5,1,3286,30.4321363359708,0,1710,0,1,1576,63.4517766497462
24453,54,54871,81,"Tasa de exámenes médico legales por presunto delito sexual contra niños, niñas y adolescentes",2017,3,1,683,146.412884333821,0,345,0,1,338,295.85798816568
24454,54,54871,81,"Tasa de exámenes médico legales por presunto delito sexual contra niños, niñas y adolescentes",2017,4,2,670,298.507462686567,0,345,0,2,325,615.384615384615
24455,54,54874,81,"Tasa de exámenes médico legales por presunto delito sexual contra niños, niñas y adolescentes",2017,2,4,8172,48.9476260401371,3,4206,71.3266761768902,1,3966,25.2143217347453
24456,54,54874,81,"Tasa de exámenes médico legales por presunto delito sexual contra niños, niñas y adolescentes",2017,3,4,9799,40.8204918869272,0,5013,0,4,4786,83.5770998746344
24457,54,54874,81,"Tasa de exámenes médico legales por presunto delito sexual contra niños, niñas y adolescentes",2017,4,8,10383,77.0490224405278,0,5289,0,8,5094,157.047506870828
24458,54,54874,121,Tasa de exámenes médico legales por presunto delito sexual cuando la víctima está entre 18 y 28 años,2017,5,1,18631,5.36739842198486,0,9594,0,1,9037,11.0656191213898
24459,63,63001,81,"Tasa de exámenes médico legales por presunto delito sexual contra niños, niñas y adolescentes",2017,2,41,22655,180.975502096667,6,11565,51.8806744487678,35,11090,315.599639314698
24460,63,63001,81,"Tasa de exámenes médico legales por presunto delito sexual contra niños, niñas y adolescentes",2017,3,80,27106,295.137607909688,14,13758,101.758976595435,66,13348,494.456098291879
24461,63,63001,81,"Tasa de exámenes médico legales por presunto delito sexual contra niños, niñas y adolescentes",2017,4,89,27395,324.876802336193,13,13890,93.5925125989921,76,13505,562.754535357275
24462,63,63001,121,Tasa de exámenes médico legales por presunto delito sexual cuando la víctima está entre 18 y 28 años,2017,5,28,53757,52.0862399315438,5,27128,18.4311412562666,23,26629,86.3720004506365
24463,63,63001,81,"Tasa de exámenes médico legales por presunto delito sexual contra niños, niñas y adolescentes",2017,1,1,4587,21.8007412252017,1,2354,42.4808836023789,0,2233,0
24464,63,63111,81,"Tasa de exámenes médico legales por presunto delito sexual contra niños, niñas y adolescentes",2017,3,1,270,370.37037037037,0,139,0,1,131,763.358778625954
24465,63,63111,81,"Tasa de exámenes médico legales por presunto delito sexual contra niños, niñas y adolescentes",2017,4,3,266,1127.81954887218,0,137,0,3,129,2325.58139534884
24466,63,63130,81,"Tasa de exámenes médico legales por presunto delito sexual contra niños, niñas y adolescentes",2017,2,13,6434,202.051600870376,3,3316,90.4704463208685,10,3118,320.71840923669
24467,63,63130,81,"Tasa de exámenes médico legales por presunto delito sexual contra niños, niñas y adolescentes",2017,3,22,7640,287.958115183246,7,3954,177.035912999494,15,3686,406.945198046663
24468,63,63130,81,"Tasa de exámenes médico legales por presunto delito sexual contra niños, niñas y adolescentes",2017,4,27,7491,360.432519022827,2,3872,51.6528925619835,25,3619,690.798563138989
24469,63,63130,121,Tasa de exámenes médico legales por presunto delito sexual cuando la víctima está entre 18 y 28 años,2017,5,2,14299,13.9869920973495,0,7405,0,2,6894,29.0107339715695
24470,63,63190,81,"Tasa de exámenes médico legales por presunto delito sexual contra niños, niñas y adolescentes",2017,2,5,2396,208.681135225376,0,1226,0,5,1170,427.350427350427
24471,63,63190,81,"Tasa de exámenes médico legales por presunto delito sexual contra niños, niñas y adolescentes",2017,3,8,2799,285.816362986781,2,1407,142.146410803127,6,1392,431.034482758621
24472,63,63190,81,"Tasa de exámenes médico legales por presunto delito sexual contra niños, niñas y adolescentes",2017,4,5,2743,182.2821728035,1,1361,73.4753857457752,4,1382,289.435600578871
24473,63,63190,121,Tasa de exámenes médico legales por presunto delito sexual cuando la víctima está entre 18 y 28 años,2017,5,3,5442,55.1267916207277,0,2748,0,3,2694,111.358574610245
24474,63,63212,81,"Tasa de exámenes médico legales por presunto delito sexual contra niños, niñas y adolescentes",2017,2,4,434,921.658986175115,1,223,448.430493273543,3,211,1421.8009478673
24475,63,63212,81,"Tasa de exámenes médico legales por presunto delito sexual contra niños, niñas y adolescentes",2017,3,2,513,389.863547758285,1,264,378.787878787879,1,249,401.606425702811
24476,63,63212,81,"Tasa de exámenes médico legales por presunto delito sexual contra niños, niñas y adolescentes",2017,4,3,503,596.421471172962,0,257,0,3,246,1219.51219512195
24477,63,63272,81,"Tasa de exámenes médico legales por presunto delito sexual contra niños, niñas y adolescentes",2017,3,3,1326,226.244343891403,1,678,147.492625368732,2,648,308.641975308642
24478,63,63272,81,"Tasa de exámenes médico legales por presunto delito sexual contra niños, niñas y adolescentes",2017,4,5,1333,375.093773443361,0,687,0,5,646,773.993808049536
24479,63,63302,81,"Tasa de exámenes médico legales por presunto delito sexual contra niños, niñas y adolescentes",2017,3,2,739,270.63599458728,0,380,0,2,359,557.103064066852
24480,63,63302,81,"Tasa de exámenes médico legales por presunto delito sexual contra niños, niñas y adolescentes",2017,4,6,727,825.309491059147,1,373,268.096514745308,5,354,1412.42937853107
24481,63,63401,81,"Tasa de exámenes médico legales por presunto delito sexual contra niños, niñas y adolescentes",2017,2,8,4237,188.812839273071,2,2182,91.6590284142988,6,2055,291.970802919708
24482,63,63401,81,"Tasa de exámenes médico legales por presunto delito sexual contra niños, niñas y adolescentes",2017,3,18,4828,372.825186412593,2,2517,79.4596742153357,16,2311,692.340977931631
24483,63,63401,81,"Tasa de exámenes médico legales por presunto delito sexual contra niños, niñas y adolescentes",2017,4,20,4826,414.421881475342,3,2491,120.433560818948,17,2335,728.051391862955
24484,63,63401,121,Tasa de exámenes médico legales por presunto delito sexual cuando la víctima está entre 18 y 28 años,2017,5,1,8445,11.8413262285376,0,4197,0,1,4248,23.5404896421846
24485,63,63470,81,"Tasa de exámenes médico legales por presunto delito sexual contra niños, niñas y adolescentes",2017,2,11,3572,307.950727883539,5,1835,272.479564032698,6,1737,345.423143350604
24486,63,63470,81,"Tasa de exámenes médico legales por presunto delito sexual contra niños, niñas y adolescentes",2017,3,11,4184,262.906309751434,5,2166,230.84025854109,6,2018,297.324083250743
24487,63,63470,81,"Tasa de exámenes médico legales por presunto delito sexual contra niños, niñas y adolescentes",2017,4,5,4144,120.656370656371,0,2186,0,5,1958,255.362614913177
24488,63,63470,121,Tasa de exámenes médico legales por presunto delito sexual cuando la víctima está entre 18 y 28 años,2017,5,1,7914,12.6358352287086,0,4188,0,1,3726,26.8384326355341
24489,63,63548,81,"Tasa de exámenes médico legales por presunto delito sexual contra niños, niñas y adolescentes",2017,2,1,499,200.400801603206,0,256,0,1,243,411.522633744856
24490,63,63548,81,"Tasa de exámenes médico legales por presunto delito sexual contra niños, niñas y adolescentes",2017,3,1,585,170.940170940171,0,300,0,1,285,350.877192982456
24491,63,63548,81,"Tasa de exámenes médico legales por presunto delito sexual contra niños, niñas y adolescentes",2017,4,1,573,174.520069808028,0,293,0,1,280,357.142857142857
24492,63,63594,81,"Tasa de exámenes médico legales por presunto delito sexual contra niños, niñas y adolescentes",2017,2,3,2902,103.376981392143,0,1491,0,3,1411,212.615166548547
24493,63,63594,81,"Tasa de exámenes médico legales por presunto delito sexual contra niños, niñas y adolescentes",2017,3,8,3384,236.406619385343,2,1748,114.41647597254,6,1636,366.748166259169
24494,63,63594,81,"Tasa de exámenes médico legales por presunto delito sexual contra niños, niñas y adolescentes",2017,4,6,3312,181.159420289855,2,1715,116.618075801749,4,1597,250.469630557295
24495,63,63690,81,"Tasa de exámenes médico legales por presunto delito sexual contra niños, niñas y adolescentes",2017,2,4,631,633.91442155309,3,328,914.634146341463,1,303,330.03300330033
24496,63,63690,81,"Tasa de exámenes médico legales por presunto delito sexual contra niños, niñas y adolescentes",2017,3,8,724,1104.97237569061,2,381,524.9343832021,6,343,1749.27113702624
24497,63,63690,81,"Tasa de exámenes médico legales por presunto delito sexual contra niños, niñas y adolescentes",2017,4,3,700,428.571428571429,0,363,0,3,337,890.207715133531
24498,66,66001,81,"Tasa de exámenes médico legales por presunto delito sexual contra niños, niñas y adolescentes",2017,2,71,33794,210.096466828431,19,17307,109.78216906454,52,16487,315.40001213077
24499,66,66001,81,"Tasa de exámenes médico legales por presunto delito sexual contra niños, niñas y adolescentes",2017,3,129,40949,315.026007961122,21,20994,100.02857959417,108,19955,541.217739914808
24500,66,66001,81,"Tasa de exámenes médico legales por presunto delito sexual contra niños, niñas y adolescentes",2017,4,109,42068,259.104307311971,11,21503,51.1556526996233,98,20565,476.537806953562
24501,66,66001,121,Tasa de exámenes médico legales por presunto delito sexual cuando la víctima está entre 18 y 28 años,2017,5,22,84101,26.1590230793926,5,42918,11.650123491309,17,41183,41.2791685889809
24502,66,66001,81,"Tasa de exámenes médico legales por presunto delito sexual contra niños, niñas y adolescentes",2017,1,2,6675,29.9625468164794,0,3420,0,2,3255,61.4439324116743
24503,66,66045,81,"Tasa de exámenes médico legales por presunto delito sexual contra niños, niñas y adolescentes",2017,2,3,1832,163.755458515284,3,940,319.148936170213,0,892,0
24504,66,66045,81,"Tasa de exámenes médico legales por presunto delito sexual contra niños, niñas y adolescentes",2017,3,4,2172,184.162062615101,0,1116,0,4,1056,378.787878787879
24505,66,66045,81,"Tasa de exámenes médico legales por presunto delito sexual contra niños, niñas y adolescentes",2017,4,7,2052,341.130604288499,0,1065,0,7,987,709.219858156028
24506,66,66045,121,Tasa de exámenes médico legales por presunto delito sexual cuando la víctima está entre 18 y 28 años,2017,5,1,3374,29.63841138115,0,1748,0,1,1626,61.5006150061501
24507,66,66075,81,"Tasa de exámenes médico legales por presunto delito sexual contra niños, niñas y adolescentes",2017,2,1,575,173.913043478261,1,291,343.642611683849,0,284,0
24508,66,66075,81,"Tasa de exámenes médico legales por presunto delito sexual contra niños, niñas y adolescentes",2017,3,2,656,304.878048780488,0,334,0,2,322,621.11801242236
24509,66,66075,81,"Tasa de exámenes médico legales por presunto delito sexual contra niños, niñas y adolescentes",2017,4,1,632,158.227848101266,0,326,0,1,306,326.797385620915
24510,66,66088,81,"Tasa de exámenes médico legales por presunto delito sexual contra niños, niñas y adolescentes",2017,2,3,2563,117.050331642606,3,1322,226.928895612708,0,1241,0
24511,66,66088,81,"Tasa de exámenes médico legales por presunto delito sexual contra niños, niñas y adolescentes",2017,3,2,2984,67.0241286863271,0,1531,0,2,1453,137.646249139711
24512,66,66088,81,"Tasa de exámenes médico legales por presunto delito sexual contra niños, niñas y adolescentes",2017,4,5,2934,170.415814587594,1,1498,66.7556742323097,4,1436,278.551532033426
24513,66,66088,121,Tasa de exámenes médico legales por presunto delito sexual cuando la víctima está entre 18 y 28 años,2017,5,3,5048,59.4294770206022,0,2648,0,3,2400,125
24514,66,66170,81,"Tasa de exámenes médico legales por presunto delito sexual contra niños, niñas y adolescentes",2017,2,18,15231,118.18002757534,4,7823,51.131279560271,14,7408,188.984881209503
24515,66,66170,81,"Tasa de exámenes médico legales por presunto delito sexual contra niños, niñas y adolescentes",2017,3,38,18478,205.649962117112,5,9466,52.820621170505,33,9012,366.178428761651
24516,66,66170,81,"Tasa de exámenes médico legales por presunto delito sexual contra niños, niñas y adolescentes",2017,4,49,19332,253.465756259052,6,9810,61.1620795107034,43,9522,451.585801302247
24517,66,66170,121,Tasa de exámenes médico legales por presunto delito sexual cuando la víctima está entre 18 y 28 años,2017,5,10,38555,25.9369731552328,2,19709,10.1476482825105,8,18846,42.4493261169479
24518,66,66318,81,"Tasa de exámenes médico legales por presunto delito sexual contra niños, niñas y adolescentes",2017,2,1,1339,74.6825989544436,0,677,0,1,662,151.057401812689
24519,66,66318,81,"Tasa de exámenes médico legales por presunto delito sexual contra niños, niñas y adolescentes",2017,3,3,1522,197.109067017083,0,758,0,3,764,392.670157068063
24520,66,66318,81,"Tasa de exámenes médico legales por presunto delito sexual contra niños, niñas y adolescentes",2017,4,3,1450,206.896551724138,0,718,0,3,732,409.83606557377
24521,66,66318,121,Tasa de exámenes médico legales por presunto delito sexual cuando la víctima está entre 18 y 28 años,2017,5,1,2496,40.0641025641026,0,1262,0,1,1234,81.0372771474878
24522,66,66400,81,"Tasa de exámenes médico legales por presunto delito sexual contra niños, niñas y adolescentes",2017,2,8,2765,289.330922242315,2,1398,143.061516452074,6,1367,438.917337234821
24523,66,66400,81,"Tasa de exámenes médico legales por presunto delito sexual contra niños, niñas y adolescentes",2017,3,15,3242,462.677359654534,1,1636,61.1246943765281,14,1606,871.73100871731
24524,66,66400,81,"Tasa de exámenes médico legales por presunto delito sexual contra niños, niñas y adolescentes",2017,4,11,3172,346.784363177806,3,1565,191.693290734824,8,1607,497.822028624767
24525,66,66400,121,Tasa de exámenes médico legales por presunto delito sexual cuando la víctima está entre 18 y 28 años,2017,5,3,5860,51.1945392491468,0,2815,0,3,3045,98.5221674876847
24526,66,66440,81,"Tasa de exámenes médico legales por presunto delito sexual contra niños, niñas y adolescentes",2017,2,2,1889,105.876124933827,0,970,0,2,919,217.627856365615
24527,66,66440,81,"Tasa de exámenes médico legales por presunto delito sexual contra niños, niñas y adolescentes",2017,3,9,2312,389.273356401384,0,1185,0,9,1127,798.580301685892
24528,66,66440,81,"Tasa de exámenes médico legales por presunto delito sexual contra niños, niñas y adolescentes",2017,4,6,2359,254.345061466723,0,1201,0,6,1158,518.134715025907
24529,66,66440,121,Tasa de exámenes médico legales por presunto delito sexual cuando la víctima está entre 18 y 28 años,2017,5,1,4383,22.8154232261008,0,2274,0,1,2109,47.4158368895211
24530,66,66456,81,"Tasa de exámenes médico legales por presunto delito sexual contra niños, niñas y adolescentes",2017,2,2,2208,90.5797101449275,0,1127,0,2,1081,185.013876040703
24531,66,66456,81,"Tasa de exámenes médico legales por presunto delito sexual contra niños, niñas y adolescentes",2017,3,3,2363,126.957257723233,1,1185,84.3881856540084,2,1178,169.779286926995
24532,66,66456,81,"Tasa de exámenes médico legales por presunto delito sexual contra niños, niñas y adolescentes",2017,4,7,2124,329.566854990584,0,1070,0,7,1054,664.136622390892
24533,66,66456,121,Tasa de exámenes médico legales por presunto delito sexual cuando la víctima está entre 18 y 28 años,2017,5,1,3260,30.6748466257669,0,1745,0,1,1515,66.006600660066
24534,66,66572,81,"Tasa de exámenes médico legales por presunto delito sexual contra niños, niñas y adolescentes",2017,2,1,1828,54.7045951859956,0,933,0,1,895,111.731843575419
24535,66,66572,81,"Tasa de exámenes médico legales por presunto delito sexual contra niños, niñas y adolescentes",2017,3,4,1960,204.081632653061,2,981,203.873598369011,2,979,204.290091930541
24536,66,66572,81,"Tasa de exámenes médico legales por presunto delito sexual contra niños, niñas y adolescentes",2017,4,2,1759,113.700966458215,0,886,0,2,873,229.095074455899
24537,66,66594,81,"Tasa de exámenes médico legales por presunto delito sexual contra niños, niñas y adolescentes",2017,3,1,3899,25.6476019492177,0,1961,0,1,1938,51.5995872033024
24538,66,66594,81,"Tasa de exámenes médico legales por presunto delito sexual contra niños, niñas y adolescentes",2017,4,3,3620,82.8729281767956,0,1816,0,3,1804,166.29711751663
24539,66,66682,81,"Tasa de exámenes médico legales por presunto delito sexual contra niños, niñas y adolescentes",2017,2,4,5832,68.5871056241427,2,2994,66.8002672010688,2,2838,70.4721634954193
24540,66,66682,81,"Tasa de exámenes médico legales por presunto delito sexual contra niños, niñas y adolescentes",2017,3,4,7130,56.1009817671809,2,3666,54.5553737043099,2,3464,57.7367205542725
24541,66,66682,81,"Tasa de exámenes médico legales por presunto delito sexual contra niños, niñas y adolescentes",2017,4,9,7240,124.309392265193,0,3687,0,9,3553,253.307064452575
24542,66,66682,121,Tasa de exámenes médico legales por presunto delito sexual cuando la víctima está entre 18 y 28 años,2017,5,4,13411,29.8262620237119,0,6943,0,4,6468,61.8429189857761
24543,66,66687,81,"Tasa de exámenes médico legales por presunto delito sexual contra niños, niñas y adolescentes",2017,2,1,1454,68.7757909215956,0,739,0,1,715,139.86013986014
24544,66,66687,81,"Tasa de exámenes médico legales por presunto delito sexual contra niños, niñas y adolescentes",2017,3,2,1658,120.627261761158,0,845,0,2,813,246.0024600246
24545,66,66687,81,"Tasa de exámenes médico legales por presunto delito sexual contra niños, niñas y adolescentes",2017,4,9,1609,559.353635798633,0,830,0,9,779,1155.32734274711
24546,68,68001,81,"Tasa de exámenes médico legales por presunto delito sexual contra niños, niñas y adolescentes",2017,2,59,34318,171.921440643394,13,17531,74.1543551423193,46,16787,274.021564305713
24547,68,68001,81,"Tasa de exámenes médico legales por presunto delito sexual contra niños, niñas y adolescentes",2017,3,104,44680,232.766338406446,19,22839,83.1910328823504,85,21841,389.176319765579
24548,68,68001,81,"Tasa de exámenes médico legales por presunto delito sexual contra niños, niñas y adolescentes",2017,4,140,49217,284.454558384298,22,25133,87.5343174312657,118,24084,489.951835243315
24549,68,68001,121,Tasa de exámenes médico legales por presunto delito sexual cuando la víctima está entre 18 y 28 años,2017,5,38,95999,39.5837456640173,5,49123,10.1785314414836,33,46876,70.3984981653725
24550,68,68051,81,"Tasa de exámenes médico legales por presunto delito sexual contra niños, niñas y adolescentes",2017,3,1,848,117.924528301887,0,459,0,1,389,257.06940874036
24551,68,68051,81,"Tasa de exámenes médico legales por presunto delito sexual contra niños, niñas y adolescentes",2017,4,1,833,120.048019207683,0,467,0,1,366,273.224043715847
24552,68,68077,81,"Tasa de exámenes médico legales por presunto delito sexual contra niños, niñas y adolescentes",2017,2,1,2493,40.1123144805455,0,1293,0,1,1200,83.3333333333333
24553,68,68077,81,"Tasa de exámenes médico legales por presunto delito sexual contra niños, niñas y adolescentes",2017,4,7,2870,243.90243902439,0,1500,0,7,1370,510.948905109489
24554,68,68077,121,Tasa de exámenes médico legales por presunto delito sexual cuando la víctima está entre 18 y 28 años,2017,5,3,5261,57.0233795856301,0,2678,0,3,2583,116.144018583043
24555,68,68079,81,"Tasa de exámenes médico legales por presunto delito sexual contra niños, niñas y adolescentes",2017,4,1,728,137.362637362637,0,369,0,1,359,278.551532033426
24556,68,68081,81,"Tasa de exámenes médico legales por presunto delito sexual contra niños, niñas y adolescentes",2017,2,31,15348,201.980714099557,2,7879,25.3839319710623,29,7469,388.271522292141
24557,68,68081,81,"Tasa de exámenes médico legales por presunto delito sexual contra niños, niñas y adolescentes",2017,3,56,18680,299.785867237687,7,9634,72.6593315341499,49,9046,541.675878841477
24558,68,68081,81,"Tasa de exámenes médico legales por presunto delito sexual contra niños, niñas y adolescentes",2017,4,88,19019,462.695199537305,9,9813,91.7150718434729,79,9206,858.135998262003
24559,68,68081,121,Tasa de exámenes médico legales por presunto delito sexual cuando la víctima está entre 18 y 28 años,2017,5,15,36232,41.3998675204239,3,18755,15.9957344708078,12,17477,68.661669622933
24560,68,68092,81,"Tasa de exámenes médico legales por presunto delito sexual contra niños, niñas y adolescentes",2017,2,1,525,190.47619047619,0,271,0,1,254,393.700787401575
24561,68,68101,81,"Tasa de exámenes médico legales por presunto delito sexual contra niños, niñas y adolescentes",2017,2,1,1262,79.2393026941363,0,644,0,1,618,161.812297734628
24562,68,68101,81,"Tasa de exámenes médico legales por presunto delito sexual contra niños, niñas y adolescentes",2017,3,1,1374,72.7802037845706,0,687,0,1,687,145.560407569141
24563,68,68101,81,"Tasa de exámenes médico legales por presunto delito sexual contra niños, niñas y adolescentes",2017,4,3,1281,234.192037470726,0,634,0,3,647,463.678516228748
24564,68,68132,81,"Tasa de exámenes médico legales por presunto delito sexual contra niños, niñas y adolescentes",2017,2,1,196,510.204081632653,0,100,0,1,96,1041.66666666667
24565,68,68147,121,Tasa de exámenes médico legales por presunto delito sexual cuando la víctima está entre 18 y 28 años,2017,5,1,985,101.522842639594,0,499,0,1,486,205.761316872428
24566,68,68152,81,"Tasa de exámenes médico legales por presunto delito sexual contra niños, niñas y adolescentes",2017,3,1,473,211.416490486258,0,244,0,1,229,436.681222707424
24567,68,68162,81,"Tasa de exámenes médico legales por presunto delito sexual contra niños, niñas y adolescentes",2017,4,2,597,335.00837520938,0,299,0,2,298,671.140939597315
24568,68,68167,81,"Tasa de exámenes médico legales por presunto delito sexual contra niños, niñas y adolescentes",2017,2,1,913,109.529025191676,0,470,0,1,443,225.733634311512
24569,68,68167,81,"Tasa de exámenes médico legales por presunto delito sexual contra niños, niñas y adolescentes",2017,3,3,1094,274.223034734918,0,560,0,3,534,561.797752808989
24570,68,68167,81,"Tasa de exámenes médico legales por presunto delito sexual contra niños, niñas y adolescentes",2017,4,3,1072,279.850746268657,0,551,0,3,521,575.815738963532
24571,68,68169,121,Tasa de exámenes médico legales por presunto delito sexual cuando la víctima está entre 18 y 28 años,2017,5,1,410,243.90243902439,0,186,0,1,224,446.428571428571
24572,68,68176,81,"Tasa de exámenes médico legales por presunto delito sexual contra niños, niñas y adolescentes",2017,2,1,236,423.728813559322,0,120,0,1,116,862.068965517241
24573,68,68176,81,"Tasa de exámenes médico legales por presunto delito sexual contra niños, niñas y adolescentes",2017,3,1,248,403.225806451613,0,123,0,1,125,800
24574,68,68179,81,"Tasa de exámenes médico legales por presunto delito sexual contra niños, niñas y adolescentes",2017,3,1,494,202.429149797571,0,257,0,1,237,421.940928270042
24575,68,68190,81,"Tasa de exámenes médico legales por presunto delito sexual contra niños, niñas y adolescentes",2017,2,5,5050,99.009900990099,2,2612,76.5696784073507,3,2438,123.051681706317
24576,68,68190,81,"Tasa de exámenes médico legales por presunto delito sexual contra niños, niñas y adolescentes",2017,3,20,5665,353.045013239188,2,2931,68.2360968952576,18,2734,658.376005852231
24577,68,68190,81,"Tasa de exámenes médico legales por presunto delito sexual contra niños, niñas y adolescentes",2017,4,28,5399,518.614558251528,3,2774,108.147080028839,25,2625,952.380952380953
24578,68,68190,121,Tasa de exámenes médico legales por presunto delito sexual cuando la víctima está entre 18 y 28 años,2017,5,2,9053,22.0921241577378,1,4566,21.9010074463425,1,4487,22.2866057499443
24579,68,68207,81,"Tasa de exámenes médico legales por presunto delito sexual contra niños, niñas y adolescentes",2017,3,1,499,200.400801603206,0,253,0,1,246,406.50406504065
24580,68,68207,81,"Tasa de exámenes médico legales por presunto delito sexual contra niños, niñas y adolescentes",2017,4,1,499,200.400801603206,1,251,398.406374501992,0,248,0
24581,68,68209,81,"Tasa de exámenes médico legales por presunto delito sexual contra niños, niñas y adolescentes",2017,4,1,258,387.596899224806,0,126,0,1,132,757.575757575758
24582,68,68217,81,"Tasa de exámenes médico legales por presunto delito sexual contra niños, niñas y adolescentes",2017,2,2,767,260.756192959583,1,395,253.164556962025,1,372,268.817204301075
24583,68,68217,81,"Tasa de exámenes médico legales por presunto delito sexual contra niños, niñas y adolescentes",2017,3,6,801,749.063670411985,3,415,722.89156626506,3,386,777.20207253886
24584,68,68217,81,"Tasa de exámenes médico legales por presunto delito sexual contra niños, niñas y adolescentes",2017,4,9,758,1187.3350923482801,2,390,512.820512820513,7,368,1902.17391304348
24585,68,68229,81,"Tasa de exámenes médico legales por presunto delito sexual contra niños, niñas y adolescentes",2017,2,1,1035,96.6183574879227,1,530,188.679245283019,0,505,0
24586,68,68229,81,"Tasa de exámenes médico legales por presunto delito sexual contra niños, niñas y adolescentes",2017,3,4,1162,344.234079173838,0,589,0,4,573,698.080279232112
24587,68,68229,81,"Tasa de exámenes médico legales por presunto delito sexual contra niños, niñas y adolescentes",2017,4,5,1146,436.30017452007,0,574,0,5,572,874.125874125874
24588,68,68235,81,"Tasa de exámenes médico legales por presunto delito sexual contra niños, niñas y adolescentes",2017,2,1,1885,53.0503978779841,1,970,103.092783505155,0,915,0
24589,68,68235,81,"Tasa de exámenes médico legales por presunto delito sexual contra niños, niñas y adolescentes",2017,3,5,2112,236.742424242424,3,1088,275.735294117647,2,1024,195.3125
24590,68,68235,81,"Tasa de exámenes médico legales por presunto delito sexual contra niños, niñas y adolescentes",2017,4,7,2050,341.463414634146,0,1064,0,7,986,709.939148073022
24591,68,68235,121,Tasa de exámenes médico legales por presunto delito sexual cuando la víctima está entre 18 y 28 años,2017,5,1,4005,24.9687890137328,0,2107,0,1,1898,52.6870389884089
24592,68,68250,81,"Tasa de exámenes médico legales por presunto delito sexual contra niños, niñas y adolescentes",2017,3,1,641,156.00624024961,0,326,0,1,315,317.460317460317
24593,68,68255,81,"Tasa de exámenes médico legales por presunto delito sexual contra niños, niñas y adolescentes",2017,2,5,1196,418.060200668896,1,626,159.744408945687,4,570,701.754385964912
24594,68,68255,81,"Tasa de exámenes médico legales por presunto delito sexual contra niños, niñas y adolescentes",2017,3,5,1334,374.812593703148,0,719,0,5,615,813.008130081301
24595,68,68255,81,"Tasa de exámenes médico legales por presunto delito sexual contra niños, niñas y adolescentes",2017,4,3,1230,243.90243902439,1,675,148.148148148148,2,555,360.36036036036
24596,68,68255,121,Tasa de exámenes médico legales por presunto delito sexual cuando la víctima está entre 18 y 28 años,2017,5,1,2155,46.4037122969838,0,1175,0,1,980,102.040816326531
24597,68,68264,81,"Tasa de exámenes médico legales por presunto delito sexual contra niños, niñas y adolescentes",2017,4,1,205,487.80487804878,0,113,0,1,92,1086.95652173913
24598,68,68276,81,"Tasa de exámenes médico legales por presunto delito sexual contra niños, niñas y adolescentes",2017,2,29,17576,164.997724169322,12,9015,133.111480865225,17,8561,198.574932834949
24599,68,68276,81,"Tasa de exámenes médico legales por presunto delito sexual contra niños, niñas y adolescentes",2017,3,36,22341,161.138713575937,3,11523,26.0348867482426,33,10818,305.047143649473
24600,68,68276,81,"Tasa de exámenes médico legales por presunto delito sexual contra niños, niñas y adolescentes",2017,4,44,24095,182.610500103756,5,12411,40.2868423172992,39,11684,333.789798014379
24601,68,68276,121,Tasa de exámenes médico legales por presunto delito sexual cuando la víctima está entre 18 y 28 años,2017,5,5,47723,10.4771284286403,0,24338,0,5,23385,21.381227282446
24602,68,68276,81,"Tasa de exámenes médico legales por presunto delito sexual contra niños, niñas y adolescentes",2017,1,1,3373,29.6471983397569,0,1737,0,1,1636,61.1246943765281
24603,68,68298,81,"Tasa de exámenes médico legales por presunto delito sexual contra niños, niñas y adolescentes",2017,3,2,546,366.300366300366,0,283,0,2,263,760.456273764259
24604,68,68307,81,"Tasa de exámenes médico legales por presunto delito sexual contra niños, niñas y adolescentes",2017,2,15,15230,98.4898227183191,2,7781,25.7036370646446,13,7449,174.520069808028
24605,68,68307,81,"Tasa de exámenes médico legales por presunto delito sexual contra niños, niñas y adolescentes",2017,3,38,18320,207.423580786026,5,9296,53.7865748709122,33,9024,365.691489361702
24606,68,68307,81,"Tasa de exámenes médico legales por presunto delito sexual contra niños, niñas y adolescentes",2017,4,28,19018,147.22894100326,4,9673,41.3522175126641,24,9345,256.821829855538
24607,68,68307,121,Tasa de exámenes médico legales por presunto delito sexual cuando la víctima está entre 18 y 28 años,2017,5,6,36038,16.649092624452,1,18404,5.43360139100196,5,17634,28.3543155268232
24608,68,68318,81,"Tasa de exámenes médico legales por presunto delito sexual contra niños, niñas y adolescentes",2017,2,2,535,373.831775700935,0,270,0,2,265,754.716981132075
24609,68,68318,81,"Tasa de exámenes médico legales por presunto delito sexual contra niños, niñas y adolescentes",2017,3,1,605,165.289256198347,0,292,0,1,313,319.488817891374
24610,68,68320,81,"Tasa de exámenes médico legales por presunto delito sexual contra niños, niñas y adolescentes",2017,3,1,539,185.528756957328,0,272,0,1,267,374.531835205993
24611,68,68320,81,"Tasa de exámenes médico legales por presunto delito sexual contra niños, niñas y adolescentes",2017,4,2,505,396.039603960396,0,255,0,2,250,800
24612,68,68322,81,"Tasa de exámenes médico legales por presunto delito sexual contra niños, niñas y adolescentes",2017,2,1,216,462.962962962963,1,110,909.090909090909,0,106,0
24613,68,68322,81,"Tasa de exámenes médico legales por presunto delito sexual contra niños, niñas y adolescentes",2017,3,3,220,1363.63636363636,2,111,1801.8018018018,1,109,917.431192660551
24614,68,68324,81,"Tasa de exámenes médico legales por presunto delito sexual contra niños, niñas y adolescentes",2017,4,1,354,282.485875706215,0,183,0,1,171,584.795321637427
24615,68,68327,81,"Tasa de exámenes médico legales por presunto delito sexual contra niños, niñas y adolescentes",2017,4,2,361,554.016620498615,0,184,0,2,177,1129.94350282486
24616,68,68368,81,"Tasa de exámenes médico legales por presunto delito sexual contra niños, niñas y adolescentes",2017,3,1,328,304.878048780488,0,172,0,1,156,641.025641025641
24617,68,68368,81,"Tasa de exámenes médico legales por presunto delito sexual contra niños, niñas y adolescentes",2017,4,3,327,917.431192660551,1,171,584.795321637427,2,156,1282.05128205128
24618,68,68377,81,"Tasa de exámenes médico legales por presunto delito sexual contra niños, niñas y adolescentes",2017,3,1,920,108.695652173913,0,481,0,1,439,227.790432801822
24619,68,68377,81,"Tasa de exámenes médico legales por presunto delito sexual contra niños, niñas y adolescentes",2017,4,1,917,109.051254089422,0,482,0,1,435,229.885057471264
24620,68,68385,81,"Tasa de exámenes médico legales por presunto delito sexual contra niños, niñas y adolescentes",2017,3,6,1750,342.857142857143,0,911,0,6,839,715.137067938021
24621,68,68385,81,"Tasa de exámenes médico legales por presunto delito sexual contra niños, niñas y adolescentes",2017,4,1,1652,60.5326876513317,0,871,0,1,781,128.040973111396
24622,68,68397,81,"Tasa de exámenes médico legales por presunto delito sexual contra niños, niñas y adolescentes",2017,4,1,473,211.416490486258,0,248,0,1,225,444.444444444444
24623,68,68406,81,"Tasa de exámenes médico legales por presunto delito sexual contra niños, niñas y adolescentes",2017,2,1,3756,26.6240681576145,0,1929,0,1,1827,54.7345374931582
24624,68,68406,81,"Tasa de exámenes médico legales por presunto delito sexual contra niños, niñas y adolescentes",2017,3,2,4269,46.849379245725,1,2215,45.1467268623025,1,2054,48.6854917234664
24625,68,68406,81,"Tasa de exámenes médico legales por presunto delito sexual contra niños, niñas y adolescentes",2017,4,15,4240,353.77358490566,0,2204,0,15,2036,736.738703339882
24626,68,68406,121,Tasa de exámenes médico legales por presunto delito sexual cuando la víctima está entre 18 y 28 años,2017,5,2,7558,26.4620269912675,0,3879,0,2,3679,54.3625985322098
24627,68,68418,81,"Tasa de exámenes médico legales por presunto delito sexual contra niños, niñas y adolescentes",2017,3,1,1260,79.3650793650794,0,658,0,1,602,166.112956810631
24628,68,68418,81,"Tasa de exámenes médico legales por presunto delito sexual contra niños, niñas y adolescentes",2017,4,3,1264,237.341772151899,0,663,0,3,601,499.168053244592
24629,68,68432,81,"Tasa de exámenes médico legales por presunto delito sexual contra niños, niñas y adolescentes",2017,3,1,1705,58.6510263929619,1,864,115.740740740741,0,841,0
24630,68,68432,81,"Tasa de exámenes médico legales por presunto delito sexual contra niños, niñas y adolescentes",2017,4,6,1739,345.025876940771,0,878,0,6,861,696.864111498258
24631,68,68432,121,Tasa de exámenes médico legales por presunto delito sexual cuando la víctima está entre 18 y 28 años,2017,5,2,3638,54.9752611324904,1,1801,55.5247084952804,1,1837,54.4365813826892
24632,68,68444,81,"Tasa de exámenes médico legales por presunto delito sexual contra niños, niñas y adolescentes",2017,2,1,473,211.416490486258,1,241,414.9377593361,0,232,0
24633,68,68444,81,"Tasa de exámenes médico legales por presunto delito sexual contra niños, niñas y adolescentes",2017,3,3,530,566.037735849057,2,269,743.494423791822,1,261,383.141762452107
24634,68,68444,81,"Tasa de exámenes médico legales por presunto delito sexual contra niños, niñas y adolescentes",2017,4,2,500,400,0,255,0,2,245,816.326530612245
24635,68,68444,121,Tasa de exámenes médico legales por presunto delito sexual cuando la víctima está entre 18 y 28 años,2017,5,1,934,107.066381156317,0,487,0,1,447,223.713646532438
24636,68,68464,81,"Tasa de exámenes médico legales por presunto delito sexual contra niños, niñas y adolescentes",2017,3,5,1262,396.196513470681,1,655,152.671755725191,4,607,658.978583196046
24637,68,68464,81,"Tasa de exámenes médico legales por presunto delito sexual contra niños, niñas y adolescentes",2017,4,4,1114,359.066427289048,0,579,0,4,535,747.663551401869
24638,68,68498,81,"Tasa de exámenes médico legales por presunto delito sexual contra niños, niñas y adolescentes",2017,3,1,496,201.612903225806,0,259,0,1,237,421.940928270042
24639,68,68498,81,"Tasa de exámenes médico legales por presunto delito sexual contra niños, niñas y adolescentes",2017,4,1,453,220.75055187638,0,238,0,1,215,465.116279069767
24640,68,68500,81,"Tasa de exámenes médico legales por presunto delito sexual contra niños, niñas y adolescentes",2017,3,1,1431,69.8812019566736,0,736,0,1,695,143.884892086331
24641,68,68500,81,"Tasa de exámenes médico legales por presunto delito sexual contra niños, niñas y adolescentes",2017,4,4,1275,313.725490196078,0,657,0,4,618,647.249190938511
24642,68,68500,121,Tasa de exámenes médico legales por presunto delito sexual cuando la víctima está entre 18 y 28 años,2017,5,1,2203,45.3926463912846,0,1123,0,1,1080,92.5925925925926
24643,68,68502,81,"Tasa de exámenes médico legales por presunto delito sexual contra niños, niñas y adolescentes",2017,2,1,520,192.307692307692,1,265,377.358490566038,0,255,0
24644,68,68522,81,"Tasa de exámenes médico legales por presunto delito sexual contra niños, niñas y adolescentes",2017,3,1,339,294.985250737463,0,177,0,1,162,617.283950617284
24645,68,68524,81,"Tasa de exámenes médico legales por presunto delito sexual contra niños, niñas y adolescentes",2017,3,1,220,454.545454545455,0,115,0,1,105,952.380952380953
24646,68,68547,81,"Tasa de exámenes médico legales por presunto delito sexual contra niños, niñas y adolescentes",2017,2,11,12293,89.4818189213374,1,6284,15.9134309357097,10,6009,166.417041105009
24647,68,68547,81,"Tasa de exámenes médico legales por presunto delito sexual contra niños, niñas y adolescentes",2017,3,23,14759,155.837116335795,12,7463,160.793246683639,11,7296,150.767543859649
24648,68,68547,81,"Tasa de exámenes médico legales por presunto delito sexual contra niños, niñas y adolescentes",2017,4,21,15169,138.440239963083,0,7727,0,21,7442,282.18220908358
24649,68,68547,121,Tasa de exámenes médico legales por presunto delito sexual cuando la víctima está entre 18 y 28 años,2017,5,6,29162,20.5747205267128,1,14602,6.84837693466648,5,14560,34.3406593406593
24650,68,68549,81,"Tasa de exámenes médico legales por presunto delito sexual contra niños, niñas y adolescentes",2017,4,1,532,187.96992481203,0,260,0,1,272,367.647058823529
24651,68,68572,81,"Tasa de exámenes médico legales por presunto delito sexual contra niños, niñas y adolescentes",2017,2,1,1036,96.5250965250965,0,533,0,1,503,198.807157057654
24652,68,68572,81,"Tasa de exámenes médico legales por presunto delito sexual contra niños, niñas y adolescentes",2017,3,1,1234,81.0372771474878,0,634,0,1,600,166.666666666667
24653,68,68572,81,"Tasa de exámenes médico legales por presunto delito sexual contra niños, niñas y adolescentes",2017,4,2,1106,180.831826401447,0,565,0,2,541,369.685767097967
24654,68,68573,81,"Tasa de exámenes médico legales por presunto delito sexual contra niños, niñas y adolescentes",2017,3,5,1023,488.758553274682,2,531,376.647834274953,3,492,609.756097560976
24655,68,68573,81,"Tasa de exámenes médico legales por presunto delito sexual contra niños, niñas y adolescentes",2017,4,5,989,505.561172901921,0,519,0,5,470,1063.82978723404
24656,68,68573,121,Tasa de exámenes médico legales por presunto delito sexual cuando la víctima está entre 18 y 28 años,2017,5,2,1570,127.388535031847,0,829,0,2,741,269.905533063428
24657,68,68575,81,"Tasa de exámenes médico legales por presunto delito sexual contra niños, niñas y adolescentes",2017,3,10,3769,265.322366675511,1,1892,52.8541226215645,9,1877,479.488545551412
24658,68,68575,81,"Tasa de exámenes médico legales por presunto delito sexual contra niños, niñas y adolescentes",2017,4,12,3483,344.530577088717,1,1728,57.8703703703704,11,1755,626.780626780627
24659,68,68615,81,"Tasa de exámenes médico legales por presunto delito sexual contra niños, niñas y adolescentes",2017,2,4,2595,154.142581888247,0,1334,0,4,1261,317.208564631245
24660,68,68615,81,"Tasa de exámenes médico legales por presunto delito sexual contra niños, niñas y adolescentes",2017,3,6,2907,206.398348813209,2,1500,133.333333333333,4,1407,284.292821606254
24661,68,68615,81,"Tasa de exámenes médico legales por presunto delito sexual contra niños, niñas y adolescentes",2017,4,8,2823,283.386468296139,0,1467,0,8,1356,589.970501474926
24662,68,68615,121,Tasa de exámenes médico legales por presunto delito sexual cuando la víctima está entre 18 y 28 años,2017,5,1,5165,19.3610842207164,0,2698,0,1,2467,40.5350628293474
24663,68,68655,81,"Tasa de exámenes médico legales por presunto delito sexual contra niños, niñas y adolescentes",2017,2,8,1710,467.836257309942,1,876,114.155251141553,7,834,839.328537170264
24664,68,68655,81,"Tasa de exámenes médico legales por presunto delito sexual contra niños, niñas y adolescentes",2017,3,9,1910,471.204188481675,2,982,203.665987780041,7,928,754.310344827586
24665,68,68655,81,"Tasa de exámenes médico legales por presunto delito sexual contra niños, niñas y adolescentes",2017,4,14,1850,756.756756756757,0,957,0,14,893,1567.74916013438
24666,68,68655,121,Tasa de exámenes médico legales por presunto delito sexual cuando la víctima está entre 18 y 28 años,2017,5,4,3599,111.141983884412,0,1906,0,4,1693,236.266981689309
24667,68,68669,81,"Tasa de exámenes médico legales por presunto delito sexual contra niños, niñas y adolescentes",2017,2,1,659,151.745068285281,1,341,293.255131964809,0,318,0
24668,68,68669,81,"Tasa de exámenes médico legales por presunto delito sexual contra niños, niñas y adolescentes",2017,4,1,716,139.664804469274,0,377,0,1,339,294.985250737463
24669,68,68673,81,"Tasa de exámenes médico legales por presunto delito sexual contra niños, niñas y adolescentes",2017,2,1,405,246.913580246914,1,210,476.190476190476,0,195,0
24670,68,68673,121,Tasa de exámenes médico legales por presunto delito sexual cuando la víctima está entre 18 y 28 años,2017,5,1,805,124.223602484472,0,434,0,1,371,269.541778975741
24671,68,68679,81,"Tasa de exámenes médico legales por presunto delito sexual contra niños, niñas y adolescentes",2017,2,3,3177,94.4287063267233,0,1625,0,3,1552,193.298969072165
24672,68,68679,81,"Tasa de exámenes médico legales por presunto delito sexual contra niños, niñas y adolescentes",2017,3,7,3945,177.43979721166,2,1983,100.857286938981,5,1962,254.841997961264
24673,68,68679,81,"Tasa de exámenes médico legales por presunto delito sexual contra niños, niñas y adolescentes",2017,4,14,3911,357.964714906673,0,1916,0,14,1995,701.754385964912
24674,68,68682,81,"Tasa de exámenes médico legales por presunto delito sexual contra niños, niñas y adolescentes",2017,4,2,218,917.431192660551,0,116,0,2,102,1960.78431372549
24675,68,68686,81,"Tasa de exámenes médico legales por presunto delito sexual contra niños, niñas y adolescentes",2017,3,2,217,921.658986175115,0,111,0,2,106,1886.79245283019
24676,68,68686,81,"Tasa de exámenes médico legales por presunto delito sexual contra niños, niñas y adolescentes",2017,4,1,216,462.962962962963,0,117,0,1,99,1010.10101010101
24677,68,68689,81,"Tasa de exámenes médico legales por presunto delito sexual contra niños, niñas y adolescentes",2017,2,1,3331,30.0210147102972,0,1706,0,1,1625,61.5384615384615
24678,68,68689,81,"Tasa de exámenes médico legales por presunto delito sexual contra niños, niñas y adolescentes",2017,3,4,3874,103.252452245741,0,1972,0,4,1902,210.304942166141
24679,68,68689,81,"Tasa de exámenes médico legales por presunto delito sexual contra niños, niñas y adolescentes",2017,4,3,3671,81.7216017433942,1,1863,53.6768652710682,2,1808,110.619469026549
24680,68,68705,81,"Tasa de exámenes médico legales por presunto delito sexual contra niños, niñas y adolescentes",2017,3,1,222,450.45045045045,0,118,0,1,104,961.538461538462
24681,68,68705,81,"Tasa de exámenes médico legales por presunto delito sexual contra niños, niñas y adolescentes",2017,4,1,203,492.610837438424,0,109,0,1,94,1063.82978723404
24682,68,68705,121,Tasa de exámenes médico legales por presunto delito sexual cuando la víctima está entre 18 y 28 años,2017,5,1,391,255.754475703325,0,207,0,1,184,543.478260869565
24683,68,68720,81,"Tasa de exámenes médico legales por presunto delito sexual contra niños, niñas y adolescentes",2017,2,1,497,201.207243460765,1,253,395.256916996047,0,244,0
24684,68,68720,81,"Tasa de exámenes médico legales por presunto delito sexual contra niños, niñas y adolescentes",2017,4,1,505,198.019801980198,0,260,0,1,245,408.163265306122
24685,68,68720,121,Tasa de exámenes médico legales por presunto delito sexual cuando la víctima está entre 18 y 28 años,2017,5,1,860,116.279069767442,0,448,0,1,412,242.718446601942
24686,68,68745,81,"Tasa de exámenes médico legales por presunto delito sexual contra niños, niñas y adolescentes",2017,4,2,786,254.452926208651,0,412,0,2,374,534.75935828877
24687,68,68755,81,"Tasa de exámenes médico legales por presunto delito sexual contra niños, niñas y adolescentes",2017,2,2,2343,85.3606487409304,0,1203,0,2,1140,175.438596491228
24688,68,68755,81,"Tasa de exámenes médico legales por presunto delito sexual contra niños, niñas y adolescentes",2017,3,2,2768,72.2543352601156,0,1385,0,2,1383,144.613159797542
24689,68,68755,81,"Tasa de exámenes médico legales por presunto delito sexual contra niños, niñas y adolescentes",2017,4,6,3196,187.734668335419,1,1769,56.5291124929339,5,1427,350.385423966363
24690,68,68755,121,Tasa de exámenes médico legales por presunto delito sexual cuando la víctima está entre 18 y 28 años,2017,5,1,6702,14.9209191286183,0,4009,0,1,2693,37.1333085777943
24691,68,68770,81,"Tasa de exámenes médico legales por presunto delito sexual contra niños, niñas y adolescentes",2017,3,2,987,202.634245187437,2,515,388.349514563107,0,472,0
24692,68,68770,81,"Tasa de exámenes médico legales por presunto delito sexual contra niños, niñas y adolescentes",2017,4,7,929,753.498385360603,0,487,0,7,442,1583.71040723982
24693,68,68770,121,Tasa de exámenes médico legales por presunto delito sexual cuando la víctima está entre 18 y 28 años,2017,5,1,1798,55.6173526140156,0,930,0,1,868,115.207373271889
24694,68,68780,81,"Tasa de exámenes médico legales por presunto delito sexual contra niños, niñas y adolescentes",2017,3,1,305,327.868852459016,0,157,0,1,148,675.675675675676
24695,68,68780,81,"Tasa de exámenes médico legales por presunto delito sexual contra niños, niñas y adolescentes",2017,4,1,294,340.136054421769,0,148,0,1,146,684.931506849315
24696,68,68820,81,"Tasa de exámenes médico legales por presunto delito sexual contra niños, niñas y adolescentes",2017,4,1,734,136.239782016349,0,382,0,1,352,284.090909090909
24697,68,68855,81,"Tasa de exámenes médico legales por presunto delito sexual contra niños, niñas y adolescentes",2017,3,3,422,710.900473933649,0,219,0,3,203,1477.83251231527
24698,68,68855,81,"Tasa de exámenes médico legales por presunto delito sexual contra niños, niñas y adolescentes",2017,4,2,451,443.458980044346,0,235,0,2,216,925.925925925926
24699,68,68861,81,"Tasa de exámenes médico legales por presunto delito sexual contra niños, niñas y adolescentes",2017,2,1,1962,50.9683995922528,0,1016,0,1,946,105.708245243129
24700,68,68861,81,"Tasa de exámenes médico legales por presunto delito sexual contra niños, niñas y adolescentes",2017,3,3,2195,136.674259681093,0,1133,0,3,1062,282.485875706215
24701,68,68861,81,"Tasa de exámenes médico legales por presunto delito sexual contra niños, niñas y adolescentes",2017,4,5,2126,235.183443085607,0,1106,0,5,1020,490.196078431373
24702,68,68867,81,"Tasa de exámenes médico legales por presunto delito sexual contra niños, niñas y adolescentes",2017,4,2,279,716.845878136201,0,148,0,2,131,1526.71755725191
24703,68,68872,81,"Tasa de exámenes médico legales por presunto delito sexual contra niños, niñas y adolescentes",2017,4,5,487,1026.69404517454,0,243,0,5,244,2049.18032786885
24704,68,68872,121,Tasa de exámenes médico legales por presunto delito sexual cuando la víctima está entre 18 y 28 años,2017,5,1,881,113.507377979569,0,436,0,1,445,224.719101123596
24705,68,68895,81,"Tasa de exámenes médico legales por presunto delito sexual contra niños, niñas y adolescentes",2017,3,2,849,235.571260306243,0,430,0,2,419,477.326968973747
24706,70,70001,81,"Tasa de exámenes médico legales por presunto delito sexual contra niños, niñas y adolescentes",2017,2,23,23671,97.1653077605509,4,12115,33.0169211721007,19,11556,164.4167532018
24707,70,70001,81,"Tasa de exámenes médico legales por presunto delito sexual contra niños, niñas y adolescentes",2017,3,49,29517,166.006030423146,7,15076,46.4314141682144,42,14441,290.838584585555
24708,70,70001,81,"Tasa de exámenes médico legales por presunto delito sexual contra niños, niñas y adolescentes",2017,4,74,31175,237.369687249399,11,15739,69.8900819620052,63,15436,408.136823011143
24709,70,70001,121,Tasa de exámenes médico legales por presunto delito sexual cuando la víctima está entre 18 y 28 años,2017,5,18,56531,31.8409368311192,1,28591,3.4976041411633,17,27940,60.8446671438797
24710,70,70110,81,"Tasa de exámenes médico legales por presunto delito sexual contra niños, niñas y adolescentes",2017,2,1,990,101.010101010101,0,506,0,1,484,206.611570247934
24711,70,70110,81,"Tasa de exámenes médico legales por presunto delito sexual contra niños, niñas y adolescentes",2017,4,2,1114,179.533213644524,0,556,0,2,558,358.4229390681
24712,70,70204,81,"Tasa de exámenes médico legales por presunto delito sexual contra niños, niñas y adolescentes",2017,2,1,552,181.159420289855,0,283,0,1,269,371.747211895911
24713,70,70204,81,"Tasa de exámenes médico legales por presunto delito sexual contra niños, niñas y adolescentes",2017,3,2,647,309.119010819165,0,332,0,2,315,634.920634920635
24714,70,70204,81,"Tasa de exámenes médico legales por presunto delito sexual contra niños, niñas y adolescentes",2017,4,3,646,464.396284829721,0,331,0,3,315,952.380952380953
24715,70,70215,81,"Tasa de exámenes médico legales por presunto delito sexual contra niños, niñas y adolescentes",2017,2,7,5178,135.187331015836,1,2652,37.7073906485671,6,2526,237.529691211401
24716,70,70215,81,"Tasa de exámenes médico legales por presunto delito sexual contra niños, niñas y adolescentes",2017,3,15,6459,232.2340919647,1,3289,30.4043782304652,14,3170,441.640378548896
24717,70,70215,81,"Tasa de exámenes médico legales por presunto delito sexual contra niños, niñas y adolescentes",2017,4,31,6869,451.302955306449,4,3496,114.41647597254,27,3373,800.474355173436
24718,70,70221,81,"Tasa de exámenes médico legales por presunto delito sexual contra niños, niñas y adolescentes",2017,2,2,1507,132.71400132714,1,781,128.040973111396,1,726,137.741046831956
24719,70,70221,81,"Tasa de exámenes médico legales por presunto delito sexual contra niños, niñas y adolescentes",2017,3,4,1728,231.481481481481,1,889,112.485939257593,3,839,357.568533969011
24720,70,70221,81,"Tasa de exámenes médico legales por presunto delito sexual contra niños, niñas y adolescentes",2017,4,4,1720,232.558139534884,0,858,0,4,862,464.037122969838
24721,70,70221,121,Tasa de exámenes médico legales por presunto delito sexual cuando la víctima está entre 18 y 28 años,2017,5,3,2832,105.932203389831,1,1390,71.9424460431655,2,1442,138.69625520111
24722,70,70230,81,"Tasa de exámenes médico legales por presunto delito sexual contra niños, niñas y adolescentes",2017,4,1,524,190.839694656489,0,274,0,1,250,400
24723,70,70233,81,"Tasa de exámenes médico legales por presunto delito sexual contra niños, niñas y adolescentes",2017,2,1,1114,89.7666068222621,0,569,0,1,545,183.48623853211
24724,70,70233,81,"Tasa de exámenes médico legales por presunto delito sexual contra niños, niñas y adolescentes",2017,3,2,1298,154.083204930663,0,667,0,2,631,316.957210776545
24725,70,70233,81,"Tasa de exámenes médico legales por presunto delito sexual contra niños, niñas y adolescentes",2017,4,4,1271,314.7128245476,0,659,0,4,612,653.59477124183
24726,70,70235,81,"Tasa de exámenes médico legales por presunto delito sexual contra niños, niñas y adolescentes",2017,2,2,2235,89.4854586129754,1,1140,87.719298245614,1,1095,91.324200913242
24727,70,70235,81,"Tasa de exámenes médico legales por presunto delito sexual contra niños, niñas y adolescentes",2017,3,5,2576,194.099378881988,1,1313,76.1614623000762,4,1263,316.706254948535
24728,70,70235,81,"Tasa de exámenes médico legales por presunto delito sexual contra niños, niñas y adolescentes",2017,4,4,2486,160.901045856798,0,1262,0,4,1224,326.797385620915
24729,70,70235,121,Tasa de exámenes médico legales por presunto delito sexual cuando la víctima está entre 18 y 28 años,2017,5,1,4311,23.1964741359313,0,2197,0,1,2114,47.3036896877956
24730,70,70265,81,"Tasa de exámenes médico legales por presunto delito sexual contra niños, niñas y adolescentes",2017,2,1,2138,46.7726847521048,0,1095,0,1,1043,95.8772770853308
24731,70,70265,81,"Tasa de exámenes médico legales por presunto delito sexual contra niños, niñas y adolescentes",2017,4,1,2285,43.7636761487965,0,1172,0,1,1113,89.8472596585804
24732,70,70400,81,"Tasa de exámenes médico legales por presunto delito sexual contra niños, niñas y adolescentes",2017,2,1,1220,81.9672131147541,1,626,159.744408945687,0,594,0
24733,70,70400,81,"Tasa de exámenes médico legales por presunto delito sexual contra niños, niñas y adolescentes",2017,4,2,1306,153.139356814701,0,679,0,2,627,318.979266347687
24734,70,70418,81,"Tasa de exámenes médico legales por presunto delito sexual contra niños, niñas y adolescentes",2017,2,1,1726,57.9374275782155,0,884,0,1,842,118.764845605701
24735,70,70418,81,"Tasa de exámenes médico legales por presunto delito sexual contra niños, niñas y adolescentes",2017,3,4,2021,197.921820880752,1,1035,96.6183574879227,3,986,304.259634888438
24736,70,70418,81,"Tasa de exámenes médico legales por presunto delito sexual contra niños, niñas y adolescentes",2017,4,4,2013,198.708395429707,0,1029,0,4,984,406.50406504065
24737,70,70418,121,Tasa de exámenes médico legales por presunto delito sexual cuando la víctima está entre 18 y 28 años,2017,5,2,3866,51.7330574236937,0,1985,0,2,1881,106.326422115896
24738,70,70429,81,"Tasa de exámenes médico legales por presunto delito sexual contra niños, niñas y adolescentes",2017,4,2,3964,50.4540867810293,0,2036,0,2,1928,103.734439834025
24739,70,70473,81,"Tasa de exámenes médico legales por presunto delito sexual contra niños, niñas y adolescentes",2017,3,3,1656,181.159420289855,0,870,0,3,786,381.679389312977
24740,70,70473,81,"Tasa de exámenes médico legales por presunto delito sexual contra niños, niñas y adolescentes",2017,4,1,1667,59.9880023995201,0,873,0,1,794,125.944584382872
24741,70,70473,121,Tasa de exámenes médico legales por presunto delito sexual cuando la víctima está entre 18 y 28 años,2017,5,1,3001,33.3222259246918,0,1565,0,1,1436,69.6378830083566
24742,70,70508,81,"Tasa de exámenes médico legales por presunto delito sexual contra niños, niñas y adolescentes",2017,2,2,2185,91.533180778032,2,1123,178.094390026714,0,1062,0
24743,70,70508,81,"Tasa de exámenes médico legales por presunto delito sexual contra niños, niñas y adolescentes",2017,3,2,2520,79.3650793650794,1,1304,76.6871165644172,1,1216,82.2368421052632
24744,70,70508,81,"Tasa de exámenes médico legales por presunto delito sexual contra niños, niñas y adolescentes",2017,4,2,2431,82.2706705059646,0,1260,0,2,1171,170.794192997438
24745,70,70523,81,"Tasa de exámenes médico legales por presunto delito sexual contra niños, niñas y adolescentes",2017,3,1,2013,49.6770988574267,1,1057,94.6073793755913,0,956,0
24746,70,70523,81,"Tasa de exámenes médico legales por presunto delito sexual contra niños, niñas y adolescentes",2017,4,4,1892,211.416490486258,1,1003,99.7008973080758,3,889,337.457817772778
24747,70,70670,81,"Tasa de exámenes médico legales por presunto delito sexual contra niños, niñas y adolescentes",2017,2,3,3945,76.0456273764259,0,2018,0,3,1927,155.682407887909
24748,70,70670,81,"Tasa de exámenes médico legales por presunto delito sexual contra niños, niñas y adolescentes",2017,3,4,4597,87.0132695236023,0,2357,0,4,2240,178.571428571429
24749,70,70670,81,"Tasa de exámenes médico legales por presunto delito sexual contra niños, niñas y adolescentes",2017,4,5,4510,110.864745011086,0,2341,0,5,2169,230.520977408944
24750,70,70678,81,"Tasa de exámenes médico legales por presunto delito sexual contra niños, niñas y adolescentes",2017,2,1,3093,32.3310701584222,0,1594,0,1,1499,66.711140760507
24751,70,70678,81,"Tasa de exámenes médico legales por presunto delito sexual contra niños, niñas y adolescentes",2017,4,5,3157,158.378207158695,0,1627,0,5,1530,326.797385620915
24752,70,70678,121,Tasa de exámenes médico legales por presunto delito sexual cuando la víctima está entre 18 y 28 años,2017,5,1,5166,19.3573364305072,0,2684,0,1,2482,40.290088638195
24753,70,70702,81,"Tasa de exámenes médico legales por presunto delito sexual contra niños, niñas y adolescentes",2017,2,1,1051,95.1474785918173,0,538,0,1,513,194.931773879142
24754,70,70702,81,"Tasa de exámenes médico legales por presunto delito sexual contra niños, niñas y adolescentes",2017,3,4,1250,320,2,641,312.01248049922,2,609,328.407224958949
24755,70,70702,81,"Tasa de exámenes médico legales por presunto delito sexual contra niños, niñas y adolescentes",2017,4,4,1301,307.455803228286,2,664,301.204819277108,2,637,313.971742543171
24756,70,70702,121,Tasa de exámenes médico legales por presunto delito sexual cuando la víctima está entre 18 y 28 años,2017,5,1,2396,41.7362270450751,1,1215,82.3045267489712,0,1181,0
24757,70,70708,81,"Tasa de exámenes médico legales por presunto delito sexual contra niños, niñas y adolescentes",2017,2,1,6283,15.9159637116027,0,3204,0,1,3079,32.478077297824
24758,70,70708,81,"Tasa de exámenes médico legales por presunto delito sexual contra niños, niñas y adolescentes",2017,3,1,7072,14.1402714932127,0,3541,0,1,3531,28.3205890682526
24759,70,70708,81,"Tasa de exámenes médico legales por presunto delito sexual contra niños, niñas y adolescentes",2017,4,5,6862,72.8650539201399,0,3390,0,5,3472,144.009216589862
24760,70,70713,81,"Tasa de exámenes médico legales por presunto delito sexual contra niños, niñas y adolescentes",2017,3,3,6846,43.8212094653812,1,3531,28.3205890682526,2,3315,60.3318250377074
24761,70,70713,81,"Tasa de exámenes médico legales por presunto delito sexual contra niños, niñas y adolescentes",2017,4,9,6466,139.189607175998,0,3354,0,9,3112,289.203084832905
24762,70,70713,121,Tasa de exámenes médico legales por presunto delito sexual cuando la víctima está entre 18 y 28 años,2017,5,2,10426,19.1828122002686,0,5500,0,2,4926,40.6008932196508
24763,70,70717,81,"Tasa de exámenes médico legales por presunto delito sexual contra niños, niñas y adolescentes",2017,3,3,1688,177.725118483412,1,876,114.155251141553,2,812,246.305418719212
24764,70,70717,81,"Tasa de exámenes médico legales por presunto delito sexual contra niños, niñas y adolescentes",2017,4,5,1650,303.030303030303,1,868,115.207373271889,4,782,511.50895140665
24765,70,70717,121,Tasa de exámenes médico legales por presunto delito sexual cuando la víctima está entre 18 y 28 años,2017,5,1,3130,31.9488817891374,0,1651,0,1,1479,67.6132521974307
24766,70,70742,81,"Tasa de exámenes médico legales por presunto delito sexual contra niños, niñas y adolescentes",2017,2,2,3209,62.3247117482082,0,1665,0,2,1544,129.533678756477
24767,70,70742,81,"Tasa de exámenes médico legales por presunto delito sexual contra niños, niñas y adolescentes",2017,3,1,3874,25.8131130614352,0,2024,0,1,1850,54.0540540540541
24768,70,70742,81,"Tasa de exámenes médico legales por presunto delito sexual contra niños, niñas y adolescentes",2017,4,4,3845,104.031209362809,0,1997,0,4,1848,216.450216450216
24769,70,70771,81,"Tasa de exámenes médico legales por presunto delito sexual contra niños, niñas y adolescentes",2017,3,1,2442,40.950040950041,0,1250,0,1,1192,83.8926174496644
24770,70,70820,81,"Tasa de exámenes médico legales por presunto delito sexual contra niños, niñas y adolescentes",2017,2,2,3565,56.1009817671809,0,1833,0,2,1732,115.473441108545
24771,70,70820,81,"Tasa de exámenes médico legales por presunto delito sexual contra niños, niñas y adolescentes",2017,3,5,4089,122.27928588897,1,2101,47.5963826749167,4,1988,201.207243460765
24772,70,70820,81,"Tasa de exámenes médico legales por presunto delito sexual contra niños, niñas y adolescentes",2017,4,9,4130,217.917675544794,1,2105,47.5059382422803,8,2025,395.061728395062
24773,70,70820,121,Tasa de exámenes médico legales por presunto delito sexual cuando la víctima está entre 18 y 28 años,2017,5,2,6792,29.4464075382803,0,3386,0,2,3406,58.7199060481503
24774,70,70823,81,"Tasa de exámenes médico legales por presunto delito sexual contra niños, niñas y adolescentes",2017,3,2,2186,91.4913083257091,0,1149,0,2,1037,192.864030858245
24775,70,70823,81,"Tasa de exámenes médico legales por presunto delito sexual contra niños, niñas y adolescentes",2017,4,11,2141,513.778608127043,1,1125,88.8888888888889,10,1016,984.251968503937
24776,70,70823,121,Tasa de exámenes médico legales por presunto delito sexual cuando la víctima está entre 18 y 28 años,2017,5,1,3769,26.5322366675511,0,2011,0,1,1758,56.8828213879408
24777,73,73001,81,"Tasa de exámenes médico legales por presunto delito sexual contra niños, niñas y adolescentes",2017,2,62,44008,140.883475731685,10,22541,44.363604099197,52,21467,242.23226347417
24778,73,73001,81,"Tasa de exámenes médico legales por presunto delito sexual contra niños, niñas y adolescentes",2017,3,113,55195,204.728689192862,22,28098,78.2973877144281,91,27097,335.830534745544
24779,73,73001,81,"Tasa de exámenes médico legales por presunto delito sexual contra niños, niñas y adolescentes",2017,4,172,58910,291.970802919708,22,30094,73.1042732770652,150,28816,520.544142143254
24780,73,73001,121,Tasa de exámenes médico legales por presunto delito sexual cuando la víctima está entre 18 y 28 años,2017,5,33,107455,30.7105299892978,3,55640,5.39180445722502,30,51815,57.898292000386
24781,73,73024,81,"Tasa de exámenes médico legales por presunto delito sexual contra niños, niñas y adolescentes",2017,3,1,507,197.23865877712,0,262,0,1,245,408.163265306122
24782,73,73026,81,"Tasa de exámenes médico legales por presunto delito sexual contra niños, niñas y adolescentes",2017,2,1,806,124.069478908189,0,420,0,1,386,259.067357512953
24783,73,73026,81,"Tasa de exámenes médico legales por presunto delito sexual contra niños, niñas y adolescentes",2017,3,1,980,102.040816326531,0,519,0,1,461,216.919739696312
24784,73,73026,81,"Tasa de exámenes médico legales por presunto delito sexual contra niños, niñas y adolescentes",2017,4,1,919,108.813928182807,0,484,0,1,435,229.885057471264
24785,73,73043,81,"Tasa de exámenes médico legales por presunto delito sexual contra niños, niñas y adolescentes",2017,4,2,2347,85.2151682999574,0,1286,0,2,1061,188.501413760603
24786,73,73055,81,"Tasa de exámenes médico legales por presunto delito sexual contra niños, niñas y adolescentes",2017,2,1,1033,96.805421103581807,0,530,0,1,503,198.807157057654
24787,73,73055,81,"Tasa de exámenes médico legales por presunto delito sexual contra niños, niñas y adolescentes",2017,3,2,1257,159.108989657916,2,646,309.597523219814,0,611,0
24788,73,73055,81,"Tasa de exámenes médico legales por presunto delito sexual contra niños, niñas y adolescentes",2017,4,3,1203,249.376558603491,1,631,158.478605388273,2,572,349.65034965035
24789,73,73067,81,"Tasa de exámenes médico legales por presunto delito sexual contra niños, niñas y adolescentes",2017,2,1,2559,39.0777647518562,0,1310,0,1,1249,80.0640512409928
24790,73,73067,81,"Tasa de exámenes médico legales por presunto delito sexual contra niños, niñas y adolescentes",2017,3,5,2868,174.337517433752,0,1468,0,5,1400,357.142857142857
24791,73,73067,81,"Tasa de exámenes médico legales por presunto delito sexual contra niños, niñas y adolescentes",2017,4,2,2726,73.3675715333822,0,1398,0,2,1328,150.602409638554
24792,73,73124,81,"Tasa de exámenes médico legales por presunto delito sexual contra niños, niñas y adolescentes",2017,2,1,1822,54.8847420417124,0,936,0,1,886,112.866817155756
24793,73,73124,81,"Tasa de exámenes médico legales por presunto delito sexual contra niños, niñas y adolescentes",2017,3,6,2195,273.348519362187,0,1144,0,6,1051,570.884871550904
24794,73,73124,81,"Tasa de exámenes médico legales por presunto delito sexual contra niños, niñas y adolescentes",2017,4,6,2119,283.152430391694,0,1127,0,6,992,604.838709677419
24795,73,73148,81,"Tasa de exámenes médico legales por presunto delito sexual contra niños, niñas y adolescentes",2017,3,3,861,348.432055749129,0,435,0,3,426,704.225352112676
24796,73,73148,81,"Tasa de exámenes médico legales por presunto delito sexual contra niños, niñas y adolescentes",2017,4,6,889,674.915635545557,0,448,0,6,441,1360.54421768707
24797,73,73152,121,Tasa de exámenes médico legales por presunto delito sexual cuando la víctima está entre 18 y 28 años,2017,5,1,1212,82.5082508250825,0,659,0,1,553,180.831826401447
24798,73,73168,81,"Tasa de exámenes médico legales por presunto delito sexual contra niños, niñas y adolescentes",2017,2,2,5356,37.3412994772218,0,2740,0,2,2616,76.4525993883792
24799,73,73168,81,"Tasa de exámenes médico legales por presunto delito sexual contra niños, niñas y adolescentes",2017,3,18,6000,300,6,3074,195.185426154847,12,2926,410.116199589884
24800,73,73168,81,"Tasa de exámenes médico legales por presunto delito sexual contra niños, niñas y adolescentes",2017,4,19,5686,334.154062609919,2,2909,68.7521485046408,17,2777,612.171407994238
24801,73,73168,121,Tasa de exámenes médico legales por presunto delito sexual cuando la víctima está entre 18 y 28 años,2017,5,3,9308,32.2303394929093,0,4662,0,3,4646,64.5716745587602
24802,73,73200,81,"Tasa de exámenes médico legales por presunto delito sexual contra niños, niñas y adolescentes",2017,2,1,955,104.712041884817,0,486,0,1,469,213.219616204691
24803,73,73200,81,"Tasa de exámenes médico legales por presunto delito sexual contra niños, niñas y adolescentes",2017,3,5,1179,424.088210347752,4,610,655.737704918033,1,569,175.746924428822
24804,73,73200,81,"Tasa de exámenes médico legales por presunto delito sexual contra niños, niñas y adolescentes",2017,4,2,1110,180.18018018018,1,582,171.821305841924,1,528,189.393939393939
24805,73,73200,121,Tasa de exámenes médico legales por presunto delito sexual cuando la víctima está entre 18 y 28 años,2017,5,2,1723,116.076610562972,0,913,0,2,810,246.913580246914
24806,73,73217,81,"Tasa de exámenes médico legales por presunto delito sexual contra niños, niñas y adolescentes",2017,2,1,3396,29.4464075382803,0,1746,0,1,1650,60.6060606060606
24807,73,73217,81,"Tasa de exámenes médico legales por presunto delito sexual contra niños, niñas y adolescentes",2017,3,2,3676,54.4069640914037,0,1909,0,2,1767,113.186191284663
24808,73,73217,81,"Tasa de exámenes médico legales por presunto delito sexual contra niños, niñas y adolescentes",2017,4,11,3369,326.506381715643,1,1793,55.7724484104852,10,1576,634.517766497462
24809,73,73217,121,Tasa de exámenes médico legales por presunto delito sexual cuando la víctima está entre 18 y 28 años,2017,5,2,5561,35.9647545405503,0,3031,0,2,2530,79.0513833992095
24810,73,73226,81,"Tasa de exámenes médico legales por presunto delito sexual contra niños, niñas y adolescentes",2017,3,1,1149,87.0322019147084,0,604,0,1,545,183.48623853211
24811,73,73226,81,"Tasa de exámenes médico legales por presunto delito sexual contra niños, niñas y adolescentes",2017,4,1,1027,97.3709834469328,0,548,0,1,479,208.768267223382
24812,73,73268,81,"Tasa de exámenes médico legales por presunto delito sexual contra niños, niñas y adolescentes",2017,2,6,6487,92.4926776630183,1,3292,30.3766707168894,5,3195,156.494522691706
24813,73,73268,81,"Tasa de exámenes médico legales por presunto delito sexual contra niños, niñas y adolescentes",2017,3,10,8059,124.084874053853,2,4156,48.1231953801732,8,3903,204.970535485524
24814,73,73268,81,"Tasa de exámenes médico legales por presunto delito sexual contra niños, niñas y adolescentes",2017,4,19,8208,231.481481481481,1,4237,23.6016049091338,18,3971,453.286325862503
24815,73,73268,121,Tasa de exámenes médico legales por presunto delito sexual cuando la víctima está entre 18 y 28 años,2017,5,6,13854,43.308791684712,0,7308,0,6,6546,91.6590284142988
24816,73,73270,81,"Tasa de exámenes médico legales por presunto delito sexual contra niños, niñas y adolescentes",2017,3,2,983,203.458799593082,1,507,197.23865877712,1,476,210.084033613445
24817,73,73270,81,"Tasa de exámenes médico legales por presunto delito sexual contra niños, niñas y adolescentes",2017,4,1,956,104.602510460251,1,499,200.400801603206,0,457,0
24818,73,73275,81,"Tasa de exámenes médico legales por presunto delito sexual contra niños, niñas y adolescentes",2017,2,2,2399,83.3680700291788,1,1225,81.6326530612245,1,1174,85.1788756388416
24819,73,73275,81,"Tasa de exámenes médico legales por presunto delito sexual contra niños, niñas y adolescentes",2017,3,6,2956,202.97699594046,1,1518,65.8761528326746,5,1438,347.705146036161
24820,73,73275,81,"Tasa de exámenes médico legales por presunto delito sexual contra niños, niñas y adolescentes",2017,4,2,3046,65.6598818122127,1,1574,63.5324015247776,1,1472,67.9347826086957
24821,73,73275,121,Tasa de exámenes médico legales por presunto delito sexual cuando la víctima está entre 18 y 28 años,2017,5,1,5480,18.2481751824818,0,2818,0,1,2662,37.5657400450789
24822,73,73283,81,"Tasa de exámenes médico legales por presunto delito sexual contra niños, niñas y adolescentes",2017,2,1,2804,35.6633380884451,1,1443,69.3000693000693,0,1361,0
24823,73,73283,81,"Tasa de exámenes médico legales por presunto delito sexual contra niños, niñas y adolescentes",2017,3,7,3319,210.906899668575,1,1726,57.9374275782155,6,1593,376.647834274953
24824,73,73283,81,"Tasa de exámenes médico legales por presunto delito sexual contra niños, niñas y adolescentes",2017,4,1,3253,30.7408545957578,0,1713,0,1,1540,64.9350649350649
24825,73,73319,81,"Tasa de exámenes médico legales por presunto delito sexual contra niños, niñas y adolescentes",2017,2,1,2709,36.9139904023625,0,1380,0,1,1329,75.2445447705041
24826,73,73319,81,"Tasa de exámenes médico legales por presunto delito sexual contra niños, niñas y adolescentes",2017,3,2,3288,60.8272506082725,0,1667,0,2,1621,123.380629241209
24827,73,73319,81,"Tasa de exámenes médico legales por presunto delito sexual contra niños, niñas y adolescentes",2017,4,5,3227,154.942671211652,0,1638,0,5,1589,314.663310258024
24828,73,73319,81,"Tasa de exámenes médico legales por presunto delito sexual contra niños, niñas y adolescentes",2017,1,2,532,375.93984962406,0,273,0,2,259,772.200772200772
24829,73,73347,81,"Tasa de exámenes médico legales por presunto delito sexual contra niños, niñas y adolescentes",2017,3,1,864,115.740740740741,0,450,0,1,414,241.545893719807
24830,73,73347,81,"Tasa de exámenes médico legales por presunto delito sexual contra niños, niñas y adolescentes",2017,4,1,825,121.212121212121,0,428,0,1,397,251.889168765743
24831,73,73349,81,"Tasa de exámenes médico legales por presunto delito sexual contra niños, niñas y adolescentes",2017,2,4,1918,208.550573514077,0,992,0,4,926,431.965442764579
24832,73,73349,81,"Tasa de exámenes médico legales por presunto delito sexual contra niños, niñas y adolescentes",2017,3,2,2311,86.5426222414539,0,1169,0,2,1142,175.131348511384
24833,73,73349,81,"Tasa de exámenes médico legales por presunto delito sexual contra niños, niñas y adolescentes",2017,4,3,2500,120,1,1396,71.6332378223496,2,1104,181.159420289855
24834,73,73352,81,"Tasa de exámenes médico legales por presunto delito sexual contra niños, niñas y adolescentes",2017,3,1,1177,84.9617672047579,0,594,0,1,583,171.526586620926
24835,73,73352,81,"Tasa de exámenes médico legales por presunto delito sexual contra niños, niñas y adolescentes",2017,4,5,1101,454.132606721163,0,562,0,5,539,927.643784786642
24836,73,73408,81,"Tasa de exámenes médico legales por presunto delito sexual contra niños, niñas y adolescentes",2017,3,3,1726,173.812282734647,0,879,0,3,847,354.191263282172
24837,73,73408,81,"Tasa de exámenes médico legales por presunto delito sexual contra niños, niñas y adolescentes",2017,4,5,1677,298.151460942159,0,854,0,5,823,607.533414337789
24838,73,73411,81,"Tasa de exámenes médico legales por presunto delito sexual contra niños, niñas y adolescentes",2017,2,1,3640,27.4725274725275,0,1866,0,1,1774,56.369785794814
24839,73,73411,81,"Tasa de exámenes médico legales por presunto delito sexual contra niños, niñas y adolescentes",2017,3,6,4289,139.892748892516,1,2214,45.16711833785,5,2075,240.963855421687
24840,73,73411,81,"Tasa de exámenes médico legales por presunto delito sexual contra niños, niñas y adolescentes",2017,4,10,4163,240.211386019697,0,2167,0,10,1996,501.002004008016
24841,73,73411,121,Tasa de exámenes médico legales por presunto delito sexual cuando la víctima está entre 18 y 28 años,2017,5,2,7445,26.8636668905306,0,3837,0,2,3608,55.4323725055432
24842,73,73443,81,"Tasa de exámenes médico legales por presunto delito sexual contra niños, niñas y adolescentes",2017,2,3,2799,107.181136120043,0,1440,0,3,1359,220.75055187638
24843,73,73443,81,"Tasa de exámenes médico legales por presunto delito sexual contra niños, niñas y adolescentes",2017,3,7,3431,204.022150976392,1,1758,56.8828213879408,6,1673,358.637178720861
24844,73,73443,81,"Tasa de exámenes médico legales por presunto delito sexual contra niños, niñas y adolescentes",2017,4,7,3304,211.864406779661,1,1684,59.3824228028504,6,1620,370.37037037037
24845,73,73443,121,Tasa de exámenes médico legales por presunto delito sexual cuando la víctima está entre 18 y 28 años,2017,5,1,6087,16.4284540824708,0,3054,0,1,3033,32.9706561160567
24846,73,73449,81,"Tasa de exámenes médico legales por presunto delito sexual contra niños, niñas y adolescentes",2017,2,5,3160,158.227848101266,0,1625,0,5,1535,325.732899022801
24847,73,73449,81,"Tasa de exámenes médico legales por presunto delito sexual contra niños, niñas y adolescentes",2017,3,11,3890,282.776349614396,0,2028,0,11,1862,590.762620837809
24848,73,73449,81,"Tasa de exámenes médico legales por presunto delito sexual contra niños, niñas y adolescentes",2017,4,8,4105,194.884287454324,0,2160,0,8,1945,411.311053984576
24849,73,73449,121,Tasa de exámenes médico legales por presunto delito sexual cuando la víctima está entre 18 y 28 años,2017,5,3,6875,43.6363636363636,1,3681,27.1665308340125,2,3194,62.6174076393237
24850,73,73461,81,"Tasa de exámenes médico legales por presunto delito sexual contra niños, niñas y adolescentes",2017,3,1,613,163.132137030995,0,313,0,1,300,333.333333333333
24851,73,73461,81,"Tasa de exámenes médico legales por presunto delito sexual contra niños, niñas y adolescentes",2017,4,1,585,170.940170940171,0,306,0,1,279,358.4229390681
24852,73,73483,81,"Tasa de exámenes médico legales por presunto delito sexual contra niños, niñas y adolescentes",2017,3,1,2252,44.404973357016,0,1163,0,1,1089,91.8273645546373
24853,73,73483,81,"Tasa de exámenes médico legales por presunto delito sexual contra niños, niñas y adolescentes",2017,4,4,2186,182.982616651418,2,1131,176.83465959328,2,1055,189.57345971564
24854,73,73504,81,"Tasa de exámenes médico legales por presunto delito sexual contra niños, niñas y adolescentes",2017,2,2,3824,52.3012552301255,0,1945,0,2,1879,106.439595529537
24855,73,73504,81,"Tasa de exámenes médico legales por presunto delito sexual contra niños, niñas y adolescentes",2017,3,5,4090,122.249388753056,1,2070,48.3091787439614,4,2020,198.019801980198
24856,73,73504,81,"Tasa de exámenes médico legales por presunto delito sexual contra niños, niñas y adolescentes",2017,4,6,3642,164.744645799012,1,1853,53.9665407447383,5,1789,279.485746226942
24857,73,73504,121,Tasa de exámenes médico legales por presunto delito sexual cuando la víctima está entre 18 y 28 años,2017,5,1,6474,15.4464009885697,0,3421,0,1,3053,32.7546675401245
24858,73,73547,81,"Tasa de exámenes médico legales por presunto delito sexual contra niños, niñas y adolescentes",2017,3,1,674,148.367952522255,0,348,0,1,326,306.748466257669
24859,73,73547,121,Tasa de exámenes médico legales por presunto delito sexual cuando la víctima está entre 18 y 28 años,2017,5,1,985,101.522842639594,0,521,0,1,464,215.51724137931
24860,73,73555,81,"Tasa de exámenes médico legales por presunto delito sexual contra niños, niñas y adolescentes",2017,3,5,4090,122.249388753056,0,2115,0,5,1975,253.164556962025
24861,73,73555,81,"Tasa de exámenes médico legales por presunto delito sexual contra niños, niñas y adolescentes",2017,4,7,3965,176.544766708701,0,2099,0,7,1866,375.13397642015
24862,73,73555,121,Tasa de exámenes médico legales por presunto delito sexual cuando la víctima está entre 18 y 28 años,2017,5,1,6244,16.0153747597694,0,3388,0,1,2856,35.0140056022409
24863,73,73563,81,"Tasa de exámenes médico legales por presunto delito sexual contra niños, niñas y adolescentes",2017,2,1,613,163.132137030995,0,316,0,1,297,336.700336700337
24864,73,73563,81,"Tasa de exámenes médico legales por presunto delito sexual contra niños, niñas y adolescentes",2017,4,1,742,134.770889487871,0,384,0,1,358,279.329608938547
24865,73,73585,81,"Tasa de exámenes médico legales por presunto delito sexual contra niños, niñas y adolescentes",2017,3,1,2962,33.7609723160027,1,1530,65.359477124183,0,1432,0
24866,73,73585,81,"Tasa de exámenes médico legales por presunto delito sexual contra niños, niñas y adolescentes",2017,4,2,2875,69.5652173913044,1,1488,67.2043010752688,1,1387,72.0980533525595
24867,73,73616,81,"Tasa de exámenes médico legales por presunto delito sexual contra niños, niñas y adolescentes",2017,4,1,3202,31.2304809494066,0,1678,0,1,1524,65.6167979002625
24868,73,73622,81,"Tasa de exámenes médico legales por presunto delito sexual contra niños, niñas y adolescentes",2017,3,4,709,564.174894217207,2,370,540.540540540541,2,339,589.970501474926
24869,73,73622,81,"Tasa de exámenes médico legales por presunto delito sexual contra niños, niñas y adolescentes",2017,4,2,684,292.397660818713,0,364,0,2,320,625
24870,73,73624,81,"Tasa de exámenes médico legales por presunto delito sexual contra niños, niñas y adolescentes",2017,3,3,2590,115.830115830116,0,1310,0,3,1280,234375
24871,73,73624,81,"Tasa de exámenes médico legales por presunto delito sexual contra niños, niñas y adolescentes",2017,4,5,2304,217.013888888889,0,1173,0,5,1131,442.086648983201
24872,73,73624,121,Tasa de exámenes médico legales por presunto delito sexual cuando la víctima está entre 18 y 28 años,2017,5,1,4095,24.4200244200244,0,2164,0,1,1931,51.7866390471258
24873,73,73671,81,"Tasa de exámenes médico legales por presunto delito sexual contra niños, niñas y adolescentes",2017,2,1,1219,82.0344544708778,0,626,0,1,593,168.634064080944
24874,73,73671,81,"Tasa de exámenes médico legales por presunto delito sexual contra niños, niñas y adolescentes",2017,4,1,1518,65.8761528326746,0,792,0,1,726,137.741046831956
24875,73,73675,81,"Tasa de exámenes médico legales por presunto delito sexual contra niños, niñas y adolescentes",2017,3,8,1798,444.938820912125,1,910,109.89010989011,7,888,788.288288288288
24876,73,73675,81,"Tasa de exámenes médico legales por presunto delito sexual contra niños, niñas y adolescentes",2017,4,6,1602,374.531835205993,0,815,0,6,787,762.388818297332
24877,73,73678,81,"Tasa de exámenes médico legales por presunto delito sexual contra niños, niñas y adolescentes",2017,3,2,1973,101.36847440446,0,1001,0,2,972,205.761316872428
24878,73,73678,81,"Tasa de exámenes médico legales por presunto delito sexual contra niños, niñas y adolescentes",2017,4,1,1940,51.5463917525773,0,985,0,1,955,104.712041884817
24879,73,73770,81,"Tasa de exámenes médico legales por presunto delito sexual contra niños, niñas y adolescentes",2017,4,1,460,217.391304347826,0,234,0,1,226,442.477876106195
24880,73,73854,81,"Tasa de exámenes médico legales por presunto delito sexual contra niños, niñas y adolescentes",2017,2,1,661,151.285930408472,0,340,0,1,321,311.526479750779
24881,73,73854,81,"Tasa de exámenes médico legales por presunto delito sexual contra niños, niñas y adolescentes",2017,3,2,790,253.164556962025,0,408,0,2,382,523.560209424084
24882,73,73854,81,"Tasa de exámenes médico legales por presunto delito sexual contra niños, niñas y adolescentes",2017,4,3,710,422.535211267606,0,370,0,3,340,882.352941176471
24883,73,73861,81,"Tasa de exámenes médico legales por presunto delito sexual contra niños, niñas y adolescentes",2017,4,1,2059,48.5672656629432,0,1084,0,1,975,102.564102564103
24884,73,73870,81,"Tasa de exámenes médico legales por presunto delito sexual contra niños, niñas y adolescentes",2017,3,3,1239,242.130750605327,0,644,0,3,595,504.201680672269
24885,73,73870,81,"Tasa de exámenes médico legales por presunto delito sexual contra niños, niñas y adolescentes",2017,4,2,1184,168.918918918919,0,626,0,2,558,358.4229390681
24886,76,76001,81,"Tasa de exámenes médico legales por presunto delito sexual contra niños, niñas y adolescentes",2017,2,201,176883,113.634436322315,51,90387,56.4240432805603,150,86496,173.418423973363
24887,76,76001,81,"Tasa de exámenes médico legales por presunto delito sexual contra niños, niñas y adolescentes",2017,3,349,215584,161.885854237791,69,109559,62.9797643278964,280,106025,264.088658335298
24888,76,76001,81,"Tasa de exámenes médico legales por presunto delito sexual contra niños, niñas y adolescentes",2017,4,440,228738,192.359817782791,43,115589,37.2007716997292,397,113149,350.864788906663
24889,76,76001,121,Tasa de exámenes médico legales por presunto delito sexual cuando la víctima está entre 18 y 28 años,2017,5,79,448674,17.6074388085782,4,227063,1.76162562812964,75,221611,33.8430854064103
24890,76,76001,81,"Tasa de exámenes médico legales por presunto delito sexual contra niños, niñas y adolescentes",2017,1,4,35539,11.2552407214609,0,18176,0,4,17363,23.0374935207049
24891,76,76020,81,"Tasa de exámenes médico legales por presunto delito sexual contra niños, niñas y adolescentes",2017,2,1,1978,50.5561172901921,0,1009,0,1,969,103.199174406605
24892,76,76020,81,"Tasa de exámenes médico legales por presunto delito sexual contra niños, niñas y adolescentes",2017,3,1,2204,45.3720508166969,0,1122,0,1,1082,92.4214417744917
24893,76,76020,81,"Tasa de exámenes médico legales por presunto delito sexual contra niños, niñas y adolescentes",2017,4,2,2237,89.4054537326777,0,1131,0,2,1106,180.831826401447
24894,76,76036,81,"Tasa de exámenes médico legales por presunto delito sexual contra niños, niñas y adolescentes",2017,3,2,1524,131.233595800525,1,784,127.551020408163,1,740,135.135135135135
24895,76,76036,81,"Tasa de exámenes médico legales por presunto delito sexual contra niños, niñas y adolescentes",2017,4,1,1576,63.4517766497462,0,811,0,1,765,130.718954248366
24896,76,76041,81,"Tasa de exámenes médico legales por presunto delito sexual contra niños, niñas y adolescentes",2017,2,1,1798,55.6173526140156,1,918,108.932461873638,0,880,0
24897,76,76041,81,"Tasa de exámenes médico legales por presunto delito sexual contra niños, niñas y adolescentes",2017,4,1,1933,51.7330574236937,0,978,0,1,955,104.712041884817
24898,76,76054,81,"Tasa de exámenes médico legales por presunto delito sexual contra niños, niñas y adolescentes",2017,4,2,610,327.868852459016,0,323,0,2,287,696.864111498258
24899,76,76100,81,"Tasa de exámenes médico legales por presunto delito sexual contra niños, niñas y adolescentes",2017,2,2,1234,162.074554294976,0,629,0,2,605,330.578512396694
24900,76,76100,81,"Tasa de exámenes médico legales por presunto delito sexual contra niños, niñas y adolescentes",2017,3,2,1368,146.198830409357,1,707,141.442715700141,1,661,151.285930408472
24901,76,76100,81,"Tasa de exámenes médico legales por presunto delito sexual contra niños, niñas y adolescentes",2017,4,3,1258,238.473767885533,0,666,0,3,592,506.756756756757
24902,76,76109,81,"Tasa de exámenes médico legales por presunto delito sexual contra niños, niñas y adolescentes",2017,2,12,43494,27.5900124155056,1,22272,4.48994252873563,11,21222,51.8330034869475
24903,76,76109,81,"Tasa de exámenes médico legales por presunto delito sexual contra niños, niñas y adolescentes",2017,3,39,48536,80.3527278720949,4,24755,16.1583518481115,35,23781,147.176317228039
24904,76,76109,81,"Tasa de exámenes médico legales por presunto delito sexual contra niños, niñas y adolescentes",2017,4,66,47216,139.783124364622,5,23903,20.9178764171861,61,23313,261.65658645391
24905,76,76109,121,Tasa de exámenes médico legales por presunto delito sexual cuando la víctima está entre 18 y 28 años,2017,5,13,84712,15.3461138917745,0,42230,0,13,42482,30.6011958005744
24906,76,76111,81,"Tasa de exámenes médico legales por presunto delito sexual contra niños, niñas y adolescentes",2017,2,17,7753,219.269960015478,3,3990,75.187969924812,14,3763,372.043582248206
24907,76,76111,81,"Tasa de exámenes médico legales por presunto delito sexual contra niños, niñas y adolescentes",2017,3,24,9365,256.273358248799,10,4851,206.14306328592,14,4514,310.146211785556
24908,76,76111,81,"Tasa de exámenes médico legales por presunto delito sexual contra niños, niñas y adolescentes",2017,4,38,9634,394.436371185385,0,5053,0,38,4581,829.513206723423
24909,76,76111,121,Tasa de exámenes médico legales por presunto delito sexual cuando la víctima está entre 18 y 28 años,2017,5,8,19938,40.1243855953456,2,10485,19.0748688602766,6,9453,63.4719136781974
24910,76,76111,81,"Tasa de exámenes médico legales por presunto delito sexual contra niños, niñas y adolescentes",2017,1,1,1547,64.6412411118293,0,789,0,1,758,131.926121372032
24911,76,76113,81,"Tasa de exámenes médico legales por presunto delito sexual contra niños, niñas y adolescentes",2017,2,1,1573,63.5727908455181,0,813,0,1,760,131.578947368421
24912,76,76113,81,"Tasa de exámenes médico legales por presunto delito sexual contra niños, niñas y adolescentes",2017,3,5,1850,270.27027027027,3,971,308.959835221421,2,879,227.531285551763
24913,76,76113,81,"Tasa de exámenes médico legales por presunto delito sexual contra niños, niñas y adolescentes",2017,4,1,1847,54.1418516513265,0,987,0,1,860,116.279069767442
24914,76,76113,121,Tasa de exámenes médico legales por presunto delito sexual cuando la víctima está entre 18 y 28 años,2017,5,1,3761,26.5886732252061,0,2034,0,1,1727,57.9038795599305
24915,76,76122,81,"Tasa de exámenes médico legales por presunto delito sexual contra niños, niñas y adolescentes",2017,2,3,2311,129.813933362181,1,1188,84.1750841750842,2,1123,178.094390026714
24916,76,76122,81,"Tasa de exámenes médico legales por presunto delito sexual contra niños, niñas y adolescentes",2017,3,8,2629,304.298212248003,1,1359,73.5835172921266,7,1270,551.181102362205
24917,76,76122,81,"Tasa de exámenes médico legales por presunto delito sexual contra niños, niñas y adolescentes",2017,4,8,2644,302.571860816944,1,1366,73.2064421669107,7,1278,547.73082942097
24918,76,76126,81,"Tasa de exámenes médico legales por presunto delito sexual contra niños, niñas y adolescentes",2017,2,1,1209,82.7129859387924,1,618,161.812297734628,0,591,0
24919,76,76126,81,"Tasa de exámenes médico legales por presunto delito sexual contra niños, niñas y adolescentes",2017,3,5,1370,364.963503649635,0,699,0,5,671,745.156482861401
24920,76,76126,81,"Tasa de exámenes médico legales por presunto delito sexual contra niños, niñas y adolescentes",2017,4,3,1307,229.533282325937,0,664,0,3,643,466.56298600311
24921,76,76130,81,"Tasa de exámenes médico legales por presunto delito sexual contra niños, niñas y adolescentes",2017,2,4,6142,65.1253663301856,1,3155,31.6957210776545,3,2987,100.435219283562
24922,76,76130,81,"Tasa de exámenes médico legales por presunto delito sexual contra niños, niñas y adolescentes",2017,3,11,6929,158.753066820609,0,3587,0,11,3342,329.144225014961
24923,76,76130,81,"Tasa de exámenes médico legales por presunto delito sexual contra niños, niñas y adolescentes",2017,4,15,7082,211.80457497882,1,3691,27.0929287455974,14,3391,412.857564140372
24924,76,76130,121,Tasa de exámenes médico legales por presunto delito sexual cuando la víctima está entre 18 y 28 años,2017,5,4,15348,26.0620276257493,0,7688,0,4,7660,52.2193211488251
24925,76,76147,81,"Tasa de exámenes médico legales por presunto delito sexual contra niños, niñas y adolescentes",2017,2,10,9903,100.979501161264,2,5069,39.4555139080687,8,4834,165.494414563508
24926,76,76147,81,"Tasa de exámenes médico legales por presunto delito sexual contra niños, niñas y adolescentes",2017,3,15,11954,125.481010540405,2,6033,33.1510028178352,13,5921,219.557507177842
24927,76,76147,81,"Tasa de exámenes médico legales por presunto delito sexual contra niños, niñas y adolescentes",2017,4,17,11873,143.182009601617,0,6002,0,17,5871,289.558848577755
24928,76,76147,121,Tasa de exámenes médico legales por presunto delito sexual cuando la víctima está entre 18 y 28 años,2017,5,10,23018,43.4442610131202,1,11747,8.51281178173151,9,11271,79.850944902848
24929,76,76233,81,"Tasa de exámenes médico legales por presunto delito sexual contra niños, niñas y adolescentes",2017,2,2,2949,67.8195998643608,0,1512,0,2,1437,139.178844815588
24930,76,76233,81,"Tasa de exámenes médico legales por presunto delito sexual contra niños, niñas y adolescentes",2017,3,5,3242,154.225786551511,0,1660,0,5,1582,316.055625790139
24931,76,76233,81,"Tasa de exámenes médico legales por presunto delito sexual contra niños, niñas y adolescentes",2017,4,6,3078,194.931773879142,1,1575,63.4920634920635,5,1503,332.667997338656
24932,76,76243,81,"Tasa de exámenes médico legales por presunto delito sexual contra niños, niñas y adolescentes",2017,3,1,1098,91.0746812386157,1,568,176.056338028169,0,530,0
24933,76,76243,81,"Tasa de exámenes médico legales por presunto delito sexual contra niños, niñas y adolescentes",2017,4,1,1063,94.0733772342427,0,551,0,1,512,195.3125
24934,76,76248,81,"Tasa de exámenes médico legales por presunto delito sexual contra niños, niñas y adolescentes",2017,2,6,4305,139.372822299652,2,2203,90.7852927825692,4,2102,190.294957183635
24935,76,76248,81,"Tasa de exámenes médico legales por presunto delito sexual contra niños, niñas y adolescentes",2017,3,3,5044,59.4766058683584,0,2580,0,3,2464,121.753246753247
24936,76,76248,81,"Tasa de exámenes médico legales por presunto delito sexual contra niños, niñas y adolescentes",2017,4,6,5028,119.331742243437,0,2538,0,6,2490,240.963855421687
24937,76,76248,121,Tasa de exámenes médico legales por presunto delito sexual cuando la víctima está entre 18 y 28 años,2017,5,1,10258,9.74848898420745,0,5071,0,1,5187,19.2789666473877
24938,76,76250,81,"Tasa de exámenes médico legales por presunto delito sexual contra niños, niñas y adolescentes",2017,4,2,818,244.498777506112,0,414,0,2,404,495.049504950495
24939,76,76275,81,"Tasa de exámenes médico legales por presunto delito sexual contra niños, niñas y adolescentes",2017,2,2,5087,39.3159032828779,0,2610,0,2,2477,80.742834073476
24940,76,76275,81,"Tasa de exámenes médico legales por presunto delito sexual contra niños, niñas y adolescentes",2017,3,2,5831,34.299434059338,0,2990,0,2,2841,70.3977472720873
24941,76,76275,81,"Tasa de exámenes médico legales por presunto delito sexual contra niños, niñas y adolescentes",2017,4,6,5719,104.913446406714,0,2929,0,6,2790,215.05376344086
24942,76,76275,121,Tasa de exámenes médico legales por presunto delito sexual cuando la víctima está entre 18 y 28 años,2017,5,3,11002,27.2677694964552,0,5520,0,3,5482,54.7245530828165
24943,76,76306,81,"Tasa de exámenes médico legales por presunto delito sexual contra niños, niñas y adolescentes",2017,3,5,1730,289.017341040462,0,873,0,5,857,583.43057176196
24944,76,76306,81,"Tasa de exámenes médico legales por presunto delito sexual contra niños, niñas y adolescentes",2017,4,4,1652,242.130750605327,0,823,0,4,829,482.509047044632
24945,76,76306,121,Tasa de exámenes médico legales por presunto delito sexual cuando la víctima está entre 18 y 28 años,2017,5,2,3682,54.3183052688756,0,1853,0,2,1829,109.349371241115
24946,76,76318,81,"Tasa de exámenes médico legales por presunto delito sexual contra niños, niñas y adolescentes",2017,2,3,2677,112.065745237206,0,1358,0,3,1319,227.445034116755
24947,76,76318,81,"Tasa de exámenes médico legales por presunto delito sexual contra niños, niñas y adolescentes",2017,3,5,3095,161.550888529887,0,1570,0,5,1525,327.868852459016
24948,76,76318,81,"Tasa de exámenes médico legales por presunto delito sexual contra niños, niñas y adolescentes",2017,4,6,3078,194.931773879142,0,1574,0,6,1504,398.936170212766
24949,76,76364,81,"Tasa de exámenes médico legales por presunto delito sexual contra niños, niñas y adolescentes",2017,2,9,10250,87.8048780487805,3,5242,57.2300648607402,6,5008,119.808306709265
24950,76,76364,81,"Tasa de exámenes médico legales por presunto delito sexual contra niños, niñas y adolescentes",2017,3,18,11966,150.426207588166,3,6163,48.6775920817784,15,5803,258.486989488196
24951,76,76364,81,"Tasa de exámenes médico legales por presunto delito sexual contra niños, niñas y adolescentes",2017,4,31,12306,251.909637575167,1,6328,15.802781289507,30,5978,501.840080294413
24952,76,76364,121,Tasa de exámenes médico legales por presunto delito sexual cuando la víctima está entre 18 y 28 años,2017,5,5,23925,20.8986415882968,0,12076,0,5,11849,42.1976538104481
24953,76,76377,81,"Tasa de exámenes médico legales por presunto delito sexual contra niños, niñas y adolescentes",2017,3,1,1017,98.3284169124877,0,535,0,1,482,207.46887966805
24954,76,76377,81,"Tasa de exámenes médico legales por presunto delito sexual contra niños, niñas y adolescentes",2017,4,2,973,205.549845837616,1,512,195.3125,1,461,216.919739696312
24955,76,76377,121,Tasa de exámenes médico legales por presunto delito sexual cuando la víctima está entre 18 y 28 años,2017,5,1,2000,50,0,1065,0,1,935,106.951871657754
24956,76,76400,81,"Tasa de exámenes médico legales por presunto delito sexual contra niños, niñas y adolescentes",2017,2,5,3111,160.720025715204,3,1580,189.873417721519,2,1531,130.633572828217
24957,76,76400,81,"Tasa de exámenes médico legales por presunto delito sexual contra niños, niñas y adolescentes",2017,3,7,3629,192.890603472031,3,1877,159.829515183804,4,1752,228.310502283105
24958,76,76400,81,"Tasa de exámenes médico legales por presunto delito sexual contra niños, niñas y adolescentes",2017,4,7,3539,197.795987567109,1,1825,54.7945205479452,6,1714,350.058343057176
24959,76,76400,121,Tasa de exámenes médico legales por presunto delito sexual cuando la víctima está entre 18 y 28 años,2017,5,3,7095,42.2832980972516,0,3602,0,3,3493,85.8860578299456
24960,76,76403,81,"Tasa de exámenes médico legales por presunto delito sexual contra niños, niñas y adolescentes",2017,2,2,925,216.216216216216,1,480,208.333333333333,1,445,224.719101123596
24961,76,76403,81,"Tasa de exámenes médico legales por presunto delito sexual contra niños, niñas y adolescentes",2017,3,3,1119,268.096514745308,1,597,167.50418760469,2,522,383.141762452107
24962,76,76403,81,"Tasa de exámenes médico legales por presunto delito sexual contra niños, niñas y adolescentes",2017,4,5,1099,454.959053685168,2,591,338.409475465313,3,508,590.551181102362
24963,76,76497,81,"Tasa de exámenes médico legales por presunto delito sexual contra niños, niñas y adolescentes",2017,2,1,1452,68.870523415978,1,747,133.868808567604,0,705,0
24964,76,76497,81,"Tasa de exámenes médico legales por presunto delito sexual contra niños, niñas y adolescentes",2017,3,1,1606,62.266500622665,0,832,0,1,774,129.198966408269
24965,76,76497,81,"Tasa de exámenes médico legales por presunto delito sexual contra niños, niñas y adolescentes",2017,4,1,1532,65.2741514360313,0,790,0,1,742,134.770889487871
24966,76,76520,81,"Tasa de exámenes médico legales por presunto delito sexual contra niños, niñas y adolescentes",2017,2,20,20971,95.3697963854847,2,10694,18.7020759304283,18,10277,175.148389607862
24967,76,76520,81,"Tasa de exámenes médico legales por presunto delito sexual contra niños, niñas y adolescentes",2017,3,48,25362,189.259522119707,6,12973,46.2499036460341,42,12389,339.010412462669
24968,76,76520,81,"Tasa de exámenes médico legales por presunto delito sexual contra niños, niñas y adolescentes",2017,4,61,26647,228.918827635381,13,13723,94.7314727100488,48,12924,371.402042711235
24969,76,76520,121,Tasa de exámenes médico legales por presunto delito sexual cuando la víctima está entre 18 y 28 años,2017,5,11,56051,19.624984389217,3,28623,10.481081647626,8,27428,29.167274318215
24970,76,76563,81,"Tasa de exámenes médico legales por presunto delito sexual contra niños, niñas y adolescentes",2017,2,2,5384,37.147102526003,1,2760,36.231884057971,1,2624,38.109756097561
24971,76,76563,81,"Tasa de exámenes médico legales por presunto delito sexual contra niños, niñas y adolescentes",2017,3,5,6084,82.1827744904668,2,3127,63.9590661976335,3,2957,101.454176530267
24972,76,76563,81,"Tasa de exámenes médico legales por presunto delito sexual contra niños, niñas y adolescentes",2017,4,3,5870,51.1073253833049,1,3006,33.2667997338656,2,2864,69.8324022346369
24973,76,76563,121,Tasa de exámenes médico legales por presunto delito sexual cuando la víctima está entre 18 y 28 años,2017,5,1,10619,9.4170825878143,0,5309,0,1,5310,18.8323917137476
24974,76,76606,81,"Tasa de exámenes médico legales por presunto delito sexual contra niños, niñas y adolescentes",2017,2,1,1372,72.8862973760933,0,704,0,1,668,149.700598802395
24975,76,76606,81,"Tasa de exámenes médico legales por presunto delito sexual contra niños, niñas y adolescentes",2017,4,3,1524,196.850393700787,0,797,0,3,727,412.654745529574
24976,76,76616,81,"Tasa de exámenes médico legales por presunto delito sexual contra niños, niñas y adolescentes",2017,2,1,1163,85.9845227858985,0,603,0,1,560,178.571428571429
24977,76,76616,81,"Tasa de exámenes médico legales por presunto delito sexual contra niños, niñas y adolescentes",2017,3,1,1334,74.9625187406297,0,705,0,1,629,158.982511923688
24978,76,76616,81,"Tasa de exámenes médico legales por presunto delito sexual contra niños, niñas y adolescentes",2017,4,2,1209,165.425971877585,0,641,0,2,568,352.112676056338
24979,76,76622,81,"Tasa de exámenes médico legales por presunto delito sexual contra niños, niñas y adolescentes",2017,2,1,2548,39.2464678178964,0,1304,0,1,1244,80.3858520900322
24980,76,76622,81,"Tasa de exámenes médico legales por presunto delito sexual contra niños, niñas y adolescentes",2017,3,4,2910,137.45704467354,1,1497,66.8002672010688,3,1413,212.314225053079
24981,76,76622,81,"Tasa de exámenes médico legales por presunto delito sexual contra niños, niñas y adolescentes",2017,4,5,2875,173.913043478261,0,1489,0,5,1386,360.750360750361
24982,76,76622,121,Tasa de exámenes médico legales por presunto delito sexual cuando la víctima está entre 18 y 28 años,2017,5,1,5683,17.5963399612881,0,2852,0,1,2831,35.3232073472271
24983,76,76622,81,"Tasa de exámenes médico legales por presunto delito sexual contra niños, niñas y adolescentes",2017,1,1,518,193.050193050193,0,265,0,1,253,395.256916996047
24984,76,76670,81,"Tasa de exámenes médico legales por presunto delito sexual contra niños, niñas y adolescentes",2017,2,2,1390,143.884892086331,0,724,0,2,666,300.3003003003
24985,76,76670,81,"Tasa de exámenes médico legales por presunto delito sexual contra niños, niñas y adolescentes",2017,3,2,1593,125.549278091651,1,850,117.647058823529,1,743,134.589502018843
24986,76,76670,81,"Tasa de exámenes médico legales por presunto delito sexual contra niños, niñas y adolescentes",2017,4,2,1688,118.483412322275,0,918,0,2,770,259.74025974026
24987,76,76736,81,"Tasa de exámenes médico legales por presunto delito sexual contra niños, niñas y adolescentes",2017,2,3,3554,84.411930219471,0,1829,0,3,1725,173.913043478261
24988,76,76736,81,"Tasa de exámenes médico legales por presunto delito sexual contra niños, niñas y adolescentes",2017,3,15,4263,351.864883884588,3,2287,131.176213379974,12,1976,607.287449392713
24989,76,76736,81,"Tasa de exámenes médico legales por presunto delito sexual contra niños, niñas y adolescentes",2017,4,11,4173,263.59932901989,3,2290,131.004366812227,8,1883,424.853956452469
24990,76,76736,121,Tasa de exámenes médico legales por presunto delito sexual cuando la víctima está entre 18 y 28 años,2017,5,2,7905,25.3004427577483,0,4157,0,2,3748,53.3617929562433
24991,76,76823,81,"Tasa de exámenes médico legales por presunto delito sexual contra niños, niñas y adolescentes",2017,2,1,1487,67.2494956287828,0,765,0,1,722,138.504155124654
24992,76,76823,81,"Tasa de exámenes médico legales por presunto delito sexual contra niños, niñas y adolescentes",2017,3,3,1739,172.512938470385,1,902,110.864745011086,2,837,238.9486260454
24993,76,76823,81,"Tasa de exámenes médico legales por presunto delito sexual contra niños, niñas y adolescentes",2017,4,4,1691,236.546422235364,0,875,0,4,816,490.196078431373
24994,76,76828,81,"Tasa de exámenes médico legales por presunto delito sexual contra niños, niñas y adolescentes",2017,2,3,1615,185.758513931889,0,834,0,3,781,384.122919334187
24995,76,76828,81,"Tasa de exámenes médico legales por presunto delito sexual contra niños, niñas y adolescentes",2017,3,5,1871,267.236771779797,2,969,206.398348813209,3,902,332.594235033259
24996,76,76828,81,"Tasa de exámenes médico legales por presunto delito sexual contra niños, niñas y adolescentes",2017,4,2,1732,115.473441108545,0,903,0,2,829,241.254523522316
24997,76,76828,121,Tasa de exámenes médico legales por presunto delito sexual cuando la víctima está entre 18 y 28 años,2017,5,2,2932,68.212824010914,0,1530,0,2,1402,142.65335235378
24998,76,76834,81,"Tasa de exámenes médico legales por presunto delito sexual contra niños, niñas y adolescentes",2017,2,9,16282,55.2757646480776,4,8372,47.7783086478739,5,7910,63.2111251580278
24999,76,76834,81,"Tasa de exámenes médico legales por presunto delito sexual contra niños, niñas y adolescentes",2017,3,36,19371,185.844819575654,4,9957,40.1727427940143,32,9414,339.919269173571
25000,76,76834,81,"Tasa de exámenes médico legales por presunto delito sexual contra niños, niñas y adolescentes",2017,4,52,19634,264.846694509524,3,10099,29.7059114763838,49,9535,513.896171997902
25001,76,76834,121,Tasa de exámenes médico legales por presunto delito sexual cuando la víctima está entre 18 y 28 años,2017,5,13,39899,32.5822702323366,4,20264,19.739439399921,9,19635,45.8365164247517
25002,76,76845,81,"Tasa de exámenes médico legales por presunto delito sexual contra niños, niñas y adolescentes",2017,4,1,501,199.600798403194,0,264,0,1,237,421.940928270042
25003,76,76863,81,"Tasa de exámenes médico legales por presunto delito sexual contra niños, niñas y adolescentes",2017,3,7,667,1049.47526236882,0,341,0,7,326,2147.23926380368
25004,76,76869,81,"Tasa de exámenes médico legales por presunto delito sexual contra niños, niñas y adolescentes",2017,2,1,852,117.370892018779,0,430,0,1,422,236.96682464455
25005,76,76869,81,"Tasa de exámenes médico legales por presunto delito sexual contra niños, niñas y adolescentes",2017,3,3,1002,299.40119760479,0,509,0,3,493,608.519269776876
25006,76,76869,81,"Tasa de exámenes médico legales por presunto delito sexual contra niños, niñas y adolescentes",2017,4,3,918,326.797385620915,0,471,0,3,447,671.140939597315
25007,76,76869,121,Tasa de exámenes médico legales por presunto delito sexual cuando la víctima está entre 18 y 28 años,2017,5,1,1844,54.2299349240781,0,964,0,1,880,113.636363636364
25008,76,76890,81,"Tasa de exámenes médico legales por presunto delito sexual contra niños, niñas y adolescentes",2017,2,3,1230,243.90243902439,1,638,156.739811912226,2,592,337.837837837838
25009,76,76890,81,"Tasa de exámenes médico legales por presunto delito sexual contra niños, niñas y adolescentes",2017,3,11,1405,782.918149466192,4,736,543.478260869565,7,669,1046.33781763827
25010,76,76890,81,"Tasa de exámenes médico legales por presunto delito sexual contra niños, niñas y adolescentes",2017,4,7,1444,484.764542936288,0,763,0,7,681,1027.90014684288
25011,76,76890,121,Tasa de exámenes médico legales por presunto delito sexual cuando la víctima está entre 18 y 28 años,2017,5,1,3149,31.7561130517625,0,1651,0,1,1498,66.7556742323097
25012,76,76892,81,"Tasa de exámenes médico legales por presunto delito sexual contra niños, niñas y adolescentes",2017,2,13,9558,136.011717932622,3,4899,61.2369871402327,10,4659,214.638334406525
25013,76,76892,81,"Tasa de exámenes médico legales por presunto delito sexual contra niños, niñas y adolescentes",2017,3,10,11229,89.0551251224508,0,5740,0,10,5489,182.182546912006
25014,76,76892,81,"Tasa de exámenes médico legales por presunto delito sexual contra niños, niñas y adolescentes",2017,4,29,11518,251.779822885918,0,5943,0,29,5575,520.179372197309
25015,76,76892,121,Tasa de exámenes médico legales por presunto delito sexual cuando la víctima está entre 18 y 28 años,2017,5,3,23048,13.0163137799375,0,11991,0,3,11057,27.1321334900968
25016,76,76895,81,"Tasa de exámenes médico legales por presunto delito sexual contra niños, niñas y adolescentes",2017,2,2,3649,54.8095368594135,0,1861,0,2,1788,111.856823266219
25017,76,76895,81,"Tasa de exámenes médico legales por presunto delito sexual contra niños, niñas y adolescentes",2017,3,8,4272,187.265917602996,2,2187,91.4494741655235,6,2085,287.769784172662
25018,76,76895,81,"Tasa de exámenes médico legales por presunto delito sexual contra niños, niñas y adolescentes",2017,4,8,4243,188.5458402074,0,2138,0,8,2105,380.047505938242
25019,76,76895,121,Tasa de exámenes médico legales por presunto delito sexual cuando la víctima está entre 18 y 28 años,2017,5,1,8269,12.093360744951,0,4113,0,1,4156,24.0615976900866
25020,8,8001,81,"Tasa de exámenes médico legales por presunto delito sexual contra niños, niñas y adolescentes",2017,2,109,95480,114.160033514872,25,48813,51.2158646262266,84,46667,179.998714294898
25021,8,8001,81,"Tasa de exámenes médico legales por presunto delito sexual contra niños, niñas y adolescentes",2017,3,186,117657,158.086641678778,37,60083,61.5814789541135,149,57574,258.797373814569
25022,8,8001,81,"Tasa de exámenes médico legales por presunto delito sexual contra niños, niñas y adolescentes",2017,4,291,120916,240.662939561348,27,61606,43.8268999772749,264,59310,445.118866970157
25023,8,8001,121,Tasa de exámenes médico legales por presunto delito sexual cuando la víctima está entre 18 y 28 años,2017,5,62,221678,27.9684948438726,7,113107,6.18883004588575,55,108571,50.6580947030054
25024,8,8078,81,"Tasa de exámenes médico legales por presunto delito sexual contra niños, niñas y adolescentes",2017,2,2,5161,38.7521798101143,0,2633,0,2,2528,79.1139240506329
25025,8,8078,81,"Tasa de exámenes médico legales por presunto delito sexual contra niños, niñas y adolescentes",2017,3,10,6059,165.043736590196,1,3096,32.2997416020672,9,2963,303.74620317246
25026,8,8078,81,"Tasa de exámenes médico legales por presunto delito sexual contra niños, niñas y adolescentes",2017,4,12,5944,201.884253028264,1,3042,32.8731097961867,11,2902,379.048931771192
25027,8,8137,81,"Tasa de exámenes médico legales por presunto delito sexual contra niños, niñas y adolescentes",2017,2,3,1724,174.013921113689,0,884,0,3,840,357.142857142857
25028,8,8137,81,"Tasa de exámenes médico legales por presunto delito sexual contra niños, niñas y adolescentes",2017,3,5,2154,232.126276694522,1,1111,90.00900090009,4,1043,383.509108341323
25029,8,8137,81,"Tasa de exámenes médico legales por presunto delito sexual contra niños, niñas y adolescentes",2017,4,1,2095,47.7326968973747,0,1085,0,1,1010,99.009900990099
25030,8,8137,121,Tasa de exámenes médico legales por presunto delito sexual cuando la víctima está entre 18 y 28 años,2017,5,2,3273,61.1060189428659,0,1685,0,2,1588,125.944584382872
25031,8,8141,81,"Tasa de exámenes médico legales por presunto delito sexual contra niños, niñas y adolescentes",2017,2,2,1293,154.679040989946,1,679,147.275405007364,1,614,162.866449511401
25032,8,8141,81,"Tasa de exámenes médico legales por presunto delito sexual contra niños, niñas y adolescentes",2017,3,1,1541,64.8929266709929,0,825,0,1,716,139.664804469274
25033,8,8141,81,"Tasa de exámenes médico legales por presunto delito sexual contra niños, niñas y adolescentes",2017,4,2,1537,130.123617436565,0,822,0,2,715,279.72027972028
25034,8,8141,121,Tasa de exámenes médico legales por presunto delito sexual cuando la víctima está entre 18 y 28 años,2017,5,1,2496,40.0641025641026,0,1333,0,1,1163,85.9845227858985
25035,8,8296,81,"Tasa de exámenes médico legales por presunto delito sexual contra niños, niñas y adolescentes",2017,2,2,4435,45.0958286358512,2,2277,87.8348704435661,0,2158,0
25036,8,8296,81,"Tasa de exámenes médico legales por presunto delito sexual contra niños, niñas y adolescentes",2017,3,14,5269,265.705067375214,4,2725,146.788990825688,10,2544,393.081761006289
25037,8,8296,81,"Tasa de exámenes médico legales por presunto delito sexual contra niños, niñas y adolescentes",2017,4,10,5222,191.497510532363,2,2715,73.6648250460405,8,2507,319.106501794974
25038,8,8296,121,Tasa de exámenes médico legales por presunto delito sexual cuando la víctima está entre 18 y 28 años,2017,5,4,8733,45.8032749341578,0,4518,0,4,4215,94.8991696322657
25039,8,8372,81,"Tasa de exámenes médico legales por presunto delito sexual contra niños, niñas y adolescentes",2017,2,1,1557,64.2260757867694,1,814,122.850122850123,0,743,0
25040,8,8372,81,"Tasa de exámenes médico legales por presunto delito sexual contra niños, niñas y adolescentes",2017,3,2,1782,112.233445566779,0,955,0,2,827,241.837968561064
25041,8,8372,81,"Tasa de exámenes médico legales por presunto delito sexual contra niños, niñas y adolescentes",2017,4,4,1807,221.361372440509,0,970,0,4,837,477.8972520908
25042,8,8372,121,Tasa de exámenes médico legales por presunto delito sexual cuando la víctima está entre 18 y 28 años,2017,5,1,3278,30.5064063453325,0,1734,0,1,1544,64.7668393782383
25043,8,8421,81,"Tasa de exámenes médico legales por presunto delito sexual contra niños, niñas y adolescentes",2017,3,2,3230,61.9195046439629,1,1659,60.2772754671489,1,1571,63.6537237428389
25044,8,8421,81,"Tasa de exámenes médico legales por presunto delito sexual contra niños, niñas y adolescentes",2017,4,3,2976,100.806451612903,0,1510,0,3,1466,204.638472032742
25045,8,8433,81,"Tasa de exámenes médico legales por presunto delito sexual contra niños, niñas y adolescentes",2017,2,10,11981,83.4654870211168,2,6158,32.478077297824,8,5823,137.38622703074
25046,8,8433,81,"Tasa de exámenes médico legales por presunto delito sexual contra niños, niñas y adolescentes",2017,3,17,13887,122.416648664218,3,7148,41.9697817571349,14,6739,207.745956373349
25047,8,8433,81,"Tasa de exámenes médico legales por presunto delito sexual contra niños, niñas y adolescentes",2017,4,29,13667,212.189946586669,2,6995,28.5918513223731,27,6672,404.676258992806
25048,8,8433,121,Tasa de exámenes médico legales por presunto delito sexual cuando la víctima está entre 18 y 28 años,2017,5,5,24255,20.614306328592,0,12770,0,5,11485,43.535045711798
25049,8,8436,81,"Tasa de exámenes médico legales por presunto delito sexual contra niños, niñas y adolescentes",2017,3,2,1507,132.71400132714,1,789,126.742712294043,1,718,139.275766016713
25050,8,8436,81,"Tasa de exámenes médico legales por presunto delito sexual contra niños, niñas y adolescentes",2017,4,4,1434,278.940027894003,0,757,0,4,677,590.841949778434
25051,8,8520,81,"Tasa de exámenes médico legales por presunto delito sexual contra niños, niñas y adolescentes",2017,2,3,2268,132.275132275132,1,1177,84.9617672047579,2,1091,183.318056828598
25052,8,8520,81,"Tasa de exámenes médico legales por presunto delito sexual contra niños, niñas y adolescentes",2017,3,1,2700,37.037037037037,0,1415,0,1,1285,77.8210116731518
25053,8,8520,81,"Tasa de exámenes médico legales por presunto delito sexual contra niños, niñas y adolescentes",2017,4,7,2771,252.616383976904,0,1447,0,7,1324,528.700906344411
25054,8,8520,121,Tasa de exámenes médico legales por presunto delito sexual cuando la víctima está entre 18 y 28 años,2017,5,1,5069,19.7277569540343,0,2648,0,1,2421,41.3052457662123
25055,8,8558,81,"Tasa de exámenes médico legales por presunto delito sexual contra niños, niñas y adolescentes",2017,3,1,1601,62.4609618988132,0,830,0,1,771,129.70168612192
25056,8,8558,81,"Tasa de exámenes médico legales por presunto delito sexual contra niños, niñas y adolescentes",2017,4,2,1576,126.903553299492,0,817,0,2,759,263.504611330698
25057,8,8558,121,Tasa de exámenes médico legales por presunto delito sexual cuando la víctima está entre 18 y 28 años,2017,5,1,2832,35.3107344632768,0,1460,0,1,1372,72.8862973760933
25058,8,8560,81,"Tasa de exámenes médico legales por presunto delito sexual contra niños, niñas y adolescentes",2017,3,1,2773,36.0620266858998,0,1424,0,1,1349,74.1289844329133
25059,8,8560,81,"Tasa de exámenes médico legales por presunto delito sexual contra niños, niñas y adolescentes",2017,4,2,2595,77.0712909441233,0,1345,0,2,1250,160
25060,8,8560,121,Tasa de exámenes médico legales por presunto delito sexual cuando la víctima está entre 18 y 28 años,2017,5,2,4298,46.5332712889716,0,2264,0,2,2034,98.3284169124877
25061,8,8573,81,"Tasa de exámenes médico legales por presunto delito sexual contra niños, niñas y adolescentes",2017,2,8,2116,378.071833648393,4,1097,364.630811303555,4,1019,392.541707556428
25062,8,8573,81,"Tasa de exámenes médico legales por presunto delito sexual contra niños, niñas y adolescentes",2017,3,3,2519,119.094878920206,2,1327,150.715900527506,1,1192,83.8926174496644
25063,8,8573,81,"Tasa de exámenes médico legales por presunto delito sexual contra niños, niñas y adolescentes",2017,4,6,2628,228.310502283105,4,1411,283.486888731396,2,1217,164.338537387017
25064,8,8573,121,Tasa de exámenes médico legales por presunto delito sexual cuando la víctima está entre 18 y 28 años,2017,5,1,4985,20.0601805416249,0,2656,0,1,2329,42.93688278231
25065,8,8606,81,"Tasa de exámenes médico legales por presunto delito sexual contra niños, niñas y adolescentes",2017,2,1,2952,33.8753387533875,0,1498,0,1,1454,68.7757909215956
25066,8,8606,81,"Tasa de exámenes médico legales por presunto delito sexual contra niños, niñas y adolescentes",2017,3,1,3271,30.571690614491,0,1656,0,1,1615,61.9195046439629
25067,8,8606,81,"Tasa de exámenes médico legales por presunto delito sexual contra niños, niñas y adolescentes",2017,4,2,3050,65.5737704918033,0,1541,0,2,1509,132.538104705103
25068,8,8606,121,Tasa de exámenes médico legales por presunto delito sexual cuando la víctima está entre 18 y 28 años,2017,5,2,5271,37.943464238285,0,2683,0,2,2588,77.2797527047913
25069,8,8634,81,"Tasa de exámenes médico legales por presunto delito sexual contra niños, niñas y adolescentes",2017,3,4,3285,121.765601217656,1,1658,60.313630880579,3,1627,184.388444990781
25070,8,8634,81,"Tasa de exámenes médico legales por presunto delito sexual contra niños, niñas y adolescentes",2017,4,7,3370,207.715133531157,2,1730,115.606936416185,5,1640,304.878048780488
25071,8,8634,121,Tasa de exámenes médico legales por presunto delito sexual cuando la víctima está entre 18 y 28 años,2017,5,1,6382,15.6690692572861,0,3402,0,1,2980,33.5570469798658
25072,8,8638,81,"Tasa de exámenes médico legales por presunto delito sexual contra niños, niñas y adolescentes",2017,2,7,9841,71.1309826237171,2,5063,39.5022713806044,5,4778,104.646295521139
25073,8,8638,81,"Tasa de exámenes médico legales por presunto delito sexual contra niños, niñas y adolescentes",2017,3,16,11659,137.233038854104,3,6045,49.6277915632754,13,5614,231.56394727467
25074,8,8638,81,"Tasa de exámenes médico legales por presunto delito sexual contra niños, niñas y adolescentes",2017,4,23,11146,206.352054548717,6,5780,103.806228373702,17,5366,316.809541557958
25075,8,8675,81,"Tasa de exámenes médico legales por presunto delito sexual contra niños, niñas y adolescentes",2017,2,1,1152,86.8055555555556,1,590,169.491525423729,0,562,0
25076,8,8675,81,"Tasa de exámenes médico legales por presunto delito sexual contra niños, niñas y adolescentes",2017,3,1,1395,71.6845878136201,1,718,139.275766016713,0,677,0
25077,8,8675,81,"Tasa de exámenes médico legales por presunto delito sexual contra niños, niñas y adolescentes",2017,4,1,1422,70.323488045007,0,734,0,1,688,145.348837209302
25078,8,8685,81,"Tasa de exámenes médico legales por presunto delito sexual contra niños, niñas y adolescentes",2017,2,2,2096,95.4198473282443,0,1069,0,2,1027,194.741966893866
25079,8,8685,81,"Tasa de exámenes médico legales por presunto delito sexual contra niños, niñas y adolescentes",2017,4,8,2538,315.208825847124,0,1290,0,8,1248,641.025641025641
25080,8,8685,121,Tasa de exámenes médico legales por presunto delito sexual cuando la víctima está entre 18 y 28 años,2017,5,1,4836,20.6782464846981,0,2459,0,1,2377,42.0698359276399
25081,8,8758,81,"Tasa de exámenes médico legales por presunto delito sexual contra niños, niñas y adolescentes",2017,2,46,58576,78.5304561595193,14,29937,46.7648728997562,32,28639,111.735744963162
25082,8,8758,81,"Tasa de exámenes médico legales por presunto delito sexual contra niños, niñas y adolescentes",2017,3,78,69815,111.723841581322,13,35568,36.5497076023392,65,34247,189.797646509183
25083,8,8758,81,"Tasa de exámenes médico legales por presunto delito sexual contra niños, niñas y adolescentes",2017,4,91,70596,128.902487393053,8,35914,22.2754357632121,83,34682,239.317225073525
25084,8,8758,121,Tasa de exámenes médico legales por presunto delito sexual cuando la víctima está entre 18 y 28 años,2017,5,15,125002,11.9998080030719,1,63751,1.56860284544556,14,61251,22.8567696853929
25085,8,8770,81,"Tasa de exámenes médico legales por presunto delito sexual contra niños, niñas y adolescentes",2017,2,1,735,136.054421768707,0,379,0,1,356,280.898876404494
25086,8,8770,81,"Tasa de exámenes médico legales por presunto delito sexual contra niños, niñas y adolescentes",2017,3,2,858,233.100233100233,1,440,227.272727272727,1,418,239.234449760766
25087,8,8770,81,"Tasa de exámenes médico legales por presunto delito sexual contra niños, niñas y adolescentes",2017,4,3,908,330.396475770925,0,466,0,3,442,678.733031674208
25088,8,8832,81,"Tasa de exámenes médico legales por presunto delito sexual contra niños, niñas y adolescentes",2017,2,1,961,104.058272632674,1,492,203.252032520325,0,469,0
25089,8,8832,81,"Tasa de exámenes médico legales por presunto delito sexual contra niños, niñas y adolescentes",2017,3,3,1088,275.735294117647,0,562,0,3,526,570.342205323194
25090,8,8832,81,"Tasa de exámenes médico legales por presunto delito sexual contra niños, niñas y adolescentes",2017,4,3,1081,277.520814061055,0,565,0,3,516,581.395348837209
25091,8,8849,81,"Tasa de exámenes médico legales por presunto delito sexual contra niños, niñas y adolescentes",2017,3,1,1005,99.502487562189,1,510,196.078431372549,0,495,0
25092,8,8849,81,"Tasa de exámenes médico legales por presunto delito sexual contra niños, niñas y adolescentes",2017,4,2,963,207.684319833853,0,493,0,2,470,425.531914893617
25093,81,81001,81,"Tasa de exámenes médico legales por presunto delito sexual contra niños, niñas y adolescentes",2017,2,16,10934,146.332540698738,6,5526,108.5776330076,10,5408,184.91124260355
25094,81,81001,81,"Tasa de exámenes médico legales por presunto delito sexual contra niños, niñas y adolescentes",2017,3,30,13569,221.092195445501,3,6834,43.8981562774363,27,6735,400.890868596882
25095,81,81001,81,"Tasa de exámenes médico legales por presunto delito sexual contra niños, niñas y adolescentes",2017,4,35,12418,281.84892897407,1,6144,16.2760416666667,34,6274,541.919030921262
25096,81,81001,121,Tasa de exámenes médico legales por presunto delito sexual cuando la víctima está entre 18 y 28 años,2017,5,6,16059,37.3622267887166,0,7532,0,6,8527,70.364723818459
25097,81,81065,81,"Tasa de exámenes médico legales por presunto delito sexual contra niños, niñas y adolescentes",2017,2,5,5205,96.0614793467819,0,2640,0,5,2565,194.931773879142
25098,81,81065,81,"Tasa de exámenes médico legales por presunto delito sexual contra niños, niñas y adolescentes",2017,3,13,5997,216.775054193764,1,3043,32.8623069339468,12,2954,406.2288422478
25099,81,81065,81,"Tasa de exámenes médico legales por presunto delito sexual contra niños, niñas y adolescentes",2017,4,19,5711,332.69129749606,2,2915,68.6106346483705,17,2796,608.011444921316
25100,81,81065,121,Tasa de exámenes médico legales por presunto delito sexual cuando la víctima está entre 18 y 28 años,2017,5,2,7999,25.0031253906738,0,3972,0,2,4027,49.6647628507574
25101,81,81220,81,"Tasa de exámenes médico legales por presunto delito sexual contra niños, niñas y adolescentes",2017,2,1,415,240.963855421687,1,211,473.9336492891,0,204,0
25102,81,81300,81,"Tasa de exámenes médico legales por presunto delito sexual contra niños, niñas y adolescentes",2017,2,3,3297,90.9918107370337,1,1665,60.0600600600601,2,1632,122.549019607843
25103,81,81300,81,"Tasa de exámenes médico legales por presunto delito sexual contra niños, niñas y adolescentes",2017,3,15,3741,400.962309542903,1,1874,53.3617929562433,14,1867,749.866095340118
25104,81,81300,81,"Tasa de exámenes médico legales por presunto delito sexual contra niños, niñas y adolescentes",2017,4,5,3526,141.803743618832,0,1739,0,5,1787,279.798545047566
25105,81,81300,121,Tasa de exámenes médico legales por presunto delito sexual cuando la víctima está entre 18 y 28 años,2017,5,4,4913,81.4166497048646,1,2345,42.6439232409382,3,2568,116.822429906542
25106,81,81591,81,"Tasa de exámenes médico legales por presunto delito sexual contra niños, niñas y adolescentes",2017,2,2,471,424.628450106157,0,239,0,2,232,862.068965517241
25107,81,81591,81,"Tasa de exámenes médico legales por presunto delito sexual contra niños, niñas y adolescentes",2017,3,1,517,193.423597678917,0,260,0,1,257,389.105058365759
25108,81,81591,81,"Tasa de exámenes médico legales por presunto delito sexual contra niños, niñas y adolescentes",2017,4,1,539,185.528756957328,0,288,0,1,251,398.406374501992
25109,81,81736,81,"Tasa de exámenes médico legales por presunto delito sexual contra niños, niñas y adolescentes",2017,2,7,6070,115.321252059308,1,3098,32.2788896061975,6,2972,201.884253028264
25110,81,81736,81,"Tasa de exámenes médico legales por presunto delito sexual contra niños, niñas y adolescentes",2017,3,9,6664,135.054021608643,2,3367,59.4000594000594,7,3297,212.314225053079
25111,81,81736,81,"Tasa de exámenes médico legales por presunto delito sexual contra niños, niñas y adolescentes",2017,4,12,6574,182.537268025555,0,3397,0,12,3177,377.714825306893
25112,81,81736,121,Tasa de exámenes médico legales por presunto delito sexual cuando la víctima está entre 18 y 28 años,2017,5,4,10223,39.1274576934364,0,5435,0,4,4788,83.5421888053467
25113,81,81794,81,"Tasa de exámenes médico legales por presunto delito sexual contra niños, niñas y adolescentes",2017,2,9,6527,137.888769725755,1,3376,29.6208530805687,8,3151,253.88765471279
25114,81,81794,81,"Tasa de exámenes médico legales por presunto delito sexual contra niños, niñas y adolescentes",2017,3,15,7334,204.526861194437,3,3834,78.2472613458529,12,3500,342.857142857143
25115,81,81794,81,"Tasa de exámenes médico legales por presunto delito sexual contra niños, niñas y adolescentes",2017,4,17,6946,244.745177080334,0,3643,0,17,3303,514.683620950651
25116,81,81794,121,Tasa de exámenes médico legales por presunto delito sexual cuando la víctima está entre 18 y 28 años,2017,5,1,10732,9.3179276928811,0,5734,0,1,4998,20.0080032012805
25117,85,85001,81,"Tasa de exámenes médico legales por presunto delito sexual contra niños, niñas y adolescentes",2017,2,21,13355,157.244477723699,3,6820,43.9882697947214,18,6535,275.439938791125
25118,85,85001,81,"Tasa de exámenes médico legales por presunto delito sexual contra niños, niñas y adolescentes",2017,3,60,16806,357.015351660121,9,8635,104.226983207875,51,8171,624.158609717293
25119,85,85001,81,"Tasa de exámenes médico legales por presunto delito sexual contra niños, niñas y adolescentes",2017,4,79,17321,456.093759020842,6,8815,68.0657969370391,73,8506,858.217728662121
25120,85,85001,121,Tasa de exámenes médico legales por presunto delito sexual cuando la víctima está entre 18 y 28 años,2017,5,13,29542,44.0051452169792,3,14654,20.4722260133752,10,14888,67.1681891456206
25121,85,85001,81,"Tasa de exámenes médico legales por presunto delito sexual contra niños, niñas y adolescentes",2017,1,1,2656,37.6506024096386,0,1346,0,1,1310,76.3358778625954
25122,85,85010,81,"Tasa de exámenes médico legales por presunto delito sexual contra niños, niñas y adolescentes",2017,2,8,3996,200.2002002002,1,2039,49.0436488474743,7,1957,357.690342360756
25123,85,85010,81,"Tasa de exámenes médico legales por presunto delito sexual contra niños, niñas y adolescentes",2017,3,23,4774,481.776288227901,6,2433,246.609124537608,17,2341,726.185390858607
25124,85,85010,81,"Tasa de exámenes médico legales por presunto delito sexual contra niños, niñas y adolescentes",2017,4,24,4936,486.223662884927,0,2471,0,24,2465,973.630831643002
25125,85,85010,121,Tasa de exámenes médico legales por presunto delito sexual cuando la víctima está entre 18 y 28 años,2017,5,6,8837,67.8963449134322,0,4308,0,6,4529,132.479576065357
25126,85,85015,81,"Tasa de exámenes médico legales por presunto delito sexual contra niños, niñas y adolescentes",2017,3,1,295,338.983050847458,0,150,0,1,145,689.655172413793
25127,85,85015,81,"Tasa de exámenes médico legales por presunto delito sexual contra niños, niñas y adolescentes",2017,4,1,308,324.675324675325,0,155,0,1,153,653.59477124183
25128,85,85125,81,"Tasa de exámenes médico legales por presunto delito sexual contra niños, niñas y adolescentes",2017,2,2,1518,131.752305665349,1,792,126.262626262626,1,726,137.741046831956
25129,85,85125,81,"Tasa de exámenes médico legales por presunto delito sexual contra niños, niñas y adolescentes",2017,4,2,1646,121.506682867558,0,865,0,2,781,256.081946222791
25130,85,85125,121,Tasa de exámenes médico legales por presunto delito sexual cuando la víctima está entre 18 y 28 años,2017,5,1,2693,37.1333085777943,0,1389,0,1,1304,76.6871165644172
25131,85,85136,81,"Tasa de exámenes médico legales por presunto delito sexual contra niños, niñas y adolescentes",2017,4,2,175,1142.85714285714,0,89,0,2,86,2325.58139534884
25132,85,85139,81,"Tasa de exámenes médico legales por presunto delito sexual contra niños, niñas y adolescentes",2017,2,1,1084,92.2509225092251,0,555,0,1,529,189.035916824197
25133,85,85139,81,"Tasa de exámenes médico legales por presunto delito sexual contra niños, niñas y adolescentes",2017,3,6,1288,465.83850931677,0,670,0,6,618,970.873786407767
25134,85,85139,81,"Tasa de exámenes médico legales por presunto delito sexual contra niños, niñas y adolescentes",2017,4,8,1275,627.450980392157,0,679,0,8,596,1342.28187919463
25135,85,85162,81,"Tasa de exámenes médico legales por presunto delito sexual contra niños, niñas y adolescentes",2017,2,3,1514,198.150594451783,1,767,130.378096479791,2,747,267.737617135207
25136,85,85162,81,"Tasa de exámenes médico legales por presunto delito sexual contra niños, niñas y adolescentes",2017,3,2,1773,112.803158488438,1,885,112.994350282486,1,888,112.612612612613
25137,85,85162,81,"Tasa de exámenes médico legales por presunto delito sexual contra niños, niñas y adolescentes",2017,4,2,1767,113.186191284663,0,869,0,2,898,222.71714922049
25138,85,85225,81,"Tasa de exámenes médico legales por presunto delito sexual contra niños, niñas y adolescentes",2017,3,6,1155,519.480519480519,1,584,171.232876712329,5,571,875.656742556918
25139,85,85225,81,"Tasa de exámenes médico legales por presunto delito sexual contra niños, niñas y adolescentes",2017,4,3,1072,279.850746268657,0,520,0,3,552,543.478260869565
25140,85,85230,81,"Tasa de exámenes médico legales por presunto delito sexual contra niños, niñas y adolescentes",2017,3,1,1179,84.8176420695505,0,607,0,1,572,174.825174825175
25141,85,85230,81,"Tasa de exámenes médico legales por presunto delito sexual contra niños, niñas y adolescentes",2017,4,2,1060,188.679245283019,0,555,0,2,505,396.039603960396
25142,85,85250,81,"Tasa de exámenes médico legales por presunto delito sexual contra niños, niñas y adolescentes",2017,2,4,2859,139.909059111577,0,1455,0,4,1404,284.900284900285
25143,85,85250,81,"Tasa de exámenes médico legales por presunto delito sexual contra niños, niñas y adolescentes",2017,3,21,3442,610.110400929692,4,1783,224.340998317443,17,1659,1024.71368294153
25144,85,85250,81,"Tasa de exámenes médico legales por presunto delito sexual contra niños, niñas y adolescentes",2017,4,28,3258,859.422958870473,2,1678,119.189511323004,26,1580,1645.56962025316
25145,85,85250,121,Tasa de exámenes médico legales por presunto delito sexual cuando la víctima está entre 18 y 28 años,2017,5,4,5191,77.0564438451165,0,2569,0,4,2622,152.55530129672
25146,85,85263,81,"Tasa de exámenes médico legales por presunto delito sexual contra niños, niñas y adolescentes",2017,3,2,955,209.424083769634,1,501,199.600798403194,1,454,220.264317180617
25147,85,85263,81,"Tasa de exámenes médico legales por presunto delito sexual contra niños, niñas y adolescentes",2017,4,4,929,430.570505920344,0,486,0,4,443,902.93453724605
25148,85,85279,81,"Tasa de exámenes médico legales por presunto delito sexual contra niños, niñas y adolescentes",2017,4,2,551,362.976406533575,0,278,0,2,273,732.600732600733
25149,85,85300,81,"Tasa de exámenes médico legales por presunto delito sexual contra niños, niñas y adolescentes",2017,3,1,338,295.85798816568,0,169,0,1,169,591.715976331361
25150,85,85315,121,Tasa de exámenes médico legales por presunto delito sexual cuando la víctima está entre 18 y 28 años,2017,5,1,409,244.498777506112,0,208,0,1,201,497.512437810945
25151,85,85325,81,"Tasa de exámenes médico legales por presunto delito sexual contra niños, niñas y adolescentes",2017,4,1,894,111.856823266219,0,487,0,1,407,245.700245700246
25152,85,85410,81,"Tasa de exámenes médico legales por presunto delito sexual contra niños, niñas y adolescentes",2017,2,3,2287,131.176213379974,1,1155,86.5800865800866,2,1132,176.678445229682
25153,85,85410,81,"Tasa de exámenes médico legales por presunto delito sexual contra niños, niñas y adolescentes",2017,3,8,2736,292.397660818713,1,1369,73.0460189919649,7,1367,512.070226773958
25154,85,85410,81,"Tasa de exámenes médico legales por presunto delito sexual contra niños, niñas y adolescentes",2017,4,15,2573,582.977069568597,1,1402,71.3266761768902,14,1171,1195.55935098207
25155,85,85410,121,Tasa de exámenes médico legales por presunto delito sexual cuando la víctima está entre 18 y 28 años,2017,5,1,5499,18.1851245681033,1,3187,31.3774709758393,0,2312,0
25156,85,85430,81,"Tasa de exámenes médico legales por presunto delito sexual contra niños, niñas y adolescentes",2017,2,1,1787,55.9597090095132,1,898,111.358574610245,0,889,0
25157,85,85430,81,"Tasa de exámenes médico legales por presunto delito sexual contra niños, niñas y adolescentes",2017,4,2,1968,101.626016260163,0,969,0,2,999,200.2002002002
25158,85,85440,81,"Tasa de exámenes médico legales por presunto delito sexual contra niños, niñas y adolescentes",2017,2,1,2433,41.101520756268,1,1246,80.2568218298555,0,1187,0
25159,85,85440,81,"Tasa de exámenes médico legales por presunto delito sexual contra niños, niñas y adolescentes",2017,3,12,2875,417.391304347826,1,1476,67.7506775067751,11,1399,786.275911365261
25160,85,85440,81,"Tasa de exámenes médico legales por presunto delito sexual contra niños, niñas y adolescentes",2017,4,11,2921,376.583361862376,1,1492,67.0241286863271,10,1429,699.790062981106
25161,86,86001,81,"Tasa de exámenes médico legales por presunto delito sexual contra niños, niñas y adolescentes",2017,2,4,4334,92.2934933087217,0,2236,0,4,2098,190.657769304099
25162,86,86001,81,"Tasa de exámenes médico legales por presunto delito sexual contra niños, niñas y adolescentes",2017,3,14,5312,263.55421686747,1,2756,36.2844702467344,13,2556,508.607198748044
25163,86,86001,81,"Tasa de exámenes médico legales por presunto delito sexual contra niños, niñas y adolescentes",2017,4,19,5046,376.535869996036,1,2579,38.7747188832881,18,2467,729.631130928253
25164,86,86001,121,Tasa de exámenes médico legales por presunto delito sexual cuando la víctima está entre 18 y 28 años,2017,5,6,8727,68.7521485046408,0,4290,0,6,4437,135.226504394861
25165,86,86001,81,"Tasa de exámenes médico legales por presunto delito sexual contra niños, niñas y adolescentes",2017,1,1,890,112.359550561798,1,457,218.818380743982,0,433,0
25166,86,86320,81,"Tasa de exámenes médico legales por presunto delito sexual contra niños, niñas y adolescentes",2017,2,2,7050,28.3687943262411,0,3571,0,2,3479,57.4877838459327
25167,86,86320,81,"Tasa de exámenes médico legales por presunto delito sexual contra niños, niñas y adolescentes",2017,3,7,7810,89.628681177977,2,3937,50.8001016002032,5,3873,129.098889749548
25168,86,86320,81,"Tasa de exámenes médico legales por presunto delito sexual contra niños, niñas y adolescentes",2017,4,5,7788,64.2013353877761,0,4004,0,5,3784,132.135306553911
25169,86,86320,121,Tasa de exámenes médico legales por presunto delito sexual cuando la víctima está entre 18 y 28 años,2017,5,3,11693,25.6563756093389,0,6004,0,3,5689,52.7333450518544
25170,86,86568,81,"Tasa de exámenes médico legales por presunto delito sexual contra niños, niñas y adolescentes",2017,2,7,6743,103.811359928815,0,3427,0,7,3316,211.097708082027
25171,86,86568,81,"Tasa de exámenes médico legales por presunto delito sexual contra niños, niñas y adolescentes",2017,3,16,8033,199.178389144778,2,4078,49.0436488474743,14,3955,353.982300884956
25172,86,86568,81,"Tasa de exámenes médico legales por presunto delito sexual contra niños, niñas y adolescentes",2017,4,11,7810,140.845070422535,1,3938,25.3936008125952,10,3872,258.264462809917
25173,86,86568,121,Tasa de exámenes médico legales por presunto delito sexual cuando la víctima está entre 18 y 28 años,2017,5,7,12960,54.0123456790123,1,6473,15.4487872701993,6,6487,92.4926776630183
25174,86,86569,81,"Tasa de exámenes médico legales por presunto delito sexual contra niños, niñas y adolescentes",2017,2,1,1596,62.65664160401,0,810,0,1,786,127.226463104326
25175,86,86569,81,"Tasa de exámenes médico legales por presunto delito sexual contra niños, niñas y adolescentes",2017,4,3,1834,163.576881134133,0,916,0,3,918,326.797385620915
25176,86,86569,121,Tasa de exámenes médico legales por presunto delito sexual cuando la víctima está entre 18 y 28 años,2017,5,1,3242,30.8451573103023,0,1621,0,1,1621,61.6903146206046
25177,86,86571,81,"Tasa de exámenes médico legales por presunto delito sexual contra niños, niñas y adolescentes",2017,3,1,3302,30.2846759539673,0,1718,0,1,1584,63.1313131313131
25178,86,86571,81,"Tasa de exámenes médico legales por presunto delito sexual contra niños, niñas y adolescentes",2017,4,3,3269,91.7711838482716,0,1710,0,3,1559,192.431045542014
25179,86,86573,81,"Tasa de exámenes médico legales por presunto delito sexual contra niños, niñas y adolescentes",2017,3,2,1980,101.010101010101,0,1021,0,2,959,208.550573514077
25180,86,86573,81,"Tasa de exámenes médico legales por presunto delito sexual contra niños, niñas y adolescentes",2017,4,3,1912,156.90376569037701,0,988,0,3,924,324.675324675325
25181,86,86573,121,Tasa de exámenes médico legales por presunto delito sexual cuando la víctima está entre 18 y 28 años,2017,5,1,3219,31.0655483069276,0,1655,0,1,1564,63.9386189258312
25182,86,86757,81,"Tasa de exámenes médico legales por presunto delito sexual contra niños, niñas y adolescentes",2017,2,4,3564,112.233445566779,2,1802,110.987791342952,2,1762,113.507377979569
25183,86,86757,81,"Tasa de exámenes médico legales por presunto delito sexual contra niños, niñas y adolescentes",2017,3,2,3953,50.5944852011131,0,1985,0,2,1968,101.626016260163
25184,86,86757,81,"Tasa de exámenes médico legales por presunto delito sexual contra niños, niñas y adolescentes",2017,4,7,3922,178.480367159612,1,2004,49.9001996007984,6,1918,312.825860271116
25185,86,86865,81,"Tasa de exámenes médico legales por presunto delito sexual contra niños, niñas y adolescentes",2017,2,4,5654,70.7463742483198,0,2884,0,4,2770,144.404332129964
25186,86,86865,81,"Tasa de exámenes médico legales por presunto delito sexual contra niños, niñas y adolescentes",2017,3,14,6567,213.187147860515,0,3357,0,14,3210,436.13707165109
25187,86,86865,81,"Tasa de exámenes médico legales por presunto delito sexual contra niños, niñas y adolescentes",2017,4,12,6877,174.494692453105,0,3478,0,12,3399,353.045013239188
25188,86,86865,121,Tasa de exámenes médico legales por presunto delito sexual cuando la víctima está entre 18 y 28 años,2017,5,4,11096,36.0490266762797,0,5671,0,4,5425,73.7327188940092
25189,86,86885,81,"Tasa de exámenes médico legales por presunto delito sexual contra niños, niñas y adolescentes",2017,2,4,2314,172.86084701815,2,1174,170.357751277683,2,1140,175.438596491228
25190,86,86885,81,"Tasa de exámenes médico legales por presunto delito sexual contra niños, niñas y adolescentes",2017,3,2,2656,75.3012048192771,1,1333,75.0187546886722,1,1323,75.5857898715042
25191,86,86885,81,"Tasa de exámenes médico legales por presunto delito sexual contra niños, niñas y adolescentes",2017,4,11,2660,413.533834586466,2,1328,150.602409638554,9,1332,675.675675675676
25192,88,88001,81,"Tasa de exámenes médico legales por presunto delito sexual contra niños, niñas y adolescentes",2017,2,3,5957,50.3609199261373,0,3048,0,3,2909,103.128222756961
25193,88,88001,81,"Tasa de exámenes médico legales por presunto delito sexual contra niños, niñas y adolescentes",2017,3,4,7031,56.8909116768596,0,3590,0,4,3441,116.2452775356
25194,88,88001,81,"Tasa de exámenes médico legales por presunto delito sexual contra niños, niñas y adolescentes",2017,4,5,7128,70.1459034792368,1,3630,27.5482093663912,4,3498,114.351057747284
25195,88,88001,121,Tasa de exámenes médico legales por presunto delito sexual cuando la víctima está entre 18 y 28 años,2017,5,7,13435,52.1027167845181,0,6869,0,7,6566,106.609808102345
25196,88,88564,121,Tasa de exámenes médico legales por presunto delito sexual cuando la víctima está entre 18 y 28 años,2017,5,1,928,107.758620689655,0,472,0,1,456,219.298245614035
25197,91,91001,81,"Tasa de exámenes médico legales por presunto delito sexual contra niños, niñas y adolescentes",2017,2,17,4851,350.443207586065,4,2493,160.449257922182,13,2358,551.314673452078
25198,91,91001,81,"Tasa de exámenes médico legales por presunto delito sexual contra niños, niñas y adolescentes",2017,3,29,5561,521.488940837979,8,2846,281.09627547435,21,2715,773.480662983425
25199,91,91001,81,"Tasa de exámenes médico legales por presunto delito sexual contra niños, niñas y adolescentes",2017,4,46,5344,860.778443113772,0,2699,0,46,2645,1739.13043478261
25200,91,91001,121,Tasa de exámenes médico legales por presunto delito sexual cuando la víctima está entre 18 y 28 años,2017,5,5,9660,51.75983436853,0,4770,0,5,4890,102.249488752556
25201,91,91405,81,"Tasa de exámenes médico legales por presunto delito sexual contra niños, niñas y adolescentes",2017,3,1,620,161.290322580645,0,312,0,1,308,324.675324675325
25202,91,91405,81,"Tasa de exámenes médico legales por presunto delito sexual contra niños, niñas y adolescentes",2017,4,1,556,179.856115107914,0,284,0,1,272,367.647058823529
25203,91,91536,81,"Tasa de exámenes médico legales por presunto delito sexual contra niños, niñas y adolescentes",2017,4,1,210,476.190476190476,0,102,0,1,108,925.925925925926
25204,91,91540,81,"Tasa de exámenes médico legales por presunto delito sexual contra niños, niñas y adolescentes",2017,3,2,1338,149.476831091181,0,681,0,2,657,304.41400304414
25205,91,91669,81,"Tasa de exámenes médico legales por presunto delito sexual contra niños, niñas y adolescentes",2017,3,1,506,197.628458498024,0,256,0,1,250,400
25206,91,91669,81,"Tasa de exámenes médico legales por presunto delito sexual contra niños, niñas y adolescentes",2017,4,1,412,242.718446601942,0,216,0,1,196,510.204081632653
25207,94,94001,81,"Tasa de exámenes médico legales por presunto delito sexual contra niños, niñas y adolescentes",2017,2,5,2367,211.237853823405,0,1223,0,5,1144,437.062937062937
25208,94,94001,81,"Tasa de exámenes médico legales por presunto delito sexual contra niños, niñas y adolescentes",2017,3,7,2699,259.355316783994,0,1394,0,7,1305,536.39846743295
25209,94,94001,81,"Tasa de exámenes médico legales por presunto delito sexual contra niños, niñas y adolescentes",2017,4,19,2683,708.162504658964,0,1382,0,19,1301,1460.41506533436
25210,94,94001,121,Tasa de exámenes médico legales por presunto delito sexual cuando la víctima está entre 18 y 28 años,2017,5,3,4834,62.0604054613157,0,2466,0,3,2368,126.689189189189
25211,94,94343,81,"Tasa de exámenes médico legales por presunto delito sexual contra niños, niñas y adolescentes",2017,4,1,684,146.198830409357,0,362,0,1,322,310.55900621118
25212,94,94886,121,Tasa de exámenes médico legales por presunto delito sexual cuando la víctima está entre 18 y 28 años,2017,5,1,607,164.744645799012,1,303,330.03300330033,0,304,0
25213,95,95001,81,"Tasa de exámenes médico legales por presunto delito sexual contra niños, niñas y adolescentes",2017,2,10,8835,113.186191284663,2,4529,44.1598586884522,8,4306,185.78727357176
25214,95,95001,81,"Tasa de exámenes médico legales por presunto delito sexual contra niños, niñas y adolescentes",2017,3,15,10019,149.715540473101,6,5081,118.086990749852,9,4938,182.260024301337
25215,95,95001,81,"Tasa de exámenes médico legales por presunto delito sexual contra niños, niñas y adolescentes",2017,4,16,8846,180.872710829754,2,4456,44.8833034111311,14,4390,318.906605922551
25216,95,95001,121,Tasa de exámenes médico legales por presunto delito sexual cuando la víctima está entre 18 y 28 años,2017,5,1,14540,6.87757909215956,0,7218,0,1,7322,13.6574706364381
25217,95,95015,81,"Tasa de exámenes médico legales por presunto delito sexual contra niños, niñas y adolescentes",2017,2,1,1229,81.366965012205,0,638,0,1,591,169.204737732656
25218,95,95015,81,"Tasa de exámenes médico legales por presunto delito sexual contra niños, niñas y adolescentes",2017,3,1,1203,83.1255195344971,0,636,0,1,567,176.36684303351
25219,95,95015,81,"Tasa de exámenes médico legales por presunto delito sexual contra niños, niñas y adolescentes",2017,4,2,1082,184.842883548983,0,586,0,2,496,403.225806451613
25220,95,95200,81,"Tasa de exámenes médico legales por presunto delito sexual contra niños, niñas y adolescentes",2017,2,1,1547,64.6412411118293,0,790,0,1,757,132.100396301189
25221,95,95200,81,"Tasa de exámenes médico legales por presunto delito sexual contra niños, niñas y adolescentes",2017,4,2,1636,122.249388753056,0,842,0,2,794,251.889168765743
25222,97,97001,81,"Tasa de exámenes médico legales por presunto delito sexual contra niños, niñas y adolescentes",2017,2,1,4211,23.7473284255521,0,2154,0,1,2057,48.6144871171609
25223,97,97001,81,"Tasa de exámenes médico legales por presunto delito sexual contra niños, niñas y adolescentes",2017,3,2,4751,42.0964007577352,0,2449,0,2,2302,86.8809730668983
25224,97,97001,81,"Tasa de exámenes médico legales por presunto delito sexual contra niños, niñas y adolescentes",2017,4,3,4359,68.8231245698555,0,2230,0,3,2129,140.911225927666
25225,97,97001,121,Tasa de exámenes médico legales por presunto delito sexual cuando la víctima está entre 18 y 28 años,2017,5,1,6694,14.9387511204063,0,3365,0,1,3329,30.0390507659958
25226,97,97666,81,"Tasa de exámenes médico legales por presunto delito sexual contra niños, niñas y adolescentes",2017,3,1,152,657.894736842105,0,78,0,1,74,1351.35135135135
25227,99,99001,81,"Tasa de exámenes médico legales por presunto delito sexual contra niños, niñas y adolescentes",2017,2,1,2004,49.9001996007984,0,1054,0,1,950,105.263157894737
25228,99,99001,81,"Tasa de exámenes médico legales por presunto delito sexual contra niños, niñas y adolescentes",2017,4,1,2232,44.8028673835125,1,1194,83.7520938023451,0,1038,0
25229,99,99624,81,"Tasa de exámenes médico legales por presunto delito sexual contra niños, niñas y adolescentes",2017,4,1,564,177.304964539007,0,295,0,1,269,371.747211895911
