id,cdep,cmun,cindica,nomind,periodo,edadR,casos,poblacion,tasa,casosh,poblacionh,tasah,casosm,poblacionm,tasam
20641,11,11001,81,"Tasa de exámenes médico legales por presunto delito sexual contra niños, niñas y adolescentes",2016,2,748,604190,123.802115228653,197,310083,63.5313770829101,551,294107,187.346781953507
20642,11,11001,81,"Tasa de exámenes médico legales por presunto delito sexual contra niños, niñas y adolescentes",2016,3,1165,718878,162.058096088627,243,368581,65.9285204609028,922,350297,263.205222996486
20643,11,11001,81,"Tasa de exámenes médico legales por presunto delito sexual contra niños, niñas y adolescentes",2016,4,1661,741167,224.106038180329,162,377800,42.8798305982001,1499,363367,412.530582028638
20644,11,11001,121,Tasa de exámenes médico legales por presunto delito sexual cuando la víctima está entre 18 y 28 años,2016,5,441,1445463,30.5092555119017,40,731674,5.46691559355669,401,713789,56.1790669231384
20645,11,11001,81,"Tasa de exámenes médico legales por presunto delito sexual contra niños, niñas y adolescentes",2016,1,9,121751,7.39213640955721,3,62567,4.79485991017629,6,59184,10.1378751013788
20646,13,13001,81,"Tasa de exámenes médico legales por presunto delito sexual contra niños, niñas y adolescentes",2016,2,67,82504,81.2081838456317,15,42106,35.62437657341,52,40398,128.719243526907
20647,13,13001,81,"Tasa de exámenes médico legales por presunto delito sexual contra niños, niñas y adolescentes",2016,3,129,103989,124.051582378905,32,52704,60.7164541590771,97,51285,189.139124500341
20648,13,13001,81,"Tasa de exámenes médico legales por presunto delito sexual contra niños, niñas y adolescentes",2016,4,247,109814,224.92578359772,22,55031,39.9774672457342,225,54783,410.711352061771
20649,13,13001,121,Tasa de exámenes médico legales por presunto delito sexual cuando la víctima está entre 18 y 28 años,2016,5,63,193804,32.5070689975439,1,97803,1.0224635236138,62,96001,64.5826605972854
20650,13,13001,81,"Tasa de exámenes médico legales por presunto delito sexual contra niños, niñas y adolescentes",2016,1,1,16088,6.21581302834411,1,8196,12.2010736944851,0,7892,0
20651,13,13006,81,"Tasa de exámenes médico legales por presunto delito sexual contra niños, niñas y adolescentes",2016,3,1,2782,35.9453630481668,0,1427,0,1,1355,73.8007380073801
20652,13,13030,81,"Tasa de exámenes médico legales por presunto delito sexual contra niños, niñas y adolescentes",2016,4,1,1566,63.8569604086846,0,822,0,1,744,134.408602150538
20653,13,13042,81,"Tasa de exámenes médico legales por presunto delito sexual contra niños, niñas y adolescentes",2016,3,1,2629,38.0372765310004,0,1363,0,1,1266,78.9889415481833
20654,13,13042,81,"Tasa de exámenes médico legales por presunto delito sexual contra niños, niñas y adolescentes",2016,4,2,2593,77.1307365985345,0,1387,0,2,1206,165.837479270315
20655,13,13042,121,Tasa de exámenes médico legales por presunto delito sexual cuando la víctima está entre 18 y 28 años,2016,5,1,3930,25.4452926208651,0,2090,0,1,1840,54.3478260869565
20656,13,13052,81,"Tasa de exámenes médico legales por presunto delito sexual contra niños, niñas y adolescentes",2016,2,4,7463,53.5977488945464,0,3819,0,4,3644,109.769484083425
20657,13,13052,81,"Tasa de exámenes médico legales por presunto delito sexual contra niños, niñas y adolescentes",2016,3,6,8977,66.8374735435001,1,4563,21.9154065307912,5,4414,113.275940190304
20658,13,13052,81,"Tasa de exámenes médico legales por presunto delito sexual contra niños, niñas y adolescentes",2016,4,14,9021,155.193437534641,0,4597,0,14,4424,316.455696202532
20659,13,13052,121,Tasa de exámenes médico legales por presunto delito sexual cuando la víctima está entre 18 y 28 años,2016,5,3,14599,20.5493526953901,0,7687,0,3,6912,43.4027777777778
20660,13,13074,81,"Tasa de exámenes médico legales por presunto delito sexual contra niños, niñas y adolescentes",2016,3,1,2550,39.2156862745098,0,1288,0,1,1262,79.2393026941363
20661,13,13140,81,"Tasa de exámenes médico legales por presunto delito sexual contra niños, niñas y adolescentes",2016,2,2,2604,76.8049155145929,0,1341,0,2,1263,158.353127474268
20662,13,13140,81,"Tasa de exámenes médico legales por presunto delito sexual contra niños, niñas y adolescentes",2016,4,2,2962,67.5219446320054,0,1578,0,2,1384,144.508670520231
20663,13,13160,81,"Tasa de exámenes médico legales por presunto delito sexual contra niños, niñas y adolescentes",2016,2,1,955,104.712041884817,1,490,204.081632653061,0,465,0
20664,13,13160,81,"Tasa de exámenes médico legales por presunto delito sexual contra niños, niñas y adolescentes",2016,3,3,1101,272.479564032698,1,566,176.678445229682,2,535,373.831775700935
20665,13,13160,81,"Tasa de exámenes médico legales por presunto delito sexual contra niños, niñas y adolescentes",2016,4,2,1111,180.01800180018,0,569,0,2,542,369.0036900369
20666,13,13188,81,"Tasa de exámenes médico legales por presunto delito sexual contra niños, niñas y adolescentes",2016,3,5,1354,369.276218611521,4,696,574.712643678161,1,658,151.975683890578
20667,13,13188,81,"Tasa de exámenes médico legales por presunto delito sexual contra niños, niñas y adolescentes",2016,4,3,1327,226.073850791258,1,681,146.842878120411,2,646,309.597523219814
20668,13,13212,81,"Tasa de exámenes médico legales por presunto delito sexual contra niños, niñas y adolescentes",2016,2,1,1529,65.402223675605,0,787,0,1,742,134.770889487871
20669,13,13212,81,"Tasa de exámenes médico legales por presunto delito sexual contra niños, niñas y adolescentes",2016,3,3,1630,184.049079754601,0,847,0,3,783,383.141762452107
20670,13,13212,81,"Tasa de exámenes médico legales por presunto delito sexual contra niños, niñas y adolescentes",2016,4,1,1559,64.143681847338,0,811,0,1,748,133.689839572193
20671,13,13212,121,Tasa de exámenes médico legales por presunto delito sexual cuando la víctima está entre 18 y 28 años,2016,5,1,2606,38.3729854182655,0,1329,0,1,1277,78.3085356303837
20672,13,13222,81,"Tasa de exámenes médico legales por presunto delito sexual contra niños, niñas y adolescentes",2016,2,1,1476,67.7506775067751,0,765,0,1,711,140.646976090014
20673,13,13222,81,"Tasa de exámenes médico legales por presunto delito sexual contra niños, niñas y adolescentes",2016,4,6,1652,363.19612590799,2,884,226.244343891403,4,768,520.833333333333
20674,13,13244,81,"Tasa de exámenes médico legales por presunto delito sexual contra niños, niñas y adolescentes",2016,2,3,9203,32.598065848093,1,4697,21.2901852246115,2,4506,44.3852640923214
20675,13,13244,81,"Tasa de exámenes médico legales por presunto delito sexual contra niños, niñas y adolescentes",2016,3,12,10070,119.165839126117,2,5236,38.1970970206264,10,4834,206.868018204386
20676,13,13244,81,"Tasa de exámenes médico legales por presunto delito sexual contra niños, niñas y adolescentes",2016,4,21,9430,222.693531283139,2,4907,40.7581006725087,19,4523,420.075171346452
20677,13,13244,121,Tasa de exámenes médico legales por presunto delito sexual cuando la víctima está entre 18 y 28 años,2016,5,3,15301,19.6065616626364,0,8036,0,3,7265,41.2938747419133
20678,13,13248,81,"Tasa de exámenes médico legales por presunto delito sexual contra niños, niñas y adolescentes",2016,4,3,828,362.31884057971,0,434,0,3,394,761.421319796954
20679,13,13268,81,"Tasa de exámenes médico legales por presunto delito sexual contra niños, niñas y adolescentes",2016,2,2,1223,163.532297628782,1,627,159.489633173844,1,596,167.785234899329
20680,13,13268,81,"Tasa de exámenes médico legales por presunto delito sexual contra niños, niñas y adolescentes",2016,3,2,1283,155.884645362432,0,669,0,2,614,325.732899022801
20681,13,13268,81,"Tasa de exámenes médico legales por presunto delito sexual contra niños, niñas y adolescentes",2016,4,2,1222,163.66612111293,0,654,0,2,568,352.112676056338
20682,13,13300,81,"Tasa de exámenes médico legales por presunto delito sexual contra niños, niñas y adolescentes",2016,3,2,1701,117.577895355673,1,887,112.739571589628,1,814,122.850122850123
20683,13,13300,81,"Tasa de exámenes médico legales por presunto delito sexual contra niños, niñas y adolescentes",2016,4,3,1552,193.298969072165,1,823,121.506682867558,2,729,274.348422496571
20684,13,13430,81,"Tasa de exámenes médico legales por presunto delito sexual contra niños, niñas y adolescentes",2016,2,11,12739,86.3490069864197,2,6528,30.6372549019608,9,6211,144.904202221864
20685,13,13430,81,"Tasa de exámenes médico legales por presunto delito sexual contra niños, niñas y adolescentes",2016,3,26,14688,177.015250544662,4,7533,53.0996946767556,22,7155,307.477288609364
20686,13,13430,81,"Tasa de exámenes médico legales por presunto delito sexual contra niños, niñas y adolescentes",2016,4,41,14110,290.574060949681,1,7241,13.8102472034249,40,6869,582.326393943805
20687,13,13430,121,Tasa de exámenes médico legales por presunto delito sexual cuando la víctima está entre 18 y 28 años,2016,5,9,24238,37.1317765492202,1,12394,8.06842020332419,8,11844,67.5447483958122
20688,13,13433,81,"Tasa de exámenes médico legales por presunto delito sexual contra niños, niñas y adolescentes",2016,3,2,3004,66.577896138482,1,1541,64.8929266709929,1,1463,68.3526999316473
20689,13,13433,81,"Tasa de exámenes médico legales por presunto delito sexual contra niños, niñas y adolescentes",2016,4,10,2905,344.234079173838,0,1490,0,10,1415,706.713780918728
20690,13,13440,81,"Tasa de exámenes médico legales por presunto delito sexual contra niños, niñas y adolescentes",2016,2,2,1122,178.25311942959,0,572,0,2,550,363.636363636364
20691,13,13440,81,"Tasa de exámenes médico legales por presunto delito sexual contra niños, niñas y adolescentes",2016,4,1,1217,82.1692686935086,0,616,0,1,601,166.389351081531
20692,13,13442,81,"Tasa de exámenes médico legales por presunto delito sexual contra niños, niñas y adolescentes",2016,2,4,5776,69.2520775623269,0,2969,0,4,2807,142.500890630566
20693,13,13442,81,"Tasa de exámenes médico legales por presunto delito sexual contra niños, niñas y adolescentes",2016,3,5,6281,79.6051584142653,1,3269,30.5903946160906,4,3012,132.802124833997
20694,13,13442,81,"Tasa de exámenes médico legales por presunto delito sexual contra niños, niñas y adolescentes",2016,4,17,5955,285.474391267842,0,3118,0,17,2837,599.224532957349
20695,13,13442,121,Tasa de exámenes médico legales por presunto delito sexual cuando la víctima está entre 18 y 28 años,2016,5,4,9812,40.766408479413,0,5124,0,4,4688,85.3242320819113
20696,13,13458,81,"Tasa de exámenes médico legales por presunto delito sexual contra niños, niñas y adolescentes",2016,4,1,2644,37.821482602118,0,1373,0,1,1271,78.6782061369001
20697,13,13468,81,"Tasa de exámenes médico legales por presunto delito sexual contra niños, niñas y adolescentes",2016,2,4,5036,79.428117553614,1,2572,38.8802488335925,3,2464,121.753246753247
20698,13,13468,81,"Tasa de exámenes médico legales por presunto delito sexual contra niños, niñas y adolescentes",2016,3,5,5604,89.2219842969308,2,2859,69.9545295557887,3,2745,109.289617486339
20699,13,13468,81,"Tasa de exámenes médico legales por presunto delito sexual contra niños, niñas y adolescentes",2016,4,12,5411,221.770467566069,1,2725,36.697247706422,11,2686,409.530900967982
20700,13,13468,121,Tasa de exámenes médico legales por presunto delito sexual cuando la víctima está entre 18 y 28 años,2016,5,1,9455,10.5764145954521,0,4837,0,1,4618,21.654395842356
20701,13,13473,81,"Tasa de exámenes médico legales por presunto delito sexual contra niños, niñas y adolescentes",2016,3,2,2776,72.0461095100865,1,1427,70.0770847932726,1,1349,74.1289844329133
20702,13,13549,81,"Tasa de exámenes médico legales por presunto delito sexual contra niños, niñas y adolescentes",2016,3,1,3565,28.0504908835905,0,1849,0,1,1716,58.2750582750583
20703,13,13549,81,"Tasa de exámenes médico legales por presunto delito sexual contra niños, niñas y adolescentes",2016,4,2,3192,62.65664160401,0,1683,0,2,1509,132.538104705103
20704,13,13600,81,"Tasa de exámenes médico legales por presunto delito sexual contra niños, niñas y adolescentes",2016,4,1,2329,42.93688278231,0,1185,0,1,1144,87.4125874125874
20705,13,13620,81,"Tasa de exámenes médico legales por presunto delito sexual contra niños, niñas y adolescentes",2016,2,1,603,165.837479270315,1,305,327.868852459016,0,298,0
20706,13,13647,81,"Tasa de exámenes médico legales por presunto delito sexual contra niños, niñas y adolescentes",2016,4,2,1914,104.493207941484,0,991,0,2,923,216.684723726977
20707,13,13650,81,"Tasa de exámenes médico legales por presunto delito sexual contra niños, niñas y adolescentes",2016,3,1,1769,56.5291124929339,0,927,0,1,842,118.764845605701
20708,13,13650,81,"Tasa de exámenes médico legales por presunto delito sexual contra niños, niñas y adolescentes",2016,4,3,1654,181.378476420798,0,866,0,3,788,380.710659898477
20709,13,13654,81,"Tasa de exámenes médico legales por presunto delito sexual contra niños, niñas y adolescentes",2016,2,2,2094,95.5109837631328,0,1074,0,2,1020,196.078431372549
20710,13,13654,81,"Tasa de exámenes médico legales por presunto delito sexual contra niños, niñas y adolescentes",2016,3,4,2299,173.988690735102,0,1191,0,4,1108,361.01083032491
20711,13,13654,81,"Tasa de exámenes médico legales por presunto delito sexual contra niños, niñas y adolescentes",2016,4,1,2369,42.2119037568594,0,1228,0,1,1141,87.6424189307625
20712,13,13657,81,"Tasa de exámenes médico legales por presunto delito sexual contra niños, niñas y adolescentes",2016,2,2,3230,61.9195046439629,2,1646,121.506682867558,0,1584,0
20713,13,13657,81,"Tasa de exámenes médico legales por presunto delito sexual contra niños, niñas y adolescentes",2016,3,2,3709,53.9228902669183,0,1921,0,2,1788,111.856823266219
20714,13,13657,81,"Tasa de exámenes médico legales por presunto delito sexual contra niños, niñas y adolescentes",2016,4,3,3679,81.5438977983148,1,1879,53.2197977647685,2,1800,111.111111111111
20715,13,13657,121,Tasa de exámenes médico legales por presunto delito sexual cuando la víctima está entre 18 y 28 años,2016,5,2,6652,30.0661455201443,1,3449,28.9939112786315,1,3203,31.2207305650952
20716,13,13667,81,"Tasa de exámenes médico legales por presunto delito sexual contra niños, niñas y adolescentes",2016,3,1,2396,41.7362270450751,0,1219,0,1,1177,84.9617672047579
20717,13,13667,81,"Tasa de exámenes médico legales por presunto delito sexual contra niños, niñas y adolescentes",2016,4,2,2202,90.8265213442325,0,1110,0,2,1092,183.150183150183
20718,13,13667,121,Tasa de exámenes médico legales por presunto delito sexual cuando la víctima está entre 18 y 28 años,2016,5,1,3715,26.9179004037685,0,1897,0,1,1818,55.005500550055
20719,13,13670,81,"Tasa de exámenes médico legales por presunto delito sexual contra niños, niñas y adolescentes",2016,2,1,3723,26.86005909213,0,1878,0,1,1845,54.2005420054201
20720,13,13670,81,"Tasa de exámenes médico legales por presunto delito sexual contra niños, niñas y adolescentes",2016,3,1,4230,23.6406619385343,0,2053,0,1,2177,45.9347726228755
20721,13,13673,81,"Tasa de exámenes médico legales por presunto delito sexual contra niños, niñas y adolescentes",2016,2,2,1531,130.633572828217,1,776,128.865979381443,1,755,132.450331125828
20722,13,13673,81,"Tasa de exámenes médico legales por presunto delito sexual contra niños, niñas y adolescentes",2016,4,3,1566,191.570881226054,0,799,0,3,767,391.134289439374
20723,13,13683,81,"Tasa de exámenes médico legales por presunto delito sexual contra niños, niñas y adolescentes",2016,2,2,2550,78.4313725490196,0,1306,0,2,1244,160.771704180064
20724,13,13683,81,"Tasa de exámenes médico legales por presunto delito sexual contra niños, niñas y adolescentes",2016,3,2,2975,67.2268907563025,0,1528,0,2,1447,138.217000691085
20725,13,13683,81,"Tasa de exámenes médico legales por presunto delito sexual contra niños, niñas y adolescentes",2016,4,9,2895,310.880829015544,3,1491,201.207243460765,6,1404,427.350427350427
20726,13,13683,121,Tasa de exámenes médico legales por presunto delito sexual cuando la víctima está entre 18 y 28 años,2016,5,1,4498,22.2321031569586,0,2376,0,1,2122,47.1253534401508
20727,13,13744,81,"Tasa de exámenes médico legales por presunto delito sexual contra niños, niñas y adolescentes",2016,2,1,2598,38.4911470361817,0,1322,0,1,1276,78.3699059561129
20728,13,13744,81,"Tasa de exámenes médico legales por presunto delito sexual contra niños, niñas y adolescentes",2016,4,2,2762,72.4112961622013,0,1405,0,2,1357,147.383935151069
20729,13,13760,81,"Tasa de exámenes médico legales por presunto delito sexual contra niños, niñas y adolescentes",2016,3,2,873,229.095074455899,0,444,0,2,429,466.200466200466
20730,13,13760,121,Tasa de exámenes médico legales por presunto delito sexual cuando la víctima está entre 18 y 28 años,2016,5,1,1627,61.4628149969269,0,832,0,1,795,125.786163522013
20731,13,13780,81,"Tasa de exámenes médico legales por presunto delito sexual contra niños, niñas y adolescentes",2016,2,1,1330,75.187969924812,0,688,0,1,642,155.763239875389
20732,13,13780,81,"Tasa de exámenes médico legales por presunto delito sexual contra niños, niñas y adolescentes",2016,4,3,1458,205.761316872428,1,775,129.032258064516,2,683,292.825768667643
20733,13,13810,81,"Tasa de exámenes médico legales por presunto delito sexual contra niños, niñas y adolescentes",2016,4,2,3056,65.4450261780105,0,1561,0,2,1495,133.779264214047
20734,13,13836,81,"Tasa de exámenes médico legales por presunto delito sexual contra niños, niñas y adolescentes",2016,2,8,6214,128.741551335694,2,3178,62.9326620516048,6,3036,197.628458498024
20735,13,13836,81,"Tasa de exámenes médico legales por presunto delito sexual contra niños, niñas y adolescentes",2016,3,9,7570,118.89035667107,2,3855,51.8806744487678,7,3715,188.42530282638
20736,13,13836,81,"Tasa de exámenes médico legales por presunto delito sexual contra niños, niñas y adolescentes",2016,4,17,8051,211.15389392622,1,4068,24.5821042281219,16,3983,401.707255837309
20737,13,13836,121,Tasa de exámenes médico legales por presunto delito sexual cuando la víctima está entre 18 y 28 años,2016,5,2,14043,14.2419710887987,0,7202,0,2,6841,29.235491887151
20738,13,13838,81,"Tasa de exámenes médico legales por presunto delito sexual contra niños, niñas y adolescentes",2016,3,1,2037,49.0918016691213,0,1048,0,1,989,101.112234580384
20739,13,13838,81,"Tasa de exámenes médico legales por presunto delito sexual contra niños, niñas y adolescentes",2016,4,2,1931,103.573278094252,0,994,0,2,937,213.447171824973
20740,13,13838,121,Tasa de exámenes médico legales por presunto delito sexual cuando la víctima está entre 18 y 28 años,2016,5,1,2696,37.0919881305638,0,1393,0,1,1303,76.7459708365311
20741,13,13873,81,"Tasa de exámenes médico legales por presunto delito sexual contra niños, niñas y adolescentes",2016,3,1,2388,41.8760469011725,0,1215,0,1,1173,85.2514919011083
20742,13,13873,81,"Tasa de exámenes médico legales por presunto delito sexual contra niños, niñas y adolescentes",2016,4,9,2354,382.32795242141,1,1198,83.4724540901503,8,1156,692.04152249135
20743,13,13873,121,Tasa de exámenes médico legales por presunto delito sexual cuando la víctima está entre 18 y 28 años,2016,5,1,3813,26.2260687123,0,1937,0,1,1876,53.3049040511727
20744,13,13894,81,"Tasa de exámenes médico legales por presunto delito sexual contra niños, niñas y adolescentes",2016,2,2,1351,148.038490007402,0,693,0,2,658,303.951367781155
20745,13,13894,81,"Tasa de exámenes médico legales por presunto delito sexual contra niños, niñas y adolescentes",2016,3,1,1427,70.0770847932726,0,745,0,1,682,146.627565982405
20746,13,13894,81,"Tasa de exámenes médico legales por presunto delito sexual contra niños, niñas y adolescentes",2016,4,2,1364,146.627565982405,0,718,0,2,646,309.597523219814
20747,15,15001,81,"Tasa de exámenes médico legales por presunto delito sexual contra niños, niñas y adolescentes",2016,2,15,14599,102.74676347695,4,7467,53.5690370965582,11,7132,154.234436343242
20748,15,15001,81,"Tasa de exámenes médico legales por presunto delito sexual contra niños, niñas y adolescentes",2016,3,35,19572,178.826895565093,5,9885,50.5816894284269,30,9687,309.693403530505
20749,15,15001,81,"Tasa de exámenes médico legales por presunto delito sexual contra niños, niñas y adolescentes",2016,4,40,21517,185.899521308733,4,10809,37.0061985382552,36,10708,336.197235711617
20750,15,15001,121,Tasa de exámenes médico legales por presunto delito sexual cuando la víctima está entre 18 y 28 años,2016,5,8,34768,23.0096640589047,1,18086,5.52913856021232,7,16682,41.9613955161252
20751,15,15001,81,"Tasa de exámenes médico legales por presunto delito sexual contra niños, niñas y adolescentes",2016,1,1,2776,36.0230547550432,0,1426,0,1,1350,74.0740740740741
20752,15,15022,81,"Tasa de exámenes médico legales por presunto delito sexual contra niños, niñas y adolescentes",2016,2,1,148,675.675675675676,0,75,0,1,73,1369.86301369863
20753,15,15022,81,"Tasa de exámenes médico legales por presunto delito sexual contra niños, niñas y adolescentes",2016,3,1,171,584.795321637427,0,87,0,1,84,1190.47619047619
20754,15,15047,81,"Tasa de exámenes médico legales por presunto delito sexual contra niños, niñas y adolescentes",2016,3,3,1921,156.168662155128,0,986,0,3,935,320.855614973262
20755,15,15051,81,"Tasa de exámenes médico legales por presunto delito sexual contra niños, niñas y adolescentes",2016,3,1,580,172.413793103448,0,306,0,1,274,364.963503649635
20756,15,15051,81,"Tasa de exámenes médico legales por presunto delito sexual contra niños, niñas y adolescentes",2016,4,1,522,191.570881226054,1,279,358.4229390681,0,243,0
20757,15,15087,81,"Tasa de exámenes médico legales por presunto delito sexual contra niños, niñas y adolescentes",2016,3,2,735,272.108843537415,0,379,0,2,356,561.797752808989
20758,15,15090,81,"Tasa de exámenes médico legales por presunto delito sexual contra niños, niñas y adolescentes",2016,4,1,268,373.134328358209,0,142,0,1,126,793.650793650794
20759,15,15092,81,"Tasa de exámenes médico legales por presunto delito sexual contra niños, niñas y adolescentes",2016,2,1,180,555.555555555556,0,92,0,1,88,1136.36363636364
20760,15,15104,81,"Tasa de exámenes médico legales por presunto delito sexual contra niños, niñas y adolescentes",2016,4,2,507,394.477317554241,0,263,0,2,244,819.672131147541
20761,15,15109,81,"Tasa de exámenes médico legales por presunto delito sexual contra niños, niñas y adolescentes",2016,4,3,642,467.289719626168,0,348,0,3,294,1020.40816326531
20762,15,15109,121,Tasa de exámenes médico legales por presunto delito sexual cuando la víctima está entre 18 y 28 años,2016,5,2,948,210.970464135021,0,523,0,2,425,470.588235294118
20763,15,15162,81,"Tasa de exámenes médico legales por presunto delito sexual contra niños, niñas y adolescentes",2016,4,2,361,554.016620498615,1,193,518.134715025907,1,168,595.238095238095
20764,15,15172,81,"Tasa de exámenes médico legales por presunto delito sexual contra niños, niñas y adolescentes",2016,3,2,335,597.014925373134,1,174,574.712643678161,1,161,621.11801242236
20765,15,15172,81,"Tasa de exámenes médico legales por presunto delito sexual contra niños, niñas y adolescentes",2016,4,1,358,279.329608938548,0,188,0,1,170,588.235294117647
20766,15,15176,81,"Tasa de exámenes médico legales por presunto delito sexual contra niños, niñas y adolescentes",2016,2,1,5648,17.7053824362606,0,2889,0,1,2759,36.2450163102573
20767,15,15176,81,"Tasa de exámenes médico legales por presunto delito sexual contra niños, niñas y adolescentes",2016,3,8,7570,105.680317040951,0,3956,0,8,3614,221.361372440509
20768,15,15176,81,"Tasa de exámenes médico legales por presunto delito sexual contra niños, niñas y adolescentes",2016,4,25,8061,310.135218955465,0,4235,0,25,3826,653.423941453215
20769,15,15187,121,Tasa de exámenes médico legales por presunto delito sexual cuando la víctima está entre 18 y 28 años,2016,5,1,1046,95.6022944550669,0,567,0,1,479,208.768267223382
20770,15,15204,81,"Tasa de exámenes médico legales por presunto delito sexual contra niños, niñas y adolescentes",2016,3,2,1109,180.34265103697,1,569,175.746924428823,1,540,185.185185185185
20771,15,15204,81,"Tasa de exámenes médico legales por presunto delito sexual contra niños, niñas y adolescentes",2016,4,2,1189,168.208578637511,0,658,0,2,531,376.647834274953
20772,15,15204,121,Tasa de exámenes médico legales por presunto delito sexual cuando la víctima está entre 18 y 28 años,2016,5,1,2184,45.7875457875458,1,1370,72.992700729927,0,814,0
20773,15,15212,81,"Tasa de exámenes médico legales por presunto delito sexual contra niños, niñas y adolescentes",2016,4,1,385,259.74025974026,0,213,0,1,172,581.395348837209
20774,15,15223,81,"Tasa de exámenes médico legales por presunto delito sexual contra niños, niñas y adolescentes",2016,3,1,899,111.234705228031,0,468,0,1,431,232.018561484919
20775,15,15232,81,"Tasa de exámenes médico legales por presunto delito sexual contra niños, niñas y adolescentes",2016,3,1,634,157.728706624606,0,335,0,1,299,334.448160535117
20776,15,15236,81,"Tasa de exámenes médico legales por presunto delito sexual contra niños, niñas y adolescentes",2016,2,1,176,568.181818181818,0,90,0,1,86,1162.79069767442
20777,15,15236,81,"Tasa de exámenes médico legales por presunto delito sexual contra niños, niñas y adolescentes",2016,3,1,211,473.9336492891,0,114,0,1,97,1030.92783505155
20778,15,15236,81,"Tasa de exámenes médico legales por presunto delito sexual contra niños, niñas y adolescentes",2016,4,2,209,956.937799043062,0,116,0,2,93,2150.5376344086
20779,15,15238,81,"Tasa de exámenes médico legales por presunto delito sexual contra niños, niñas y adolescentes",2016,2,9,8981,100.211557732992,3,4579,65.5164883162262,6,4402,136.301681054066
20780,15,15238,81,"Tasa de exámenes médico legales por presunto delito sexual contra niños, niñas y adolescentes",2016,3,15,11771,127.431823974174,2,5864,34.106412005457,13,5907,220.077873709159
20781,15,15238,81,"Tasa de exámenes médico legales por presunto delito sexual contra niños, niñas y adolescentes",2016,4,36,12680,283.91167192429,2,6162,32.4569944823109,34,6518,521.632402577478
20782,15,15238,121,Tasa de exámenes médico legales por presunto delito sexual cuando la víctima está entre 18 y 28 años,2016,5,6,19235,31.1931375097479,2,9589,20.8572322452811,4,9646,41.4679659962679
20783,15,15272,81,"Tasa de exámenes médico legales por presunto delito sexual contra niños, niñas y adolescentes",2016,2,1,428,233.644859813084,0,220,0,1,208,480.769230769231
20784,15,15276,81,"Tasa de exámenes médico legales por presunto delito sexual contra niños, niñas y adolescentes",2016,4,1,424,235.849056603774,0,221,0,1,203,492.610837438424
20785,15,15293,81,"Tasa de exámenes médico legales por presunto delito sexual contra niños, niñas y adolescentes",2016,3,1,290,344.827586206897,1,153,653.59477124183,0,137,0
20786,15,15293,121,Tasa de exámenes médico legales por presunto delito sexual cuando la víctima está entre 18 y 28 años,2016,5,1,404,247.524752475248,0,215,0,1,189,529.100529100529
20787,15,15296,81,"Tasa de exámenes médico legales por presunto delito sexual contra niños, niñas y adolescentes",2016,4,1,557,179.533213644524,0,303,0,1,254,393.700787401575
20788,15,15299,81,"Tasa de exámenes médico legales por presunto delito sexual contra niños, niñas y adolescentes",2016,2,1,1508,66.3129973474801,1,766,130.548302872063,0,742,0
20789,15,15299,81,"Tasa de exámenes médico legales por presunto delito sexual contra niños, niñas y adolescentes",2016,3,7,1907,367.068694284216,2,959,208.550573514077,5,948,527.426160337553
20790,15,15299,81,"Tasa de exámenes médico legales por presunto delito sexual contra niños, niñas y adolescentes",2016,4,8,1948,410.677618069815,1,971,102.986611740474,7,977,716.479017400205
20791,15,15299,121,Tasa de exámenes médico legales por presunto delito sexual cuando la víctima está entre 18 y 28 años,2016,5,3,2803,107.028184088477,1,1450,68.9655172413793,2,1353,147.819660014782
20792,15,15322,81,"Tasa de exámenes médico legales por presunto delito sexual contra niños, niñas y adolescentes",2016,3,1,901,110.987791342952,0,482,0,1,419,238.663484486874
20793,15,15322,81,"Tasa de exámenes médico legales por presunto delito sexual contra niños, niñas y adolescentes",2016,4,2,931,214.822771213749,1,503,198.807157057654,1,428,233.644859813084
20794,15,15325,81,"Tasa de exámenes médico legales por presunto delito sexual contra niños, niñas y adolescentes",2016,2,1,253,395.256916996047,0,130,0,1,123,813.008130081301
20795,15,15325,81,"Tasa de exámenes médico legales por presunto delito sexual contra niños, niñas y adolescentes",2016,4,1,380,263.157894736842,1,208,480.769230769231,0,172,0
20796,15,15362,81,"Tasa de exámenes médico legales por presunto delito sexual contra niños, niñas y adolescentes",2016,3,1,209,478.468899521531,0,112,0,1,97,1030.92783505155
20797,15,15367,81,"Tasa de exámenes médico legales por presunto delito sexual contra niños, niñas y adolescentes",2016,4,1,804,124.378109452736,0,408,0,1,396,252.525252525253
20798,15,15368,121,Tasa de exámenes médico legales por presunto delito sexual cuando la víctima está entre 18 y 28 años,2016,5,1,687,145.560407569141,0,384,0,1,303,330.03300330033
20799,15,15380,81,"Tasa de exámenes médico legales por presunto delito sexual contra niños, niñas y adolescentes",2016,4,1,231,432.900432900433,0,120,0,1,111,900.900900900901
20800,15,15407,81,"Tasa de exámenes médico legales por presunto delito sexual contra niños, niñas y adolescentes",2016,2,1,1306,76.5696784073507,1,676,147.92899408284,0,630,0
20801,15,15407,81,"Tasa de exámenes médico legales por presunto delito sexual contra niños, niñas y adolescentes",2016,3,3,1677,178.890876565295,0,892,0,3,785,382.165605095541
20802,15,15407,81,"Tasa de exámenes médico legales por presunto delito sexual contra niños, niñas y adolescentes",2016,4,4,1831,218.459858001092,0,995,0,4,836,478.468899521531
20803,15,15425,81,"Tasa de exámenes médico legales por presunto delito sexual contra niños, niñas y adolescentes",2016,4,1,477,209.643605870021,0,241,0,1,236,423.728813559322
20804,15,15442,81,"Tasa de exámenes médico legales por presunto delito sexual contra niños, niñas y adolescentes",2016,3,3,955,314.13612565445,1,498,200.803212851406,2,457,437.636761487965
20805,15,15442,81,"Tasa de exámenes médico legales por presunto delito sexual contra niños, niñas y adolescentes",2016,4,1,890,112.359550561798,0,470,0,1,420,238.095238095238
20806,15,15455,81,"Tasa de exámenes médico legales por presunto delito sexual contra niños, niñas y adolescentes",2016,4,1,975,102.564102564103,0,505,0,1,470,212.765957446809
20807,15,15466,81,"Tasa de exámenes médico legales por presunto delito sexual contra niños, niñas y adolescentes",2016,2,2,450,444.444444444444,2,226,884.955752212389,0,224,0
20808,15,15469,81,"Tasa de exámenes médico legales por presunto delito sexual contra niños, niñas y adolescentes",2016,2,2,1831,109.229929000546,1,943,106.044538706257,1,888,112.612612612613
20809,15,15469,81,"Tasa de exámenes médico legales por presunto delito sexual contra niños, niñas y adolescentes",2016,3,4,2194,182.315405651778,1,1129,88.5739592559788,3,1065,281.69014084507
20810,15,15469,81,"Tasa de exámenes médico legales por presunto delito sexual contra niños, niñas y adolescentes",2016,4,7,2166,323.176361957525,0,1112,0,7,1054,664.136622390892
20811,15,15476,81,"Tasa de exámenes médico legales por presunto delito sexual contra niños, niñas y adolescentes",2016,3,1,917,109.051254089422,0,484,0,1,433,230.94688221709
20812,15,15476,81,"Tasa de exámenes médico legales por presunto delito sexual contra niños, niñas y adolescentes",2016,4,1,819,122.100122100122,0,439,0,1,380,263.157894736842
20813,15,15480,81,"Tasa de exámenes médico legales por presunto delito sexual contra niños, niñas y adolescentes",2016,4,2,1092,183.150183150183,2,582,343.642611683849,0,510,0
20814,15,15491,81,"Tasa de exámenes médico legales por presunto delito sexual contra niños, niñas y adolescentes",2016,3,1,1857,53.850296176629,0,960,0,1,897,111.482720178372
20815,15,15491,81,"Tasa de exámenes médico legales por presunto delito sexual contra niños, niñas y adolescentes",2016,4,1,1914,52.2466039707419,0,980,0,1,934,107.066381156317
20816,15,15494,81,"Tasa de exámenes médico legales por presunto delito sexual contra niños, niñas y adolescentes",2016,3,1,744,134.408602150538,0,371,0,1,373,268.096514745308
20817,15,15500,81,"Tasa de exámenes médico legales por presunto delito sexual contra niños, niñas y adolescentes",2016,4,2,344,581.395348837209,0,181,0,2,163,1226.99386503068
20818,15,15507,81,"Tasa de exámenes médico legales por presunto delito sexual contra niños, niñas y adolescentes",2016,3,1,1408,71.0227272727273,1,727,137.551581843191,0,681,0
20819,15,15507,81,"Tasa de exámenes médico legales por presunto delito sexual contra niños, niñas y adolescentes",2016,4,1,1398,71.5307582260372,0,720,0,1,678,147.492625368732
20820,15,15514,81,"Tasa de exámenes médico legales por presunto delito sexual contra niños, niñas y adolescentes",2016,3,1,352,284.090909090909,0,178,0,1,174,574.712643678161
20821,15,15516,81,"Tasa de exámenes médico legales por presunto delito sexual contra niños, niñas y adolescentes",2016,2,2,2620,76.3358778625954,0,1347,0,2,1273,157.109190887667
20822,15,15516,81,"Tasa de exámenes médico legales por presunto delito sexual contra niños, niñas y adolescentes",2016,3,2,3275,61.0687022900763,0,1674,0,2,1601,124.921923797626
20823,15,15516,81,"Tasa de exámenes médico legales por presunto delito sexual contra niños, niñas y adolescentes",2016,4,4,3420,116.959064327485,0,1764,0,4,1656,241.545893719807
20824,15,15516,121,Tasa de exámenes médico legales por presunto delito sexual cuando la víctima está entre 18 y 28 años,2016,5,1,5078,19.6927924379677,0,2578,0,1,2500,40
20825,15,15542,81,"Tasa de exámenes médico legales por presunto delito sexual contra niños, niñas y adolescentes",2016,4,1,822,121.654501216545,0,437,0,1,385,259.74025974026
20826,15,15542,121,Tasa de exámenes médico legales por presunto delito sexual cuando la víctima está entre 18 y 28 años,2016,5,1,1175,85.1063829787234,0,628,0,1,547,182.815356489945
20827,15,15550,81,"Tasa de exámenes médico legales por presunto delito sexual contra niños, niñas y adolescentes",2016,3,1,140,714.285714285714,0,68,0,1,72,1388.88888888889
20828,15,15550,81,"Tasa de exámenes médico legales por presunto delito sexual contra niños, niñas y adolescentes",2016,4,2,120,1666.66666666667,0,69,0,2,51,3921.56862745098
20829,15,15572,81,"Tasa de exámenes médico legales por presunto delito sexual contra niños, niñas y adolescentes",2016,2,4,4949,80.8244089715094,0,2544,0,4,2405,166.320166320166
20830,15,15572,81,"Tasa de exámenes médico legales por presunto delito sexual contra niños, niñas y adolescentes",2016,3,15,6497,230.875788825612,3,3304,90.7990314769976,12,3193,375.822110867523
20831,15,15572,81,"Tasa de exámenes médico legales por presunto delito sexual contra niños, niñas y adolescentes",2016,4,15,6475,231.660231660232,2,3330,60.0600600600601,13,3145,413.35453100159
20832,15,15572,121,Tasa de exámenes médico legales por presunto delito sexual cuando la víctima está entre 18 y 28 años,2016,5,3,9431,31.8099883363376,0,5059,0,3,4372,68.6184812442818
20833,15,15580,81,"Tasa de exámenes médico legales por presunto delito sexual contra niños, niñas y adolescentes",2016,3,1,789,126.742712294043,0,425,0,1,364,274.725274725275
20834,15,15599,81,"Tasa de exámenes médico legales por presunto delito sexual contra niños, niñas y adolescentes",2016,4,2,1185,168.776371308017,0,621,0,2,564,354.609929078014
20835,15,15599,121,Tasa de exámenes médico legales por presunto delito sexual cuando la víctima está entre 18 y 28 años,2016,5,1,1688,59.2417061611374,1,864,115.740740740741,0,824,0
20836,15,15600,81,"Tasa de exámenes médico legales por presunto delito sexual contra niños, niñas y adolescentes",2016,2,2,1511,132.362673726009,1,792,126.262626262626,1,719,139.082058414465
20837,15,15600,81,"Tasa de exámenes médico legales por presunto delito sexual contra niños, niñas y adolescentes",2016,3,1,2025,49.3827160493827,1,1092,91.5750915750916,0,933,0
20838,15,15600,81,"Tasa de exámenes médico legales por presunto delito sexual contra niños, niñas y adolescentes",2016,4,2,2102,95.1474785918173,1,1166,85.7632933104631,1,936,106.837606837607
20839,15,15600,121,Tasa de exámenes médico legales por presunto delito sexual cuando la víctima está entre 18 y 28 años,2016,5,1,2490,40.1606425702811,0,1398,0,1,1092,91.5750915750916
20840,15,15632,81,"Tasa de exámenes médico legales por presunto delito sexual contra niños, niñas y adolescentes",2016,2,4,1145,349.344978165939,0,591,0,4,554,722.02166064982
20841,15,15632,81,"Tasa de exámenes médico legales por presunto delito sexual contra niños, niñas y adolescentes",2016,4,1,1397,71.5819613457409,0,744,0,1,653,153.139356814701
20842,15,15646,81,"Tasa de exámenes médico legales por presunto delito sexual contra niños, niñas y adolescentes",2016,2,1,2086,47.9386385426654,0,1075,0,1,1011,98.9119683481701
20843,15,15646,81,"Tasa de exámenes médico legales por presunto delito sexual contra niños, niñas y adolescentes",2016,3,4,2618,152.788388082506,0,1358,0,4,1260,317.460317460317
20844,15,15646,81,"Tasa de exámenes médico legales por presunto delito sexual contra niños, niñas y adolescentes",2016,4,6,2509,239.139099242726,0,1315,0,6,1194,502.51256281407
20845,15,15646,121,Tasa de exámenes médico legales por presunto delito sexual cuando la víctima está entre 18 y 28 años,2016,5,2,3470,57.6368876080692,0,1816,0,2,1654,120.918984280532
20846,15,15664,81,"Tasa de exámenes médico legales por presunto delito sexual contra niños, niñas y adolescentes",2016,3,1,559,178.890876565295,0,303,0,1,256,390625
20847,15,15667,121,Tasa de exámenes médico legales por presunto delito sexual cuando la víctima está entre 18 y 28 años,2016,5,1,804,124.378109452736,0,436,0,1,368,271.739130434783
20848,15,15673,81,"Tasa de exámenes médico legales por presunto delito sexual contra niños, niñas y adolescentes",2016,2,2,309,647.249190938511,0,158,0,2,151,1324.50331125828
20849,15,15676,81,"Tasa de exámenes médico legales por presunto delito sexual contra niños, niñas y adolescentes",2016,3,1,518,193.050193050193,0,271,0,1,247,404.858299595142
20850,15,15681,81,"Tasa de exámenes médico legales por presunto delito sexual contra niños, niñas y adolescentes",2016,2,1,972,102.880658436214,0,502,0,1,470,212.765957446809
20851,15,15681,81,"Tasa de exámenes médico legales por presunto delito sexual contra niños, niñas y adolescentes",2016,3,4,1201,333.055786844296,2,633,315.955766192733,2,568,352.112676056338
20852,15,15681,81,"Tasa de exámenes médico legales por presunto delito sexual contra niños, niñas y adolescentes",2016,4,4,1161,344.530577088717,1,626,159.744408945687,3,535,560.747663551402
20853,15,15686,81,"Tasa de exámenes médico legales por presunto delito sexual contra niños, niñas y adolescentes",2016,3,2,905,220.994475138122,0,476,0,2,429,466.200466200466
20854,15,15686,81,"Tasa de exámenes médico legales por presunto delito sexual contra niños, niñas y adolescentes",2016,4,2,863,231.749710312862,0,456,0,2,407,491.400491400491
20855,15,15690,81,"Tasa de exámenes médico legales por presunto delito sexual contra niños, niñas y adolescentes",2016,4,1,441,226.757369614512,0,230,0,1,211,473.9336492891
20856,15,15693,81,"Tasa de exámenes médico legales por presunto delito sexual contra niños, niñas y adolescentes",2016,4,2,1403,142.551674982181,0,810,0,2,593,337.268128161889
20857,15,15696,81,"Tasa de exámenes médico legales por presunto delito sexual contra niños, niñas y adolescentes",2016,2,1,235,425.531914893617,0,120,0,1,115,869.565217391304
20858,15,15740,81,"Tasa de exámenes médico legales por presunto delito sexual contra niños, niñas y adolescentes",2016,2,1,953,104.931794333683,0,488,0,1,465,215.05376344086
20859,15,15755,81,"Tasa de exámenes médico legales por presunto delito sexual contra niños, niñas y adolescentes",2016,3,1,768,130.208333333333,0,402,0,1,366,273.224043715847
20860,15,15755,121,Tasa de exámenes médico legales por presunto delito sexual cuando la víctima está entre 18 y 28 años,2016,5,1,1335,74.9063670411985,0,743,0,1,592,168.918918918919
20861,15,15759,81,"Tasa de exámenes médico legales por presunto delito sexual contra niños, niñas y adolescentes",2016,3,10,11202,89.2697732547759,2,5602,35.7015351660121,8,5600,142.857142857143
20862,15,15759,81,"Tasa de exámenes médico legales por presunto delito sexual contra niños, niñas y adolescentes",2016,4,9,11945,75.3453327752198,1,5983,16.7140230653518,8,5962,134.183160013418
20863,15,15759,121,Tasa de exámenes médico legales por presunto delito sexual cuando la víctima está entre 18 y 28 años,2016,5,8,18754,42.6575663858377,0,9672,0,8,9082,88.0863245981062
20864,15,15761,81,"Tasa de exámenes médico legales por presunto delito sexual contra niños, niñas y adolescentes",2016,2,1,259,386.100386100386,1,132,757.575757575758,0,127,0
20865,15,15763,81,"Tasa de exámenes médico legales por presunto delito sexual contra niños, niñas y adolescentes",2016,2,1,794,125.944584382872,0,399,0,1,395,253.164556962025
20866,15,15763,81,"Tasa de exámenes médico legales por presunto delito sexual contra niños, niñas y adolescentes",2016,3,2,1015,197.044334975369,0,508,0,2,507,394.477317554241
20867,15,15763,81,"Tasa de exámenes médico legales por presunto delito sexual contra niños, niñas y adolescentes",2016,4,2,950,210.526315789474,0,479,0,2,471,424.628450106157
20868,15,15763,121,Tasa de exámenes médico legales por presunto delito sexual cuando la víctima está entre 18 y 28 años,2016,5,1,1196,83.6120401337793,0,629,0,1,567,176.36684303351
20869,15,15764,81,"Tasa de exámenes médico legales por presunto delito sexual contra niños, niñas y adolescentes",2016,4,1,608,164.473684210526,0,316,0,1,292,342.465753424658
20870,15,15776,81,"Tasa de exámenes médico legales por presunto delito sexual contra niños, niñas y adolescentes",2016,2,1,495,202.020202020202,0,257,0,1,238,420.168067226891
20871,15,15776,81,"Tasa de exámenes médico legales por presunto delito sexual contra niños, niñas y adolescentes",2016,3,3,619,484.652665589661,0,322,0,3,297,1010.10101010101
20872,15,15776,81,"Tasa de exámenes médico legales por presunto delito sexual contra niños, niñas y adolescentes",2016,4,1,646,154.798761609907,0,336,0,1,310,322.58064516129
20873,15,15790,81,"Tasa de exámenes médico legales por presunto delito sexual contra niños, niñas y adolescentes",2016,3,1,747,133.868808567604,0,380,0,1,367,272.479564032698
20874,15,15798,81,"Tasa de exámenes médico legales por presunto delito sexual contra niños, niñas y adolescentes",2016,2,1,267,374.531835205993,0,139,0,1,128,781.25
20875,15,15804,81,"Tasa de exámenes médico legales por presunto delito sexual contra niños, niñas y adolescentes",2016,3,2,960,208.333333333333,1,496,201.612903225806,1,464,215.51724137931
20876,15,15804,81,"Tasa de exámenes médico legales por presunto delito sexual contra niños, niñas y adolescentes",2016,4,2,948,210.970464135021,0,497,0,2,451,443.458980044346
20877,15,15806,81,"Tasa de exámenes médico legales por presunto delito sexual contra niños, niñas y adolescentes",2016,2,1,1207,82.8500414250207,0,621,0,1,586,170.648464163823
20878,15,15806,81,"Tasa de exámenes médico legales por presunto delito sexual contra niños, niñas y adolescentes",2016,3,2,1585,126.182965299685,0,818,0,2,767,260.756192959583
20879,15,15806,81,"Tasa de exámenes médico legales por presunto delito sexual contra niños, niñas y adolescentes",2016,4,3,1607,186.683260734288,0,832,0,3,775,387.096774193548
20880,15,15806,121,Tasa de exámenes médico legales por presunto delito sexual cuando la víctima está entre 18 y 28 años,2016,5,1,2353,42.4989375265618,0,1255,0,1,1098,91.0746812386157
20881,15,15808,81,"Tasa de exámenes médico legales por presunto delito sexual contra niños, niñas y adolescentes",2016,4,1,330,303.030303030303,0,176,0,1,154,649.350649350649
20882,15,15814,81,"Tasa de exámenes médico legales por presunto delito sexual contra niños, niñas y adolescentes",2016,3,1,1222,81.8330605564648,0,638,0,1,584,171.232876712329
20883,15,15814,81,"Tasa de exámenes médico legales por presunto delito sexual contra niños, niñas y adolescentes",2016,4,1,1168,85.6164383561644,0,616,0,1,552,181.159420289855
20884,15,15816,121,Tasa de exámenes médico legales por presunto delito sexual cuando la víctima está entre 18 y 28 años,2016,5,2,806,248.138957816377,0,459,0,2,347,576.368876080692
20885,15,15822,81,"Tasa de exámenes médico legales por presunto delito sexual contra niños, niñas y adolescentes",2016,4,1,566,176.678445229682,0,306,0,1,260,384.615384615385
20886,15,15835,81,"Tasa de exámenes médico legales por presunto delito sexual contra niños, niñas y adolescentes",2016,2,1,502,199.203187250996,1,258,387.596899224806,0,244,0
20887,15,15835,81,"Tasa de exámenes médico legales por presunto delito sexual contra niños, niñas y adolescentes",2016,3,1,666,150.15015015015,0,345,0,1,321,311.526479750779
20888,15,15835,81,"Tasa de exámenes médico legales por presunto delito sexual contra niños, niñas y adolescentes",2016,4,1,668,149.700598802395,0,354,0,1,314,318.471337579618
20889,15,15837,81,"Tasa de exámenes médico legales por presunto delito sexual contra niños, niñas y adolescentes",2016,3,3,1101,272.479564032698,2,577,346.620450606586,1,524,190.839694656489
20890,15,15837,121,Tasa de exámenes médico legales por presunto delito sexual cuando la víctima está entre 18 y 28 años,2016,5,1,1595,62.6959247648903,0,877,0,1,718,139.275766016713
20891,15,15839,81,"Tasa de exámenes médico legales por presunto delito sexual contra niños, niñas y adolescentes",2016,3,2,157,1273.88535031847,0,85,0,2,72,2777.77777777778
20892,15,15842,81,"Tasa de exámenes médico legales por presunto delito sexual contra niños, niñas y adolescentes",2016,3,1,1414,70.7213578500707,0,732,0,1,682,146.627565982405
20893,15,15861,81,"Tasa de exámenes médico legales por presunto delito sexual contra niños, niñas y adolescentes",2016,3,1,1883,53.1067445565587,0,956,0,1,927,107.874865156419
20894,15,15861,81,"Tasa de exámenes médico legales por presunto delito sexual contra niños, niñas y adolescentes",2016,4,1,1895,52.7704485488127,0,945,0,1,950,105.263157894737
20895,15,15879,81,"Tasa de exámenes médico legales por presunto delito sexual contra niños, niñas y adolescentes",2016,3,1,357,280.11204481792703,0,196,0,1,161,621.11801242236
20896,15,15879,81,"Tasa de exámenes médico legales por presunto delito sexual contra niños, niñas y adolescentes",2016,4,1,363,275.482093663912,0,205,0,1,158,632.911392405063
20897,17,17001,81,"Tasa de exámenes médico legales por presunto delito sexual contra niños, niñas y adolescentes",2016,2,45,25467,176.699257863117,14,13025,107.485604606526,31,12442,249.156084230831
20898,17,17001,81,"Tasa de exámenes médico legales por presunto delito sexual contra niños, niñas y adolescentes",2016,3,63,32321,194.919711642585,16,16453,97.2467027289856,47,15868,296.193597176708
20899,17,17001,81,"Tasa de exámenes médico legales por presunto delito sexual contra niños, niñas y adolescentes",2016,4,93,34843,266.911574778291,14,17699,79.100514153342,79,17144,460.802613159123
20900,17,17001,121,Tasa de exámenes médico legales por presunto delito sexual cuando la víctima está entre 18 y 28 años,2016,5,23,74467,30.8861643412518,4,38510,10.3869124902623,19,35957,52.8408932892066
20901,17,17013,81,"Tasa de exámenes médico legales por presunto delito sexual contra niños, niñas y adolescentes",2016,4,2,2236,89.4454382826476,0,1144,0,2,1092,183.150183150183
20902,17,17042,81,"Tasa de exámenes médico legales por presunto delito sexual contra niños, niñas y adolescentes",2016,2,2,2754,72.6216412490922,1,1409,70.97232079489,1,1345,74.3494423791822
20903,17,17042,81,"Tasa de exámenes médico legales por presunto delito sexual contra niños, niñas y adolescentes",2016,3,8,3399,235.363342159459,1,1695,58.9970501474926,7,1704,410.798122065728
20904,17,17042,81,"Tasa de exámenes médico legales por presunto delito sexual contra niños, niñas y adolescentes",2016,4,10,3257,307.031010132023,2,1613,123.992560446373,8,1644,486.61800486618
20905,17,17042,121,Tasa de exámenes médico legales por presunto delito sexual cuando la víctima está entre 18 y 28 años,2016,5,5,5438,91.9455682236116,0,2732,0,5,2706,184.774575018477
20906,17,17042,81,"Tasa de exámenes médico legales por presunto delito sexual contra niños, niñas y adolescentes",2016,1,1,529,189.035916824197,0,267,0,1,262,381.679389312977
20907,17,17050,81,"Tasa de exámenes médico legales por presunto delito sexual contra niños, niñas y adolescentes",2016,2,1,1049,95.3288846520496,0,535,0,1,514,194.552529182879
20908,17,17050,81,"Tasa de exámenes médico legales por presunto delito sexual contra niños, niñas y adolescentes",2016,4,2,1168,171.232876712329,0,598,0,2,570,350.877192982456
20909,17,17174,81,"Tasa de exámenes médico legales por presunto delito sexual contra niños, niñas y adolescentes",2016,2,2,4344,46.0405156537753,0,2219,0,2,2125,94.1176470588235
20910,17,17174,81,"Tasa de exámenes médico legales por presunto delito sexual contra niños, niñas y adolescentes",2016,3,5,5353,93.4055669717915,2,2719,73.5564545788893,3,2634,113.895216400911
20911,17,17174,81,"Tasa de exámenes médico legales por presunto delito sexual contra niños, niñas y adolescentes",2016,4,17,5258,323.316850513503,3,2643,113.507377979569,14,2615,535.372848948375
20912,17,17174,121,Tasa de exámenes médico legales por presunto delito sexual cuando la víctima está entre 18 y 28 años,2016,5,2,9425,21.2201591511936,0,4627,0,2,4798,41.6840350145894
20913,17,17174,81,"Tasa de exámenes médico legales por presunto delito sexual contra niños, niñas y adolescentes",2016,1,1,864,115.740740740741,0,442,0,1,422,236.96682464455
20914,17,17272,81,"Tasa de exámenes médico legales por presunto delito sexual contra niños, niñas y adolescentes",2016,2,1,989,101.112234580384,0,508,0,1,481,207.900207900208
20915,17,17272,81,"Tasa de exámenes médico legales por presunto delito sexual contra niños, niñas y adolescentes",2016,4,1,1112,89.9280575539568,0,573,0,1,539,185.528756957328
20916,17,17380,81,"Tasa de exámenes médico legales por presunto delito sexual contra niños, niñas y adolescentes",2016,2,2,7008,28.5388127853881,0,3593,0,2,3415,58.5651537335286
20917,17,17380,81,"Tasa de exámenes médico legales por presunto delito sexual contra niños, niñas y adolescentes",2016,3,13,8276,157.080715321411,3,4212,71.2250712250712,10,4064,246.062992125984
20918,17,17380,81,"Tasa de exámenes médico legales por presunto delito sexual contra niños, niñas y adolescentes",2016,4,16,7905,202.403542061986,3,4004,74.9250749250749,13,3901,333.247885157652
20919,17,17380,121,Tasa de exámenes médico legales por presunto delito sexual cuando la víctima está entre 18 y 28 años,2016,5,4,14832,26.9687162891046,1,7636,13.0958617077004,3,7196,41.6898276820456
20920,17,17388,81,"Tasa de exámenes médico legales por presunto delito sexual contra niños, niñas y adolescentes",2016,2,1,483,207.03933747412,1,246,406.50406504065,0,237,0
20921,17,17388,81,"Tasa de exámenes médico legales por presunto delito sexual contra niños, niñas y adolescentes",2016,4,2,537,372.43947858473,1,279,358.4229390681,1,258,387.596899224806
20922,17,17388,121,Tasa de exámenes médico legales por presunto delito sexual cuando la víctima está entre 18 y 28 años,2016,5,1,995,100.502512562814,0,517,0,1,478,209.205020920502
20923,17,17433,81,"Tasa de exámenes médico legales por presunto delito sexual contra niños, niñas y adolescentes",2016,2,1,2144,46.6417910447761,1,1096,91.2408759124088,0,1048,0
20924,17,17433,81,"Tasa de exámenes médico legales por presunto delito sexual contra niños, niñas y adolescentes",2016,3,1,2491,40.1445202729827,0,1281,0,1,1210,82.6446280991735
20925,17,17442,81,"Tasa de exámenes médico legales por presunto delito sexual contra niños, niñas y adolescentes",2016,3,4,1125,355.555555555556,1,577,173.310225303293,3,548,547.445255474453
20926,17,17442,81,"Tasa de exámenes médico legales por presunto delito sexual contra niños, niñas y adolescentes",2016,4,1,1100,90.9090909090909,1,574,174.216027874564,0,526,0
20927,17,17486,81,"Tasa de exámenes médico legales por presunto delito sexual contra niños, niñas y adolescentes",2016,2,1,3197,31.2793243665937,0,1643,0,1,1554,64.3500643500643
20928,17,17486,81,"Tasa de exámenes médico legales por presunto delito sexual contra niños, niñas y adolescentes",2016,3,5,3840,130.208333333333,1,1984,50.4032258064516,4,1856,215.51724137931
20929,17,17486,81,"Tasa de exámenes médico legales por presunto delito sexual contra niños, niñas y adolescentes",2016,4,12,3565,336.605890603086,1,1842,54.2888165038002,11,1723,638.421358096344
20930,17,17486,121,Tasa de exámenes médico legales por presunto delito sexual cuando la víctima está entre 18 y 28 años,2016,5,1,5464,18.3016105417277,0,2901,0,1,2563,39.0167772142021
20931,17,17495,121,Tasa de exámenes médico legales por presunto delito sexual cuando la víctima está entre 18 y 28 años,2016,5,1,1287,77.7000777000777,0,709,0,1,578,173.010380622837
20932,17,17513,81,"Tasa de exámenes médico legales por presunto delito sexual contra niños, niñas y adolescentes",2016,3,1,1729,57.8368999421631,1,915,109.289617486339,0,814,0
20933,17,17513,81,"Tasa de exámenes médico legales por presunto delito sexual contra niños, niñas y adolescentes",2016,4,1,1609,62.1504039776259,0,827,0,1,782,127.877237851662
20934,17,17524,81,"Tasa de exámenes médico legales por presunto delito sexual contra niños, niñas y adolescentes",2016,3,2,2031,98.4736582964057,0,1049,0,2,982,203.665987780041
20935,17,17524,81,"Tasa de exámenes médico legales por presunto delito sexual contra niños, niñas y adolescentes",2016,4,2,1897,105.429625724829,0,988,0,2,909,220.02200220022
20936,17,17524,121,Tasa de exámenes médico legales por presunto delito sexual cuando la víctima está entre 18 y 28 años,2016,5,1,3368,29.6912114014252,1,1756,56.9476082004556,0,1612,0
20937,17,17614,81,"Tasa de exámenes médico legales por presunto delito sexual contra niños, niñas y adolescentes",2016,2,1,5221,19.153418885271,0,2678,0,1,2543,39.3236335037357
20938,17,17614,81,"Tasa de exámenes médico legales por presunto delito sexual contra niños, niñas y adolescentes",2016,3,2,6109,32.7385824193812,0,3160,0,2,2949,67.8195998643608
20939,17,17614,81,"Tasa de exámenes médico legales por presunto delito sexual contra niños, niñas y adolescentes",2016,4,4,5850,68.3760683760684,1,3049,32.797638570023,3,2801,107.104605498036
20940,17,17614,121,Tasa de exámenes médico legales por presunto delito sexual cuando la víctima está entre 18 y 28 años,2016,5,1,10773,9.2824654228163,0,5429,0,1,5344,18.7125748502994
20941,17,17616,81,"Tasa de exámenes médico legales por presunto delito sexual contra niños, niñas y adolescentes",2016,3,3,1092,274.725274725275,0,580,0,3,512,585.9375
20942,17,17616,81,"Tasa de exámenes médico legales por presunto delito sexual contra niños, niñas y adolescentes",2016,4,3,1030,291.26213592233,0,555,0,3,475,631.578947368421
20943,17,17616,121,Tasa de exámenes médico legales por presunto delito sexual cuando la víctima está entre 18 y 28 años,2016,5,1,1689,59.206631142688,0,925,0,1,764,130.890052356021
20944,17,17653,81,"Tasa de exámenes médico legales por presunto delito sexual contra niños, niñas y adolescentes",2016,3,2,1905,104.98687664042,0,983,0,2,922,216.919739696312
20945,17,17653,81,"Tasa de exámenes médico legales por presunto delito sexual contra niños, niñas y adolescentes",2016,4,6,1806,332.225913621262,2,949,210.748155953635,4,857,466.744457409568
20946,17,17662,81,"Tasa de exámenes médico legales por presunto delito sexual contra niños, niñas y adolescentes",2016,2,1,2525,39.6039603960396,0,1291,0,1,1234,81.0372771474878
20947,17,17662,81,"Tasa de exámenes médico legales por presunto delito sexual contra niños, niñas y adolescentes",2016,3,1,2864,34.9162011173184,0,1484,0,1,1380,72.463768115942
20948,17,17662,121,Tasa de exámenes médico legales por presunto delito sexual cuando la víctima está entre 18 y 28 años,2016,5,1,5220,19.1570881226054,1,2856,35.0140056022409,0,2364,0
20949,17,17777,81,"Tasa de exámenes médico legales por presunto delito sexual contra niños, niñas y adolescentes",2016,2,3,2381,125.997480050399,0,1217,0,3,1164,257.731958762887
20950,17,17777,81,"Tasa de exámenes médico legales por presunto delito sexual contra niños, niñas y adolescentes",2016,3,2,2879,69.468565474123,1,1464,68.3060109289618,1,1415,70.6713780918728
20951,17,17777,81,"Tasa de exámenes médico legales por presunto delito sexual contra niños, niñas y adolescentes",2016,4,5,2735,182.815356489945,1,1383,72.3065798987708,4,1352,295.85798816568
20952,17,17867,121,Tasa de exámenes médico legales por presunto delito sexual cuando la víctima está entre 18 y 28 años,2016,5,1,1558,64.1848523748395,1,793,126.103404791929,0,765,0
20953,17,17873,81,"Tasa de exámenes médico legales por presunto delito sexual contra niños, niñas y adolescentes",2016,2,6,4495,133.481646273637,1,2323,43.0477830391735,5,2172,230.202578268877
20954,17,17873,81,"Tasa de exámenes médico legales por presunto delito sexual contra niños, niñas y adolescentes",2016,3,13,5472,237.573099415205,0,2818,0,13,2654,489.826676714393
20955,17,17873,81,"Tasa de exámenes médico legales por presunto delito sexual contra niños, niñas y adolescentes",2016,4,10,5416,184.638109305761,1,2789,35.8551452133381,9,2627,342.596117244005
20956,17,17873,121,Tasa de exámenes médico legales por presunto delito sexual cuando la víctima está entre 18 y 28 años,2016,5,1,10944,9.1374269005848,0,5503,0,1,5441,18.3789744532255
20957,17,17877,81,"Tasa de exámenes médico legales por presunto delito sexual contra niños, niñas y adolescentes",2016,3,1,1379,72.5163161711385,0,709,0,1,670,149.253731343284
20958,18,18001,81,"Tasa de exámenes médico legales por presunto delito sexual contra niños, niñas y adolescentes",2016,2,11,16740,65.7108721624851,3,8441,35.5408126999171,8,8299,96.3971562838896
20959,18,18001,81,"Tasa de exámenes médico legales por presunto delito sexual contra niños, niñas y adolescentes",2016,3,41,20123,203.746956219252,9,10135,88.8011840157869,32,9988,320.384461353624
20960,18,18001,81,"Tasa de exámenes médico legales por presunto delito sexual contra niños, niñas y adolescentes",2016,4,58,20620,281.280310378274,3,10432,28.7576687116564,55,10188,539.850804868473
20961,18,18001,121,Tasa de exámenes médico legales por presunto delito sexual cuando la víctima está entre 18 y 28 años,2016,5,5,35640,14.0291806958474,1,18174,5.50236601738748,4,17466,22.9016374670789
20962,18,18029,81,"Tasa de exámenes médico legales por presunto delito sexual contra niños, niñas y adolescentes",2016,3,1,889,112.485939257593,0,451,0,1,438,228.310502283105
20963,18,18029,81,"Tasa de exámenes médico legales por presunto delito sexual contra niños, niñas y adolescentes",2016,4,1,853,117.233294255569,0,436,0,1,417,239.808153477218
20964,18,18094,81,"Tasa de exámenes médico legales por presunto delito sexual contra niños, niñas y adolescentes",2016,3,1,1766,56.6251415628539,0,875,0,1,891,112.233445566779
20965,18,18094,81,"Tasa de exámenes médico legales por presunto delito sexual contra niños, niñas y adolescentes",2016,4,1,1611,62.0732464307883,0,779,0,1,832,120.192307692308
20966,18,18150,81,"Tasa de exámenes médico legales por presunto delito sexual contra niños, niñas y adolescentes",2016,2,1,4429,22.5784601490178,0,2271,0,1,2158,46.339202965709
20967,18,18150,81,"Tasa de exámenes médico legales por presunto delito sexual contra niños, niñas y adolescentes",2016,3,4,5020,79.6812749003984,1,2567,38.9559797428905,3,2453,122.299225438239
20968,18,18150,81,"Tasa de exámenes médico legales por presunto delito sexual contra niños, niñas y adolescentes",2016,4,10,4606,217.108119843682,0,2306,0,10,2300,434.782608695652
20969,18,18205,81,"Tasa de exámenes médico legales por presunto delito sexual contra niños, niñas y adolescentes",2016,3,3,1576,190.355329949239,0,802,0,3,774,387.596899224806
20970,18,18205,81,"Tasa de exámenes médico legales por presunto delito sexual contra niños, niñas y adolescentes",2016,4,6,1517,395.5174686882,0,782,0,6,735,816.326530612245
20971,18,18205,121,Tasa de exámenes médico legales por presunto delito sexual cuando la víctima está entre 18 y 28 años,2016,5,1,2423,41.2711514651259,0,1244,0,1,1179,84.8176420695505
20972,18,18247,81,"Tasa de exámenes médico legales por presunto delito sexual contra niños, niñas y adolescentes",2016,3,6,2705,221.81146025878,1,1390,71.9424460431655,5,1315,380.228136882129
20973,18,18247,81,"Tasa de exámenes médico legales por presunto delito sexual contra niños, niñas y adolescentes",2016,4,4,2694,148.478099480327,0,1383,0,4,1311,305.11060259344
20974,18,18247,121,Tasa de exámenes médico legales por presunto delito sexual cuando la víctima está entre 18 y 28 años,2016,5,1,4535,22.0507166482911,0,2300,0,1,2235,44.7427293064877
20975,18,18256,81,"Tasa de exámenes médico legales por presunto delito sexual contra niños, niñas y adolescentes",2016,3,3,2902,103.376981392143,1,1484,67.3854447439353,2,1418,141.043723554302
20976,18,18256,81,"Tasa de exámenes médico legales por presunto delito sexual contra niños, niñas y adolescentes",2016,4,6,2806,213.827512473272,1,1377,72.6216412490922,5,1429,349.895031490553
20977,18,18410,81,"Tasa de exámenes médico legales por presunto delito sexual contra niños, niñas y adolescentes",2016,4,1,3201,31.2402374258044,0,1660,0,1,1541,64.8929266709929
20978,18,18410,121,Tasa de exámenes médico legales por presunto delito sexual cuando la víctima está entre 18 y 28 años,2016,5,1,4924,20.3086921202275,0,2532,0,1,2392,41.8060200668896
20979,18,18460,81,"Tasa de exámenes médico legales por presunto delito sexual contra niños, niñas y adolescentes",2016,4,1,1618,61.8046971569839,0,822,0,1,796,125.628140703518
20980,18,18479,81,"Tasa de exámenes médico legales por presunto delito sexual contra niños, niñas y adolescentes",2016,2,1,457,218.818380743983,0,233,0,1,224,446.428571428571
20981,18,18479,81,"Tasa de exámenes médico legales por presunto delito sexual contra niños, niñas y adolescentes",2016,3,1,525,190.47619047619,0,267,0,1,258,387.596899224806
20982,18,18592,81,"Tasa de exámenes médico legales por presunto delito sexual contra niños, niñas y adolescentes",2016,3,5,4583,109.098843552258,0,2355,0,5,2228,224.416517055655
20983,18,18592,81,"Tasa de exámenes médico legales por presunto delito sexual contra niños, niñas y adolescentes",2016,4,11,4380,251.141552511416,0,2269,0,11,2111,521.080056845097
20984,18,18592,121,Tasa de exámenes médico legales por presunto delito sexual cuando la víctima está entre 18 y 28 años,2016,5,4,6960,57.4712643678161,1,3573,27.9876854184159,3,3387,88.5739592559788
20985,18,18610,81,"Tasa de exámenes médico legales por presunto delito sexual contra niños, niñas y adolescentes",2016,2,1,1777,56.274620146314,0,915,0,1,862,116.009280742459
20986,18,18610,81,"Tasa de exámenes médico legales por presunto delito sexual contra niños, niñas y adolescentes",2016,4,1,1952,51.2295081967213,0,1026,0,1,926,107.991360691145
20987,18,18610,121,Tasa de exámenes médico legales por presunto delito sexual cuando la víctima está entre 18 y 28 años,2016,5,1,3145,31.7965023847377,0,1634,0,1,1511,66.1813368630046
20988,18,18753,81,"Tasa de exámenes médico legales por presunto delito sexual contra niños, niñas y adolescentes",2016,2,2,8174,24.4678248103744,0,4189,0,2,3985,50.1882057716437
20989,18,18753,81,"Tasa de exámenes médico legales por presunto delito sexual contra niños, niñas y adolescentes",2016,3,2,9346,21.3995292103574,0,4754,0,2,4592,43.5540069686411
20990,18,18753,81,"Tasa de exámenes médico legales por presunto delito sexual contra niños, niñas y adolescentes",2016,4,6,8985,66.7779632721202,0,4566,0,6,4419,135.777325186694
20991,18,18753,121,Tasa de exámenes médico legales por presunto delito sexual cuando la víctima está entre 18 y 28 años,2016,5,2,14293,13.9928636395438,0,7425,0,2,6868,29.120559114735
20992,18,18753,81,"Tasa de exámenes médico legales por presunto delito sexual contra niños, niñas y adolescentes",2016,1,1,1700,58.8235294117647,0,863,0,1,837,119.4743130227
20993,18,18756,81,"Tasa de exámenes médico legales por presunto delito sexual contra niños, niñas y adolescentes",2016,3,3,3263,91.9399325773828,1,1656,60.3864734299517,2,1607,124.455507156192
20994,18,18785,81,"Tasa de exámenes médico legales por presunto delito sexual contra niños, niñas y adolescentes",2016,3,2,1233,162.20600162206,0,634,0,2,599,333.889816360601
20995,18,18785,81,"Tasa de exámenes médico legales por presunto delito sexual contra niños, niñas y adolescentes",2016,4,2,1186,168.634064080944,0,615,0,2,571,350.262697022767
20996,18,18860,81,"Tasa de exámenes médico legales por presunto delito sexual contra niños, niñas y adolescentes",2016,4,2,1517,131.8391562294,0,787,0,2,730,273.972602739726
20997,19,19001,81,"Tasa de exámenes médico legales por presunto delito sexual contra niños, niñas y adolescentes",2016,2,34,18582,182.97276934668,7,9449,74.0819134299926,27,9133,295.631227417059
20998,19,19001,81,"Tasa de exámenes médico legales por presunto delito sexual contra niños, niñas y adolescentes",2016,3,74,23511,314.74628897112,14,11967,116.988384724659,60,11544,519.75051975052
20999,19,19001,81,"Tasa de exámenes médico legales por presunto delito sexual contra niños, niñas y adolescentes",2016,4,85,26273,323.526053362768,8,13297,60.1639467549071,77,12976,593.403205918619
21000,19,19001,121,Tasa de exámenes médico legales por presunto delito sexual cuando la víctima está entre 18 y 28 años,2016,5,30,51989,57.7045144165112,7,26060,26.8610897927859,23,25929,88.7037679817965
21001,19,19001,81,"Tasa de exámenes médico legales por presunto delito sexual contra niños, niñas y adolescentes",2016,1,1,3680,27.1739130434783,0,1882,0,1,1798,55.6173526140156
21002,19,19050,81,"Tasa de exámenes médico legales por presunto delito sexual contra niños, niñas y adolescentes",2016,2,2,2794,71.5819613457409,0,1409,0,2,1385,144.404332129964
21003,19,19050,81,"Tasa de exámenes médico legales por presunto delito sexual contra niños, niñas y adolescentes",2016,3,2,3100,64.5161290322581,0,1546,0,2,1554,128.700128700129
21004,19,19050,81,"Tasa de exámenes médico legales por presunto delito sexual contra niños, niñas y adolescentes",2016,4,2,3127,63.9590661976335,0,1563,0,2,1564,127.877237851662
21005,19,19075,81,"Tasa de exámenes médico legales por presunto delito sexual contra niños, niñas y adolescentes",2016,3,1,3009,33.2336324360253,0,1563,0,1,1446,69.1562932226833
21006,19,19075,81,"Tasa de exámenes médico legales por presunto delito sexual contra niños, niñas y adolescentes",2016,4,1,3004,33.288948069241,0,1567,0,1,1437,69.589422407794
21007,19,19100,81,"Tasa de exámenes médico legales por presunto delito sexual contra niños, niñas y adolescentes",2016,4,1,4750,21.0526315789474,0,2467,0,1,2283,43.8020148926851
21008,19,19100,121,Tasa de exámenes médico legales por presunto delito sexual cuando la víctima está entre 18 y 28 años,2016,5,1,8552,11.6931711880262,0,4565,0,1,3987,25.0815149235014
21009,19,19110,81,"Tasa de exámenes médico legales por presunto delito sexual contra niños, niñas y adolescentes",2016,2,1,3212,31.1332503113325,0,1638,0,1,1574,63.5324015247776
21010,19,19110,81,"Tasa de exámenes médico legales por presunto delito sexual contra niños, niñas y adolescentes",2016,3,1,3662,27.3074822501365,1,1862,53.7056928034372,0,1800,0
21011,19,19110,81,"Tasa de exámenes médico legales por presunto delito sexual contra niños, niñas y adolescentes",2016,4,1,3920,25.5102040816327,0,1995,0,1,1925,51.948051948052
21012,19,19130,81,"Tasa de exámenes médico legales por presunto delito sexual contra niños, niñas y adolescentes",2016,3,2,4541,44.0431622990531,0,2360,0,2,2181,91.7010545621275
21013,19,19130,81,"Tasa de exámenes médico legales por presunto delito sexual contra niños, niñas y adolescentes",2016,4,2,4506,44.3852640923214,0,2410,0,2,2096,95.4198473282443
21014,19,19137,81,"Tasa de exámenes médico legales por presunto delito sexual contra niños, niñas y adolescentes",2016,3,1,4287,23.3263354327035,0,2161,0,1,2126,47.0366886171214
21015,19,19137,81,"Tasa de exámenes médico legales por presunto delito sexual contra niños, niñas y adolescentes",2016,4,2,4298,46.5332712889716,0,2184,0,2,2114,94.6073793755913
21016,19,19142,81,"Tasa de exámenes médico legales por presunto delito sexual contra niños, niñas y adolescentes",2016,2,2,1507,132.71400132714,1,765,130.718954248366,1,742,134.770889487871
21017,19,19142,81,"Tasa de exámenes médico legales por presunto delito sexual contra niños, niñas y adolescentes",2016,3,4,1801,222.098833981122,1,911,109.769484083425,3,890,337.078651685393
21018,19,19142,81,"Tasa de exámenes médico legales por presunto delito sexual contra niños, niñas y adolescentes",2016,4,4,1946,205.549845837616,0,999,0,4,947,422.386483632524
21019,19,19142,121,Tasa de exámenes médico legales por presunto delito sexual cuando la víctima está entre 18 y 28 años,2016,5,2,3600,55.5555555555556,0,1789,0,2,1811,110.436223081171
21020,19,19212,81,"Tasa de exámenes médico legales por presunto delito sexual contra niños, niñas y adolescentes",2016,3,3,3544,84.6501128668172,1,1798,55.6173526140156,2,1746,114.54753722795
21021,19,19212,81,"Tasa de exámenes médico legales por presunto delito sexual contra niños, niñas y adolescentes",2016,4,4,3877,103.172556100077,0,1981,0,4,1896,210.970464135021
21022,19,19212,121,Tasa de exámenes médico legales por presunto delito sexual cuando la víctima está entre 18 y 28 años,2016,5,1,6870,14.5560407569141,0,3618,0,1,3252,30.750307503075
21023,19,19256,81,"Tasa de exámenes médico legales por presunto delito sexual contra niños, niñas y adolescentes",2016,3,1,5219,19.1607587660471,0,2701,0,1,2518,39.714058776807
21024,19,19256,81,"Tasa de exámenes médico legales por presunto delito sexual contra niños, niñas y adolescentes",2016,4,2,4773,41.9023674837628,0,2483,0,2,2290,87.3362445414847
21025,19,19256,121,Tasa de exámenes médico legales por presunto delito sexual cuando la víctima está entre 18 y 28 años,2016,5,2,8012,24.9625561657514,0,4198,0,2,3814,52.4383848977452
21026,19,19300,81,"Tasa de exámenes médico legales por presunto delito sexual contra niños, niñas y adolescentes",2016,3,1,2473,40.4367165386171,1,1236,80.9061488673139,0,1237,0
21027,19,19300,121,Tasa de exámenes médico legales por presunto delito sexual cuando la víctima está entre 18 y 28 años,2016,5,1,4055,24.6609124537608,0,1990,0,1,2065,48.4261501210654
21028,19,19355,81,"Tasa de exámenes médico legales por presunto delito sexual contra niños, niñas y adolescentes",2016,4,1,4121,24.265954865324,0,2125,0,1,1996,50.1002004008016
21029,19,19364,81,"Tasa de exámenes médico legales por presunto delito sexual contra niños, niñas y adolescentes",2016,4,1,2438,41.0172272354389,0,1227,0,1,1211,82.5763831544178
21030,19,19392,81,"Tasa de exámenes médico legales por presunto delito sexual contra niños, niñas y adolescentes",2016,3,1,944,105.932203389831,0,490,0,1,454,220.264317180617
21031,19,19397,81,"Tasa de exámenes médico legales por presunto delito sexual contra niños, niñas y adolescentes",2016,4,1,5207,19.2049164586134,0,2633,0,1,2574,38.8500388500389
21032,19,19418,81,"Tasa de exámenes médico legales por presunto delito sexual contra niños, niñas y adolescentes",2016,4,1,2878,34.7463516330785,0,1430,0,1,1448,69.060773480663
21033,19,19455,81,"Tasa de exámenes médico legales por presunto delito sexual contra niños, niñas y adolescentes",2016,4,2,5065,39.4866732477789,0,2588,0,2,2477,80.742834073476
21034,19,19513,81,"Tasa de exámenes médico legales por presunto delito sexual contra niños, niñas y adolescentes",2016,2,1,725,137.931034482759,0,369,0,1,356,280.898876404494
21035,19,19513,81,"Tasa de exámenes médico legales por presunto delito sexual contra niños, niñas y adolescentes",2016,3,1,877,114.025085518814,0,444,0,1,433,230.94688221709
21036,19,19513,121,Tasa de exámenes médico legales por presunto delito sexual cuando la víctima está entre 18 y 28 años,2016,5,2,1533,130.463144161774,0,776,0,2,757,264.200792602378
21037,19,19517,81,"Tasa de exámenes médico legales por presunto delito sexual contra niños, niñas y adolescentes",2016,3,1,4825,20.7253886010363,0,2487,0,1,2338,42.7715996578272
21038,19,19517,81,"Tasa de exámenes médico legales por presunto delito sexual contra niños, niñas y adolescentes",2016,4,1,4827,20.7168013258753,0,2499,0,1,2328,42.9553264604811
21039,19,19517,121,Tasa de exámenes médico legales por presunto delito sexual cuando la víctima está entre 18 y 28 años,2016,5,3,7292,41.1409764125069,0,3832,0,3,3460,86.7052023121387
21040,19,19532,121,Tasa de exámenes médico legales por presunto delito sexual cuando la víctima está entre 18 y 28 años,2016,5,1,7747,12.9082225377565,0,4085,0,1,3662,27.3074822501365
21041,19,19533,81,"Tasa de exámenes médico legales por presunto delito sexual contra niños, niñas y adolescentes",2016,4,1,969,103.199174406605,0,511,0,1,458,218.340611353712
21042,19,19548,81,"Tasa de exámenes médico legales por presunto delito sexual contra niños, niñas y adolescentes",2016,3,1,4696,21.2947189097104,0,2403,0,1,2293,43.6109899694723
21043,19,19548,81,"Tasa de exámenes médico legales por presunto delito sexual contra niños, niñas y adolescentes",2016,4,1,4903,20.3956761166633,0,2513,0,1,2390,41.8410041841004
21044,19,19548,121,Tasa de exámenes médico legales por presunto delito sexual cuando la víctima está entre 18 y 28 años,2016,5,1,8769,11.4038088721633,0,4440,0,1,4329,23.1000231000231
21045,19,19573,81,"Tasa de exámenes médico legales por presunto delito sexual contra niños, niñas y adolescentes",2016,2,2,3940,50.761421319797,0,2016,0,2,1924,103.950103950104
21046,19,19573,81,"Tasa de exámenes médico legales por presunto delito sexual contra niños, niñas y adolescentes",2016,3,3,4683,64.0614990390775,0,2377,0,3,2306,130.09540329575
21047,19,19573,81,"Tasa de exámenes médico legales por presunto delito sexual contra niños, niñas y adolescentes",2016,4,3,5073,59.1366055588409,0,2565,0,3,2508,119.617224880383
21048,19,19573,121,Tasa de exámenes médico legales por presunto delito sexual cuando la víctima está entre 18 y 28 años,2016,5,2,9460,21.1416490486258,0,4742,0,2,4718,42.3908435777872
21049,19,19585,81,"Tasa de exámenes médico legales por presunto delito sexual contra niños, niñas y adolescentes",2016,2,3,1582,189.633375474083,1,805,124.223602484472,2,777,257.400257400257
21050,19,19585,81,"Tasa de exámenes médico legales por presunto delito sexual contra niños, niñas y adolescentes",2016,3,3,1715,174.927113702624,3,879,341.296928327645,0,836,0
21051,19,19585,81,"Tasa de exámenes médico legales por presunto delito sexual contra niños, niñas y adolescentes",2016,4,1,1852,53.9956803455724,0,956,0,1,896,111.607142857143
21052,19,19585,121,Tasa de exámenes médico legales por presunto delito sexual cuando la víctima está entre 18 y 28 años,2016,5,3,3336,89.9280575539568,0,1764,0,3,1572,190.839694656489
21053,19,19622,81,"Tasa de exámenes médico legales por presunto delito sexual contra niños, niñas y adolescentes",2016,3,1,1272,78.6163522012579,1,654,152.905198776758,0,618,0
21054,19,19622,81,"Tasa de exámenes médico legales por presunto delito sexual contra niños, niñas y adolescentes",2016,4,2,1326,150.829562594268,0,688,0,2,638,313.479623824451
21055,19,19693,81,"Tasa de exámenes médico legales por presunto delito sexual contra niños, niñas y adolescentes",2016,4,1,1372,72.8862973760933,0,725,0,1,647,154.559505409583
21056,19,19693,121,Tasa de exámenes médico legales por presunto delito sexual cuando la víctima está entre 18 y 28 años,2016,5,1,3384,29.5508274231679,0,2232,0,1,1152,86.8055555555556
21057,19,19698,81,"Tasa de exámenes médico legales por presunto delito sexual contra niños, niñas y adolescentes",2016,2,5,8114,61.6218880946512,2,4108,48.6854917234664,3,4006,74.8876684972541
21058,19,19698,81,"Tasa de exámenes médico legales por presunto delito sexual contra niños, niñas y adolescentes",2016,3,12,9716,123.507616303005,1,4905,20.3873598369011,11,4811,228.642693826647
21059,19,19698,81,"Tasa de exámenes médico legales por presunto delito sexual contra niños, niñas y adolescentes",2016,4,18,10514,171.200304356097,1,5398,18.5253797702853,17,5116,332.290852228303
21060,19,19698,121,Tasa de exámenes médico legales por presunto delito sexual cuando la víctima está entre 18 y 28 años,2016,5,2,19359,10.3311121442223,1,9608,10.4079933388843,1,9751,10.2553584247769
21061,19,19743,81,"Tasa de exámenes médico legales por presunto delito sexual contra niños, niñas y adolescentes",2016,2,1,3359,29.7707651086633,0,1715,0,1,1644,60.8272506082725
21062,19,19743,81,"Tasa de exámenes médico legales por presunto delito sexual contra niños, niñas y adolescentes",2016,3,2,3727,53.6624631070566,0,1905,0,2,1822,109.769484083425
21063,19,19743,81,"Tasa de exámenes médico legales por presunto delito sexual contra niños, niñas y adolescentes",2016,4,1,4038,24.7647350173353,0,2068,0,1,1970,50.761421319797
21064,19,19760,81,"Tasa de exámenes médico legales por presunto delito sexual contra niños, niñas y adolescentes",2016,3,1,1683,59.41770647653,0,866,0,1,817,122.399020807834
21065,19,19760,81,"Tasa de exámenes médico legales por presunto delito sexual contra niños, niñas y adolescentes",2016,4,1,1828,54.7045951859956,1,948,105.485232067511,0,880,0
21066,19,19780,81,"Tasa de exámenes médico legales por presunto delito sexual contra niños, niñas y adolescentes",2016,2,1,2007,49.825610363727,0,1021,0,1,986,101.419878296146
21067,19,19785,81,"Tasa de exámenes médico legales por presunto delito sexual contra niños, niñas y adolescentes",2016,3,1,891,112.233445566779,0,457,0,1,434,230.414746543779
21068,19,19807,81,"Tasa de exámenes médico legales por presunto delito sexual contra niños, niñas y adolescentes",2016,3,6,3218,186.451211932878,1,1679,59.5592614651578,5,1539,324.886289798571
21069,19,19807,81,"Tasa de exámenes médico legales por presunto delito sexual contra niños, niñas y adolescentes",2016,4,10,3377,296.120817293456,0,1788,0,10,1589,629.326620516048
21070,19,19807,121,Tasa de exámenes médico legales por presunto delito sexual cuando la víctima está entre 18 y 28 años,2016,5,3,6544,45.8435207823961,0,3431,0,3,3113,96.370061034372
21071,19,19821,81,"Tasa de exámenes médico legales por presunto delito sexual contra niños, niñas y adolescentes",2016,3,1,3801,26.3088660878716,0,1935,0,1,1866,53.5905680600214
21072,19,19824,81,"Tasa de exámenes médico legales por presunto delito sexual contra niños, niñas y adolescentes",2016,3,1,2661,37.5798571965427,0,1358,0,1,1303,76.7459708365311
21073,19,19824,81,"Tasa de exámenes médico legales por presunto delito sexual contra niños, niñas y adolescentes",2016,4,2,2684,74.5156482861401,0,1365,0,2,1319,151.630022744503
21074,19,19824,121,Tasa de exámenes médico legales por presunto delito sexual cuando la víctima está entre 18 y 28 años,2016,5,3,3994,75.1126690035053,0,2050,0,3,1944,154.320987654321
21075,19,19845,81,"Tasa de exámenes médico legales por presunto delito sexual contra niños, niñas y adolescentes",2016,2,1,1585,63.0914826498423,0,808,0,1,777,128.700128700129
21076,19,19845,81,"Tasa de exámenes médico legales por presunto delito sexual contra niños, niñas y adolescentes",2016,3,4,1918,208.550573514077,1,974,102.669404517454,3,944,317.796610169492
21077,19,19845,81,"Tasa de exámenes médico legales por presunto delito sexual contra niños, niñas y adolescentes",2016,4,1,1991,50.2260170768458,0,1015,0,1,976,102.459016393443
21078,20,20001,81,"Tasa de exámenes médico legales por presunto delito sexual contra niños, niñas y adolescentes",2016,2,47,44557,105.482864645286,11,22690,48.4795063904804,36,21867,164.631636712855
21079,20,20001,81,"Tasa de exámenes médico legales por presunto delito sexual contra niños, niñas y adolescentes",2016,3,94,54571,172.252661670118,22,27599,79.7130330809087,72,26972,266.94349695981
21080,20,20001,81,"Tasa de exámenes médico legales por presunto delito sexual contra niños, niñas y adolescentes",2016,4,126,55738,226.057626753741,9,28306,31.7953790715749,117,27432,426.509186351706
21081,20,20001,121,Tasa de exámenes médico legales por presunto delito sexual cuando la víctima está entre 18 y 28 años,2016,5,39,93784,41.5849185362109,2,47761,4.18751701178786,37,46023,80.3945853160376
21082,20,20001,81,"Tasa de exámenes médico legales por presunto delito sexual contra niños, niñas y adolescentes",2016,1,1,8889,11.2498593767578,0,4566,0,1,4323,23.1320842007865
21083,20,20011,81,"Tasa de exámenes médico legales por presunto delito sexual contra niños, niñas y adolescentes",2016,2,8,9665,82.77289187791,1,4912,20.3583061889251,7,4753,147.275405007364
21084,20,20011,81,"Tasa de exámenes médico legales por presunto delito sexual contra niños, niñas y adolescentes",2016,3,15,11465,130.832969908417,4,5834,68.5635927322592,11,5631,195.347185224649
21085,20,20011,81,"Tasa de exámenes médico legales por presunto delito sexual contra niños, niñas y adolescentes",2016,4,21,11304,185.774946921444,1,5683,17.5963399612881,20,5621,355.808574986657
21086,20,20011,121,Tasa de exámenes médico legales por presunto delito sexual cuando la víctima está entre 18 y 28 años,2016,5,1,19273,5.18860582161573,0,9599,0,1,9674,10.3369857349597
21087,20,20013,81,"Tasa de exámenes médico legales por presunto delito sexual contra niños, niñas y adolescentes",2016,2,2,5729,34.9101064758248,0,2933,0,2,2796,71.5307582260372
21088,20,20013,81,"Tasa de exámenes médico legales por presunto delito sexual contra niños, niñas y adolescentes",2016,3,8,6766,118.238250073899,2,3453,57.9206487112656,6,3313,181.104738907335
21089,20,20013,81,"Tasa de exámenes médico legales por presunto delito sexual contra niños, niñas y adolescentes",2016,4,21,6516,322.283609576427,3,3327,90.1713255184851,18,3189,564.440263405456
21090,20,20013,121,Tasa de exámenes médico legales por presunto delito sexual cuando la víctima está entre 18 y 28 años,2016,5,3,10025,29.925187032419,0,5199,0,3,4826,62.1632822213013
21091,20,20032,81,"Tasa de exámenes médico legales por presunto delito sexual contra niños, niñas y adolescentes",2016,3,3,2895,103.626943005181,2,1514,132.100396301189,1,1381,72.4112961622013
21092,20,20032,81,"Tasa de exámenes médico legales por presunto delito sexual contra niños, niñas y adolescentes",2016,4,2,2542,78.6782061369001,0,1333,0,2,1209,165.425971877585
21093,20,20045,81,"Tasa de exámenes médico legales por presunto delito sexual contra niños, niñas y adolescentes",2016,3,3,1813,165.471594043023,0,961,0,3,852,352.112676056338
21094,20,20045,81,"Tasa de exámenes médico legales por presunto delito sexual contra niños, niñas y adolescentes",2016,4,4,1798,222.469410456062,0,962,0,4,836,478.468899521531
21095,20,20045,121,Tasa de exámenes médico legales por presunto delito sexual cuando la víctima está entre 18 y 28 años,2016,5,2,2711,73.7735153080044,0,1450,0,2,1261,158.604282315623
21096,20,20060,81,"Tasa de exámenes médico legales por presunto delito sexual contra niños, niñas y adolescentes",2016,2,3,4640,64.6551724137931,0,2374,0,3,2266,132.391879964696
21097,20,20060,81,"Tasa de exámenes médico legales por presunto delito sexual contra niños, niñas y adolescentes",2016,3,10,5424,184.365781710914,3,2796,107.296137339056,7,2628,266.362252663623
21098,20,20060,81,"Tasa de exámenes médico legales por presunto delito sexual contra niños, niñas y adolescentes",2016,4,14,5042,277.667592225307,1,2604,38.4024577572965,13,2438,533.223954060706
21099,20,20060,121,Tasa de exámenes médico legales por presunto delito sexual cuando la víctima está entre 18 y 28 años,2016,5,2,7482,26.7308206361935,0,3862,0,2,3620,55.2486187845304
21100,20,20175,81,"Tasa de exámenes médico legales por presunto delito sexual contra niños, niñas y adolescentes",2016,2,1,3971,25.182573659028,1,2047,48.8519785051295,0,1924,0
21101,20,20175,81,"Tasa de exámenes médico legales por presunto delito sexual contra niños, niñas y adolescentes",2016,3,3,4499,66.6814847743943,0,2371,0,3,2128,140.977443609023
21102,20,20175,81,"Tasa de exámenes médico legales por presunto delito sexual contra niños, niñas y adolescentes",2016,4,2,4149,48.2043865991805,0,2231,0,2,1918,104.275286757039
21103,20,20178,81,"Tasa de exámenes médico legales por presunto delito sexual contra niños, niñas y adolescentes",2016,2,1,2245,44.543429844098,0,1149,0,1,1096,91.2408759124088
21104,20,20178,81,"Tasa de exámenes médico legales por presunto delito sexual contra niños, niñas y adolescentes",2016,3,6,2674,224.382946896036,0,1370,0,6,1304,460.122699386503
21105,20,20178,81,"Tasa de exámenes médico legales por presunto delito sexual contra niños, niñas y adolescentes",2016,4,6,2475,242.424242424242,0,1266,0,6,1209,496.277915632754
21106,20,20228,81,"Tasa de exámenes médico legales por presunto delito sexual contra niños, niñas y adolescentes",2016,3,3,3129,95.8772770853308,1,1600,62.5,2,1529,130.80444735121
21107,20,20228,81,"Tasa de exámenes médico legales por presunto delito sexual contra niños, niñas y adolescentes",2016,4,1,2954,33.85240352065,0,1489,0,1,1465,68.259385665529
21108,20,20228,121,Tasa de exámenes médico legales por presunto delito sexual cuando la víctima está entre 18 y 28 años,2016,5,1,4741,21.092596498629,0,2360,0,1,2381,41.9991600167997
21109,20,20238,81,"Tasa de exámenes médico legales por presunto delito sexual contra niños, niñas y adolescentes",2016,2,3,3185,94.1915227629513,1,1628,61.4250614250614,2,1557,128.452151573539
21110,20,20238,81,"Tasa de exámenes médico legales por presunto delito sexual contra niños, niñas y adolescentes",2016,4,5,3449,144.969556393157,0,1745,0,5,1704,293.427230046948
21111,20,20238,121,Tasa de exámenes médico legales por presunto delito sexual cuando la víctima está entre 18 y 28 años,2016,5,2,5373,37.2231528010423,0,2776,0,2,2597,77.0119368502118
21112,20,20250,81,"Tasa de exámenes médico legales por presunto delito sexual contra niños, niñas y adolescentes",2016,2,3,2865,104.712041884817,2,1470,136.054421768707,1,1395,71.6845878136201
21113,20,20250,81,"Tasa de exámenes médico legales por presunto delito sexual contra niños, niñas y adolescentes",2016,4,9,3110,289.389067524116,0,1576,0,9,1534,586.701434159061
21114,20,20250,121,Tasa de exámenes médico legales por presunto delito sexual cuando la víctima está entre 18 y 28 años,2016,5,1,4630,21.5982721382289,0,2323,0,1,2307,43.3463372345037
21115,20,20383,81,"Tasa de exámenes médico legales por presunto delito sexual contra niños, niñas y adolescentes",2016,3,2,1690,118.343195266272,0,886,0,2,804,248.756218905473
21116,20,20383,81,"Tasa de exámenes médico legales por presunto delito sexual contra niños, niñas y adolescentes",2016,4,6,1593,376.647834274953,0,844,0,6,749,801.068090787717
21117,20,20400,81,"Tasa de exámenes médico legales por presunto delito sexual contra niños, niñas y adolescentes",2016,3,2,2891,69.1802144586648,1,1513,66.0938532716457,1,1378,72.5689404934688
21118,20,20400,81,"Tasa de exámenes médico legales por presunto delito sexual contra niños, niñas y adolescentes",2016,4,3,2738,109.569028487947,0,1454,0,3,1284,233.644859813084
21119,20,20443,81,"Tasa de exámenes médico legales por presunto delito sexual contra niños, niñas y adolescentes",2016,2,1,1680,59.5238095238095,0,865,0,1,815,122.699386503067
21120,20,20443,81,"Tasa de exámenes médico legales por presunto delito sexual contra niños, niñas y adolescentes",2016,3,1,1981,50.4795557799091,0,1026,0,1,955,104.712041884817
21121,20,20550,81,"Tasa de exámenes médico legales por presunto delito sexual contra niños, niñas y adolescentes",2016,2,2,2068,96.7117988394584,0,1056,0,2,1012,197.628458498024
21122,20,20550,81,"Tasa de exámenes médico legales por presunto delito sexual contra niños, niñas y adolescentes",2016,3,4,2417,165.494414563508,0,1238,0,4,1179,339.270568278202
21123,20,20550,81,"Tasa de exámenes médico legales por presunto delito sexual contra niños, niñas y adolescentes",2016,4,1,2273,43.994720633524,0,1161,0,1,1112,89.9280575539568
21124,20,20570,81,"Tasa de exámenes médico legales por presunto delito sexual contra niños, niñas y adolescentes",2016,2,2,3132,63.8569604086846,1,1616,61.8811881188119,1,1516,65.9630606860158
21125,20,20570,81,"Tasa de exámenes médico legales por presunto delito sexual contra niños, niñas y adolescentes",2016,3,6,3396,176.678445229682,1,1784,56.0538116591928,5,1612,310.173697270472
21126,20,20570,81,"Tasa de exámenes médico legales por presunto delito sexual contra niños, niñas y adolescentes",2016,4,4,3359,119.083060434653,0,1786,0,4,1573,254.291163382072
21127,20,20570,121,Tasa de exámenes médico legales por presunto delito sexual cuando la víctima está entre 18 y 28 años,2016,5,2,4897,40.8413314274045,0,2598,0,2,2299,86.9943453675511
21128,20,20614,81,"Tasa de exámenes médico legales por presunto delito sexual contra niños, niñas y adolescentes",2016,3,1,1481,67.5219446320054,0,764,0,1,717,139.470013947001
21129,20,20614,81,"Tasa de exámenes médico legales por presunto delito sexual contra niños, niñas y adolescentes",2016,4,2,1489,134.318334452653,0,784,0,2,705,283.687943262411
21130,20,20621,81,"Tasa de exámenes médico legales por presunto delito sexual contra niños, niñas y adolescentes",2016,3,5,3041,164.419598816179,0,1570,0,5,1471,339.904826648538
21131,20,20621,81,"Tasa de exámenes médico legales por presunto delito sexual contra niños, niñas y adolescentes",2016,4,2,2990,66.8896321070234,0,1541,0,2,1449,138.026224982747
21132,20,20621,121,Tasa de exámenes médico legales por presunto delito sexual cuando la víctima está entre 18 y 28 años,2016,5,2,4334,46.1467466543609,0,2240,0,2,2094,95.5109837631328
21133,20,20710,81,"Tasa de exámenes médico legales por presunto delito sexual contra niños, niñas y adolescentes",2016,2,1,2542,39.33910306845,0,1295,0,1,1247,80.1924619085806
21134,20,20710,81,"Tasa de exámenes médico legales por presunto delito sexual contra niños, niñas y adolescentes",2016,3,4,2937,136.193394620361,1,1486,67.2947510094213,3,1451,206.753962784287
21135,20,20710,121,Tasa de exámenes médico legales por presunto delito sexual cuando la víctima está entre 18 y 28 años,2016,5,1,5346,18.7055742611298,0,2669,0,1,2677,37.3552484124019
21136,20,20750,81,"Tasa de exámenes médico legales por presunto delito sexual contra niños, niñas y adolescentes",2016,4,2,1663,120.264582080577,0,882,0,2,781,256.081946222791
21137,20,20770,81,"Tasa de exámenes médico legales por presunto delito sexual contra niños, niñas y adolescentes",2016,3,1,2283,43.8020148926851,0,1177,0,1,1106,90.4159132007233
21138,20,20770,81,"Tasa de exámenes médico legales por presunto delito sexual contra niños, niñas y adolescentes",2016,4,2,2229,89.7263346792283,1,1146,87.260034904014,1,1083,92.3361034164358
21139,20,20787,81,"Tasa de exámenes médico legales por presunto delito sexual contra niños, niñas y adolescentes",2016,4,1,1727,57.9038795599305,1,916,109.170305676856,0,811,0
21140,23,23001,81,"Tasa de exámenes médico legales por presunto delito sexual contra niños, niñas y adolescentes",2016,2,25,40499,61.7299192572656,5,20616,24.2530073729142,20,19883,100.58844238797
21141,23,23001,81,"Tasa de exámenes médico legales por presunto delito sexual contra niños, niñas y adolescentes",2016,3,71,49381,143.779996354873,12,24905,48.1830957639028,59,24476,241.052459552214
21142,23,23001,81,"Tasa de exámenes médico legales por presunto delito sexual contra niños, niñas y adolescentes",2016,4,125,49277,253.668039856322,10,24746,40.4105714054797,115,24531,468.794586441645
21143,23,23001,121,Tasa de exámenes médico legales por presunto delito sexual cuando la víctima está entre 18 y 28 años,2016,5,25,89466,27.9435763306731,2,45417,4.40363740449611,23,44049,52.2145792185975
21144,23,23068,81,"Tasa de exámenes médico legales por presunto delito sexual contra niños, niñas y adolescentes",2016,4,1,6383,15.6666144446185,0,3449,0,1,2934,34.0831629175188
21145,23,23079,81,"Tasa de exámenes médico legales por presunto delito sexual contra niños, niñas y adolescentes",2016,4,2,2684,74.5156482861401,0,1451,0,2,1233,162.20600162206
21146,23,23090,81,"Tasa de exámenes médico legales por presunto delito sexual contra niños, niñas y adolescentes",2016,3,2,2728,73.3137829912023,1,1471,67.9809653297077,1,1257,79.5544948289578
21147,23,23090,81,"Tasa de exámenes médico legales por presunto delito sexual contra niños, niñas y adolescentes",2016,4,5,2608,191.717791411043,0,1448,0,5,1160,431.034482758621
21148,23,23162,81,"Tasa de exámenes médico legales por presunto delito sexual contra niños, niñas y adolescentes",2016,2,2,8143,24.5609726145155,0,4164,0,2,3979,50.2638853983413
21149,23,23162,81,"Tasa de exámenes médico legales por presunto delito sexual contra niños, niñas y adolescentes",2016,3,12,9848,121.852152721365,1,4941,20.2388180530257,11,4907,224.169553698798
21150,23,23162,81,"Tasa de exámenes médico legales por presunto delito sexual contra niños, niñas y adolescentes",2016,4,19,9841,193.069809978661,1,4888,20.4582651391162,18,4953,363.416111447608
21151,23,23162,121,Tasa de exámenes médico legales por presunto delito sexual cuando la víctima está entre 18 y 28 años,2016,5,6,17865,33.5852225020991,1,8961,11.1594688092847,5,8904,56.1545372866128
21152,23,23168,81,"Tasa de exámenes médico legales por presunto delito sexual contra niños, niñas y adolescentes",2016,2,1,1455,68.7285223367698,1,754,132.62599469496,0,701,0
21153,23,23168,81,"Tasa de exámenes médico legales por presunto delito sexual contra niños, niñas y adolescentes",2016,3,1,1764,56.6893424036281,0,911,0,1,853,117.233294255569
21154,23,23168,81,"Tasa de exámenes médico legales por presunto delito sexual contra niños, niñas y adolescentes",2016,4,4,1665,240.24024024024,1,862,116.009280742459,3,803,373.59900373599
21155,23,23182,81,"Tasa de exámenes médico legales por presunto delito sexual contra niños, niñas y adolescentes",2016,2,2,4375,45.7142857142857,1,2206,45.3309156844968,1,2169,46.1041954817888
21156,23,23182,81,"Tasa de exámenes médico legales por presunto delito sexual contra niños, niñas y adolescentes",2016,3,1,5097,19.6193839513439,0,2550,0,1,2547,39.2618767177071
21157,23,23182,81,"Tasa de exámenes médico legales por presunto delito sexual contra niños, niñas y adolescentes",2016,4,7,4917,142.363229611552,2,2467,81.0701256586948,5,2450,204.081632653061
21158,23,23189,81,"Tasa de exámenes médico legales por presunto delito sexual contra niños, niñas y adolescentes",2016,3,11,7661,143.584388461036,5,3962,126.198889449773,6,3699,162.20600162206
21159,23,23189,81,"Tasa de exámenes médico legales por presunto delito sexual contra niños, niñas y adolescentes",2016,4,13,7428,175.013462574044,0,3834,0,13,3594,361.713967723984
21160,23,23300,81,"Tasa de exámenes médico legales por presunto delito sexual contra niños, niñas y adolescentes",2016,3,1,1508,66.3129973474801,0,776,0,1,732,136.612021857924
21161,23,23300,81,"Tasa de exámenes médico legales por presunto delito sexual contra niños, niñas y adolescentes",2016,4,1,1548,64.5994832041344,0,796,0,1,752,132.978723404255
21162,23,23300,121,Tasa de exámenes médico legales por presunto delito sexual cuando la víctima está entre 18 y 28 años,2016,5,1,2868,34.8675034867503,0,1465,0,1,1403,71.2758374910905
21163,23,23350,81,"Tasa de exámenes médico legales por presunto delito sexual contra niños, niñas y adolescentes",2016,4,1,1970,50.761421319797,0,992,0,1,978,102.249488752556
21164,23,23417,81,"Tasa de exámenes médico legales por presunto delito sexual contra niños, niñas y adolescentes",2016,2,4,12099,33.0605835192991,0,6195,0,4,5904,67.7506775067751
21165,23,23417,81,"Tasa de exámenes médico legales por presunto delito sexual contra niños, niñas y adolescentes",2016,3,8,14160,56.4971751412429,2,7280,27.4725274725275,6,6880,87.2093023255814
21166,23,23417,81,"Tasa de exámenes médico legales por presunto delito sexual contra niños, niñas y adolescentes",2016,4,18,13376,134.569377990431,0,6822,0,18,6554,274.641440341776
21167,23,23417,121,Tasa de exámenes médico legales por presunto delito sexual cuando la víctima está entre 18 y 28 años,2016,5,2,23617,8.46847609772621,0,12158,0,2,11459,17.4535299764377
21168,23,23419,81,"Tasa de exámenes médico legales por presunto delito sexual contra niños, niñas y adolescentes",2016,4,4,3195,125.195618153365,1,1652,60.5326876513317,3,1543,194.426441996111
21169,23,23464,81,"Tasa de exámenes médico legales por presunto delito sexual contra niños, niñas y adolescentes",2016,2,1,1468,68.1198910081744,0,756,0,1,712,140.449438202247
21170,23,23464,81,"Tasa de exámenes médico legales por presunto delito sexual contra niños, niñas y adolescentes",2016,4,2,1672,119.617224880383,0,851,0,2,821,243.605359317905
21171,23,23466,81,"Tasa de exámenes médico legales por presunto delito sexual contra niños, niñas y adolescentes",2016,2,3,9183,32.6690623979092,1,4672,21.4041095890411,2,4511,44.3360673908224
21172,23,23466,81,"Tasa de exámenes médico legales por presunto delito sexual contra niños, niñas y adolescentes",2016,3,4,10521,38.0191996958464,0,5307,0,4,5214,76.7165324127349
21173,23,23466,81,"Tasa de exámenes médico legales por presunto delito sexual contra niños, niñas y adolescentes",2016,4,13,10015,129.805292061907,0,4964,0,13,5051,257.374777271827
21174,23,23466,121,Tasa de exámenes médico legales por presunto delito sexual cuando la víctima está entre 18 y 28 años,2016,5,2,17505,11.4253070551271,0,8678,0,2,8827,22.6577546165175
21175,23,23500,81,"Tasa de exámenes médico legales por presunto delito sexual contra niños, niñas y adolescentes",2016,2,1,3492,28.6368843069874,0,1795,0,1,1697,58.9275191514437
21176,23,23500,81,"Tasa de exámenes médico legales por presunto delito sexual contra niños, niñas y adolescentes",2016,3,2,3813,52.4521374246001,0,1967,0,2,1846,108.342361863489
21177,23,23500,81,"Tasa de exámenes médico legales por presunto delito sexual contra niños, niñas y adolescentes",2016,4,4,3413,117.198945209493,0,1759,0,4,1654,241.837968561064
21178,23,23555,81,"Tasa de exámenes médico legales por presunto delito sexual contra niños, niñas y adolescentes",2016,2,1,6880,14.5348837209302,0,3513,0,1,3367,29.7000297000297
21179,23,23555,81,"Tasa de exámenes médico legales por presunto delito sexual contra niños, niñas y adolescentes",2016,3,6,8078,74.2758108442684,0,4111,0,6,3967,151.247794303
21180,23,23555,81,"Tasa de exámenes médico legales por presunto delito sexual contra niños, niñas y adolescentes",2016,4,13,7703,168.76541607166,0,3918,0,13,3785,343.461030383091
21181,23,23555,121,Tasa de exámenes médico legales por presunto delito sexual cuando la víctima está entre 18 y 28 años,2016,5,3,13873,21.624738701074,1,7070,14.1442715700141,2,6803,29.3987946494194
21182,23,23555,81,"Tasa de exámenes médico legales por presunto delito sexual contra niños, niñas y adolescentes",2016,1,1,1378,72.5689404934688,0,706,0,1,672,148.809523809524
21183,23,23570,81,"Tasa de exámenes médico legales por presunto delito sexual contra niños, niñas y adolescentes",2016,3,1,5017,19.9322304165836,1,2575,38.8349514563107,0,2442,0
21184,23,23570,121,Tasa de exámenes médico legales por presunto delito sexual cuando la víctima está entre 18 y 28 años,2016,5,1,7864,12.7161749745677,0,4103,0,1,3761,26.5886732252061
21185,23,23574,81,"Tasa de exámenes médico legales por presunto delito sexual contra niños, niñas y adolescentes",2016,3,3,4057,73.9462657135815,1,2130,46.9483568075117,2,1927,103.788271925272
21186,23,23574,81,"Tasa de exámenes médico legales por presunto delito sexual contra niños, niñas y adolescentes",2016,4,3,3717,80.7102502017756,0,1987,0,3,1730,173.410404624277
21187,23,23574,121,Tasa de exámenes médico legales por presunto delito sexual cuando la víctima está entre 18 y 28 años,2016,5,1,6267,15.956598053295,0,3374,0,1,2893,34.5661942620118
21188,23,23580,81,"Tasa de exámenes médico legales por presunto delito sexual contra niños, niñas y adolescentes",2016,4,1,6305,15.8604282315623,0,3255,0,1,3050,32.7868852459016
21189,23,23586,81,"Tasa de exámenes médico legales por presunto delito sexual contra niños, niñas y adolescentes",2016,2,1,1603,62.3830318153462,0,823,0,1,780,128.205128205128
21190,23,23586,81,"Tasa de exámenes médico legales por presunto delito sexual contra niños, niñas y adolescentes",2016,3,2,1863,107.353730542136,0,971,0,2,892,224.215246636771
21191,23,23586,81,"Tasa de exámenes médico legales por presunto delito sexual contra niños, niñas y adolescentes",2016,4,1,1775,56.3380281690141,0,923,0,1,852,117.370892018779
21192,23,23660,81,"Tasa de exámenes médico legales por presunto delito sexual contra niños, niñas y adolescentes",2016,2,3,8472,35.4107648725213,1,4326,23.1160425335183,2,4146,48.2392667631452
21193,23,23660,81,"Tasa de exámenes médico legales por presunto delito sexual contra niños, niñas y adolescentes",2016,3,4,10024,39.9042298483639,0,5106,0,4,4918,81.3338755591704
21194,23,23660,81,"Tasa de exámenes médico legales por presunto delito sexual contra niños, niñas y adolescentes",2016,4,5,9793,51.0568773613806,0,4984,0,5,4809,103.971719692244
21195,23,23660,121,Tasa de exámenes médico legales por presunto delito sexual cuando la víctima está entre 18 y 28 años,2016,5,1,17658,5.66315551025031,0,9074,0,1,8584,11.6495806150979
21196,23,23670,81,"Tasa de exámenes médico legales por presunto delito sexual contra niños, niñas y adolescentes",2016,3,3,5873,51.0812191384301,0,2991,0,3,2882,104.094378903539
21197,23,23670,81,"Tasa de exámenes médico legales por presunto delito sexual contra niños, niñas y adolescentes",2016,4,3,5495,54.5950864422202,0,2875,0,3,2620,114.503816793893
21198,23,23672,81,"Tasa de exámenes médico legales por presunto delito sexual contra niños, niñas y adolescentes",2016,2,1,3247,30.7976593778873,0,1651,0,1,1596,62.65664160401
21199,23,23672,81,"Tasa de exámenes médico legales por presunto delito sexual contra niños, niñas y adolescentes",2016,3,2,3702,54.0248514316586,0,1879,0,2,1823,109.709270433352
21200,23,23672,81,"Tasa de exámenes médico legales por presunto delito sexual contra niños, niñas y adolescentes",2016,4,3,3569,84.0571588680303,0,1828,0,3,1741,172.314761631246
21201,23,23675,81,"Tasa de exámenes médico legales por presunto delito sexual contra niños, niñas y adolescentes",2016,3,3,4220,71.0900473933649,0,2214,0,3,2006,149.551345962114
21202,23,23675,81,"Tasa de exámenes médico legales por presunto delito sexual contra niños, niñas y adolescentes",2016,4,5,3889,128.567755206994,0,2057,0,5,1832,272.92576419214
21203,23,23678,81,"Tasa de exámenes médico legales por presunto delito sexual contra niños, niñas y adolescentes",2016,2,1,2982,33.5345405767941,0,1519,0,1,1463,68.3526999316473
21204,23,23678,81,"Tasa de exámenes médico legales por presunto delito sexual contra niños, niñas y adolescentes",2016,3,3,3366,89.126559714795,0,1712,0,3,1654,181.378476420798
21205,23,23678,81,"Tasa de exámenes médico legales por presunto delito sexual contra niños, niñas y adolescentes",2016,4,1,3109,32.1646831778707,0,1583,0,1,1526,65.5307994757536
21206,23,23682,81,"Tasa de exámenes médico legales por presunto delito sexual contra niños, niñas y adolescentes",2016,4,1,1377,72.6216412490922,0,727,0,1,650,153.846153846154
21207,23,23682,121,Tasa de exámenes médico legales por presunto delito sexual cuando la víctima está entre 18 y 28 años,2016,5,2,2237,89.4054537326777,0,1145,0,2,1092,183.150183150183
21208,23,23686,81,"Tasa de exámenes médico legales por presunto delito sexual contra niños, niñas y adolescentes",2016,3,1,4719,21.1909302818394,0,2413,0,1,2306,43.3651344319167
21209,23,23686,81,"Tasa de exámenes médico legales por presunto delito sexual contra niños, niñas y adolescentes",2016,4,7,4703,148.841165213693,0,2389,0,7,2314,302.506482281763
21210,23,23686,121,Tasa de exámenes médico legales por presunto delito sexual cuando la víctima está entre 18 y 28 años,2016,5,1,8417,11.8807175953428,0,4285,0,1,4132,24.2013552758955
21211,23,23807,81,"Tasa de exámenes médico legales por presunto delito sexual contra niños, niñas y adolescentes",2016,2,1,12901,7.75133710565072,0,6582,0,1,6319,15.8252888115208
21212,23,23807,81,"Tasa de exámenes médico legales por presunto delito sexual contra niños, niñas y adolescentes",2016,3,4,14173,28.2226769209059,0,7236,0,4,6937,57.6618134640334
21213,23,23807,81,"Tasa de exámenes médico legales por presunto delito sexual contra niños, niñas y adolescentes",2016,4,6,13132,45.689917758148,0,6711,0,6,6421,93.4433888802367
21214,23,23807,121,Tasa de exámenes médico legales por presunto delito sexual cuando la víctima está entre 18 y 28 años,2016,5,1,21495,4.65224470807164,0,10991,0,1,10504,9.52018278750952
21215,23,23815,81,"Tasa de exámenes médico legales por presunto delito sexual contra niños, niñas y adolescentes",2016,2,1,5734,17.4398325776073,0,2960,0,1,2774,36.0490266762797
21216,23,23815,81,"Tasa de exámenes médico legales por presunto delito sexual contra niños, niñas y adolescentes",2016,4,1,5388,18.5597624350408,0,2735,0,1,2653,37.6931775348662
21217,23,23855,81,"Tasa de exámenes médico legales por presunto delito sexual contra niños, niñas y adolescentes",2016,3,1,5820,17.1821305841924,0,3012,0,1,2808,35.6125356125356
21218,23,23855,81,"Tasa de exámenes médico legales por presunto delito sexual contra niños, niñas y adolescentes",2016,4,2,5427,36.8527731711811,0,2826,0,2,2601,76.8935024990388
21219,25,25001,81,"Tasa de exámenes médico legales por presunto delito sexual contra niños, niñas y adolescentes",2016,2,1,886,112.866817155756,0,455,0,1,431,232.018561484919
21220,25,25001,81,"Tasa de exámenes médico legales por presunto delito sexual contra niños, niñas y adolescentes",2016,3,3,1061,282.752120640905,2,551,362.976406533575,1,510,196.078431372549
21221,25,25001,81,"Tasa de exámenes médico legales por presunto delito sexual contra niños, niñas y adolescentes",2016,4,1,1033,96.805421103581807,0,531,0,1,502,199.203187250996
21222,25,25019,81,"Tasa de exámenes médico legales por presunto delito sexual contra niños, niñas y adolescentes",2016,3,1,613,163.132137030995,0,303,0,1,310,322.58064516129
21223,25,25035,81,"Tasa de exámenes médico legales por presunto delito sexual contra niños, niñas y adolescentes",2016,2,1,1087,91.9963201471941,0,554,0,1,533,187.617260787993
21224,25,25035,81,"Tasa de exámenes médico legales por presunto delito sexual contra niños, niñas y adolescentes",2016,3,5,1215,411.522633744856,0,617,0,5,598,836.120401337793
21225,25,25035,81,"Tasa de exámenes médico legales por presunto delito sexual contra niños, niñas y adolescentes",2016,4,1,1289,77.5795190069822,0,657,0,1,632,158.227848101266
21226,25,25040,81,"Tasa de exámenes médico legales por presunto delito sexual contra niños, niñas y adolescentes",2016,2,3,1014,295.85798816568,2,518,386.100386100386,1,496,201.612903225806
21227,25,25040,81,"Tasa de exámenes médico legales por presunto delito sexual contra niños, niñas y adolescentes",2016,3,3,1195,251.046025104603,0,613,0,3,582,515.463917525773
21228,25,25040,81,"Tasa de exámenes médico legales por presunto delito sexual contra niños, niñas y adolescentes",2016,4,10,1107,903.342366757001,0,577,0,10,530,1886.79245283019
21229,25,25040,121,Tasa de exámenes médico legales por presunto delito sexual cuando la víctima está entre 18 y 28 años,2016,5,3,2158,139.017608897127,1,1151,86.8809730668984,2,1007,198.609731876862
21230,25,25053,81,"Tasa de exámenes médico legales por presunto delito sexual contra niños, niñas y adolescentes",2016,3,2,1478,135.31799729364,0,756,0,2,722,277.008310249308
21231,25,25053,81,"Tasa de exámenes médico legales por presunto delito sexual contra niños, niñas y adolescentes",2016,4,2,1430,139.86013986014,1,718,139.275766016713,1,712,140.449438202247
21232,25,25095,81,"Tasa de exámenes médico legales por presunto delito sexual contra niños, niñas y adolescentes",2016,2,1,245,408.163265306122,1,129,775.193798449612,0,116,0
21233,25,25099,81,"Tasa de exámenes médico legales por presunto delito sexual contra niños, niñas y adolescentes",2016,2,3,1294,231.839258114374,2,658,303.951367781155,1,636,157.232704402516
21234,25,25099,81,"Tasa de exámenes médico legales por presunto delito sexual contra niños, niñas y adolescentes",2016,3,2,1532,130.548302872063,0,776,0,2,756,264.550264550265
21235,25,25099,81,"Tasa de exámenes médico legales por presunto delito sexual contra niños, niñas y adolescentes",2016,4,2,1438,139.082058414465,0,731,0,2,707,282.885431400283
21236,25,25099,121,Tasa de exámenes médico legales por presunto delito sexual cuando la víctima está entre 18 y 28 años,2016,5,1,2277,43.9174352217831,0,1157,0,1,1120,89.2857142857143
21237,25,25123,81,"Tasa de exámenes médico legales por presunto delito sexual contra niños, niñas y adolescentes",2016,3,3,1260,238.095238095238,0,635,0,3,625,480
21238,25,25123,81,"Tasa de exámenes médico legales por presunto delito sexual contra niños, niñas y adolescentes",2016,4,6,1224,490.196078431373,1,623,160.513643659711,5,601,831.946755407654
21239,25,25126,81,"Tasa de exámenes médico legales por presunto delito sexual contra niños, niñas y adolescentes",2016,2,4,4876,82.0344544708778,1,2489,40.1767778224186,3,2387,125.680770842061
21240,25,25126,81,"Tasa de exámenes médico legales por presunto delito sexual contra niños, niñas y adolescentes",2016,3,22,6221,353.640893746986,2,3261,61.3308800981294,20,2960,675.675675675676
21241,25,25126,81,"Tasa de exámenes médico legales por presunto delito sexual contra niños, niñas y adolescentes",2016,4,18,6292,286.077558804832,3,3302,90.8540278619019,15,2990,501.672240802676
21242,25,25126,121,Tasa de exámenes médico legales por presunto delito sexual cuando la víctima está entre 18 y 28 años,2016,5,1,11466,8.72143729286587,0,5923,0,1,5543,18.0407721450478
21243,25,25151,81,"Tasa de exámenes médico legales por presunto delito sexual contra niños, niñas y adolescentes",2016,3,2,1763,113.442994895065,0,906,0,2,857,233.372228704784
21244,25,25151,81,"Tasa de exámenes médico legales por presunto delito sexual contra niños, niñas y adolescentes",2016,4,2,1725,115.942028985507,0,893,0,2,832,240.384615384615
21245,25,25151,121,Tasa de exámenes médico legales por presunto delito sexual cuando la víctima está entre 18 y 28 años,2016,5,1,3292,30.3766707168894,0,1719,0,1,1573,63.5727908455181
21246,25,25154,81,"Tasa de exámenes médico legales por presunto delito sexual contra niños, niñas y adolescentes",2016,2,1,774,129.198966408269,0,399,0,1,375,266.666666666667
21247,25,25168,81,"Tasa de exámenes médico legales por presunto delito sexual contra niños, niñas y adolescentes",2016,2,1,385,259.74025974026,0,197,0,1,188,531.914893617021
21248,25,25168,81,"Tasa de exámenes médico legales por presunto delito sexual contra niños, niñas y adolescentes",2016,3,2,430,465.116279069767,1,222,450.45045045045,1,208,480.769230769231
21249,25,25168,81,"Tasa de exámenes médico legales por presunto delito sexual contra niños, niñas y adolescentes",2016,4,1,423,236.406619385343,0,221,0,1,202,495.049504950495
21250,25,25175,81,"Tasa de exámenes médico legales por presunto delito sexual contra niños, niñas y adolescentes",2016,2,1,10354,9.65810314854163,0,5286,0,1,5068,19.7316495659037
21251,25,25175,81,"Tasa de exámenes médico legales por presunto delito sexual contra niños, niñas y adolescentes",2016,3,4,12832,31.1720698254364,0,6558,0,4,6274,63.7551801083838
21252,25,25175,81,"Tasa de exámenes médico legales por presunto delito sexual contra niños, niñas y adolescentes",2016,4,6,12938,46.3750193229247,1,6483,15.4249575813667,5,6455,77.4593338497289
21253,25,25175,121,Tasa de exámenes médico legales por presunto delito sexual cuando la víctima está entre 18 y 28 años,2016,5,1,24525,4.07747196738022,0,12126,0,1,12399,8.06516654568917
21254,25,25181,81,"Tasa de exámenes médico legales por presunto delito sexual contra niños, niñas y adolescentes",2016,3,3,1216,246.710526315789,0,619,0,3,597,502.51256281407
21255,25,25181,81,"Tasa de exámenes médico legales por presunto delito sexual contra niños, niñas y adolescentes",2016,4,1,1116,89.6057347670251,1,571,175.131348511384,0,545,0
21256,25,25183,81,"Tasa de exámenes médico legales por presunto delito sexual contra niños, niñas y adolescentes",2016,2,2,2398,83.4028356964137,0,1227,0,2,1171,170.794192997438
21257,25,25183,81,"Tasa de exámenes médico legales por presunto delito sexual contra niños, niñas y adolescentes",2016,3,2,2748,72.7802037845706,2,1392,143.67816091954,0,1356,0
21258,25,25183,81,"Tasa de exámenes médico legales por presunto delito sexual contra niños, niñas y adolescentes",2016,4,1,2649,37.7500943752359,0,1338,0,1,1311,76.27765064836
21259,25,25200,81,"Tasa de exámenes médico legales por presunto delito sexual contra niños, niñas y adolescentes",2016,2,1,2036,49.1159135559921,1,1039,96.2463907603465,0,997,0
21260,25,25200,81,"Tasa de exámenes médico legales por presunto delito sexual contra niños, niñas y adolescentes",2016,3,1,2454,40.7497962510187,0,1215,0,1,1239,80.7102502017756
21261,25,25200,81,"Tasa de exámenes médico legales por presunto delito sexual contra niños, niñas y adolescentes",2016,4,7,2487,281.463610776035,1,1261,79.3021411578113,6,1226,489.396411092985
21262,25,25200,121,Tasa de exámenes médico legales por presunto delito sexual cuando la víctima está entre 18 y 28 años,2016,5,1,4491,22.2667557336896,0,2288,0,1,2203,45.3926463912846
21263,25,25214,81,"Tasa de exámenes médico legales por presunto delito sexual contra niños, niñas y adolescentes",2016,3,1,2621,38.1533765738268,1,1334,74.9625187406297,0,1287,0
21264,25,25214,81,"Tasa de exámenes médico legales por presunto delito sexual contra niños, niñas y adolescentes",2016,4,2,2618,76.3941940412529,1,1312,76.219512195122,1,1306,76.5696784073507
21265,25,25224,81,"Tasa de exámenes médico legales por presunto delito sexual contra niños, niñas y adolescentes",2016,4,2,907,220.507166482911,0,471,0,2,436,458.715596330275
21266,25,25245,81,"Tasa de exámenes médico legales por presunto delito sexual contra niños, niñas y adolescentes",2016,2,4,1720,232.558139534884,1,883,113.250283125708,3,837,358.4229390681
21267,25,25245,81,"Tasa de exámenes médico legales por presunto delito sexual contra niños, niñas y adolescentes",2016,3,10,2124,470.809792843691,1,1074,93.1098696461825,9,1050,857.142857142857
21268,25,25245,81,"Tasa de exámenes médico legales por presunto delito sexual contra niños, niñas y adolescentes",2016,4,7,2169,322.729368372522,1,1103,90.6618313689937,6,1066,562.851782363978
21269,25,25245,121,Tasa de exámenes médico legales por presunto delito sexual cuando la víctima está entre 18 y 28 años,2016,5,2,4058,49.2853622474125,0,2033,0,2,2025,98.7654320987654
21270,25,25258,81,"Tasa de exámenes médico legales por presunto delito sexual contra niños, niñas y adolescentes",2016,4,1,436,229.357798165138,0,228,0,1,208,480.769230769231
21271,25,25258,121,Tasa de exámenes médico legales por presunto delito sexual cuando la víctima está entre 18 y 28 años,2016,5,1,895,111.731843575419,0,447,0,1,448,223.214285714286
21272,25,25260,81,"Tasa de exámenes médico legales por presunto delito sexual contra niños, niñas y adolescentes",2016,2,1,1767,56.5930956423316,0,904,0,1,863,115.874855156431
21273,25,25260,81,"Tasa de exámenes médico legales por presunto delito sexual contra niños, niñas y adolescentes",2016,3,7,2148,325.884543761639,1,1084,92.2509225092251,6,1064,563.90977443609
21274,25,25260,81,"Tasa de exámenes médico legales por presunto delito sexual contra niños, niñas y adolescentes",2016,4,4,2154,185.701021355617,0,1075,0,4,1079,370.713623725672
21275,25,25269,81,"Tasa de exámenes médico legales por presunto delito sexual contra niños, niñas y adolescentes",2016,2,11,11987,91.7660799199132,3,6151,48.7725573077548,8,5836,137.080191912269
21276,25,25269,81,"Tasa de exámenes médico legales por presunto delito sexual contra niños, niñas y adolescentes",2016,3,23,14789,155.52099533437,3,7564,39.6615547329455,20,7225,276.81660899654
21277,25,25269,81,"Tasa de exámenes médico legales por presunto delito sexual contra niños, niñas y adolescentes",2016,4,30,14606,205.395043132959,3,7514,39.925472451424,27,7092,380.710659898477
21278,25,25269,121,Tasa de exámenes médico legales por presunto delito sexual cuando la víctima está entre 18 y 28 años,2016,5,7,25877,27.0510491942652,0,13160,0,7,12717,55.0444287174648
21279,25,25279,81,"Tasa de exámenes médico legales por presunto delito sexual contra niños, niñas y adolescentes",2016,4,3,1146,261.780104712042,0,599,0,3,547,548.446069469836
21280,25,25281,121,Tasa de exámenes médico legales por presunto delito sexual cuando la víctima está entre 18 y 28 años,2016,5,1,1548,64.5994832041344,0,805,0,1,743,134.589502018843
21281,25,25286,81,"Tasa de exámenes médico legales por presunto delito sexual contra niños, niñas y adolescentes",2016,2,8,6654,120.228434024647,5,3406,146.799765120376,3,3248,92.3645320197044
21282,25,25286,81,"Tasa de exámenes médico legales por presunto delito sexual contra niños, niñas y adolescentes",2016,3,11,7990,137.672090112641,3,3981,75.3579502637528,8,4009,199.551010226989
21283,25,25286,81,"Tasa de exámenes médico legales por presunto delito sexual contra niños, niñas y adolescentes",2016,4,25,8091,308.985292300087,0,3983,0,25,4108,608.56864654333
21284,25,25286,121,Tasa de exámenes médico legales por presunto delito sexual cuando la víctima está entre 18 y 28 años,2016,5,7,15182,46.1072322487156,0,7250,0,7,7932,88.2501260716087
21285,25,25288,81,"Tasa de exámenes médico legales por presunto delito sexual contra niños, niñas y adolescentes",2016,3,3,617,486.223662884927,0,318,0,3,299,1003.34448160535
21286,25,25288,81,"Tasa de exámenes médico legales por presunto delito sexual contra niños, niñas y adolescentes",2016,4,1,598,167.224080267559,1,311,321.543408360129,0,287,0
21287,25,25290,81,"Tasa de exámenes médico legales por presunto delito sexual contra niños, niñas y adolescentes",2016,2,9,10636,84.6182775479504,1,5402,18.5116623472788,8,5234,152.84677111196
21288,25,25290,81,"Tasa de exámenes médico legales por presunto delito sexual contra niños, niñas y adolescentes",2016,3,18,12891,139.632301605771,5,6678,74.8727163821503,13,6213,209.238693062933
21289,25,25290,81,"Tasa de exámenes médico legales por presunto delito sexual contra niños, niñas y adolescentes",2016,4,31,12162,254.892287452722,2,5960,33.5570469798658,29,6202,467.591099645276
21290,25,25290,121,Tasa de exámenes médico legales por presunto delito sexual cuando la víctima está entre 18 y 28 años,2016,5,7,25611,27.3320057787669,2,13027,15.3527289475704,5,12584,39.7329942784488
21291,25,25295,81,"Tasa de exámenes médico legales por presunto delito sexual contra niños, niñas y adolescentes",2016,3,1,1937,51.6262261228704,1,993,100.704934541793,0,944,0
21292,25,25295,81,"Tasa de exámenes médico legales por presunto delito sexual contra niños, niñas y adolescentes",2016,4,4,1863,214.707461084273,0,949,0,4,914,437.636761487965
21293,25,25295,81,"Tasa de exámenes médico legales por presunto delito sexual contra niños, niñas y adolescentes",2016,1,1,347,288.184438040346,0,177,0,1,170,588.235294117647
21294,25,25297,81,"Tasa de exámenes médico legales por presunto delito sexual contra niños, niñas y adolescentes",2016,3,1,1116,89.6057347670251,0,547,0,1,569,175.746924428823
21295,25,25307,81,"Tasa de exámenes médico legales por presunto delito sexual contra niños, niñas y adolescentes",2016,2,14,7758,180.458881154937,5,3902,128.139415684264,9,3856,233.402489626556
21296,25,25307,81,"Tasa de exámenes médico legales por presunto delito sexual contra niños, niñas y adolescentes",2016,3,40,9475,422.163588390501,10,4651,215.007525263384,30,4824,621.890547263682
21297,25,25307,81,"Tasa de exámenes médico legales por presunto delito sexual contra niños, niñas y adolescentes",2016,4,34,9612,353.724511027882,2,4642,43.0848772081,32,4970,643.863179074447
21298,25,25307,121,Tasa de exámenes médico legales por presunto delito sexual cuando la víctima está entre 18 y 28 años,2016,5,3,19612,15.2967570874975,1,9552,10.4690117252931,2,10060,19.8807157057654
21299,25,25307,81,"Tasa de exámenes médico legales por presunto delito sexual contra niños, niñas y adolescentes",2016,1,1,1551,64.4745325596389,1,791,126.422250316056,0,760,0
21300,25,25312,81,"Tasa de exámenes médico legales por presunto delito sexual contra niños, niñas y adolescentes",2016,3,1,1052,95.0570342205323,0,527,0,1,525,190.47619047619
21301,25,25317,81,"Tasa de exámenes médico legales por presunto delito sexual contra niños, niñas y adolescentes",2016,2,3,1042,287.907869481766,0,529,0,3,513,584.795321637427
21302,25,25317,81,"Tasa de exámenes médico legales por presunto delito sexual contra niños, niñas y adolescentes",2016,3,3,1186,252.951096121417,0,602,0,3,584,513.698630136986
21303,25,25317,81,"Tasa de exámenes médico legales por presunto delito sexual contra niños, niñas y adolescentes",2016,4,2,1133,176.522506619594,0,582,0,2,551,362.976406533575
21304,25,25317,121,Tasa de exámenes médico legales por presunto delito sexual cuando la víctima está entre 18 y 28 años,2016,5,2,2254,88.7311446317658,0,1177,0,2,1077,185.701021355617
21305,25,25320,81,"Tasa de exámenes médico legales por presunto delito sexual contra niños, niñas y adolescentes",2016,2,5,3735,133.868808567604,1,1915,52.2193211488251,4,1820,219.78021978022
21306,25,25320,81,"Tasa de exámenes médico legales por presunto delito sexual contra niños, niñas y adolescentes",2016,3,4,4423,90.4363554148768,0,2255,0,4,2168,184.50184501845
21307,25,25320,81,"Tasa de exámenes médico legales por presunto delito sexual contra niños, niñas y adolescentes",2016,4,9,4185,215.05376344086,1,2100,47.6190476190476,8,2085,383.693045563549
21308,25,25320,81,"Tasa de exámenes médico legales por presunto delito sexual contra niños, niñas y adolescentes",2016,1,1,761,131.406044678055,0,390,0,1,371,269.541778975741
21309,25,25322,81,"Tasa de exámenes médico legales por presunto delito sexual contra niños, niñas y adolescentes",2016,2,2,1431,139.762403913347,1,728,137.362637362637,1,703,142.247510668563
21310,25,25322,81,"Tasa de exámenes médico legales por presunto delito sexual contra niños, niñas y adolescentes",2016,3,3,1715,174.927113702624,1,874,114.41647597254,2,841,237.812128418549
21311,25,25322,81,"Tasa de exámenes médico legales por presunto delito sexual contra niños, niñas y adolescentes",2016,4,8,1732,461.89376443418,0,904,0,8,828,966.183574879227
21312,25,25322,121,Tasa de exámenes médico legales por presunto delito sexual cuando la víctima está entre 18 y 28 años,2016,5,1,3047,32.8191663931736,0,1586,0,1,1461,68.4462696783025
21313,25,25324,81,"Tasa de exámenes médico legales por presunto delito sexual contra niños, niñas y adolescentes",2016,4,1,297,336.700336700337,0,152,0,1,145,689.655172413793
21314,25,25326,81,"Tasa de exámenes médico legales por presunto delito sexual contra niños, niñas y adolescentes",2016,4,1,736,135.869565217391,0,382,0,1,354,282.485875706215
21315,25,25328,81,"Tasa de exámenes médico legales por presunto delito sexual contra niños, niñas y adolescentes",2016,2,1,327,305.810397553517,0,168,0,1,159,628.930817610063
21316,25,25328,81,"Tasa de exámenes médico legales por presunto delito sexual contra niños, niñas y adolescentes",2016,3,2,387,516.795865633075,0,204,0,2,183,1092.89617486339
21317,25,25335,81,"Tasa de exámenes médico legales por presunto delito sexual contra niños, niñas y adolescentes",2016,3,2,463,431.965442764579,0,234,0,2,229,873.362445414847
21318,25,25335,81,"Tasa de exámenes médico legales por presunto delito sexual contra niños, niñas y adolescentes",2016,4,3,467,642.398286937902,0,225,0,3,242,1239.6694214876
21319,25,25339,81,"Tasa de exámenes médico legales por presunto delito sexual contra niños, niñas y adolescentes",2016,2,1,402,248.756218905473,0,205,0,1,197,507.61421319797
21320,25,25339,81,"Tasa de exámenes médico legales por presunto delito sexual contra niños, niñas y adolescentes",2016,3,4,427,936.768149882904,0,213,0,4,214,1869.15887850467
21321,25,25339,81,"Tasa de exámenes médico legales por presunto delito sexual contra niños, niñas y adolescentes",2016,4,2,438,456.62100456621,0,216,0,2,222,900.900900900901
21322,25,25368,81,"Tasa de exámenes médico legales por presunto delito sexual contra niños, niñas y adolescentes",2016,3,1,334,299.40119760479,1,165,606.060606060606,0,169,0
21323,25,25372,81,"Tasa de exámenes médico legales por presunto delito sexual contra niños, niñas y adolescentes",2016,3,1,832,120.192307692308,0,427,0,1,405,246.913580246914
21324,25,25372,81,"Tasa de exámenes médico legales por presunto delito sexual contra niños, niñas y adolescentes",2016,4,1,849,117.785630153121,1,428,233.644859813084,0,421,0
21325,25,25377,81,"Tasa de exámenes médico legales por presunto delito sexual contra niños, niñas y adolescentes",2016,3,3,2772,108.225108225108,2,1396,143.266475644699,1,1376,72.6744186046512
21326,25,25377,81,"Tasa de exámenes médico legales por presunto delito sexual contra niños, niñas y adolescentes",2016,4,3,2819,106.420716566158,0,1445,0,3,1374,218.340611353712
21327,25,25377,121,Tasa de exámenes médico legales por presunto delito sexual cuando la víctima está entre 18 y 28 años,2016,5,2,5375,37.2093023255814,0,2776,0,2,2599,76.9526741054252
21328,25,25386,81,"Tasa de exámenes médico legales por presunto delito sexual contra niños, niñas y adolescentes",2016,2,4,2495,160.320641282565,1,1280,78125,3,1215,246.913580246914
21329,25,25386,81,"Tasa de exámenes médico legales por presunto delito sexual contra niños, niñas y adolescentes",2016,3,8,3076,260.078023407022,0,1555,0,8,1521,525.969756738988
21330,25,25386,81,"Tasa de exámenes médico legales por presunto delito sexual contra niños, niñas y adolescentes",2016,4,10,3146,317.863954227591,3,1600,187.5,7,1546,452.781371280724
21331,25,25386,121,Tasa de exámenes médico legales por presunto delito sexual cuando la víctima está entre 18 y 28 años,2016,5,1,5885,16.9923534409516,0,2949,0,1,2936,34.0599455040872
21332,25,25394,81,"Tasa de exámenes médico legales por presunto delito sexual contra niños, niñas y adolescentes",2016,4,1,1063,94.0733772342427,0,536,0,1,527,189.753320683112
21333,25,25394,121,Tasa de exámenes médico legales por presunto delito sexual cuando la víctima está entre 18 y 28 años,2016,5,1,2145,46.6200466200466,0,1075,0,1,1070,93.4579439252337
21334,25,25398,81,"Tasa de exámenes médico legales por presunto delito sexual contra niños, niñas y adolescentes",2016,2,1,589,169.779286926995,0,301,0,1,288,347.222222222222
21335,25,25398,81,"Tasa de exámenes médico legales por presunto delito sexual contra niños, niñas y adolescentes",2016,3,5,676,739.644970414201,2,345,579.710144927536,3,331,906.344410876133
21336,25,25398,81,"Tasa de exámenes médico legales por presunto delito sexual contra niños, niñas y adolescentes",2016,4,2,691,289.435600578871,1,349,286.532951289398,1,342,292.397660818713
21337,25,25402,81,"Tasa de exámenes médico legales por presunto delito sexual contra niños, niñas y adolescentes",2016,2,1,1201,83.2639467110741,0,613,0,1,588,170.068027210884
21338,25,25402,81,"Tasa de exámenes médico legales por presunto delito sexual contra niños, niñas y adolescentes",2016,3,3,1377,217.864923747277,1,706,141.643059490085,2,671,298.06259314456
21339,25,25402,81,"Tasa de exámenes médico legales por presunto delito sexual contra niños, niñas y adolescentes",2016,4,6,1408,426.136363636364,2,710,281.69014084507,4,698,573.065902578797
21340,25,25407,81,"Tasa de exámenes médico legales por presunto delito sexual contra niños, niñas y adolescentes",2016,3,2,1123,178.094390026714,1,583,171.526586620926,1,540,185.185185185185
21341,25,25407,81,"Tasa de exámenes médico legales por presunto delito sexual contra niños, niñas y adolescentes",2016,4,4,1102,362.976406533575,2,571,350.262697022767,2,531,376.647834274953
21342,25,25407,121,Tasa de exámenes médico legales por presunto delito sexual cuando la víctima está entre 18 y 28 años,2016,5,1,2183,45.8085203847916,0,1127,0,1,1056,94.6969696969697
21343,25,25426,81,"Tasa de exámenes médico legales por presunto delito sexual contra niños, niñas y adolescentes",2016,3,2,629,317.965023847377,1,308,324.675324675325,1,321,311.526479750779
21344,25,25426,81,"Tasa de exámenes médico legales por presunto delito sexual contra niños, niñas y adolescentes",2016,4,4,612,653.59477124183,0,285,0,4,327,1223.24159021407
21345,25,25426,121,Tasa de exámenes médico legales por presunto delito sexual cuando la víctima está entre 18 y 28 años,2016,5,3,1204,249.169435215947,0,575,0,3,629,476.947535771065
21346,25,25430,81,"Tasa de exámenes médico legales por presunto delito sexual contra niños, niñas y adolescentes",2016,2,4,7126,56.1324726354196,0,3655,0,4,3471,115.240564678767
21347,25,25430,81,"Tasa de exámenes médico legales por presunto delito sexual contra niños, niñas y adolescentes",2016,3,11,8787,125.184932286332,2,4441,45.034902049088,9,4346,207.086976530143
21348,25,25430,81,"Tasa de exámenes médico legales por presunto delito sexual contra niños, niñas y adolescentes",2016,4,20,8705,229.753015508329,2,4442,45.024763619991,18,4263,422.237860661506
21349,25,25430,121,Tasa de exámenes médico legales por presunto delito sexual cuando la víctima está entre 18 y 28 años,2016,5,4,15544,25.7334019557386,0,7866,0,4,7678,52.0969002344361
21350,25,25436,81,"Tasa de exámenes médico legales por presunto delito sexual contra niños, niñas y adolescentes",2016,2,1,422,236.96682464455,1,217,460.829493087558,0,205,0
21351,25,25436,81,"Tasa de exámenes médico legales por presunto delito sexual contra niños, niñas y adolescentes",2016,3,2,528,378.787878787879,0,270,0,2,258,775.193798449612
21352,25,25436,121,Tasa de exámenes médico legales por presunto delito sexual cuando la víctima está entre 18 y 28 años,2016,5,1,926,107.991360691145,0,462,0,1,464,215.51724137931
21353,25,25438,81,"Tasa de exámenes médico legales por presunto delito sexual contra niños, niñas y adolescentes",2016,2,4,1129,354.295837023915,0,582,0,4,547,731.261425959781
21354,25,25438,81,"Tasa de exámenes médico legales por presunto delito sexual contra niños, niñas y adolescentes",2016,3,4,1231,324.939073923639,0,651,0,4,580,689.655172413793
21355,25,25473,81,"Tasa de exámenes médico legales por presunto delito sexual contra niños, niñas y adolescentes",2016,2,5,7627,65.5565753245051,0,3898,0,5,3729,134.084204880665
21356,25,25473,81,"Tasa de exámenes médico legales por presunto delito sexual contra niños, niñas y adolescentes",2016,3,10,9108,109.793588054458,0,4676,0,10,4432,225.631768953069
21357,25,25473,81,"Tasa de exámenes médico legales por presunto delito sexual contra niños, niñas y adolescentes",2016,4,10,9651,103.616205574552,1,5008,19.9680511182109,9,4643,193.84018953263
21358,25,25473,121,Tasa de exámenes médico legales por presunto delito sexual cuando la víctima está entre 18 y 28 años,2016,5,3,17287,17.3540811014057,1,8642,11.5713955102985,2,8645,23.1347599768652
21359,25,25483,81,"Tasa de exámenes médico legales por presunto delito sexual contra niños, niñas y adolescentes",2016,2,1,193,518.134715025907,0,97,0,1,96,1041.66666666667
21360,25,25483,81,"Tasa de exámenes médico legales por presunto delito sexual contra niños, niñas y adolescentes",2016,3,1,232,431.034482758621,0,118,0,1,114,877.19298245614
21361,25,25483,81,"Tasa de exámenes médico legales por presunto delito sexual contra niños, niñas y adolescentes",2016,4,1,242,413.223140495868,0,123,0,1,119,840.336134453782
21362,25,25486,81,"Tasa de exámenes médico legales por presunto delito sexual contra niños, niñas y adolescentes",2016,2,2,1393,143.575017946877,0,708,0,2,685,291.970802919708
21363,25,25486,81,"Tasa de exámenes médico legales por presunto delito sexual contra niños, niñas y adolescentes",2016,3,3,1683,178.25311942959,1,849,117.785630153121,2,834,239.808153477218
21364,25,25486,81,"Tasa de exámenes médico legales por presunto delito sexual contra niños, niñas y adolescentes",2016,4,4,1635,244.648318042813,0,838,0,4,797,501.882057716437
21365,25,25486,121,Tasa de exámenes médico legales por presunto delito sexual cuando la víctima está entre 18 y 28 años,2016,5,1,2905,34.4234079173838,1,1524,65.6167979002625,0,1381,0
21366,25,25488,81,"Tasa de exámenes médico legales por presunto delito sexual contra niños, niñas y adolescentes",2016,3,1,1437,69.589422407794,0,699,0,1,738,135.50135501355
21367,25,25491,81,"Tasa de exámenes médico legales por presunto delito sexual contra niños, niñas y adolescentes",2016,3,1,597,167.50418760469,0,312,0,1,285,350.877192982456
21368,25,25491,121,Tasa de exámenes médico legales por presunto delito sexual cuando la víctima está entre 18 y 28 años,2016,5,1,1305,76.6283524904215,0,689,0,1,616,162.337662337662
21369,25,25506,81,"Tasa de exámenes médico legales por presunto delito sexual contra niños, niñas y adolescentes",2016,3,2,297,673.400673400673,1,154,649.350649350649,1,143,699.300699300699
21370,25,25513,81,"Tasa de exámenes médico legales por presunto delito sexual contra niños, niñas y adolescentes",2016,2,2,2451,81.5993472052224,2,1250,160,0,1201,0
21371,25,25513,81,"Tasa de exámenes médico legales por presunto delito sexual contra niños, niñas y adolescentes",2016,4,8,2990,267.558528428094,0,1516,0,8,1474,542.740841248304
21372,25,25513,121,Tasa de exámenes médico legales por presunto delito sexual cuando la víctima está entre 18 y 28 años,2016,5,1,5399,18.5219485089831,0,2752,0,1,2647,37.7786173026067
21373,25,25518,81,"Tasa de exámenes médico legales por presunto delito sexual contra niños, niñas y adolescentes",2016,2,1,416,240.384615384615,0,215,0,1,201,497.512437810945
21374,25,25518,81,"Tasa de exámenes médico legales por presunto delito sexual contra niños, niñas y adolescentes",2016,3,1,431,232.018561484919,0,224,0,1,207,483.091787439614
21375,25,25518,81,"Tasa de exámenes médico legales por presunto delito sexual contra niños, niñas y adolescentes",2016,4,2,392,510.204081632653,0,193,0,2,199,1005.02512562814
21376,25,25524,81,"Tasa de exámenes médico legales por presunto delito sexual contra niños, niñas y adolescentes",2016,3,4,573,698.080279232112,0,304,0,4,269,1486.98884758364
21377,25,25524,81,"Tasa de exámenes médico legales por presunto delito sexual contra niños, niñas y adolescentes",2016,4,1,582,171.821305841924,0,315,0,1,267,374.531835205993
21378,25,25530,81,"Tasa de exámenes médico legales por presunto delito sexual contra niños, niñas y adolescentes",2016,2,3,816,367.647058823529,1,416,240.384615384615,2,400,500
21379,25,25530,81,"Tasa de exámenes médico legales por presunto delito sexual contra niños, niñas y adolescentes",2016,3,9,905,994.475138121547,3,455,659.340659340659,6,450,1333.33333333333
21380,25,25530,81,"Tasa de exámenes médico legales por presunto delito sexual contra niños, niñas y adolescentes",2016,4,6,848,707.547169811321,0,427,0,6,421,1425.17814726841
21381,25,25535,81,"Tasa de exámenes médico legales por presunto delito sexual contra niños, niñas y adolescentes",2016,3,1,1453,68.8231245698555,0,727,0,1,726,137.741046831956
21382,25,25535,81,"Tasa de exámenes médico legales por presunto delito sexual contra niños, niñas y adolescentes",2016,4,1,1328,75.3012048192771,0,662,0,1,666,150.15015015015
21383,25,25572,81,"Tasa de exámenes médico legales por presunto delito sexual contra niños, niñas y adolescentes",2016,2,1,1842,54.2888165038002,0,936,0,1,906,110.37527593819
21384,25,25572,81,"Tasa de exámenes médico legales por presunto delito sexual contra niños, niñas y adolescentes",2016,3,1,2177,45.9347726228755,0,1119,0,1,1058,94.5179584120983
21385,25,25572,81,"Tasa de exámenes médico legales por presunto delito sexual contra niños, niñas y adolescentes",2016,4,1,2188,45.7038391224863,0,1106,0,1,1082,92.4214417744917
21386,25,25572,121,Tasa de exámenes médico legales por presunto delito sexual cuando la víctima está entre 18 y 28 años,2016,5,1,3612,27.6854928017719,0,1871,0,1,1741,57.4382538770821
21387,25,25592,81,"Tasa de exámenes médico legales por presunto delito sexual contra niños, niñas y adolescentes",2016,2,1,460,217.391304347826,0,231,0,1,229,436.681222707424
21388,25,25592,81,"Tasa de exámenes médico legales por presunto delito sexual contra niños, niñas y adolescentes",2016,3,1,500,200,1,251,398.406374501992,0,249,0
21389,25,25592,81,"Tasa de exámenes médico legales por presunto delito sexual contra niños, niñas y adolescentes",2016,4,4,500,800,0,263,0,4,237,1687.76371308017
21390,25,25594,121,Tasa de exámenes médico legales por presunto delito sexual cuando la víctima está entre 18 y 28 años,2016,5,1,1287,77.7000777000777,0,697,0,1,590,169.491525423729
21391,25,25596,81,"Tasa de exámenes médico legales por presunto delito sexual contra niños, niñas y adolescentes",2016,3,1,1023,97.7517106549365,0,527,0,1,496,201.612903225806
21392,25,25596,121,Tasa de exámenes médico legales por presunto delito sexual cuando la víctima está entre 18 y 28 años,2016,5,1,1719,58.173356602676,0,895,0,1,824,121.359223300971
21393,25,25599,81,"Tasa de exámenes médico legales por presunto delito sexual contra niños, niñas y adolescentes",2016,3,3,780,384.615384615385,2,392,510.204081632653,1,388,257.731958762887
21394,25,25612,81,"Tasa de exámenes médico legales por presunto delito sexual contra niños, niñas y adolescentes",2016,2,1,778,128.53470437018,1,394,253.807106598985,0,384,0
21395,25,25612,81,"Tasa de exámenes médico legales por presunto delito sexual contra niños, niñas y adolescentes",2016,3,3,891,336.700336700337,0,436,0,3,455,659.340659340659
21396,25,25612,81,"Tasa de exámenes médico legales por presunto delito sexual contra niños, niñas y adolescentes",2016,4,6,940,638.297872340425,1,453,220.75055187638,5,487,1026.69404517454
21397,25,25612,121,Tasa de exámenes médico legales por presunto delito sexual cuando la víctima está entre 18 y 28 años,2016,5,2,1807,110.680686220255,0,858,0,2,949,210.748155953635
21398,25,25645,81,"Tasa de exámenes médico legales por presunto delito sexual contra niños, niñas y adolescentes",2016,2,2,1033,193.610842207164,0,530,0,2,503,397.614314115308
21399,25,25645,81,"Tasa de exámenes médico legales por presunto delito sexual contra niños, niñas y adolescentes",2016,3,4,1272,314.465408805032,4,644,621.11801242236,0,628,0
21400,25,25645,81,"Tasa de exámenes médico legales por presunto delito sexual contra niños, niñas y adolescentes",2016,4,4,1298,308.166409861325,2,660,303.030303030303,2,638,313.479623824451
21401,25,25649,81,"Tasa de exámenes médico legales por presunto delito sexual contra niños, niñas y adolescentes",2016,3,1,1117,89.5255147717099,0,576,0,1,541,184.842883548983
21402,25,25649,81,"Tasa de exámenes médico legales por presunto delito sexual contra niños, niñas y adolescentes",2016,4,4,1107,361.3369467028,1,559,178.890876565295,3,548,547.445255474453
21403,25,25653,81,"Tasa de exámenes médico legales por presunto delito sexual contra niños, niñas y adolescentes",2016,4,1,552,181.159420289855,0,298,0,1,254,393.700787401575
21404,25,25658,81,"Tasa de exámenes médico legales por presunto delito sexual contra niños, niñas y adolescentes",2016,2,1,945,105.820105820106,0,494,0,1,451,221.729490022173
21405,25,25658,81,"Tasa de exámenes médico legales por presunto delito sexual contra niños, niñas y adolescentes",2016,3,1,1118,89.4454382826476,0,584,0,1,534,187.265917602996
21406,25,25658,81,"Tasa de exámenes médico legales por presunto delito sexual contra niños, niñas y adolescentes",2016,4,3,1056,284.090909090909,1,556,179.856115107914,2,500,400
21407,25,25658,121,Tasa de exámenes médico legales por presunto delito sexual cuando la víctima está entre 18 y 28 años,2016,5,3,1746,171.821305841924,1,919,108.813928182807,2,827,241.837968561064
21408,25,25662,81,"Tasa de exámenes médico legales por presunto delito sexual contra niños, niñas y adolescentes",2016,3,1,1000,100,1,493,202.839756592292,0,507,0
21409,25,25662,81,"Tasa de exámenes médico legales por presunto delito sexual contra niños, niñas y adolescentes",2016,4,2,1026,194.931773879142,0,506,0,2,520,384.615384615385
21410,25,25718,81,"Tasa de exámenes médico legales por presunto delito sexual contra niños, niñas y adolescentes",2016,2,1,883,113.250283125708,0,448,0,1,435,229.885057471264
21411,25,25718,81,"Tasa de exámenes médico legales por presunto delito sexual contra niños, niñas y adolescentes",2016,3,7,1018,687.62278978389,1,523,191.204588910134,6,495,1212.12121212121
21412,25,25718,81,"Tasa de exámenes médico legales por presunto delito sexual contra niños, niñas y adolescentes",2016,4,1,1036,96.5250965250965,0,526,0,1,510,196.078431372549
21413,25,25736,81,"Tasa de exámenes médico legales por presunto delito sexual contra niños, niñas y adolescentes",2016,3,1,1651,60.5693519079346,0,841,0,1,810,123.456790123457
21414,25,25736,81,"Tasa de exámenes médico legales por presunto delito sexual contra niños, niñas y adolescentes",2016,4,2,1623,123.228589032656,0,815,0,2,808,247.524752475248
21415,25,25736,121,Tasa de exámenes médico legales por presunto delito sexual cuando la víctima está entre 18 y 28 años,2016,5,1,2867,34.8796651552145,0,1468,0,1,1399,71.4796283059328
21416,25,25736,81,"Tasa de exámenes médico legales por presunto delito sexual contra niños, niñas y adolescentes",2016,1,1,279,358.4229390681,1,141,709.219858156028,0,138,0
21417,25,25740,81,"Tasa de exámenes médico legales por presunto delito sexual contra niños, niñas y adolescentes",2016,2,1,3391,29.4898260100265,0,1728,0,1,1663,60.1322910402886
21418,25,25740,81,"Tasa de exámenes médico legales por presunto delito sexual contra niños, niñas y adolescentes",2016,3,4,4017,99.5767986059248,0,2044,0,4,1973,202.73694880892
21419,25,25740,81,"Tasa de exámenes médico legales por presunto delito sexual contra niños, niñas y adolescentes",2016,4,9,4335,207.612456747405,1,2216,45.1263537906137,8,2119,377.536573855592
21420,25,25740,121,Tasa de exámenes médico legales por presunto delito sexual cuando la víctima está entre 18 y 28 años,2016,5,1,7825,12.779552715655,0,4041,0,1,3784,26.4270613107822
21421,25,25743,81,"Tasa de exámenes médico legales por presunto delito sexual contra niños, niñas y adolescentes",2016,2,2,1869,107.009095773141,0,959,0,2,910,219.78021978022
21422,25,25743,81,"Tasa de exámenes médico legales por presunto delito sexual contra niños, niñas y adolescentes",2016,3,9,2183,412.276683463124,0,1124,0,9,1059,849.85835694051
21423,25,25743,81,"Tasa de exámenes médico legales por presunto delito sexual contra niños, niñas y adolescentes",2016,4,3,2296,130.662020905923,0,1179,0,3,1117,268.57654431513
21424,25,25743,121,Tasa de exámenes médico legales por presunto delito sexual cuando la víctima está entre 18 y 28 años,2016,5,2,4095,48.8400488400488,0,2036,0,2,2059,97.1345313258863
21425,25,25743,81,"Tasa de exámenes médico legales por presunto delito sexual contra niños, niñas y adolescentes",2016,1,1,364,274.725274725275,1,185,540.540540540541,0,179,0
21426,25,25745,81,"Tasa de exámenes médico legales por presunto delito sexual contra niños, niñas y adolescentes",2016,3,3,1574,190.597204574333,0,793,0,3,781,384.122919334187
21427,25,25745,81,"Tasa de exámenes médico legales por presunto delito sexual contra niños, niñas y adolescentes",2016,4,5,1506,332.005312084993,0,754,0,5,752,664.893617021277
21428,25,25745,121,Tasa de exámenes médico legales por presunto delito sexual cuando la víctima está entre 18 y 28 años,2016,5,1,2625,38.0952380952381,0,1337,0,1,1288,77.639751552795
21429,25,25754,81,"Tasa de exámenes médico legales por presunto delito sexual contra niños, niñas y adolescentes",2016,2,47,48205,97.5002593092003,18,24689,72.9069626149297,29,23516,123.320292566763
21430,25,25754,81,"Tasa de exámenes médico legales por presunto delito sexual contra niños, niñas y adolescentes",2016,3,97,56855,170.609445079588,11,29071,37.8383956520244,86,27784,309.530665131011
21431,25,25754,81,"Tasa de exámenes médico legales por presunto delito sexual contra niños, niñas y adolescentes",2016,4,111,57166,194.171360598957,9,29173,30.8504439036095,102,27993,364.376808487836
21432,25,25754,121,Tasa de exámenes médico legales por presunto delito sexual cuando la víctima está entre 18 y 28 años,2016,5,14,104994,13.3340952816351,1,52435,1.90712310479641,13,52559,24.7341083353945
21433,25,25758,121,Tasa de exámenes médico legales por presunto delito sexual cuando la víctima está entre 18 y 28 años,2016,5,1,5238,19.0912562046583,0,2643,0,1,2595,38.5356454720617
21434,25,25769,81,"Tasa de exámenes médico legales por presunto delito sexual contra niños, niñas y adolescentes",2016,2,1,1357,73.6919675755343,0,689,0,1,668,149.700598802395
21435,25,25769,81,"Tasa de exámenes médico legales por presunto delito sexual contra niños, niñas y adolescentes",2016,3,2,1620,123.456790123457,0,820,0,2,800,250
21436,25,25769,81,"Tasa de exámenes médico legales por presunto delito sexual contra niños, niñas y adolescentes",2016,4,1,1636,61.1246943765281,0,835,0,1,801,124.843945068664
21437,25,25772,81,"Tasa de exámenes médico legales por presunto delito sexual contra niños, niñas y adolescentes",2016,2,1,2046,48.8758553274682,0,1035,0,1,1011,98.9119683481701
21438,25,25772,81,"Tasa de exámenes médico legales por presunto delito sexual contra niños, niñas y adolescentes",2016,3,1,2373,42.1407501053519,1,1175,85.1063829787234,0,1198,0
21439,25,25772,81,"Tasa de exámenes médico legales por presunto delito sexual contra niños, niñas y adolescentes",2016,4,1,2309,43.308791684712,0,1124,0,1,1185,84.3881856540084
21440,25,25772,121,Tasa de exámenes médico legales por presunto delito sexual cuando la víctima está entre 18 y 28 años,2016,5,1,3621,27.6166804750069,0,1770,0,1,1851,54.0248514316586
21441,25,25777,81,"Tasa de exámenes médico legales por presunto delito sexual contra niños, niñas y adolescentes",2016,3,1,654,152.905198776758,1,325,307.692307692308,0,329,0
21442,25,25777,81,"Tasa de exámenes médico legales por presunto delito sexual contra niños, niñas y adolescentes",2016,4,1,666,150.15015015015,0,324,0,1,342,292.397660818713
21443,25,25779,81,"Tasa de exámenes médico legales por presunto delito sexual contra niños, niñas y adolescentes",2016,2,1,1383,72.3065798987708,0,705,0,1,678,147.492625368732
21444,25,25779,81,"Tasa de exámenes médico legales por presunto delito sexual contra niños, niñas y adolescentes",2016,4,3,1503,199.600798403194,1,772,129.533678756477,2,731,273.59781121751
21445,25,25793,81,"Tasa de exámenes médico legales por presunto delito sexual contra niños, niñas y adolescentes",2016,3,2,1064,187.96992481203,0,566,0,2,498,401.606425702811
21446,25,25793,81,"Tasa de exámenes médico legales por presunto delito sexual contra niños, niñas y adolescentes",2016,4,4,967,413.650465356774,0,522,0,4,445,898.876404494382
21447,25,25797,81,"Tasa de exámenes médico legales por presunto delito sexual contra niños, niñas y adolescentes",2016,2,1,1013,98.7166831194472,0,516,0,1,497,201.207243460765
21448,25,25797,81,"Tasa de exámenes médico legales por presunto delito sexual contra niños, niñas y adolescentes",2016,3,4,1182,338.409475465313,2,586,341.296928327645,2,596,335.570469798658
21449,25,25797,81,"Tasa de exámenes médico legales por presunto delito sexual contra niños, niñas y adolescentes",2016,4,3,1200,250,0,584,0,3,616,487.012987012987
21450,25,25797,121,Tasa de exámenes médico legales por presunto delito sexual cuando la víctima está entre 18 y 28 años,2016,5,1,1858,53.8213132400431,0,904,0,1,954,104.82180293501
21451,25,25799,81,"Tasa de exámenes médico legales por presunto delito sexual contra niños, niñas y adolescentes",2016,2,1,1841,54.3183052688756,0,946,0,1,895,111.731843575419
21452,25,25799,81,"Tasa de exámenes médico legales por presunto delito sexual contra niños, niñas y adolescentes",2016,3,2,2179,91.7852225791648,0,1112,0,2,1067,187.441424554827
21453,25,25799,81,"Tasa de exámenes médico legales por presunto delito sexual contra niños, niñas y adolescentes",2016,4,1,2259,44.2673749446658,0,1144,0,1,1115,89.6860986547085
21454,25,25799,121,Tasa de exámenes médico legales por presunto delito sexual cuando la víctima está entre 18 y 28 años,2016,5,1,3905,25.6081946222791,0,1970,0,1,1935,51.6795865633075
21455,25,25805,81,"Tasa de exámenes médico legales por presunto delito sexual contra niños, niñas y adolescentes",2016,4,2,568,352.112676056338,0,274,0,2,294,680.272108843537
21456,25,25807,81,"Tasa de exámenes médico legales por presunto delito sexual contra niños, niñas y adolescentes",2016,3,1,352,284.090909090909,0,176,0,1,176,568.181818181818
21457,25,25807,81,"Tasa de exámenes médico legales por presunto delito sexual contra niños, niñas y adolescentes",2016,4,4,335,1194.02985074627,1,168,595.238095238095,3,167,1796.40718562874
21458,25,25815,81,"Tasa de exámenes médico legales por presunto delito sexual contra niños, niñas y adolescentes",2016,2,1,1501,66.6222518321119,0,776,0,1,725,137.931034482759
21459,25,25815,81,"Tasa de exámenes médico legales por presunto delito sexual contra niños, niñas y adolescentes",2016,3,4,1800,222.222222222222,0,930,0,4,870,459.770114942529
21460,25,25815,81,"Tasa de exámenes médico legales por presunto delito sexual contra niños, niñas y adolescentes",2016,4,6,1752,342.465753424658,0,906,0,6,846,709.219858156028
21461,25,25817,81,"Tasa de exámenes médico legales por presunto delito sexual contra niños, niñas y adolescentes",2016,2,1,3386,29.5333727111636,0,1739,0,1,1647,60.7164541590771
21462,25,25817,81,"Tasa de exámenes médico legales por presunto delito sexual contra niños, niñas y adolescentes",2016,3,7,4038,173.353145121347,3,2078,144.36958614052,4,1960,204.081632653061
21463,25,25817,81,"Tasa de exámenes médico legales por presunto delito sexual contra niños, niñas y adolescentes",2016,4,10,4017,248.941996514812,0,2039,0,10,1978,505.561172901921
21464,25,25817,121,Tasa de exámenes médico legales por presunto delito sexual cuando la víctima está entre 18 y 28 años,2016,5,2,6551,30.5296901236453,0,3240,0,2,3311,60.4047115675023
21465,25,25823,81,"Tasa de exámenes médico legales por presunto delito sexual contra niños, niñas y adolescentes",2016,4,1,475,210.526315789474,0,251,0,1,224,446.428571428571
21466,25,25839,81,"Tasa de exámenes médico legales por presunto delito sexual contra niños, niñas y adolescentes",2016,4,1,1229,81.366965012205,0,689,0,1,540,185.185185185185
21467,25,25841,81,"Tasa de exámenes médico legales por presunto delito sexual contra niños, niñas y adolescentes",2016,2,1,523,191.204588910134,0,274,0,1,249,401.606425702811
21468,25,25841,81,"Tasa de exámenes médico legales por presunto delito sexual contra niños, niñas y adolescentes",2016,3,2,588,340.136054421769,0,315,0,2,273,732.600732600733
21469,25,25841,121,Tasa de exámenes médico legales por presunto delito sexual cuando la víctima está entre 18 y 28 años,2016,5,1,1043,95.8772770853308,0,560,0,1,483,207.03933747412
21470,25,25843,81,"Tasa de exámenes médico legales por presunto delito sexual contra niños, niñas y adolescentes",2016,2,4,3784,105.708245243129,1,1921,52.0562207183759,3,1863,161.030595813205
21471,25,25843,81,"Tasa de exámenes médico legales por presunto delito sexual contra niños, niñas y adolescentes",2016,3,17,4386,387.596899224806,3,2195,136.674259681093,14,2191,638.977635782748
21472,25,25843,81,"Tasa de exámenes médico legales por presunto delito sexual contra niños, niñas y adolescentes",2016,4,19,4272,444.756554307116,4,2099,190.566936636494,15,2173,690.289921767142
21473,25,25843,121,Tasa de exámenes médico legales por presunto delito sexual cuando la víctima está entre 18 y 28 años,2016,5,2,7794,25.6607646907878,0,3729,0,2,4065,49.20049200492
21474,25,25845,81,"Tasa de exámenes médico legales por presunto delito sexual contra niños, niñas y adolescentes",2016,4,1,950,105.263157894737,0,488,0,1,462,216.450216450216
21475,25,25851,121,Tasa de exámenes médico legales por presunto delito sexual cuando la víctima está entre 18 y 28 años,2016,5,2,992,201.612903225806,1,487,205.338809034908,1,505,198.019801980198
21476,25,25862,81,"Tasa de exámenes médico legales por presunto delito sexual contra niños, niñas y adolescentes",2016,3,1,789,126.742712294043,0,398,0,1,391,255.754475703325
21477,25,25862,81,"Tasa de exámenes médico legales por presunto delito sexual contra niños, niñas y adolescentes",2016,4,1,779,128.369704749679,0,375,0,1,404,247.524752475248
21478,25,25867,81,"Tasa de exámenes médico legales por presunto delito sexual contra niños, niñas y adolescentes",2016,3,2,422,473.9336492891,0,207,0,2,215,930.232558139535
21479,25,25867,81,"Tasa de exámenes médico legales por presunto delito sexual contra niños, niñas y adolescentes",2016,4,1,415,240.963855421687,0,194,0,1,221,452.488687782805
21480,25,25871,81,"Tasa de exámenes médico legales por presunto delito sexual contra niños, niñas y adolescentes",2016,4,1,233,429.184549356223,0,119,0,1,114,877.19298245614
21481,25,25873,81,"Tasa de exámenes médico legales por presunto delito sexual contra niños, niñas y adolescentes",2016,3,2,2528,79.1139240506329,1,1316,75.9878419452888,1,1212,82.5082508250825
21482,25,25873,81,"Tasa de exámenes médico legales por presunto delito sexual contra niños, niñas y adolescentes",2016,4,2,2427,82.4062628759786,0,1283,0,2,1144,174.825174825175
21483,25,25875,81,"Tasa de exámenes médico legales por presunto delito sexual contra niños, niñas y adolescentes",2016,2,6,2165,277.136258660508,3,1105,271.493212669683,3,1060,283.018867924528
21484,25,25875,81,"Tasa de exámenes médico legales por presunto delito sexual contra niños, niñas y adolescentes",2016,3,16,2579,620.39550213261,8,1306,612.557427258806,8,1273,628.436763550668
21485,25,25875,81,"Tasa de exámenes médico legales por presunto delito sexual contra niños, niñas y adolescentes",2016,4,17,2596,654.853620955316,2,1326,150.829562594268,15,1270,1181.10236220472
21486,25,25875,121,Tasa de exámenes médico legales por presunto delito sexual cuando la víctima está entre 18 y 28 años,2016,5,2,4872,41.0509031198686,0,2492,0,2,2380,84.0336134453782
21487,25,25878,81,"Tasa de exámenes médico legales por presunto delito sexual contra niños, niñas y adolescentes",2016,2,2,1100,181.818181818182,0,568,0,2,532,375.93984962406
21488,25,25878,81,"Tasa de exámenes médico legales por presunto delito sexual contra niños, niñas y adolescentes",2016,3,2,1303,153.491941673062,0,667,0,2,636,314.465408805032
21489,25,25878,81,"Tasa de exámenes médico legales por presunto delito sexual contra niños, niñas y adolescentes",2016,4,2,1328,150.602409638554,0,680,0,2,648,308.641975308642
21490,25,25885,81,"Tasa de exámenes médico legales por presunto delito sexual contra niños, niñas y adolescentes",2016,3,2,1847,108.283703302653,0,977,0,2,870,229.885057471264
21491,25,25885,81,"Tasa de exámenes médico legales por presunto delito sexual contra niños, niñas y adolescentes",2016,4,4,1787,223.838836038053,0,933,0,4,854,468.384074941452
21492,25,25898,81,"Tasa de exámenes médico legales por presunto delito sexual contra niños, niñas y adolescentes",2016,4,5,618,809.061488673139,0,308,0,5,310,1612.90322580645
21493,25,25899,81,"Tasa de exámenes médico legales por presunto delito sexual contra niños, niñas y adolescentes",2016,2,9,10663,84.4040138797712,4,5451,73.3810310034856,5,5212,95.9324635456639
21494,25,25899,81,"Tasa de exámenes médico legales por presunto delito sexual contra niños, niñas y adolescentes",2016,3,18,13092,137.488542621448,5,6721,74.393691414968,13,6371,204.049599748862
21495,25,25899,81,"Tasa de exámenes médico legales por presunto delito sexual contra niños, niñas y adolescentes",2016,4,24,13170,182.232346241458,2,6654,30.0571085061617,22,6516,337.630448127686
21496,25,25899,121,Tasa de exámenes médico legales por presunto delito sexual cuando la víctima está entre 18 y 28 años,2016,5,9,23711,37.9570663405171,0,11842,0,9,11869,75.8277866711602
21497,27,27001,81,"Tasa de exámenes médico legales por presunto delito sexual contra niños, niñas y adolescentes",2016,2,16,14688,108.932461873638,2,7474,26.7594327000268,14,7214,194.067091766011
21498,27,27001,81,"Tasa de exámenes médico legales por presunto delito sexual contra niños, niñas y adolescentes",2016,3,28,17304,161.812297734628,5,8812,56.7408079891058,23,8492,270.843146490815
21499,27,27001,81,"Tasa de exámenes médico legales por presunto delito sexual contra niños, niñas y adolescentes",2016,4,30,15903,188.643652141105,3,8127,36.9139904023625,27,7776,347.222222222222
21500,27,27001,121,Tasa de exámenes médico legales por presunto delito sexual cuando la víctima está entre 18 y 28 años,2016,5,10,25951,38.5341605333128,0,13475,0,10,12476,80.1538954793203
21501,27,27025,81,"Tasa de exámenes médico legales por presunto delito sexual contra niños, niñas y adolescentes",2016,2,1,5512,18.1422351233672,0,2849,0,1,2663,37.5516334960571
21502,27,27050,81,"Tasa de exámenes médico legales por presunto delito sexual contra niños, niñas y adolescentes",2016,2,2,1315,152.091254752852,0,665,0,2,650,307.692307692308
21503,27,27050,81,"Tasa de exámenes médico legales por presunto delito sexual contra niños, niñas y adolescentes",2016,3,1,1537,65.0618087182824,0,786,0,1,751,133.155792276964
21504,27,27050,81,"Tasa de exámenes médico legales por presunto delito sexual contra niños, niñas y adolescentes",2016,4,1,1371,72.9394602479942,0,708,0,1,663,150.829562594268
21505,27,27073,81,"Tasa de exámenes médico legales por presunto delito sexual contra niños, niñas y adolescentes",2016,3,1,1213,82.4402308326463,0,620,0,1,593,168.634064080944
21506,27,27073,121,Tasa de exámenes médico legales por presunto delito sexual cuando la víctima está entre 18 y 28 años,2016,5,1,1694,59.0318772136954,0,879,0,1,815,122.699386503067
21507,27,27075,81,"Tasa de exámenes médico legales por presunto delito sexual contra niños, niñas y adolescentes",2016,4,1,1198,83.4724540901503,0,612,0,1,586,170.648464163823
21508,27,27077,81,"Tasa de exámenes médico legales por presunto delito sexual contra niños, niñas y adolescentes",2016,3,1,2863,34.9283967865875,0,1493,0,1,1370,72.992700729927
21509,27,27077,81,"Tasa de exámenes médico legales por presunto delito sexual contra niños, niñas y adolescentes",2016,4,1,2688,37.202380952381,0,1426,0,1,1262,79.2393026941363
21510,27,27135,81,"Tasa de exámenes médico legales por presunto delito sexual contra niños, niñas y adolescentes",2016,4,1,974,102.669404517454,0,496,0,1,478,209.205020920502
21511,27,27160,81,"Tasa de exámenes médico legales por presunto delito sexual contra niños, niñas y adolescentes",2016,4,1,1207,82.8500414250207,0,649,0,1,558,179.21146953405
21512,27,27205,81,"Tasa de exámenes médico legales por presunto delito sexual contra niños, niñas y adolescentes",2016,2,1,1783,56.0852495793606,1,895,111.731843575419,0,888,0
21513,27,27205,81,"Tasa de exámenes médico legales por presunto delito sexual contra niños, niñas y adolescentes",2016,3,2,2091,95.6480153036825,0,1021,0,2,1070,186.915887850467
21514,27,27245,81,"Tasa de exámenes médico legales por presunto delito sexual contra niños, niñas y adolescentes",2016,2,1,1875,53.3333333333333,1,946,105.708245243129,0,929,0
21515,27,27245,81,"Tasa de exámenes médico legales por presunto delito sexual contra niños, niñas y adolescentes",2016,4,1,1919,52.1104742053153,0,967,0,1,952,105.042016806723
21516,27,27361,81,"Tasa de exámenes médico legales por presunto delito sexual contra niños, niñas y adolescentes",2016,2,1,3100,32.258064516129,0,1554,0,1,1546,64.6830530401035
21517,27,27361,81,"Tasa de exámenes médico legales por presunto delito sexual contra niños, niñas y adolescentes",2016,3,3,3586,83.6586726157278,0,1756,0,3,1830,163.934426229508
21518,27,27361,81,"Tasa de exámenes médico legales por presunto delito sexual contra niños, niñas y adolescentes",2016,4,2,3156,63.3713561470215,0,1540,0,2,1616,123.762376237624
21519,27,27361,121,Tasa de exámenes médico legales por presunto delito sexual cuando la víctima está entre 18 y 28 años,2016,5,2,6073,32.932652725177,0,2901,0,2,3172,63.0517023959647
21520,27,27413,81,"Tasa de exámenes médico legales por presunto delito sexual contra niños, niñas y adolescentes",2016,2,2,1423,140.548137737175,1,704,142.045454545455,1,719,139.082058414465
21521,27,27413,81,"Tasa de exámenes médico legales por presunto delito sexual contra niños, niñas y adolescentes",2016,3,1,1741,57.4382538770821,0,853,0,1,888,112.612612612613
21522,27,27413,81,"Tasa de exámenes médico legales por presunto delito sexual contra niños, niñas y adolescentes",2016,4,1,1532,65.2741514360313,0,762,0,1,770,129.87012987013
21523,27,27425,81,"Tasa de exámenes médico legales por presunto delito sexual contra niños, niñas y adolescentes",2016,4,1,3549,28.1769512538743,0,1809,0,1,1740,57.4712643678161
21524,27,27430,81,"Tasa de exámenes médico legales por presunto delito sexual contra niños, niñas y adolescentes",2016,2,3,1792,167.410714285714,0,898,0,3,894,335.570469798658
21525,27,27430,81,"Tasa de exámenes médico legales por presunto delito sexual contra niños, niñas y adolescentes",2016,3,1,2135,46.8384074941452,0,1066,0,1,1069,93.5453695042096
21526,27,27430,81,"Tasa de exámenes médico legales por presunto delito sexual contra niños, niñas y adolescentes",2016,4,3,1860,161.290322580645,0,932,0,3,928,323.275862068966
21527,27,27450,81,"Tasa de exámenes médico legales por presunto delito sexual contra niños, niñas y adolescentes",2016,4,2,2109,94.8316737790422,0,1059,0,2,1050,190.47619047619
21528,27,27491,81,"Tasa de exámenes médico legales por presunto delito sexual contra niños, niñas y adolescentes",2016,3,1,1210,82.6446280991735,0,623,0,1,587,170.357751277683
21529,27,27491,81,"Tasa de exámenes médico legales por presunto delito sexual contra niños, niñas y adolescentes",2016,4,2,1073,186.393289841566,0,555,0,2,518,386.100386100386
21530,27,27495,81,"Tasa de exámenes médico legales por presunto delito sexual contra niños, niñas y adolescentes",2016,3,1,1352,73.9644970414201,0,673,0,1,679,147.275405007364
21531,27,27495,121,Tasa de exámenes médico legales por presunto delito sexual cuando la víctima está entre 18 y 28 años,2016,5,2,1801,111.049416990561,0,933,0,2,868,230.414746543779
21532,27,27580,81,"Tasa de exámenes médico legales por presunto delito sexual contra niños, niñas y adolescentes",2016,4,1,1327,75.3579502637528,0,653,0,1,674,148.367952522255
21533,27,27600,81,"Tasa de exámenes médico legales por presunto delito sexual contra niños, niñas y adolescentes",2016,4,1,1159,86.2812769628991,0,593,0,1,566,176.678445229682
21534,27,27600,121,Tasa de exámenes médico legales por presunto delito sexual cuando la víctima está entre 18 y 28 años,2016,5,1,1851,54.0248514316586,0,958,0,1,893,111.982082866741
21535,27,27615,81,"Tasa de exámenes médico legales por presunto delito sexual contra niños, niñas y adolescentes",2016,2,1,4089,24.4558571777941,0,2074,0,1,2015,49.6277915632754
21536,27,27615,81,"Tasa de exámenes médico legales por presunto delito sexual contra niños, niñas y adolescentes",2016,3,1,4537,22.0409962530306,0,2294,0,1,2243,44.5831475702185
21537,27,27615,81,"Tasa de exámenes médico legales por presunto delito sexual contra niños, niñas y adolescentes",2016,4,2,4234,47.2366556447804,0,2142,0,2,2092,95.6022944550669
21538,27,27660,81,"Tasa de exámenes médico legales por presunto delito sexual contra niños, niñas y adolescentes",2016,3,1,753,132.802124833997,0,365,0,1,388,257.731958762887
21539,27,27660,121,Tasa de exámenes médico legales por presunto delito sexual cuando la víctima está entre 18 y 28 años,2016,5,1,956,104.602510460251,0,479,0,1,477,209.643605870021
21540,27,27745,81,"Tasa de exámenes médico legales por presunto delito sexual contra niños, niñas y adolescentes",2016,2,1,530,188.679245283019,0,268,0,1,262,381.679389312977
21541,27,27787,81,"Tasa de exámenes médico legales por presunto delito sexual contra niños, niñas y adolescentes",2016,2,1,2568,38.9408099688474,0,1299,0,1,1269,78.8022064617809
21542,27,27787,81,"Tasa de exámenes médico legales por presunto delito sexual contra niños, niñas y adolescentes",2016,3,2,2910,68.7285223367698,0,1453,0,2,1457,137.268359643102
21543,27,27787,121,Tasa de exámenes médico legales por presunto delito sexual cuando la víctima está entre 18 y 28 años,2016,5,2,4353,45.9453250631748,0,2154,0,2,2199,90.9504320145521
21544,27,27800,81,"Tasa de exámenes médico legales por presunto delito sexual contra niños, niñas y adolescentes",2016,4,2,1965,101.781170483461,0,987,0,2,978,204.498977505113
21545,27,27810,81,"Tasa de exámenes médico legales por presunto delito sexual contra niños, niñas y adolescentes",2016,4,1,1338,74.7384155455904,0,685,0,1,653,153.139356814701
21546,27,27810,121,Tasa de exámenes médico legales por presunto delito sexual cuando la víctima está entre 18 y 28 años,2016,5,1,2108,47.438330170778,0,1102,0,1,1006,99.403578528827
21547,41,41001,81,"Tasa de exámenes médico legales por presunto delito sexual contra niños, niñas y adolescentes",2016,2,19,26055,72.9226635962387,3,13252,22.6380923634168,16,12803,124.970709989846
21548,41,41001,81,"Tasa de exámenes médico legales por presunto delito sexual contra niños, niñas y adolescentes",2016,3,51,33275,153.268219383922,10,16873,59.2662834113673,41,16402,249.969515912694
21549,41,41001,81,"Tasa de exámenes médico legales por presunto delito sexual contra niños, niñas y adolescentes",2016,4,71,35047,202.58510000856,13,17496,74.3026977594879,58,17551,330.46550054128
21550,41,41001,121,Tasa de exámenes médico legales por presunto delito sexual cuando la víctima está entre 18 y 28 años,2016,5,19,68050,27.9206465833946,4,33527,11.9306827333194,15,34523,43.4492946731165
21551,41,41006,81,"Tasa de exámenes médico legales por presunto delito sexual contra niños, niñas y adolescentes",2016,2,5,4133,120.977498185338,0,2117,0,5,2016,248.015873015873
21552,41,41006,81,"Tasa de exámenes médico legales por presunto delito sexual contra niños, niñas y adolescentes",2016,3,10,4597,217.533173809006,1,2354,42.4808836023789,9,2243,401.248328131966
21553,41,41006,81,"Tasa de exámenes médico legales por presunto delito sexual contra niños, niñas y adolescentes",2016,4,11,4450,247.191011235955,0,2263,0,11,2187,502.97210791038
21554,41,41006,121,Tasa de exámenes médico legales por presunto delito sexual cuando la víctima está entre 18 y 28 años,2016,5,2,6790,29.4550810014728,0,3476,0,2,3314,60.3500301750151
21555,41,41016,81,"Tasa de exámenes médico legales por presunto delito sexual contra niños, niñas y adolescentes",2016,2,1,2867,34.8796651552145,0,1468,0,1,1399,71.4796283059328
21556,41,41016,81,"Tasa de exámenes médico legales por presunto delito sexual contra niños, niñas y adolescentes",2016,3,2,3406,58.7199060481503,0,1769,0,2,1637,122.174709835064
21557,41,41016,81,"Tasa de exámenes médico legales por presunto delito sexual contra niños, niñas y adolescentes",2016,4,8,3201,249.921899406435,0,1631,0,8,1570,509.554140127389
21558,41,41016,121,Tasa de exámenes médico legales por presunto delito sexual cuando la víctima está entre 18 y 28 años,2016,5,3,5258,57.0559147965006,0,2680,0,3,2578,116.369278510473
21559,41,41020,81,"Tasa de exámenes médico legales por presunto delito sexual contra niños, niñas y adolescentes",2016,2,1,2553,39.1696043869957,0,1313,0,1,1240,80.6451612903226
21560,41,41020,81,"Tasa de exámenes médico legales por presunto delito sexual contra niños, niñas y adolescentes",2016,3,3,2955,101.522842639594,0,1529,0,3,1426,210.378681626928
21561,41,41020,81,"Tasa de exámenes médico legales por presunto delito sexual contra niños, niñas y adolescentes",2016,4,9,2733,329.308452250274,0,1412,0,9,1321,681.302043906132
21562,41,41078,81,"Tasa de exámenes médico legales por presunto delito sexual contra niños, niñas y adolescentes",2016,2,1,971,102.986611740474,0,496,0,1,475,210.526315789474
21563,41,41078,81,"Tasa de exámenes médico legales por presunto delito sexual contra niños, niñas y adolescentes",2016,4,1,1091,91.6590284142988,0,576,0,1,515,194.174757281553
21564,41,41132,81,"Tasa de exámenes médico legales por presunto delito sexual contra niños, niñas y adolescentes",2016,3,2,3843,52.0426749934947,1,1964,50.9164969450102,1,1879,53.2197977647685
21565,41,41132,121,Tasa de exámenes médico legales por presunto delito sexual cuando la víctima está entre 18 y 28 años,2016,5,1,6583,15.1906425641805,0,3216,0,1,3367,29.7000297000297
21566,41,41206,81,"Tasa de exámenes médico legales por presunto delito sexual contra niños, niñas y adolescentes",2016,3,1,1436,69.6378830083566,1,751,133.155792276964,0,685,0
21567,41,41244,81,"Tasa de exámenes médico legales por presunto delito sexual contra niños, niñas y adolescentes",2016,4,1,506,197.628458498024,0,252,0,1,254,393.700787401575
21568,41,41244,121,Tasa de exámenes médico legales por presunto delito sexual cuando la víctima está entre 18 y 28 años,2016,5,2,837,238.9486260454,0,416,0,2,421,475.059382422803
21569,41,41298,81,"Tasa de exámenes médico legales por presunto delito sexual contra niños, niñas y adolescentes",2016,2,2,9947,20.106564793405,1,5113,19.5579894386857,1,4834,20.6868018204386
21570,41,41298,81,"Tasa de exámenes médico legales por presunto delito sexual contra niños, niñas y adolescentes",2016,3,10,11319,88.3470271225373,1,5810,17.2117039586919,9,5509,163.369032492285
21571,41,41298,81,"Tasa de exámenes médico legales por presunto delito sexual contra niños, niñas y adolescentes",2016,4,14,11426,122.527568702958,1,6000,16.6666666666667,13,5426,239.58717287136
21572,41,41298,121,Tasa de exámenes médico legales por presunto delito sexual cuando la víctima está entre 18 y 28 años,2016,5,3,19814,15.1408095286161,0,11238,0,3,8576,34.9813432835821
21573,41,41306,81,"Tasa de exámenes médico legales por presunto delito sexual contra niños, niñas y adolescentes",2016,3,1,4199,23.8151940938319,0,2169,0,1,2030,49.2610837438424
21574,41,41319,81,"Tasa de exámenes médico legales por presunto delito sexual contra niños, niñas y adolescentes",2016,4,1,2641,37.8644452858766,0,1359,0,1,1282,78.003120124805
21575,41,41319,121,Tasa de exámenes médico legales por presunto delito sexual cuando la víctima está entre 18 y 28 años,2016,5,1,4431,22.5682690137666,0,2276,0,1,2155,46.4037122969838
21576,41,41357,81,"Tasa de exámenes médico legales por presunto delito sexual contra niños, niñas y adolescentes",2016,4,1,1397,71.5819613457409,0,746,0,1,651,153.609831029186
21577,41,41359,81,"Tasa de exámenes médico legales por presunto delito sexual contra niños, niñas y adolescentes",2016,4,2,3279,60.9942055504727,0,1709,0,2,1570,127.388535031847
21578,41,41359,121,Tasa de exámenes médico legales por presunto delito sexual cuando la víctima está entre 18 y 28 años,2016,5,2,5628,35.5366027007818,0,2889,0,2,2739,73.0193501277839
21579,41,41378,81,"Tasa de exámenes médico legales por presunto delito sexual contra niños, niñas y adolescentes",2016,2,2,1691,118.273211117682,0,858,0,2,833,240.096038415366
21580,41,41378,81,"Tasa de exámenes médico legales por presunto delito sexual contra niños, niñas y adolescentes",2016,3,7,1841,380.228136882129,0,933,0,7,908,770.925110132159
21581,41,41378,81,"Tasa de exámenes médico legales por presunto delito sexual contra niños, niñas y adolescentes",2016,4,3,1773,169.204737732657,0,899,0,3,874,343.24942791762
21582,41,41378,121,Tasa de exámenes médico legales por presunto delito sexual cuando la víctima está entre 18 y 28 años,2016,5,1,2913,34.3288705801579,0,1451,0,1,1462,68.3994528043776
21583,41,41396,81,"Tasa de exámenes médico legales por presunto delito sexual contra niños, niñas y adolescentes",2016,2,1,7123,14.0390284992279,0,3646,0,1,3477,28.7604256542997
21584,41,41396,81,"Tasa de exámenes médico legales por presunto delito sexual contra niños, niñas y adolescentes",2016,3,21,8172,256.97503671072,5,4194,119.217930376729,16,3978,402.212166918049
21585,41,41396,81,"Tasa de exámenes médico legales por presunto delito sexual contra niños, niñas y adolescentes",2016,4,17,8073,210.578471448037,0,4174,0,17,3899,436.009233136702
21586,41,41396,121,Tasa de exámenes médico legales por presunto delito sexual cuando la víctima está entre 18 y 28 años,2016,5,2,12903,15.500271254747,0,6638,0,2,6265,31.9233838786911
21587,41,41503,81,"Tasa de exámenes médico legales por presunto delito sexual contra niños, niñas y adolescentes",2016,3,1,2048,48.828125,1,1056,94.6969696969697,0,992,0
21588,41,41518,81,"Tasa de exámenes médico legales por presunto delito sexual contra niños, niñas y adolescentes",2016,4,3,696,431.034482758621,0,362,0,3,334,898.203592814371
21589,41,41524,81,"Tasa de exámenes médico legales por presunto delito sexual contra niños, niñas y adolescentes",2016,2,4,3151,126.943827356395,1,1604,62.3441396508728,3,1547,193.923723335488
21590,41,41524,81,"Tasa de exámenes médico legales por presunto delito sexual contra niños, niñas y adolescentes",2016,3,6,3784,158.562367864693,0,1929,0,6,1855,323.45013477089
21591,41,41524,81,"Tasa de exámenes médico legales por presunto delito sexual contra niños, niñas y adolescentes",2016,4,7,3712,188.577586206897,0,1906,0,7,1806,387.596899224806
21592,41,41524,121,Tasa de exámenes médico legales por presunto delito sexual cuando la víctima está entre 18 y 28 años,2016,5,2,6278,31.8572793883402,0,3236,0,2,3042,65.7462195923734
21593,41,41530,81,"Tasa de exámenes médico legales por presunto delito sexual contra niños, niñas y adolescentes",2016,3,5,1436,348.189415041783,3,764,392.670157068063,2,672,297.619047619048
21594,41,41530,81,"Tasa de exámenes médico legales por presunto delito sexual contra niños, niñas y adolescentes",2016,4,8,1427,560.616678346181,0,756,0,8,671,1192.25037257824
21595,41,41548,81,"Tasa de exámenes médico legales por presunto delito sexual contra niños, niñas y adolescentes",2016,2,1,1508,66.3129973474801,0,776,0,1,732,136.612021857924
21596,41,41548,81,"Tasa de exámenes médico legales por presunto delito sexual contra niños, niñas y adolescentes",2016,3,1,1602,62.4219725343321,0,834,0,1,768,130.208333333333
21597,41,41548,121,Tasa de exámenes médico legales por presunto delito sexual cuando la víctima está entre 18 y 28 años,2016,5,1,2789,35.8551452133381,0,1463,0,1,1326,75.4147812971342
21598,41,41551,81,"Tasa de exámenes médico legales por presunto delito sexual contra niños, niñas y adolescentes",2016,2,5,12951,38.6070573700873,1,6604,15.1423379769836,4,6347,63.0219001102883
21599,41,41551,81,"Tasa de exámenes médico legales por presunto delito sexual contra niños, niñas y adolescentes",2016,3,15,15258,98.3090837593394,5,7717,64.7920176234288,10,7541,132.608407373027
21600,41,41551,81,"Tasa de exámenes médico legales por presunto delito sexual contra niños, niñas y adolescentes",2016,4,23,15460,148.771021992238,0,7814,0,23,7646,300.81088150667
21601,41,41551,121,Tasa de exámenes médico legales por presunto delito sexual cuando la víctima está entre 18 y 28 años,2016,5,2,26231,7.62456635278869,0,13059,0,2,13172,15.1837230488916
21602,41,41615,81,"Tasa de exámenes médico legales por presunto delito sexual contra niños, niñas y adolescentes",2016,3,3,2075,144.578313253012,1,1058,94.5179584120983,2,1017,196.656833824975
21603,41,41615,81,"Tasa de exámenes médico legales por presunto delito sexual contra niños, niñas y adolescentes",2016,4,2,1962,101.936799184506,0,987,0,2,975,205.128205128205
21604,41,41615,121,Tasa de exámenes médico legales por presunto delito sexual cuando la víctima está entre 18 y 28 años,2016,5,2,3595,55.6328233657858,2,1802,110.987791342952,0,1793,0
21605,41,41660,81,"Tasa de exámenes médico legales por presunto delito sexual contra niños, niñas y adolescentes",2016,3,2,1574,127.064803049555,1,822,121.654501216545,1,752,132.978723404255
21606,41,41660,81,"Tasa de exámenes médico legales por presunto delito sexual contra niños, niñas y adolescentes",2016,4,3,1487,201.748486886348,0,770,0,3,717,418.410041841004
21607,41,41668,81,"Tasa de exámenes médico legales por presunto delito sexual contra niños, niñas y adolescentes",2016,3,7,3722,188.070929607738,1,1888,52.9661016949153,6,1834,327.153762268266
21608,41,41668,81,"Tasa de exámenes médico legales por presunto delito sexual contra niños, niñas y adolescentes",2016,4,18,3744,480.769230769231,3,1894,158.394931362196,15,1850,810.810810810811
21609,41,41668,121,Tasa de exámenes médico legales por presunto delito sexual cuando la víctima está entre 18 y 28 años,2016,5,1,6957,14.3740117866897,0,3615,0,1,3342,29.9222022740874
21610,41,41676,81,"Tasa de exámenes médico legales por presunto delito sexual contra niños, niñas y adolescentes",2016,3,3,1425,210.526315789474,2,752,265.957446808511,1,673,148.588410104012
21611,41,41676,121,Tasa de exámenes médico legales por presunto delito sexual cuando la víctima está entre 18 y 28 años,2016,5,1,2306,43.3651344319167,0,1221,0,1,1085,92.1658986175115
21612,41,41770,81,"Tasa de exámenes médico legales por presunto delito sexual contra niños, niñas y adolescentes",2016,2,1,2225,44.9438202247191,0,1136,0,1,1089,91.8273645546373
21613,41,41770,81,"Tasa de exámenes médico legales por presunto delito sexual contra niños, niñas y adolescentes",2016,3,3,2518,119.142176330421,0,1289,0,3,1229,244.100895036615
21614,41,41770,81,"Tasa de exámenes médico legales por presunto delito sexual contra niños, niñas y adolescentes",2016,4,6,2357,254.560882477726,0,1217,0,6,1140,526.315789473684
21615,41,41770,121,Tasa de exámenes médico legales por presunto delito sexual cuando la víctima está entre 18 y 28 años,2016,5,1,3989,25.0689395838556,1,2065,48.4261501210654,0,1924,0
21616,41,41797,81,"Tasa de exámenes médico legales por presunto delito sexual contra niños, niñas y adolescentes",2016,2,3,920,326.086956521739,0,476,0,3,444,675.675675675676
21617,41,41797,81,"Tasa de exámenes médico legales por presunto delito sexual contra niños, niñas y adolescentes",2016,3,2,1089,183.654729109275,0,566,0,2,523,382.409177820268
21618,41,41797,81,"Tasa de exámenes médico legales por presunto delito sexual contra niños, niñas y adolescentes",2016,4,5,1048,477.099236641221,0,546,0,5,502,996.01593625498
21619,41,41799,81,"Tasa de exámenes médico legales por presunto delito sexual contra niños, niñas y adolescentes",2016,3,2,1913,104.547830632514,1,978,102.249488752556,1,935,106.951871657754
21620,41,41799,81,"Tasa de exámenes médico legales por presunto delito sexual contra niños, niñas y adolescentes",2016,4,5,1797,278.241513633834,1,923,108.342361863489,4,874,457.66590389016
21621,41,41807,81,"Tasa de exámenes médico legales por presunto delito sexual contra niños, niñas y adolescentes",2016,2,2,2108,94.876660341556,0,1075,0,2,1033,193.610842207164
21622,41,41807,81,"Tasa de exámenes médico legales por presunto delito sexual contra niños, niñas y adolescentes",2016,4,2,2480,80.6451612903226,0,1241,0,2,1239,161.420500403551
21623,41,41872,81,"Tasa de exámenes médico legales por presunto delito sexual contra niños, niñas y adolescentes",2016,4,2,869,230.149597238205,0,443,0,2,426,469.483568075117
21624,41,41885,81,"Tasa de exámenes médico legales por presunto delito sexual contra niños, niñas y adolescentes",2016,3,1,890,112.359550561798,0,451,0,1,439,227.790432801822
21625,41,41885,81,"Tasa de exámenes médico legales por presunto delito sexual contra niños, niñas y adolescentes",2016,4,1,928,107.758620689655,0,465,0,1,463,215.982721382289
21626,44,44001,81,"Tasa de exámenes médico legales por presunto delito sexual contra niños, niñas y adolescentes",2016,2,17,35049,48.5035236383349,4,17960,22.271714922049,13,17089,76.0723272280414
21627,44,44001,81,"Tasa de exámenes médico legales por presunto delito sexual contra niños, niñas y adolescentes",2016,3,37,39060,94.726062467998,6,20010,29.9850074962519,31,19050,162.729658792651
21628,44,44001,81,"Tasa de exámenes médico legales por presunto delito sexual contra niños, niñas y adolescentes",2016,4,35,32812,106.66829208826,3,16646,18.0223477111618,32,16166,197.946307064209
21629,44,44001,121,Tasa de exámenes médico legales por presunto delito sexual cuando la víctima está entre 18 y 28 años,2016,5,12,49750,24.1206030150754,0,24510,0,12,25240,47.5435816164818
21630,44,44001,81,"Tasa de exámenes médico legales por presunto delito sexual contra niños, niñas y adolescentes",2016,1,2,7195,27.7970813064628,0,3688,0,2,3507,57.0287995437696
21631,44,44035,81,"Tasa de exámenes médico legales por presunto delito sexual contra niños, niñas y adolescentes",2016,2,1,3471,28.8101411696917,0,1784,0,1,1687,59.2768227622999
21632,44,44035,81,"Tasa de exámenes médico legales por presunto delito sexual contra niños, niñas y adolescentes",2016,3,2,3648,54.8245614035088,1,1897,52.7148128624143,1,1751,57.1102227298686
21633,44,44035,81,"Tasa de exámenes médico legales por presunto delito sexual contra niños, niñas y adolescentes",2016,4,6,3389,177.043375627029,3,1767,169.779286926995,3,1622,184.956843403206
21634,44,44078,81,"Tasa de exámenes médico legales por presunto delito sexual contra niños, niñas y adolescentes",2016,2,1,4559,21.9346347883308,1,2307,43.3463372345037,0,2252,0
21635,44,44078,81,"Tasa de exámenes médico legales por presunto delito sexual contra niños, niñas y adolescentes",2016,3,10,4999,200.0400080016,2,2525,79.2079207920792,8,2474,323.362974939369
21636,44,44078,81,"Tasa de exámenes médico legales por presunto delito sexual contra niños, niñas y adolescentes",2016,4,9,4555,197.585071350165,0,2312,0,9,2243,401.248328131966
21637,44,44090,81,"Tasa de exámenes médico legales por presunto delito sexual contra niños, niñas y adolescentes",2016,2,2,4633,43.1685732786531,0,2375,0,2,2258,88.5739592559788
21638,44,44090,81,"Tasa de exámenes médico legales por presunto delito sexual contra niños, niñas y adolescentes",2016,3,4,4734,84.4951415293621,0,2452,0,4,2282,175.284837861525
21639,44,44090,81,"Tasa de exámenes médico legales por presunto delito sexual contra niños, niñas y adolescentes",2016,4,4,4354,91.869545245751,0,2290,0,4,2064,193.798449612403
21640,44,44090,121,Tasa de exámenes médico legales por presunto delito sexual cuando la víctima está entre 18 y 28 años,2016,5,1,6931,14.427932477276,0,3607,0,1,3324,30.0842358604091
21641,44,44098,81,"Tasa de exámenes médico legales por presunto delito sexual contra niños, niñas y adolescentes",2016,2,1,1899,52.6592943654555,1,974,102.669404517454,0,925,0
21642,44,44098,81,"Tasa de exámenes médico legales por presunto delito sexual contra niños, niñas y adolescentes",2016,4,3,2038,147.20314033366,0,1080,0,3,958,313.152400835073
21643,44,44110,81,"Tasa de exámenes médico legales por presunto delito sexual contra niños, niñas y adolescentes",2016,3,2,947,211.193241816262,0,489,0,2,458,436.681222707424
21644,44,44279,81,"Tasa de exámenes médico legales por presunto delito sexual contra niños, niñas y adolescentes",2016,2,4,3850,103.896103896104,1,1956,51.1247443762781,3,1894,158.394931362196
21645,44,44279,81,"Tasa de exámenes médico legales por presunto delito sexual contra niños, niñas y adolescentes",2016,3,7,4199,166.706358656823,0,2120,0,7,2079,336.700336700337
21646,44,44279,81,"Tasa de exámenes médico legales por presunto delito sexual contra niños, niñas y adolescentes",2016,4,9,3685,244.233378561737,0,1865,0,9,1820,494.505494505495
21647,44,44279,121,Tasa de exámenes médico legales por presunto delito sexual cuando la víctima está entre 18 y 28 años,2016,5,2,7114,28.1135788585887,0,3558,0,2,3556,56.2429696287964
21648,44,44378,81,"Tasa de exámenes médico legales por presunto delito sexual contra niños, niñas y adolescentes",2016,2,1,3274,30.543677458766,0,1683,0,1,1591,62.8535512256443
21649,44,44378,81,"Tasa de exámenes médico legales por presunto delito sexual contra niños, niñas y adolescentes",2016,3,5,3434,145.602795573675,0,1776,0,5,1658,301.568154402895
21650,44,44378,81,"Tasa de exámenes médico legales por presunto delito sexual contra niños, niñas y adolescentes",2016,4,5,3152,158.629441624365,1,1629,61.3873542050338,4,1523,262.639527248851
21651,44,44378,121,Tasa de exámenes médico legales por presunto delito sexual cuando la víctima está entre 18 y 28 años,2016,5,2,5351,37.3761913660998,0,2717,0,2,2634,75.9301442672741
21652,44,44420,81,"Tasa de exámenes médico legales por presunto delito sexual contra niños, niñas y adolescentes",2016,4,1,321,311.526479750779,0,176,0,1,145,689.655172413793
21653,44,44430,81,"Tasa de exámenes médico legales por presunto delito sexual contra niños, niñas y adolescentes",2016,2,6,19476,30.8071472581639,0,9946,0,6,9530,62.9590766002099
21654,44,44430,81,"Tasa de exámenes médico legales por presunto delito sexual contra niños, niñas y adolescentes",2016,3,23,22817,100.80203357146,5,11648,42.9258241758242,18,11169,161.16035455278
21655,44,44430,81,"Tasa de exámenes médico legales por presunto delito sexual contra niños, niñas y adolescentes",2016,4,46,20085,229.026636793627,0,10161,0,46,9924,463.522773075373
21656,44,44430,121,Tasa de exámenes médico legales por presunto delito sexual cuando la víctima está entre 18 y 28 años,2016,5,10,29395,34.0193910529002,0,14872,0,10,14523,68.8562969083523
21657,44,44560,81,"Tasa de exámenes médico legales por presunto delito sexual contra niños, niñas y adolescentes",2016,2,1,15492,6.45494448747741,1,7870,12.7064803049555,0,7622,0
21658,44,44560,81,"Tasa de exámenes médico legales por presunto delito sexual contra niños, niñas y adolescentes",2016,4,2,14216,14.0686550365785,0,7050,0,2,7166,27.9095729835334
21659,44,44650,81,"Tasa de exámenes médico legales por presunto delito sexual contra niños, niñas y adolescentes",2016,2,2,4147,48.227634434531,1,2150,46.5116279069768,1,1997,50.0751126690035
21660,44,44650,81,"Tasa de exámenes médico legales por presunto delito sexual contra niños, niñas y adolescentes",2016,3,10,4508,221.827861579414,1,2365,42.2832980972516,9,2143,419.972001866542
21661,44,44650,81,"Tasa de exámenes médico legales por presunto delito sexual contra niños, niñas y adolescentes",2016,4,6,3986,150.526843953838,0,2073,0,6,1913,313.643491897543
21662,44,44847,81,"Tasa de exámenes médico legales por presunto delito sexual contra niños, niñas y adolescentes",2016,2,1,25578,3.90960982093987,0,12985,0,1,12593,7.94091955848487
21663,44,44847,81,"Tasa de exámenes médico legales por presunto delito sexual contra niños, niñas y adolescentes",2016,3,3,26073,11.5061557933494,0,13134,0,3,12939,23.1857175979597
21664,44,44847,81,"Tasa de exámenes médico legales por presunto delito sexual contra niños, niñas y adolescentes",2016,4,6,23704,25.312183597705,0,11880,0,6,11824,50.744248985115
21665,44,44847,121,Tasa de exámenes médico legales por presunto delito sexual cuando la víctima está entre 18 y 28 años,2016,5,1,36665,2.72739669984999,1,18084,5.5297500552975,0,18581,0
21666,44,44855,81,"Tasa de exámenes médico legales por presunto delito sexual contra niños, niñas y adolescentes",2016,4,1,1881,53.1632110579479,0,955,0,1,926,107.991360691145
21667,44,44874,81,"Tasa de exámenes médico legales por presunto delito sexual contra niños, niñas y adolescentes",2016,2,4,2947,135.731252120801,0,1506,0,4,1441,277.585010409438
21668,44,44874,81,"Tasa de exámenes médico legales por presunto delito sexual contra niños, niñas y adolescentes",2016,3,2,3098,64.5577792123951,0,1589,0,2,1509,132.538104705103
21669,44,44874,81,"Tasa de exámenes médico legales por presunto delito sexual contra niños, niñas y adolescentes",2016,4,2,2789,71.7102904266762,1,1434,69.7350069735007,1,1355,73.8007380073801
21670,44,44874,121,Tasa de exámenes médico legales por presunto delito sexual cuando la víctima está entre 18 y 28 años,2016,5,1,5874,17.0241743275451,0,2998,0,1,2876,34.7705146036161
21671,44,44874,81,"Tasa de exámenes médico legales por presunto delito sexual contra niños, niñas y adolescentes",2016,1,1,621,161.030595813205,0,316,0,1,305,327.868852459016
21672,47,47001,81,"Tasa de exámenes médico legales por presunto delito sexual contra niños, niñas y adolescentes",2016,2,35,46932,74.5759822722236,10,24006,41.6562526035158,25,22926,109.046497426503
21673,47,47001,81,"Tasa de exámenes médico legales por presunto delito sexual contra niños, niñas y adolescentes",2016,3,93,59022,157.568364338721,19,29861,63.6281437326278,74,29161,253.763588354309
21674,47,47001,81,"Tasa de exámenes médico legales por presunto delito sexual contra niños, niñas y adolescentes",2016,4,131,61312,213.66127348643,12,30666,39.1312854627275,119,30646,388.305162174509
21675,47,47001,121,Tasa de exámenes médico legales por presunto delito sexual cuando la víctima está entre 18 y 28 años,2016,5,26,93610,27.774810383506,1,47406,2.10943762392946,25,46204,54.1078694485326
21676,47,47030,81,"Tasa de exámenes médico legales por presunto delito sexual contra niños, niñas y adolescentes",2016,3,1,1966,50.8646998982706,0,1000,0,1,966,103.51966873706
21677,47,47053,81,"Tasa de exámenes médico legales por presunto delito sexual contra niños, niñas y adolescentes",2016,2,3,5002,59.9760095961615,0,2562,0,3,2440,122.950819672131
21678,47,47053,81,"Tasa de exámenes médico legales por presunto delito sexual contra niños, niñas y adolescentes",2016,3,4,5619,71.1870439579996,0,2887,0,4,2732,146.412884333821
21679,47,47053,81,"Tasa de exámenes médico legales por presunto delito sexual contra niños, niñas y adolescentes",2016,4,6,5350,112.14953271028,1,2762,36.2056480811007,5,2588,193.199381761978
21680,47,47053,121,Tasa de exámenes médico legales por presunto delito sexual cuando la víctima está entre 18 y 28 años,2016,5,2,7523,26.5851389073508,0,3869,0,2,3654,54.7345374931582
21681,47,47058,81,"Tasa de exámenes médico legales por presunto delito sexual contra niños, niñas y adolescentes",2016,2,1,3510,28.4900284900285,1,1802,55.4938956714761,0,1708,0
21682,47,47058,81,"Tasa de exámenes médico legales por presunto delito sexual contra niños, niñas y adolescentes",2016,3,1,4139,24.1604252234839,0,2171,0,1,1968,50.8130081300813
21683,47,47058,81,"Tasa de exámenes médico legales por presunto delito sexual contra niños, niñas y adolescentes",2016,4,2,3924,50.9683995922528,0,2102,0,2,1822,109.769484083425
21684,47,47170,81,"Tasa de exámenes médico legales por presunto delito sexual contra niños, niñas y adolescentes",2016,4,5,2186,228.728270814273,0,1148,0,5,1038,481.695568400771
21685,47,47170,121,Tasa de exámenes médico legales por presunto delito sexual cuando la víctima está entre 18 y 28 años,2016,5,1,2934,34.0831629175188,1,1573,63.5727908455181,0,1361,0
21686,47,47189,81,"Tasa de exámenes médico legales por presunto delito sexual contra niños, niñas y adolescentes",2016,2,3,11062,27.1198698246248,0,5679,0,3,5383,55.7310050157905
21687,47,47189,81,"Tasa de exámenes médico legales por presunto delito sexual contra niños, niñas y adolescentes",2016,3,5,13068,38.2614018977655,1,6767,14.7775971627013,4,6301,63.4819869861927
21688,47,47189,81,"Tasa de exámenes médico legales por presunto delito sexual contra niños, niñas y adolescentes",2016,4,17,13317,127.656379064354,3,6929,43.2962909510752,14,6388,219.160926737633
21689,47,47189,121,Tasa de exámenes médico legales por presunto delito sexual cuando la víctima está entre 18 y 28 años,2016,5,2,19457,10.2790769388909,0,9955,0,2,9502,21.0482003788676
21690,47,47205,81,"Tasa de exámenes médico legales por presunto delito sexual contra niños, niñas y adolescentes",2016,3,1,997,100.300902708124,0,517,0,1,480,208.333333333333
21691,47,47205,81,"Tasa de exámenes médico legales por presunto delito sexual contra niños, niñas y adolescentes",2016,4,1,1036,96.5250965250965,0,537,0,1,499,200.400801603206
21692,47,47245,81,"Tasa de exámenes médico legales por presunto delito sexual contra niños, niñas y adolescentes",2016,2,7,6745,103.780578206079,3,3454,86.8558193398958,4,3291,121.543603767852
21693,47,47245,81,"Tasa de exámenes médico legales por presunto delito sexual contra niños, niñas y adolescentes",2016,3,7,7607,92.0205074273695,3,3900,76.9230769230769,4,3707,107.903965470731
21694,47,47245,81,"Tasa de exámenes médico legales por presunto delito sexual contra niños, niñas y adolescentes",2016,4,21,7174,292.723724560914,0,3690,0,21,3484,602.755453501722
21695,47,47245,121,Tasa de exámenes médico legales por presunto delito sexual cuando la víctima está entre 18 y 28 años,2016,5,2,11225,17.8173719376392,1,5841,17.1203561034069,1,5384,18.5735512630015
21696,47,47258,81,"Tasa de exámenes médico legales por presunto delito sexual contra niños, niñas y adolescentes",2016,4,1,2001,49.9750124937531,0,1023,0,1,978,102.249488752556
21697,47,47268,81,"Tasa de exámenes médico legales por presunto delito sexual contra niños, niñas y adolescentes",2016,3,1,3031,32.9924117452986,1,1583,63.1711939355654,0,1448,0
21698,47,47268,81,"Tasa de exámenes médico legales por presunto delito sexual contra niños, niñas y adolescentes",2016,4,1,3033,32.9706561160567,0,1622,0,1,1411,70.871722182849
21699,47,47268,121,Tasa de exámenes médico legales por presunto delito sexual cuando la víctima está entre 18 y 28 años,2016,5,1,4319,23.1535077564251,0,2362,0,1,1957,51.0986203372509
21700,47,47288,81,"Tasa de exámenes médico legales por presunto delito sexual contra niños, niñas y adolescentes",2016,3,6,8038,74.6454341876089,1,4077,24.5278390973755,5,3961,126.230749810654
21701,47,47288,81,"Tasa de exámenes médico legales por presunto delito sexual contra niños, niñas y adolescentes",2016,4,6,7660,78.3289817232376,0,3882,0,6,3778,158.814187400741
21702,47,47288,121,Tasa de exámenes médico legales por presunto delito sexual cuando la víctima está entre 18 y 28 años,2016,5,1,11050,9.04977375565611,0,5518,0,1,5532,18.0766449746927
21703,47,47318,81,"Tasa de exámenes médico legales por presunto delito sexual contra niños, niñas y adolescentes",2016,2,1,3337,29.9670362601139,0,1710,0,1,1627,61.4628149969269
21704,47,47318,81,"Tasa de exámenes médico legales por presunto delito sexual contra niños, niñas y adolescentes",2016,3,5,3511,142.409569923099,0,1823,0,5,1688,296.208530805687
21705,47,47318,81,"Tasa de exámenes médico legales por presunto delito sexual contra niños, niñas y adolescentes",2016,4,5,3380,147.92899408284,1,1793,55.7724484104852,4,1587,252.047889098929
21706,47,47318,121,Tasa de exámenes médico legales por presunto delito sexual cuando la víctima está entre 18 y 28 años,2016,5,1,5607,17.8348492955235,0,3070,0,1,2537,39.4166338194718
21707,47,47460,81,"Tasa de exámenes médico legales por presunto delito sexual contra niños, niñas y adolescentes",2016,3,1,2592,38.5802469135803,0,1359,0,1,1233,81.10300081103
21708,47,47460,81,"Tasa de exámenes médico legales por presunto delito sexual contra niños, niñas y adolescentes",2016,4,4,2456,162.866449511401,0,1316,0,4,1140,350.877192982456
21709,47,47541,81,"Tasa de exámenes médico legales por presunto delito sexual contra niños, niñas y adolescentes",2016,4,2,955,209.424083769634,0,493,0,2,462,432.900432900433
21710,47,47545,81,"Tasa de exámenes médico legales por presunto delito sexual contra niños, niñas y adolescentes",2016,4,1,2444,40.9165302782324,0,1326,0,1,1118,89.4454382826476
21711,47,47551,81,"Tasa de exámenes médico legales por presunto delito sexual contra niños, niñas y adolescentes",2016,2,1,3307,30.2388872089507,0,1699,0,1,1608,62.1890547263682
21712,47,47551,81,"Tasa de exámenes médico legales por presunto delito sexual contra niños, niñas y adolescentes",2016,4,3,3863,77.6598498576236,0,2029,0,3,1834,163.576881134133
21713,47,47555,81,"Tasa de exámenes médico legales por presunto delito sexual contra niños, niñas y adolescentes",2016,2,2,6771,29.5377344557672,0,3455,0,2,3316,60.313630880579
21714,47,47555,81,"Tasa de exámenes médico legales por presunto delito sexual contra niños, niñas y adolescentes",2016,3,10,7960,125.628140703518,1,4087,24.4678248103744,9,3873,232.378001549187
21715,47,47555,81,"Tasa de exámenes médico legales por presunto delito sexual contra niños, niñas y adolescentes",2016,4,21,7523,279.143958527183,0,3903,0,21,3620,580.110497237569
21716,47,47555,121,Tasa de exámenes médico legales por presunto delito sexual cuando la víctima está entre 18 y 28 años,2016,5,1,11132,8.98311174991017,0,5788,0,1,5344,18.7125748502994
21717,47,47570,81,"Tasa de exámenes médico legales por presunto delito sexual contra niños, niñas y adolescentes",2016,4,2,4442,45.024763619991,0,2276,0,2,2166,92.3361034164358
21718,47,47660,81,"Tasa de exámenes médico legales por presunto delito sexual contra niños, niñas y adolescentes",2016,4,1,2348,42.5894378194208,0,1233,0,1,1115,89.6860986547085
21719,47,47675,81,"Tasa de exámenes médico legales por presunto delito sexual contra niños, niñas y adolescentes",2016,4,1,779,128.369704749679,0,393,0,1,386,259.067357512953
21720,47,47720,81,"Tasa de exámenes médico legales por presunto delito sexual contra niños, niñas y adolescentes",2016,4,1,1891,52.8820729772607,0,970,0,1,921,108.5776330076
21721,47,47745,81,"Tasa de exámenes médico legales por presunto delito sexual contra niños, niñas y adolescentes",2016,4,1,4093,24.4319569997557,0,2109,0,1,1984,50.4032258064516
21722,47,47798,81,"Tasa de exámenes médico legales por presunto delito sexual contra niños, niñas y adolescentes",2016,2,1,1457,68.6341798215511,0,753,0,1,704,142.045454545455
21723,47,47798,81,"Tasa de exámenes médico legales por presunto delito sexual contra niños, niñas y adolescentes",2016,3,2,1670,119.760479041916,0,860,0,2,810,246.913580246914
21724,47,47798,81,"Tasa de exámenes médico legales por presunto delito sexual contra niños, niñas y adolescentes",2016,4,3,1540,194.805194805195,0,787,0,3,753,398.406374501992
21725,47,47960,81,"Tasa de exámenes médico legales por presunto delito sexual contra niños, niñas y adolescentes",2016,2,1,930,107.52688172043,1,475,210.526315789474,0,455,0
21726,47,47960,81,"Tasa de exámenes médico legales por presunto delito sexual contra niños, niñas y adolescentes",2016,4,3,1048,286.259541984733,0,544,0,3,504,595.238095238095
21727,47,47960,121,Tasa de exámenes médico legales por presunto delito sexual cuando la víctima está entre 18 y 28 años,2016,5,1,1666,60.0240096038415,0,870,0,1,796,125.628140703518
21728,47,47980,81,"Tasa de exámenes médico legales por presunto delito sexual contra niños, niñas y adolescentes",2016,2,2,7897,25.3260731923515,0,4055,0,2,3842,52.0562207183759
21729,47,47980,81,"Tasa de exámenes médico legales por presunto delito sexual contra niños, niñas y adolescentes",2016,3,7,9303,75.2445447705041,0,4816,0,7,4487,156.00624024961
21730,47,47980,81,"Tasa de exámenes médico legales por presunto delito sexual contra niños, niñas y adolescentes",2016,4,6,8808,68.1198910081744,1,4597,21.7533173809006,5,4211,118.736642127761
21731,47,47980,121,Tasa de exámenes médico legales por presunto delito sexual cuando la víctima está entre 18 y 28 años,2016,5,1,11919,8.38996560114104,0,6253,0,1,5666,17.6491351923756
21732,5,5001,81,"Tasa de exámenes médico legales por presunto delito sexual contra niños, niñas y adolescentes",2016,2,216,146964,146.974769331265,53,75089,70.5829082821718,163,71875,226.782608695652
21733,5,5001,81,"Tasa de exámenes médico legales por presunto delito sexual contra niños, niñas y adolescentes",2016,3,320,180780,177.010731275584,80,92437,86.5454309421552,240,88343,271.668383459923
21734,5,5001,81,"Tasa de exámenes médico legales por presunto delito sexual contra niños, niñas y adolescentes",2016,4,419,193936,216.050655886478,45,99068,45.4233455808132,374,94868,394.231985495636
21735,5,5001,121,Tasa de exámenes médico legales por presunto delito sexual cuando la víctima está entre 18 y 28 años,2016,5,106,427819,24.7768331934767,3,216029,1.3887024427276,103,211790,48.6330799376741
21736,5,5002,81,"Tasa de exámenes médico legales por presunto delito sexual contra niños, niñas y adolescentes",2016,2,2,1701,117.577895355673,0,875,0,2,826,242.130750605327
21737,5,5002,81,"Tasa de exámenes médico legales por presunto delito sexual contra niños, niñas y adolescentes",2016,3,6,1914,313.479623824451,0,990,0,6,924,649.350649350649
21738,5,5002,81,"Tasa de exámenes médico legales por presunto delito sexual contra niños, niñas y adolescentes",2016,4,7,1841,380.228136882129,1,955,104.712041884817,6,886,677.200902934537
21739,5,5002,121,Tasa de exámenes médico legales por presunto delito sexual cuando la víctima está entre 18 y 28 años,2016,5,2,3405,58.7371512481645,1,1796,55.6792873051225,1,1609,62.1504039776259
21740,5,5021,81,"Tasa de exámenes médico legales por presunto delito sexual contra niños, niñas y adolescentes",2016,3,1,280,357.142857142857,0,144,0,1,136,735.294117647059
21741,5,5021,81,"Tasa de exámenes médico legales por presunto delito sexual contra niños, niñas y adolescentes",2016,4,1,311,321.543408360129,0,162,0,1,149,671.140939597315
21742,5,5030,81,"Tasa de exámenes médico legales por presunto delito sexual contra niños, niñas y adolescentes",2016,2,2,2778,71.9942404607631,0,1431,0,2,1347,148.478099480327
21743,5,5030,81,"Tasa de exámenes médico legales por presunto delito sexual contra niños, niñas y adolescentes",2016,4,2,3162,63.2511068943707,0,1619,0,2,1543,129.617627997408
21744,5,5031,81,"Tasa de exámenes médico legales por presunto delito sexual contra niños, niñas y adolescentes",2016,2,5,2414,207.125103562552,2,1236,161.812297734628,3,1178,254.668930390492
21745,5,5031,81,"Tasa de exámenes médico legales por presunto delito sexual contra niños, niñas y adolescentes",2016,3,4,2647,151.114469210427,0,1358,0,4,1289,310.318076027929
21746,5,5031,81,"Tasa de exámenes médico legales por presunto delito sexual contra niños, niñas y adolescentes",2016,4,6,2533,236.873272799053,4,1297,308.40400925212,2,1236,161.812297734628
21747,5,5031,121,Tasa de exámenes médico legales por presunto delito sexual cuando la víctima está entre 18 y 28 años,2016,5,4,4503,88.8296691094826,0,2313,0,4,2190,182.648401826484
21748,5,5034,81,"Tasa de exámenes médico legales por presunto delito sexual contra niños, niñas y adolescentes",2016,2,5,4337,115.28706479133,0,2205,0,5,2132,234.521575984991
21749,5,5034,81,"Tasa de exámenes médico legales por presunto delito sexual contra niños, niñas y adolescentes",2016,3,9,5153,174.655540461867,3,2645,113.421550094518,6,2508,239.234449760766
21750,5,5034,81,"Tasa de exámenes médico legales por presunto delito sexual contra niños, niñas y adolescentes",2016,4,6,4935,121.580547112462,1,2564,39.0015600624025,5,2371,210.881484605652
21751,5,5034,121,Tasa de exámenes médico legales por presunto delito sexual cuando la víctima está entre 18 y 28 años,2016,5,5,9447,52.9268550862708,0,4843,0,5,4604,108.601216333623
21752,5,5036,81,"Tasa de exámenes médico legales por presunto delito sexual contra niños, niñas y adolescentes",2016,4,1,844,118.483412322275,0,441,0,1,403,248.138957816377
21753,5,5038,81,"Tasa de exámenes médico legales por presunto delito sexual contra niños, niñas y adolescentes",2016,3,1,1315,76.0456273764259,1,690,144.927536231884,0,625,0
21754,5,5038,81,"Tasa de exámenes médico legales por presunto delito sexual contra niños, niñas y adolescentes",2016,4,1,1429,69.9790062981106,0,752,0,1,677,147.710487444609
21755,5,5040,81,"Tasa de exámenes médico legales por presunto delito sexual contra niños, niñas y adolescentes",2016,2,1,1745,57.3065902578797,0,894,0,1,851,117.508813160987
21756,5,5040,81,"Tasa de exámenes médico legales por presunto delito sexual contra niños, niñas y adolescentes",2016,3,1,1982,50.4540867810293,0,1031,0,1,951,105.15247108307
21757,5,5040,81,"Tasa de exámenes médico legales por presunto delito sexual contra niños, niñas y adolescentes",2016,4,7,1893,369.783412572636,1,1001,99.9000999000999,6,892,672.645739910314
21758,5,5042,81,"Tasa de exámenes médico legales por presunto delito sexual contra niños, niñas y adolescentes",2016,2,2,2564,78.003120124805,0,1324,0,2,1240,161.290322580645
21759,5,5042,81,"Tasa de exámenes médico legales por presunto delito sexual contra niños, niñas y adolescentes",2016,3,10,2907,343.997248022016,0,1515,0,10,1392,718.390804597701
21760,5,5042,81,"Tasa de exámenes médico legales por presunto delito sexual contra niños, niñas y adolescentes",2016,4,6,2689,223.131275567125,0,1399,0,6,1290,465.116279069767
21761,5,5042,121,Tasa de exámenes médico legales por presunto delito sexual cuando la víctima está entre 18 y 28 años,2016,5,2,4941,40.4776361060514,1,2600,38.4615384615385,1,2341,42.7167876975651
21762,5,5044,81,"Tasa de exámenes médico legales por presunto delito sexual contra niños, niñas y adolescentes",2016,4,1,855,116.959064327485,0,464,0,1,391,255.754475703325
21763,5,5045,81,"Tasa de exámenes médico legales por presunto delito sexual contra niños, niñas y adolescentes",2016,3,4,24379,16.4075638869519,1,12455,8.02890405459655,3,11924,25.1593425025159
21764,5,5045,81,"Tasa de exámenes médico legales por presunto delito sexual contra niños, niñas y adolescentes",2016,4,2,23895,8.36995187277673,0,12154,0,2,11741,17.0343241631888
21765,5,5051,81,"Tasa de exámenes médico legales por presunto delito sexual contra niños, niñas y adolescentes",2016,4,2,5587,35.7973867907643,0,2845,0,2,2742,72.9394602479942
21766,5,5079,81,"Tasa de exámenes médico legales por presunto delito sexual contra niños, niñas y adolescentes",2016,2,2,4720,42.3728813559322,1,2414,41.4250207125104,1,2306,43.3651344319167
21767,5,5079,81,"Tasa de exámenes médico legales por presunto delito sexual contra niños, niñas y adolescentes",2016,3,10,5626,177.746178457163,1,2883,34.6860908775581,9,2743,328.1079110463
21768,5,5079,81,"Tasa de exámenes médico legales por presunto delito sexual contra niños, niñas y adolescentes",2016,4,7,5500,127.272727272727,1,2800,35.7142857142857,6,2700,222.222222222222
21769,5,5079,121,Tasa de exámenes médico legales por presunto delito sexual cuando la víctima está entre 18 y 28 años,2016,5,4,10261,38.9825553065003,0,5219,0,4,5042,79.3335977786593
21770,5,5088,81,"Tasa de exámenes médico legales por presunto delito sexual contra niños, niñas y adolescentes",2016,2,24,37932,63.2711167352104,5,19384,25.7944696657037,19,18548,102.436920422687
21771,5,5088,81,"Tasa de exámenes médico legales por presunto delito sexual contra niños, niñas y adolescentes",2016,3,49,45526,107.630804375522,14,23069,60.6875027092635,35,22457,155.853408736697
21772,5,5088,81,"Tasa de exámenes médico legales por presunto delito sexual contra niños, niñas y adolescentes",2016,4,60,47768,125.607100988109,8,23797,33.617682901206,52,23971,216.928788953319
21773,5,5088,121,Tasa de exámenes médico legales por presunto delito sexual cuando la víctima está entre 18 y 28 años,2016,5,12,96521,12.4325276364729,1,47813,2.09148139627298,11,48708,22.583559168925
21774,5,5091,81,"Tasa de exámenes médico legales por presunto delito sexual contra niños, niñas y adolescentes",2016,4,1,1037,96.4320154291225,0,545,0,1,492,203.252032520325
21775,5,5091,121,Tasa de exámenes médico legales por presunto delito sexual cuando la víctima está entre 18 y 28 años,2016,5,1,1921,52.0562207183759,0,1036,0,1,885,112.994350282486
21776,5,5101,81,"Tasa de exámenes médico legales por presunto delito sexual contra niños, niñas y adolescentes",2016,3,3,3046,98.4898227183191,1,1561,64.0614990390775,2,1485,134.680134680135
21777,5,5101,81,"Tasa de exámenes médico legales por presunto delito sexual contra niños, niñas y adolescentes",2016,4,1,2978,33.5795836131632,0,1531,0,1,1447,69.1085003455425
21778,5,5107,81,"Tasa de exámenes médico legales por presunto delito sexual contra niños, niñas y adolescentes",2016,2,1,910,109.89010989011,0,465,0,1,445,224.719101123596
21779,5,5107,81,"Tasa de exámenes médico legales por presunto delito sexual contra niños, niñas y adolescentes",2016,4,1,1007,99.304865938431,0,514,0,1,493,202.839756592292
21780,5,5113,81,"Tasa de exámenes médico legales por presunto delito sexual contra niños, niñas y adolescentes",2016,3,1,762,131.233595800525,0,405,0,1,357,280.112044817927
21781,5,5113,121,Tasa de exámenes médico legales por presunto delito sexual cuando la víctima está entre 18 y 28 años,2016,5,1,1289,77.5795190069822,0,706,0,1,583,171.526586620926
21782,5,5120,81,"Tasa de exámenes médico legales por presunto delito sexual contra niños, niñas y adolescentes",2016,3,1,5620,17.7935943060498,0,2882,0,1,2738,36.5230094959825
21783,5,5120,81,"Tasa de exámenes médico legales por presunto delito sexual contra niños, niñas y adolescentes",2016,4,1,5164,19.3648334624322,0,2660,0,1,2504,39.9361022364217
21784,5,5125,81,"Tasa de exámenes médico legales por presunto delito sexual contra niños, niñas y adolescentes",2016,3,1,982,101.83299389002,0,524,0,1,458,218.340611353712
21785,5,5129,81,"Tasa de exámenes médico legales por presunto delito sexual contra niños, niñas y adolescentes",2016,2,6,5687,105.503780552136,2,2907,68.7994496044032,4,2780,143.884892086331
21786,5,5129,81,"Tasa de exámenes médico legales por presunto delito sexual contra niños, niñas y adolescentes",2016,3,10,7138,140.09526478005,3,3647,82.2593912805045,7,3491,200.515611572615
21787,5,5129,81,"Tasa de exámenes médico legales por presunto delito sexual contra niños, niñas y adolescentes",2016,4,9,7397,121.670947681493,2,3770,53.0503978779841,7,3627,192.996967190516
21788,5,5129,121,Tasa de exámenes médico legales por presunto delito sexual cuando la víctima está entre 18 y 28 años,2016,5,4,14879,26.883527118758,0,7505,0,4,7374,54.24464334147
21789,5,5134,81,"Tasa de exámenes médico legales por presunto delito sexual contra niños, niñas y adolescentes",2016,4,1,989,101.112234580384,0,522,0,1,467,214.132762312634
21790,5,5142,81,"Tasa de exámenes médico legales por presunto delito sexual contra niños, niñas y adolescentes",2016,3,1,493,202.839756592292,0,255,0,1,238,420.168067226891
21791,5,5147,81,"Tasa de exámenes médico legales por presunto delito sexual contra niños, niñas y adolescentes",2016,3,1,7520,13.2978723404255,0,3796,0,1,3724,26.8528464017186
21792,5,5148,81,"Tasa de exámenes médico legales por presunto delito sexual contra niños, niñas y adolescentes",2016,2,1,4805,20.811654526534898,1,2466,40.551500405515,0,2339,0
21793,5,5148,81,"Tasa de exámenes médico legales por presunto delito sexual contra niños, niñas y adolescentes",2016,3,8,5594,143.010368251698,0,2875,0,8,2719,294.225818315557
21794,5,5148,81,"Tasa de exámenes médico legales por presunto delito sexual contra niños, niñas y adolescentes",2016,4,8,5362,149.198060425215,2,2767,72.2804481387785,6,2595,231.21387283237
21795,5,5148,121,Tasa de exámenes médico legales por presunto delito sexual cuando la víctima está entre 18 y 28 años,2016,5,1,10159,9.84348853233586,0,5211,0,1,4948,20.2101859337106
21796,5,5154,81,"Tasa de exámenes médico legales por presunto delito sexual contra niños, niñas y adolescentes",2016,2,1,12347,8.09913339272698,1,6301,15.8704967465482,0,6046,0
21797,5,5154,81,"Tasa de exámenes médico legales por presunto delito sexual contra niños, niñas y adolescentes",2016,3,10,13880,72.0461095100865,3,7030,42.674253200569,7,6850,102.189781021898
21798,5,5154,81,"Tasa de exámenes médico legales por presunto delito sexual contra niños, niñas y adolescentes",2016,4,10,13911,71.8855581913594,1,6963,14.3616257360333,9,6948,129.533678756477
21799,5,5154,121,Tasa de exámenes médico legales por presunto delito sexual cuando la víctima está entre 18 y 28 años,2016,5,3,24519,12.2354092744402,0,11819,0,3,12700,23.6220472440945
21800,5,5172,81,"Tasa de exámenes médico legales por presunto delito sexual contra niños, niñas y adolescentes",2016,4,1,9808,10.1957585644372,0,4867,0,1,4941,20.2388180530257
21801,5,5190,81,"Tasa de exámenes médico legales por presunto delito sexual contra niños, niñas y adolescentes",2016,2,1,752,132.978723404255,0,385,0,1,367,272.479564032698
21802,5,5190,81,"Tasa de exámenes médico legales por presunto delito sexual contra niños, niñas y adolescentes",2016,3,1,900,111.111111111111,0,465,0,1,435,229.885057471264
21803,5,5190,81,"Tasa de exámenes médico legales por presunto delito sexual contra niños, niñas y adolescentes",2016,4,5,878,569.476082004556,0,458,0,5,420,1190.47619047619
21804,5,5197,81,"Tasa de exámenes médico legales por presunto delito sexual contra niños, niñas y adolescentes",2016,4,1,1399,71.4796283059328,0,707,0,1,692,144.508670520231
21805,5,5209,81,"Tasa de exámenes médico legales por presunto delito sexual contra niños, niñas y adolescentes",2016,3,3,2530,118.577075098814,0,1319,0,3,1211,247.729149463254
21806,5,5209,81,"Tasa de exámenes médico legales por presunto delito sexual contra niños, niñas y adolescentes",2016,4,3,2371,126.528890763391,0,1237,0,3,1134,264.550264550265
21807,5,5209,121,Tasa de exámenes médico legales por presunto delito sexual cuando la víctima está entre 18 y 28 años,2016,5,2,4223,47.3596968979399,0,2203,0,2,2020,99.009900990099
21808,5,5212,81,"Tasa de exámenes médico legales por presunto delito sexual contra niños, niñas y adolescentes",2016,2,4,4837,82.6958858796775,0,2454,0,4,2383,167.855644146034
21809,5,5212,81,"Tasa de exámenes médico legales por presunto delito sexual contra niños, niñas y adolescentes",2016,3,8,6042,132.406487917908,0,3119,0,8,2923,273.691412931919
21810,5,5212,81,"Tasa de exámenes médico legales por presunto delito sexual contra niños, niñas y adolescentes",2016,4,11,6717,163.76358493375,2,3459,57.8201792425557,9,3258,276.243093922652
21811,5,5212,121,Tasa de exámenes médico legales por presunto delito sexual cuando la víctima está entre 18 y 28 años,2016,5,4,13276,30.1295570955107,0,6700,0,4,6576,60.8272506082725
21812,5,5237,81,"Tasa de exámenes médico legales por presunto delito sexual contra niños, niñas y adolescentes",2016,4,3,2625,114.285714285714,0,1329,0,3,1296,231.481481481481
21813,5,5237,121,Tasa de exámenes médico legales por presunto delito sexual cuando la víctima está entre 18 y 28 años,2016,5,1,4875,20.5128205128205,0,2380,0,1,2495,40.0801603206413
21814,5,5240,81,"Tasa de exámenes médico legales por presunto delito sexual contra niños, niñas y adolescentes",2016,2,1,1192,83.8926174496644,0,607,0,1,585,170.940170940171
21815,5,5240,81,"Tasa de exámenes médico legales por presunto delito sexual contra niños, niñas y adolescentes",2016,3,1,1367,73.1528895391368,1,699,143.061516452074,0,668,0
21816,5,5240,81,"Tasa de exámenes médico legales por presunto delito sexual contra niños, niñas y adolescentes",2016,4,5,1319,379.075056861259,1,678,147.492625368732,4,641,624.02496099844
21817,5,5240,121,Tasa de exámenes médico legales por presunto delito sexual cuando la víctima está entre 18 y 28 años,2016,5,1,2603,38.4172109104879,0,1351,0,1,1252,79.8722044728435
21818,5,5250,81,"Tasa de exámenes médico legales por presunto delito sexual contra niños, niñas y adolescentes",2016,2,1,5554,18.0050414115952,0,2851,0,1,2703,36.9959304476508
21819,5,5250,81,"Tasa de exámenes médico legales por presunto delito sexual contra niños, niñas y adolescentes",2016,4,1,6115,16.3532297628782,0,3167,0,1,2948,33.921302578019
21820,5,5264,121,Tasa de exámenes médico legales por presunto delito sexual cuando la víctima está entre 18 y 28 años,2016,5,1,2054,48.6854917234664,1,1087,91.9963201471941,0,967,0
21821,5,5266,81,"Tasa de exámenes médico legales por presunto delito sexual contra niños, niñas y adolescentes",2016,2,12,16087,74.5943929881271,4,8221,48.6558812796497,8,7866,101.703534197813
21822,5,5266,81,"Tasa de exámenes médico legales por presunto delito sexual contra niños, niñas y adolescentes",2016,3,11,20046,54.8737902823506,5,10283,48.6239424292522,6,9763,61.4565195124449
21823,5,5266,81,"Tasa de exámenes médico legales por presunto delito sexual contra niños, niñas y adolescentes",2016,4,10,21273,47.0079443425939,5,10912,45.8211143695015,5,10361,48.257890165042
21824,5,5266,121,Tasa de exámenes médico legales por presunto delito sexual cuando la víctima está entre 18 y 28 años,2016,5,1,41686,2.39888691647076,0,21174,0,1,20512,4.87519500780031
21825,5,5282,81,"Tasa de exámenes médico legales por presunto delito sexual contra niños, niñas y adolescentes",2016,2,2,1817,110.071546505228,1,925,108.108108108108,1,892,112.107623318386
21826,5,5282,81,"Tasa de exámenes médico legales por presunto delito sexual contra niños, niñas y adolescentes",2016,3,2,2223,89.9685110211426,1,1137,87.9507475813545,1,1086,92.0810313075507
21827,5,5282,81,"Tasa de exámenes médico legales por presunto delito sexual contra niños, niñas y adolescentes",2016,4,7,2209,316.8854685378,2,1129,177.147918511958,5,1080,462.962962962963
21828,5,5282,121,Tasa de exámenes médico legales por presunto delito sexual cuando la víctima está entre 18 y 28 años,2016,5,1,4286,23.3317778814746,0,2205,0,1,2081,48.0538202787122
21829,5,5306,81,"Tasa de exámenes médico legales por presunto delito sexual contra niños, niñas y adolescentes",2016,2,1,410,243.90243902439,0,210,0,1,200,500
21830,5,5306,81,"Tasa de exámenes médico legales por presunto delito sexual contra niños, niñas y adolescentes",2016,3,1,458,218.340611353712,0,234,0,1,224,446.428571428571
21831,5,5308,81,"Tasa de exámenes médico legales por presunto delito sexual contra niños, niñas y adolescentes",2016,2,1,4696,21.2947189097104,0,2393,0,1,2303,43.4216239687364
21832,5,5308,81,"Tasa de exámenes médico legales por presunto delito sexual contra niños, niñas y adolescentes",2016,3,5,5736,87.1687587168759,0,2890,0,5,2846,175.685172171469
21833,5,5308,81,"Tasa de exámenes médico legales por presunto delito sexual contra niños, niñas y adolescentes",2016,4,3,5935,50.547598989048,0,3006,0,3,2929,102.424035506999
21834,5,5308,121,Tasa de exámenes médico legales por presunto delito sexual cuando la víctima está entre 18 y 28 años,2016,5,1,11334,8.82301041115229,0,5717,0,1,5617,17.8030977390066
21835,5,5313,81,"Tasa de exámenes médico legales por presunto delito sexual contra niños, niñas y adolescentes",2016,3,1,1008,99.2063492063492,0,518,0,1,490,204.081632653061
21836,5,5318,81,"Tasa de exámenes médico legales por presunto delito sexual contra niños, niñas y adolescentes",2016,2,2,4576,43.7062937062937,0,2340,0,2,2236,89.4454382826476
21837,5,5318,81,"Tasa de exámenes médico legales por presunto delito sexual contra niños, niñas y adolescentes",2016,3,3,5402,55.5349870418364,1,2762,36.2056480811007,2,2640,75.7575757575758
21838,5,5318,81,"Tasa de exámenes médico legales por presunto delito sexual contra niños, niñas y adolescentes",2016,4,7,5227,133.920030610293,0,2699,0,7,2528,276.898734177215
21839,5,5318,121,Tasa de exámenes médico legales por presunto delito sexual cuando la víctima está entre 18 y 28 años,2016,5,3,9715,30.8800823468863,0,4949,0,3,4766,62.9458665547629
21840,5,5321,81,"Tasa de exámenes médico legales por presunto delito sexual contra niños, niñas y adolescentes",2016,4,1,522,191.570881226054,0,270,0,1,252,396.825396825397
21841,5,5321,121,Tasa de exámenes médico legales por presunto delito sexual cuando la víctima está entre 18 y 28 años,2016,5,1,967,103.412616339193,0,494,0,1,473,211.416490486258
21842,5,5353,81,"Tasa de exámenes médico legales por presunto delito sexual contra niños, niñas y adolescentes",2016,4,1,469,213.219616204691,0,241,0,1,228,438.59649122807
21843,5,5360,81,"Tasa de exámenes médico legales por presunto delito sexual contra niños, niñas y adolescentes",2016,2,21,20463,102.624248643894,11,10519,104.572678011218,10,9944,100.563153660499
21844,5,5360,81,"Tasa de exámenes médico legales por presunto delito sexual contra niños, niñas y adolescentes",2016,3,31,24754,125.232285691201,9,12564,71.6332378223496,22,12190,180.475799835931
21845,5,5360,81,"Tasa de exámenes médico legales por presunto delito sexual contra niños, niñas y adolescentes",2016,4,22,26661,82.5175349761824,1,13377,7.47551767959931,21,13284,158.084914182475
21846,5,5360,121,Tasa de exámenes médico legales por presunto delito sexual cuando la víctima está entre 18 y 28 años,2016,5,12,53653,22.3659441224163,1,27327,3.65938449152853,11,26326,41.7837878902986
21847,5,5361,81,"Tasa de exámenes médico legales por presunto delito sexual contra niños, niñas y adolescentes",2016,2,1,2738,36.5230094959825,0,1386,0,1,1352,73.9644970414201
21848,5,5361,81,"Tasa de exámenes médico legales por presunto delito sexual contra niños, niñas y adolescentes",2016,3,12,2928,409.836065573771,4,1490,268.456375838926,8,1438,556.328233657858
21849,5,5361,81,"Tasa de exámenes médico legales por presunto delito sexual contra niños, niñas y adolescentes",2016,4,13,2619,496.372661321115,0,1335,0,13,1284,1012.46105919003
21850,5,5361,121,Tasa de exámenes médico legales por presunto delito sexual cuando la víctima está entre 18 y 28 años,2016,5,2,3873,51.6395558998193,0,1995,0,2,1878,106.496272630458
21851,5,5364,81,"Tasa de exámenes médico legales por presunto delito sexual contra niños, niñas y adolescentes",2016,4,1,1443,69.3000693000693,0,755,0,1,688,145.348837209302
21852,5,5368,81,"Tasa de exámenes médico legales por presunto delito sexual contra niños, niñas y adolescentes",2016,4,1,1227,81.4995925020375,0,619,0,1,608,164.473684210526
21853,5,5376,81,"Tasa de exámenes médico legales por presunto delito sexual contra niños, niñas y adolescentes",2016,2,9,4553,197.67186470459,0,2320,0,9,2233,403.045230631438
21854,5,5376,81,"Tasa de exámenes médico legales por presunto delito sexual contra niños, niñas y adolescentes",2016,3,10,5529,180.864532465184,0,2834,0,10,2695,371.057513914657
21855,5,5376,81,"Tasa de exámenes médico legales por presunto delito sexual contra niños, niñas y adolescentes",2016,4,22,5634,390.486332978346,1,2845,35.1493848857645,21,2789,752.9580494801
21856,5,5376,121,Tasa de exámenes médico legales por presunto delito sexual cuando la víctima está entre 18 y 28 años,2016,5,1,11119,8.99361453368109,0,5615,0,1,5504,18.1686046511628
21857,5,5380,81,"Tasa de exámenes médico legales por presunto delito sexual contra niños, niñas y adolescentes",2016,2,7,5093,137.443549970548,3,2628,114.155251141553,4,2465,162.271805273834
21858,5,5380,81,"Tasa de exámenes médico legales por presunto delito sexual contra niños, niñas y adolescentes",2016,3,2,6190,32.3101777059774,1,3163,31.6155548529877,1,3027,33.0360092500826
21859,5,5380,81,"Tasa de exámenes médico legales por presunto delito sexual contra niños, niñas y adolescentes",2016,4,6,6453,92.9800092980009,1,3256,30.7125307125307,5,3197,156.396621832968
21860,5,5380,121,Tasa de exámenes médico legales por presunto delito sexual cuando la víctima está entre 18 y 28 años,2016,5,2,12804,15.6201187129022,0,6455,0,2,6349,31.501023783273
21861,5,5380,81,"Tasa de exámenes médico legales por presunto delito sexual contra niños, niñas y adolescentes",2016,1,1,1036,96.5250965250965,1,528,189.393939393939,0,508,0
21862,5,5390,81,"Tasa de exámenes médico legales por presunto delito sexual contra niños, niñas y adolescentes",2016,3,1,713,140.252454417952,0,364,0,1,349,286.532951289398
21863,5,5390,121,Tasa de exámenes médico legales por presunto delito sexual cuando la víctima está entre 18 y 28 años,2016,5,1,1274,78.4929356357928,0,639,0,1,635,157.48031496063
21864,5,5400,81,"Tasa de exámenes médico legales por presunto delito sexual contra niños, niñas y adolescentes",2016,3,1,2157,46.3606861381548,0,1115,0,1,1042,95.9692898272553
21865,5,5411,81,"Tasa de exámenes médico legales por presunto delito sexual contra niños, niñas y adolescentes",2016,2,1,809,123.609394313968,0,419,0,1,390,256.410256410256
21866,5,5411,81,"Tasa de exámenes médico legales por presunto delito sexual contra niños, niñas y adolescentes",2016,4,1,1020,98.0392156862745,0,547,0,1,473,211.416490486258
21867,5,5425,81,"Tasa de exámenes médico legales por presunto delito sexual contra niños, niñas y adolescentes",2016,4,1,677,147.710487444609,0,350,0,1,327,305.810397553517
21868,5,5425,121,Tasa de exámenes médico legales por presunto delito sexual cuando la víctima está entre 18 y 28 años,2016,5,1,1249,80.0640512409928,0,662,0,1,587,170.357751277683
21869,5,5440,81,"Tasa de exámenes médico legales por presunto delito sexual contra niños, niñas y adolescentes",2016,2,2,5349,37.3901663862404,2,2705,73.9371534195933,0,2644,0
21870,5,5440,81,"Tasa de exámenes médico legales por presunto delito sexual contra niños, niñas y adolescentes",2016,3,2,6470,30.9119010819165,2,3303,60.5510142294883,0,3167,0
21871,5,5440,81,"Tasa de exámenes médico legales por presunto delito sexual contra niños, niñas y adolescentes",2016,4,3,6120,49.0196078431373,0,3166,0,3,2954,101.55721056195
21872,5,5440,121,Tasa de exámenes médico legales por presunto delito sexual cuando la víctima está entre 18 y 28 años,2016,5,2,11462,17.4489617867737,0,5868,0,2,5594,35.7525920629246
21873,5,5480,81,"Tasa de exámenes médico legales por presunto delito sexual contra niños, niñas y adolescentes",2016,2,1,2342,42.6985482493595,0,1200,0,1,1142,87.5656742556918
21874,5,5480,81,"Tasa de exámenes médico legales por presunto delito sexual contra niños, niñas y adolescentes",2016,4,2,2538,78.8022064617809,0,1305,0,2,1233,162.20600162206
21875,5,5483,81,"Tasa de exámenes médico legales por presunto delito sexual contra niños, niñas y adolescentes",2016,2,1,1830,54.6448087431694,1,947,105.596620908131,0,883,0
21876,5,5490,81,"Tasa de exámenes médico legales por presunto delito sexual contra niños, niñas y adolescentes",2016,3,1,8432,11.8595825426945,1,4303,23.2396002788752,0,4129,0
21877,5,5490,81,"Tasa de exámenes médico legales por presunto delito sexual contra niños, niñas y adolescentes",2016,4,2,8259,24.2160067804819,0,4201,0,2,4058,49.2853622474125
21878,5,5541,81,"Tasa de exámenes médico legales por presunto delito sexual contra niños, niñas y adolescentes",2016,2,1,1547,64.6412411118293,0,786,0,1,761,131.406044678055
21879,5,5541,81,"Tasa de exámenes médico legales por presunto delito sexual contra niños, niñas y adolescentes",2016,4,1,1740,57.4712643678161,0,885,0,1,855,116.959064327485
21880,5,5543,81,"Tasa de exámenes médico legales por presunto delito sexual contra niños, niñas y adolescentes",2016,4,1,1248,80.1282051282051,0,676,0,1,572,174.825174825175
21881,5,5579,81,"Tasa de exámenes médico legales por presunto delito sexual contra niños, niñas y adolescentes",2016,2,4,4282,93.4142923867352,2,2191,91.2825193975354,2,2091,95.6480153036825
21882,5,5579,81,"Tasa de exámenes médico legales por presunto delito sexual contra niños, niñas y adolescentes",2016,3,11,5118,214.927706135209,3,2604,115.207373271889,8,2514,318.217979315831
21883,5,5579,81,"Tasa de exámenes médico legales por presunto delito sexual contra niños, niñas y adolescentes",2016,4,10,5084,196.69551534225,1,2569,38.9256520046711,9,2515,357.852882703777
21884,5,5579,121,Tasa de exámenes médico legales por presunto delito sexual cuando la víctima está entre 18 y 28 años,2016,5,4,9828,40.7000407000407,1,4860,20.5761316872428,3,4968,60.3864734299517
21885,5,5591,81,"Tasa de exámenes médico legales por presunto delito sexual contra niños, niñas y adolescentes",2016,2,1,2128,46.9924812030075,0,1096,0,1,1032,96.8992248062015
21886,5,5591,81,"Tasa de exámenes médico legales por presunto delito sexual contra niños, niñas y adolescentes",2016,4,1,2330,42.9184549356223,0,1243,0,1,1087,91.9963201471941
21887,5,5604,81,"Tasa de exámenes médico legales por presunto delito sexual contra niños, niñas y adolescentes",2016,2,1,2982,33.5345405767941,0,1538,0,1,1444,69.2520775623269
21888,5,5604,81,"Tasa de exámenes médico legales por presunto delito sexual contra niños, niñas y adolescentes",2016,3,1,3532,28.312570781427,0,1842,0,1,1690,59.1715976331361
21889,5,5604,81,"Tasa de exámenes médico legales por presunto delito sexual contra niños, niñas y adolescentes",2016,4,1,3562,28.0741156653565,0,1866,0,1,1696,58.9622641509434
21890,5,5607,81,"Tasa de exámenes médico legales por presunto delito sexual contra niños, niñas y adolescentes",2016,3,2,1993,100.351229302559,0,1022,0,2,971,205.973223480947
21891,5,5607,81,"Tasa de exámenes médico legales por presunto delito sexual contra niños, niñas y adolescentes",2016,4,3,1993,150.526843953838,1,1033,96.8054211035818,2,960,208.333333333333
21892,5,5615,81,"Tasa de exámenes médico legales por presunto delito sexual contra niños, niñas y adolescentes",2016,2,4,10009,39.9640323708662,1,5154,19.4024058983314,3,4855,61.7919670442842
21893,5,5615,81,"Tasa de exámenes médico legales por presunto delito sexual contra niños, niñas y adolescentes",2016,3,18,12231,147.167034584253,1,6261,15.9718894745248,17,5970,284.757118927973
21894,5,5615,81,"Tasa de exámenes médico legales por presunto delito sexual contra niños, niñas y adolescentes",2016,4,15,12421,120.763223572981,2,6333,31.5806095057635,13,6088,213.53482260184
21895,5,5615,121,Tasa de exámenes médico legales por presunto delito sexual cuando la víctima está entre 18 y 28 años,2016,5,8,24238,33.0060235993069,1,12436,8.04117079446768,7,11802,59.3119810201661
21896,5,5628,81,"Tasa de exámenes médico legales por presunto delito sexual contra niños, niñas y adolescentes",2016,3,1,1066,93.8086303939963,0,550,0,1,516,193.798449612403
21897,5,5631,81,"Tasa de exámenes médico legales por presunto delito sexual contra niños, niñas y adolescentes",2016,2,3,2867,104.638995465644,1,1456,68.6813186813187,2,1411,141.743444365698
21898,5,5631,81,"Tasa de exámenes médico legales por presunto delito sexual contra niños, niñas y adolescentes",2016,3,4,3509,113.992590481619,1,1768,56.5610859728507,3,1741,172.314761631246
21899,5,5631,81,"Tasa de exámenes médico legales por presunto delito sexual contra niños, niñas y adolescentes",2016,4,6,4230,141.843971631206,1,2122,47.1253534401508,5,2108,237.19165085389
21900,5,5631,121,Tasa de exámenes médico legales por presunto delito sexual cuando la víctima está entre 18 y 28 años,2016,5,2,10240,19.53125,0,5057,0,2,5183,38.587690526722
21901,5,5642,81,"Tasa de exámenes médico legales por presunto delito sexual contra niños, niñas y adolescentes",2016,3,3,2135,140.515222482436,0,1113,0,3,1022,293.542074363992
21902,5,5642,81,"Tasa de exámenes médico legales por presunto delito sexual contra niños, niñas y adolescentes",2016,4,1,1981,50.4795557799091,0,1044,0,1,937,106.723585912487
21903,5,5642,121,Tasa de exámenes médico legales por presunto delito sexual cuando la víctima está entre 18 y 28 años,2016,5,2,3483,57.4217628481194,0,1859,0,2,1624,123.152709359606
21904,5,5647,81,"Tasa de exámenes médico legales por presunto delito sexual contra niños, niñas y adolescentes",2016,3,2,703,284.495021337127,0,365,0,2,338,591.715976331361
21905,5,5649,81,"Tasa de exámenes médico legales por presunto delito sexual contra niños, niñas y adolescentes",2016,3,2,1768,113.122171945701,1,919,108.813928182807,1,849,117.785630153121
21906,5,5649,81,"Tasa de exámenes médico legales por presunto delito sexual contra niños, niñas y adolescentes",2016,4,1,1579,63.3312222925903,0,827,0,1,752,132.978723404255
21907,5,5656,121,Tasa de exámenes médico legales por presunto delito sexual cuando la víctima está entre 18 y 28 años,2016,5,3,2499,120.048019207683,0,1301,0,3,1198,250.417362270451
21908,5,5658,81,"Tasa de exámenes médico legales por presunto delito sexual contra niños, niñas y adolescentes",2016,3,1,471,212.314225053079,0,239,0,1,232,431.034482758621
21909,5,5659,81,"Tasa de exámenes médico legales por presunto delito sexual contra niños, niñas y adolescentes",2016,3,1,3750,26.6666666666667,1,1924,51.975051975052,0,1826,0
21910,5,5660,81,"Tasa de exámenes médico legales por presunto delito sexual contra niños, niñas y adolescentes",2016,4,3,1155,259.74025974026,0,633,0,3,522,574.712643678161
21911,5,5660,121,Tasa de exámenes médico legales por presunto delito sexual cuando la víctima está entre 18 y 28 años,2016,5,1,2042,48.9715964740451,1,1136,88.0281690140845,0,906,0
21912,5,5664,81,"Tasa de exámenes médico legales por presunto delito sexual contra niños, niñas y adolescentes",2016,4,4,3059,130.76168682576,0,1578,0,4,1481,270.087778528022
21913,5,5664,121,Tasa de exámenes médico legales por presunto delito sexual cuando la víctima está entre 18 y 28 años,2016,5,1,5767,17.3400381480839,0,2987,0,1,2780,35.9712230215827
21914,5,5667,81,"Tasa de exámenes médico legales por presunto delito sexual contra niños, niñas y adolescentes",2016,2,2,1065,187.793427230047,2,551,362.976406533575,0,514,0
21915,5,5667,81,"Tasa de exámenes médico legales por presunto delito sexual contra niños, niñas y adolescentes",2016,3,2,1188,168.350168350168,2,628,318.471337579618,0,560,0
21916,5,5667,81,"Tasa de exámenes médico legales por presunto delito sexual contra niños, niñas y adolescentes",2016,4,2,1235,161.943319838057,1,651,153.609831029186,1,584,171.232876712329
21917,5,5667,121,Tasa de exámenes médico legales por presunto delito sexual cuando la víctima está entre 18 y 28 años,2016,5,4,2382,167.926112510495,1,1217,82.1692686935086,3,1165,257.510729613734
21918,5,5670,81,"Tasa de exámenes médico legales por presunto delito sexual contra niños, niñas y adolescentes",2016,2,2,1706,117.233294255569,1,874,114.41647597254,1,832,120.192307692308
21919,5,5670,81,"Tasa de exámenes médico legales por presunto delito sexual contra niños, niñas y adolescentes",2016,3,4,1967,203.355363497712,1,1008,99.2063492063492,3,959,312.825860271116
21920,5,5670,81,"Tasa de exámenes médico legales por presunto delito sexual contra niños, niñas y adolescentes",2016,4,4,1806,221.483942414175,1,923,108.342361863489,3,883,339.750849377124
21921,5,5674,81,"Tasa de exámenes médico legales por presunto delito sexual contra niños, niñas y adolescentes",2016,4,1,1691,59.1366055588409,1,871,114.810562571757,0,820,0
21922,5,5679,81,"Tasa de exámenes médico legales por presunto delito sexual contra niños, niñas y adolescentes",2016,2,1,2008,49.800796812749,0,1020,0,1,988,101.214574898785
21923,5,5679,81,"Tasa de exámenes médico legales por presunto delito sexual contra niños, niñas y adolescentes",2016,4,2,2292,87.260034904014,0,1167,0,2,1125,177.777777777778
21924,5,5686,81,"Tasa de exámenes médico legales por presunto delito sexual contra niños, niñas y adolescentes",2016,3,4,3945,101.394169835234,0,2007,0,4,1938,206.398348813209
21925,5,5686,81,"Tasa de exámenes médico legales por presunto delito sexual contra niños, niñas y adolescentes",2016,4,8,4054,197.335964479526,0,2128,0,8,1926,415.368639667705
21926,5,5686,121,Tasa de exámenes médico legales por presunto delito sexual cuando la víctima está entre 18 y 28 años,2016,5,3,7591,39.5204847846134,0,3983,0,3,3608,83.1485587583149
21927,5,5697,81,"Tasa de exámenes médico legales por presunto delito sexual contra niños, niñas y adolescentes",2016,2,1,2229,44.8631673396142,0,1134,0,1,1095,91.324200913242
21928,5,5697,81,"Tasa de exámenes médico legales por presunto delito sexual contra niños, niñas y adolescentes",2016,3,3,2641,113.59333585763,1,1360,73.5294117647059,2,1281,156.128024980484
21929,5,5697,81,"Tasa de exámenes médico legales por presunto delito sexual contra niños, niñas y adolescentes",2016,4,2,2687,74.4324525493115,0,1398,0,2,1289,155.159038013964
21930,5,5697,121,Tasa de exámenes médico legales por presunto delito sexual cuando la víctima está entre 18 y 28 años,2016,5,2,5161,38.7521798101143,0,2645,0,2,2516,79.4912559618442
21931,5,5736,81,"Tasa de exámenes médico legales por presunto delito sexual contra niños, niñas y adolescentes",2016,3,2,4863,41.1268764137364,1,2515,39.7614314115308,1,2348,42.5894378194208
21932,5,5736,121,Tasa de exámenes médico legales por presunto delito sexual cuando la víctima está entre 18 y 28 años,2016,5,1,8806,11.3558937088349,0,4576,0,1,4230,23.6406619385343
21933,5,5756,81,"Tasa de exámenes médico legales por presunto delito sexual contra niños, niñas y adolescentes",2016,2,2,3073,65.0829808005207,0,1569,0,2,1504,132.978723404255
21934,5,5756,81,"Tasa de exámenes médico legales por presunto delito sexual contra niños, niñas y adolescentes",2016,3,8,3828,208.986415882968,2,1959,102.092904543134,6,1869,321.027287319422
21935,5,5756,81,"Tasa de exámenes médico legales por presunto delito sexual contra niños, niñas y adolescentes",2016,4,7,3719,188.222640494757,2,1903,105.097214923805,5,1816,275.330396475771
21936,5,5756,121,Tasa de exámenes médico legales por presunto delito sexual cuando la víctima está entre 18 y 28 años,2016,5,1,7376,13.5574837310195,0,3729,0,1,3647,27.4197970935015
21937,5,5761,81,"Tasa de exámenes médico legales por presunto delito sexual contra niños, niñas y adolescentes",2016,2,2,1333,150.037509377344,1,685,145.985401459854,1,648,154.320987654321
21938,5,5761,81,"Tasa de exámenes médico legales por presunto delito sexual contra niños, niñas y adolescentes",2016,3,4,1591,251.414204902577,1,827,120.918984280532,3,764,392.670157068063
21939,5,5761,81,"Tasa de exámenes médico legales por presunto delito sexual contra niños, niñas y adolescentes",2016,4,2,1579,126.662444585181,0,844,0,2,735,272.108843537415
21940,5,5761,121,Tasa de exámenes médico legales por presunto delito sexual cuando la víctima está entre 18 y 28 años,2016,5,1,2982,33.5345405767941,0,1609,0,1,1373,72.8332119446468
21941,5,5819,81,"Tasa de exámenes médico legales por presunto delito sexual contra niños, niñas y adolescentes",2016,3,1,815,122.699386503067,0,419,0,1,396,252.525252525253
21942,5,5819,81,"Tasa de exámenes médico legales por presunto delito sexual contra niños, niñas y adolescentes",2016,4,1,721,138.69625520111,0,371,0,1,350,285.714285714286
21943,5,5819,121,Tasa de exámenes médico legales por presunto delito sexual cuando la víctima está entre 18 y 28 años,2016,5,1,1176,85.0340136054422,0,610,0,1,566,176.678445229682
21944,5,5837,81,"Tasa de exámenes médico legales por presunto delito sexual contra niños, niñas y adolescentes",2016,2,3,19862,15.1042191118719,0,10211,0,3,9651,31.0848616723656
21945,5,5837,81,"Tasa de exámenes médico legales por presunto delito sexual contra niños, niñas y adolescentes",2016,3,16,21913,73.0160178889244,1,11346,8.81367882954345,15,10567,141.951358001325
21946,5,5837,81,"Tasa de exámenes médico legales por presunto delito sexual contra niños, niñas y adolescentes",2016,4,16,21477,74.4983005075197,0,10621,0,16,10856,147.383935151069
21947,5,5837,121,Tasa de exámenes médico legales por presunto delito sexual cuando la víctima está entre 18 y 28 años,2016,5,3,36157,8.29714854661615,0,18294,0,3,17863,16.7944914068186
21948,5,5842,81,"Tasa de exámenes médico legales por presunto delito sexual contra niños, niñas y adolescentes",2016,3,1,949,105.374077976818,1,507,197.23865877712,0,442,0
21949,5,5842,121,Tasa de exámenes médico legales por presunto delito sexual cuando la víctima está entre 18 y 28 años,2016,5,1,1614,61.9578686493185,0,886,0,1,728,137.362637362637
21950,5,5847,81,"Tasa de exámenes médico legales por presunto delito sexual contra niños, niñas y adolescentes",2016,4,1,5074,19.7083169097359,0,2728,0,1,2346,42.6257459505541
21951,5,5854,81,"Tasa de exámenes médico legales por presunto delito sexual contra niños, niñas y adolescentes",2016,4,1,2847,35.1246926589392,0,1475,0,1,1372,72.8862973760933
21952,5,5856,81,"Tasa de exámenes médico legales por presunto delito sexual contra niños, niñas y adolescentes",2016,4,1,667,149.925037481259,1,345,289.855072463768,0,322,0
21953,5,5861,81,"Tasa de exámenes médico legales por presunto delito sexual contra niños, niñas y adolescentes",2016,3,2,1241,161.16035455278,0,646,0,2,595,336.134453781513
21954,5,5887,81,"Tasa de exámenes médico legales por presunto delito sexual contra niños, niñas y adolescentes",2016,2,1,4966,20.1369311316955,1,2542,39.33910306845,0,2424,0
21955,5,5887,81,"Tasa de exámenes médico legales por presunto delito sexual contra niños, niñas y adolescentes",2016,3,4,5866,68.1895669962496,0,2999,0,4,2867,139.518660620858
21956,5,5887,81,"Tasa de exámenes médico legales por presunto delito sexual contra niños, niñas y adolescentes",2016,4,6,5493,109.229929000546,1,2806,35.6379187455453,5,2687,186.081131373279
21957,5,5887,121,Tasa de exámenes médico legales por presunto delito sexual cuando la víctima está entre 18 y 28 años,2016,5,1,9799,10.2051229717318,0,4929,0,1,4870,20.5338809034908
21958,5,5890,81,"Tasa de exámenes médico legales por presunto delito sexual contra niños, niñas y adolescentes",2016,2,1,2405,41.5800415800416,1,1228,81.4332247557003,0,1177,0
21959,5,5890,81,"Tasa de exámenes médico legales por presunto delito sexual contra niños, niñas y adolescentes",2016,3,1,2869,34.8553502962705,1,1468,68.1198910081744,0,1401,0
21960,5,5890,81,"Tasa de exámenes médico legales por presunto delito sexual contra niños, niñas y adolescentes",2016,4,4,2658,150.489089541008,0,1367,0,4,1291,309.837335398916
21961,5,5893,81,"Tasa de exámenes médico legales por presunto delito sexual contra niños, niñas y adolescentes",2016,4,3,2150,139.53488372093,0,1109,0,3,1041,288.184438040346
21962,5,5893,121,Tasa de exámenes médico legales por presunto delito sexual cuando la víctima está entre 18 y 28 años,2016,5,3,4000,75,0,2058,0,3,1942,154.479917610711
21963,50,50001,81,"Tasa de exámenes médico legales por presunto delito sexual contra niños, niñas y adolescentes",2016,2,81,43141,187.756426601145,25,22027,113.497071775548,56,21114,265.226863692337
21964,50,50001,81,"Tasa de exámenes médico legales por presunto delito sexual contra niños, niñas y adolescentes",2016,3,176,52464,335.4681305276,45,26621,169.039480109688,131,25843,506.90709282978
21965,50,50001,81,"Tasa de exámenes médico legales por presunto delito sexual contra niños, niñas y adolescentes",2016,4,192,52637,364.762429469765,22,26499,83.02200083022,170,26138,650.394062284796
21966,50,50001,121,Tasa de exámenes médico legales por presunto delito sexual cuando la víctima está entre 18 y 28 años,2016,5,30,96170,31.1947592804409,1,46491,2.15095394807597,29,49679,58.3747659977053
21967,50,50001,81,"Tasa de exámenes médico legales por presunto delito sexual contra niños, niñas y adolescentes",2016,1,1,8466,11.8119536971415,0,4337,0,1,4129,24.2189392104626
21968,50,50006,81,"Tasa de exámenes médico legales por presunto delito sexual contra niños, niñas y adolescentes",2016,2,12,6449,186.075360521011,2,3265,61.2557427258806,10,3184,314.070351758794
21969,50,50006,81,"Tasa de exámenes médico legales por presunto delito sexual contra niños, niñas y adolescentes",2016,3,17,7513,226.274457606815,3,3748,80.042689434365,14,3765,371.845949535193
21970,50,50006,81,"Tasa de exámenes médico legales por presunto delito sexual contra niños, niñas y adolescentes",2016,4,22,7265,302.821748107364,2,3600,55.5555555555556,20,3665,545.702592087312
21971,50,50006,121,Tasa de exámenes médico legales por presunto delito sexual cuando la víctima está entre 18 y 28 años,2016,5,2,13379,14.9488003587712,0,6518,0,2,6861,29.1502696399942
21972,50,50110,81,"Tasa de exámenes médico legales por presunto delito sexual contra niños, niñas y adolescentes",2016,2,1,490,204.081632653061,0,250,0,1,240,416.666666666667
21973,50,50110,81,"Tasa de exámenes médico legales por presunto delito sexual contra niños, niñas y adolescentes",2016,3,3,523,573.613766730402,0,266,0,3,257,1167.31517509728
21974,50,50110,81,"Tasa de exámenes médico legales por presunto delito sexual contra niños, niñas y adolescentes",2016,4,3,501,598.802395209581,0,251,0,3,250,1200
21975,50,50124,81,"Tasa de exámenes médico legales por presunto delito sexual contra niños, niñas y adolescentes",2016,4,1,462,216.450216450216,0,246,0,1,216,462.962962962963
21976,50,50124,81,"Tasa de exámenes médico legales por presunto delito sexual contra niños, niñas y adolescentes",2016,1,1,93,1075.2688172043,1,48,2083.33333333333,0,45,0
21977,50,50150,81,"Tasa de exámenes médico legales por presunto delito sexual contra niños, niñas y adolescentes",2016,3,5,1110,450.45045045045,2,564,354.609929078014,3,546,549.45054945055
21978,50,50150,81,"Tasa de exámenes médico legales por presunto delito sexual contra niños, niñas y adolescentes",2016,4,4,1076,371.747211895911,1,539,185.528756957328,3,537,558.659217877095
21979,50,50223,121,Tasa de exámenes médico legales por presunto delito sexual cuando la víctima está entre 18 y 28 años,2016,5,1,1238,80.7754442649435,0,617,0,1,621,161.030595813205
21980,50,50226,81,"Tasa de exámenes médico legales por presunto delito sexual contra niños, niñas y adolescentes",2016,2,5,1893,264.131008980454,3,974,308.008213552361,2,919,217.627856365615
21981,50,50226,81,"Tasa de exámenes médico legales por presunto delito sexual contra niños, niñas y adolescentes",2016,3,9,2320,387.931034482759,2,1178,169.779286926995,7,1142,612.959719789842
21982,50,50226,81,"Tasa de exámenes médico legales por presunto delito sexual contra niños, niñas y adolescentes",2016,4,9,2057,437.530384054448,1,1027,97.3709834469328,8,1030,776.699029126214
21983,50,50226,121,Tasa de exámenes médico legales por presunto delito sexual cuando la víctima está entre 18 y 28 años,2016,5,1,3692,27.0855904658722,0,1780,0,1,1912,52.3012552301255
21984,50,50251,81,"Tasa de exámenes médico legales por presunto delito sexual contra niños, niñas y adolescentes",2016,2,3,666,450.45045045045,1,343,291.545189504373,2,323,619.195046439629
21985,50,50251,81,"Tasa de exámenes médico legales por presunto delito sexual contra niños, niñas y adolescentes",2016,3,3,742,404.312668463612,0,384,0,3,358,837.988826815643
21986,50,50251,81,"Tasa de exámenes médico legales por presunto delito sexual contra niños, niñas y adolescentes",2016,4,5,668,748.50299401197606,0,347,0,5,321,1557.63239875389
21987,50,50270,81,"Tasa de exámenes médico legales por presunto delito sexual contra niños, niñas y adolescentes",2016,3,1,463,215.982721382289,0,246,0,1,217,460.829493087558
21988,50,50270,121,Tasa de exámenes médico legales por presunto delito sexual cuando la víctima está entre 18 y 28 años,2016,5,1,659,151.745068285281,0,363,0,1,296,337.837837837838
21989,50,50287,81,"Tasa de exámenes médico legales por presunto delito sexual contra niños, niñas y adolescentes",2016,2,1,1421,70.3729767769177,0,722,0,1,699,143.061516452074
21990,50,50287,81,"Tasa de exámenes médico legales por presunto delito sexual contra niños, niñas y adolescentes",2016,4,2,1597,125.234815278647,0,815,0,2,782,255.754475703325
21991,50,50313,81,"Tasa de exámenes médico legales por presunto delito sexual contra niños, niñas y adolescentes",2016,2,8,6598,121.248863291907,0,3355,0,8,3243,246.685168054271
21992,50,50313,81,"Tasa de exámenes médico legales por presunto delito sexual contra niños, niñas y adolescentes",2016,3,18,7317,246.0024600246,4,3712,107.758620689655,14,3605,388.349514563107
21993,50,50313,81,"Tasa de exámenes médico legales por presunto delito sexual contra niños, niñas y adolescentes",2016,4,18,6804,264.550264550265,1,3431,29.146021568056,17,3373,504.002371775867
21994,50,50318,81,"Tasa de exámenes médico legales por presunto delito sexual contra niños, niñas y adolescentes",2016,3,3,986,304.259634888438,0,512,0,3,474,632.911392405063
21995,50,50318,81,"Tasa de exámenes médico legales por presunto delito sexual contra niños, niñas y adolescentes",2016,4,2,932,214.592274678112,0,472,0,2,460,434.782608695652
21996,50,50318,121,Tasa de exámenes médico legales por presunto delito sexual cuando la víctima está entre 18 y 28 años,2016,5,1,1764,56.6893424036281,0,863,0,1,901,110.987791342952
21997,50,50330,81,"Tasa de exámenes médico legales por presunto delito sexual contra niños, niñas y adolescentes",2016,4,2,1367,146.30577907827401,0,694,0,2,673,297.176820208024
21998,50,50350,81,"Tasa de exámenes médico legales por presunto delito sexual contra niños, niñas y adolescentes",2016,2,4,3831,104.411380840512,0,1957,0,4,1874,213.447171824973
21999,50,50350,81,"Tasa de exámenes médico legales por presunto delito sexual contra niños, niñas y adolescentes",2016,3,8,4434,180.42399639152,0,2278,0,8,2156,371.057513914657
22000,50,50350,81,"Tasa de exámenes médico legales por presunto delito sexual contra niños, niñas y adolescentes",2016,4,6,4097,146.448620942153,0,2120,0,6,1977,303.490136570561
22001,50,50370,81,"Tasa de exámenes médico legales por presunto delito sexual contra niños, niñas y adolescentes",2016,2,1,1838,54.4069640914037,0,932,0,1,906,110.37527593819
22002,50,50370,81,"Tasa de exámenes médico legales por presunto delito sexual contra niños, niñas y adolescentes",2016,3,3,2005,149.625935162095,1,1024,97.65625,2,981,203.873598369011
22003,50,50370,81,"Tasa de exámenes médico legales por presunto delito sexual contra niños, niñas y adolescentes",2016,4,1,1857,53.850296176629,0,961,0,1,896,111.607142857143
22004,50,50400,81,"Tasa de exámenes médico legales por presunto delito sexual contra niños, niñas y adolescentes",2016,4,1,1082,92.4214417744917,0,597,0,1,485,206.185567010309
22005,50,50450,81,"Tasa de exámenes médico legales por presunto delito sexual contra niños, niñas y adolescentes",2016,3,1,2576,38.8198757763975,0,1336,0,1,1240,80.6451612903226
22006,50,50450,121,Tasa de exámenes médico legales por presunto delito sexual cuando la víctima está entre 18 y 28 años,2016,5,2,4210,47.5059382422803,0,2084,0,2,2126,94.0733772342427
22007,50,50568,81,"Tasa de exámenes médico legales por presunto delito sexual contra niños, niñas y adolescentes",2016,2,5,2628,190.258751902588,0,1360,0,5,1268,394.321766561514
22008,50,50568,81,"Tasa de exámenes médico legales por presunto delito sexual contra niños, niñas y adolescentes",2016,3,8,2874,278.357689631176,4,1488,268.817204301075,4,1386,288.600288600289
22009,50,50568,81,"Tasa de exámenes médico legales por presunto delito sexual contra niños, niñas y adolescentes",2016,4,6,2506,239.425379090184,0,1276,0,6,1230,487.804878048781
22010,50,50568,121,Tasa de exámenes médico legales por presunto delito sexual cuando la víctima está entre 18 y 28 años,2016,5,1,3650,27.3972602739726,0,1761,0,1,1889,52.9380624669137
22011,50,50573,81,"Tasa de exámenes médico legales por presunto delito sexual contra niños, niñas y adolescentes",2016,2,13,3421,380.005846243788,5,1766,283.12570781427,8,1655,483.383685800604
22012,50,50573,81,"Tasa de exámenes médico legales por presunto delito sexual contra niños, niñas y adolescentes",2016,3,22,4142,531.144374698213,9,2178,413.223140495868,13,1964,661.914460285132
22013,50,50573,81,"Tasa de exámenes médico legales por presunto delito sexual contra niños, niñas y adolescentes",2016,4,19,3912,485.685071574642,0,2119,0,19,1793,1059.67651979922
22014,50,50573,121,Tasa de exámenes médico legales por presunto delito sexual cuando la víctima está entre 18 y 28 años,2016,5,2,6586,30.3674460977832,0,3504,0,2,3082,64.8929266709929
22015,50,50577,81,"Tasa de exámenes médico legales por presunto delito sexual contra niños, niñas y adolescentes",2016,2,2,1041,192.122958693564,1,539,185.528756957328,1,502,199.203187250996
22016,50,50577,81,"Tasa de exámenes médico legales por presunto delito sexual contra niños, niñas y adolescentes",2016,3,2,1241,161.16035455278,1,650,153.846153846154,1,591,169.204737732657
22017,50,50577,81,"Tasa de exámenes médico legales por presunto delito sexual contra niños, niñas y adolescentes",2016,4,5,1147,435.9197907585,0,613,0,5,534,936.329588014981
22018,50,50577,121,Tasa de exámenes médico legales por presunto delito sexual cuando la víctima está entre 18 y 28 años,2016,5,1,1833,54.5553737043099,0,1013,0,1,820,121.951219512195
22019,50,50590,81,"Tasa de exámenes médico legales por presunto delito sexual contra niños, niñas y adolescentes",2016,2,1,2191,45.6412596987677,1,1145,87.3362445414847,0,1046,0
22020,50,50590,81,"Tasa de exámenes médico legales por presunto delito sexual contra niños, niñas y adolescentes",2016,3,1,2497,40.0480576692031,0,1363,0,1,1134,88.1834215167549
22021,50,50590,81,"Tasa de exámenes médico legales por presunto delito sexual contra niños, niñas y adolescentes",2016,4,2,2288,87.4125874125874,0,1303,0,2,985,203.045685279188
22022,50,50606,81,"Tasa de exámenes médico legales por presunto delito sexual contra niños, niñas y adolescentes",2016,2,2,1018,196.463654223969,1,521,191.938579654511,1,497,201.207243460765
22023,50,50606,81,"Tasa de exámenes médico legales por presunto delito sexual contra niños, niñas y adolescentes",2016,3,3,1196,250.836120401338,0,612,0,3,584,513.698630136986
22024,50,50606,81,"Tasa de exámenes médico legales por presunto delito sexual contra niños, niñas y adolescentes",2016,4,5,1133,441.306266548985,0,569,0,5,564,886.524822695036
22025,50,50680,81,"Tasa de exámenes médico legales por presunto delito sexual contra niños, niñas y adolescentes",2016,2,1,1162,86.0585197934596,0,596,0,1,566,176.678445229682
22026,50,50680,81,"Tasa de exámenes médico legales por presunto delito sexual contra niños, niñas y adolescentes",2016,3,2,1287,155.400155400155,0,660,0,2,627,318.979266347687
22027,50,50680,81,"Tasa de exámenes médico legales por presunto delito sexual contra niños, niñas y adolescentes",2016,1,1,249,401.606425702811,0,128,0,1,121,826.446280991736
22028,50,50683,81,"Tasa de exámenes médico legales por presunto delito sexual contra niños, niñas y adolescentes",2016,3,5,1247,400.962309542903,1,647,154.559505409583,4,600,666.666666666667
22029,50,50683,81,"Tasa de exámenes médico legales por presunto delito sexual contra niños, niñas y adolescentes",2016,4,3,1052,285.171102661597,0,544,0,3,508,590.551181102362
22030,50,50683,121,Tasa de exámenes médico legales por presunto delito sexual cuando la víctima está entre 18 y 28 años,2016,5,2,1639,122.02562538133,0,847,0,2,792,252.525252525253
22031,50,50686,121,Tasa de exámenes médico legales por presunto delito sexual cuando la víctima está entre 18 y 28 años,2016,5,1,417,239.808153477218,0,219,0,1,198,505.050505050505
22032,50,50689,81,"Tasa de exámenes médico legales por presunto delito sexual contra niños, niñas y adolescentes",2016,3,6,2910,206.185567010309,0,1495,0,6,1415,424.028268551237
22033,50,50689,81,"Tasa de exámenes médico legales por presunto delito sexual contra niños, niñas y adolescentes",2016,4,8,2612,306.278713629403,2,1326,150.829562594268,6,1286,466.56298600311
22034,50,50689,121,Tasa de exámenes médico legales por presunto delito sexual cuando la víctima está entre 18 y 28 años,2016,5,3,4352,68.9338235294118,0,2101,0,3,2251,133.274100399822
22035,50,50711,81,"Tasa de exámenes médico legales por presunto delito sexual contra niños, niñas y adolescentes",2016,3,1,3292,30.3766707168894,1,1689,59.206631142688,0,1603,0
22036,50,50711,81,"Tasa de exámenes médico legales por presunto delito sexual contra niños, niñas y adolescentes",2016,4,2,3031,65.9848234905972,1,1562,64.0204865556978,1,1469,68.073519400953
22037,50,50711,121,Tasa de exámenes médico legales por presunto delito sexual cuando la víctima está entre 18 y 28 años,2016,5,1,4875,20.5128205128205,0,2427,0,1,2448,40.8496732026144
22038,52,52001,81,"Tasa de exámenes médico legales por presunto delito sexual contra niños, niñas y adolescentes",2016,2,7,31323,22.3477955495961,1,16034,6.23674691281028,6,15289,39.2439008437439
22039,52,52001,81,"Tasa de exámenes médico legales por presunto delito sexual contra niños, niñas y adolescentes",2016,3,22,40077,54.8943284177957,1,20318,4.92174426616793,21,19759,106.28068222076
22040,52,52001,81,"Tasa de exámenes médico legales por presunto delito sexual contra niños, niñas y adolescentes",2016,4,42,44398,94.5988558043155,2,22081,9.05756079887686,40,22317,179.235560335171
22041,52,52001,121,Tasa de exámenes médico legales por presunto delito sexual cuando la víctima está entre 18 y 28 años,2016,5,33,83876,39.3437932185607,1,42739,2.33978333606308,32,41137,77.7888518851642
22042,52,52079,81,"Tasa de exámenes médico legales por presunto delito sexual contra niños, niñas y adolescentes",2016,4,1,5636,17.7430801987225,0,2849,0,1,2787,35.880875493362
22043,52,52079,121,Tasa de exámenes médico legales por presunto delito sexual cuando la víctima está entre 18 y 28 años,2016,5,1,8042,12.4347177319075,0,4075,0,1,3967,25.2079657171666
22044,52,52110,81,"Tasa de exámenes médico legales por presunto delito sexual contra niños, niñas y adolescentes",2016,4,1,2646,37.7928949357521,0,1322,0,1,1324,75.5287009063444
22045,52,52215,121,Tasa de exámenes médico legales por presunto delito sexual cuando la víctima está entre 18 y 28 años,2016,5,1,2644,37.821482602118,0,1365,0,1,1279,78.1860828772479
22046,52,52224,81,"Tasa de exámenes médico legales por presunto delito sexual contra niños, niñas y adolescentes",2016,3,1,1004,99.601593625498,0,512,0,1,492,203.252032520325
22047,52,52233,81,"Tasa de exámenes médico legales por presunto delito sexual contra niños, niñas y adolescentes",2016,4,1,1934,51.7063081695967,0,998,0,1,936,106.837606837607
22048,52,52240,81,"Tasa de exámenes médico legales por presunto delito sexual contra niños, niñas y adolescentes",2016,4,2,1559,128.287363694676,0,772,0,2,787,254.129606099111
22049,52,52250,81,"Tasa de exámenes médico legales por presunto delito sexual contra niños, niñas y adolescentes",2016,3,1,5588,17.8954903364352,0,2798,0,1,2790,35.84229390681
22050,52,52250,81,"Tasa de exámenes médico legales por presunto delito sexual contra niños, niñas y adolescentes",2016,4,1,5381,18.5839063371121,0,2719,0,1,2662,37.5657400450789
22051,52,52258,121,Tasa de exámenes médico legales por presunto delito sexual cuando la víctima está entre 18 y 28 años,2016,5,1,2443,40.9332787556283,0,1246,0,1,1197,83.5421888053467
22052,52,52260,81,"Tasa de exámenes médico legales por presunto delito sexual contra niños, niñas y adolescentes",2016,3,1,1222,81.8330605564648,0,623,0,1,599,166.944908180301
22053,52,52260,81,"Tasa de exámenes médico legales por presunto delito sexual contra niños, niñas y adolescentes",2016,4,1,1287,77.7000777000777,0,651,0,1,636,157.232704402516
22054,52,52320,81,"Tasa de exámenes médico legales por presunto delito sexual contra niños, niñas y adolescentes",2016,4,1,1207,82.8500414250207,1,623,160.513643659711,0,584,0
22055,52,52320,121,Tasa de exámenes médico legales por presunto delito sexual cuando la víctima está entre 18 y 28 años,2016,5,1,2259,44.2673749446658,0,1184,0,1,1075,93.0232558139535
22056,52,52352,81,"Tasa de exámenes médico legales por presunto delito sexual contra niños, niñas y adolescentes",2016,4,1,863,115.874855156431,0,445,0,1,418,239.234449760766
22057,52,52354,121,Tasa de exámenes médico legales por presunto delito sexual cuando la víctima está entre 18 y 28 años,2016,5,2,1043,191.754554170662,0,536,0,2,507,394.477317554241
22058,52,52356,81,"Tasa de exámenes médico legales por presunto delito sexual contra niños, niñas y adolescentes",2016,2,1,12106,8.26036676028416,0,6213,0,1,5893,16.9692855930765
22059,52,52356,81,"Tasa de exámenes médico legales por presunto delito sexual contra niños, niñas y adolescentes",2016,3,3,15314,19.5899177223456,1,7835,12.7632418634333,2,7479,26.7415429870304
22060,52,52356,81,"Tasa de exámenes médico legales por presunto delito sexual contra niños, niñas y adolescentes",2016,4,3,15702,19.105846388995,0,7808,0,3,7894,38.0035469977198
22061,52,52356,121,Tasa de exámenes médico legales por presunto delito sexual cuando la víctima está entre 18 y 28 años,2016,5,3,25502,11.7637832326876,0,13042,0,3,12460,24.0770465489567
22062,52,52378,81,"Tasa de exámenes médico legales por presunto delito sexual contra niños, niñas y adolescentes",2016,4,1,1820,54.9450549450549,0,982,0,1,838,119.331742243437
22063,52,52378,121,Tasa de exámenes médico legales por presunto delito sexual cuando la víctima está entre 18 y 28 años,2016,5,2,3519,56.8343279340722,0,1942,0,2,1577,126.823081800888
22064,52,52381,81,"Tasa de exámenes médico legales por presunto delito sexual contra niños, niñas y adolescentes",2016,3,1,936,106.837606837607,1,472,211.864406779661,0,464,0
22065,52,52381,81,"Tasa de exámenes médico legales por presunto delito sexual contra niños, niñas y adolescentes",2016,4,1,950,105.263157894737,0,484,0,1,466,214.592274678112
22066,52,52405,81,"Tasa de exámenes médico legales por presunto delito sexual contra niños, niñas y adolescentes",2016,4,1,1789,55.8971492453885,0,922,0,1,867,115.340253748558
22067,52,52480,81,"Tasa de exámenes médico legales por presunto delito sexual contra niños, niñas y adolescentes",2016,4,1,503,198.807157057654,0,260,0,1,243,411.522633744856
22068,52,52506,121,Tasa de exámenes médico legales por presunto delito sexual cuando la víctima está entre 18 y 28 años,2016,5,1,1470,68.0272108843537,0,793,0,1,677,147.710487444609
22069,52,52540,81,"Tasa de exámenes médico legales por presunto delito sexual contra niños, niñas y adolescentes",2016,3,1,1888,52.9661016949153,0,988,0,1,900,111.111111111111
22070,52,52540,121,Tasa de exámenes médico legales por presunto delito sexual cuando la víctima está entre 18 y 28 años,2016,5,3,3413,87.8992089071198,0,1832,0,3,1581,189.753320683112
22071,52,52585,81,"Tasa de exámenes médico legales por presunto delito sexual contra niños, niñas y adolescentes",2016,4,1,1846,54.1711809317443,0,942,0,1,904,110.619469026549
22072,52,52612,81,"Tasa de exámenes médico legales por presunto delito sexual contra niños, niñas y adolescentes",2016,3,1,2564,39.0015600624025,0,1334,0,1,1230,81.3008130081301
22073,52,52678,81,"Tasa de exámenes médico legales por presunto delito sexual contra niños, niñas y adolescentes",2016,3,2,5261,38.0155863904201,0,2670,0,2,2591,77.1902740254728
22074,52,52678,81,"Tasa de exámenes médico legales por presunto delito sexual contra niños, niñas y adolescentes",2016,4,1,5611,17.822135091784,0,2826,0,1,2785,35.9066427289049
22075,52,52683,81,"Tasa de exámenes médico legales por presunto delito sexual contra niños, niñas y adolescentes",2016,2,1,1895,52.7704485488127,0,965,0,1,930,107.52688172043
22076,52,52687,121,Tasa de exámenes médico legales por presunto delito sexual cuando la víctima está entre 18 y 28 años,2016,5,1,3766,26.5533722782793,0,2028,0,1,1738,57.5373993095512
22077,52,52720,81,"Tasa de exámenes médico legales por presunto delito sexual contra niños, niñas y adolescentes",2016,2,1,505,198.019801980198,0,258,0,1,247,404.858299595142
22078,52,52788,81,"Tasa de exámenes médico legales por presunto delito sexual contra niños, niñas y adolescentes",2016,3,1,927,107.874865156419,0,469,0,1,458,218.340611353712
22079,52,52788,81,"Tasa de exámenes médico legales por presunto delito sexual contra niños, niñas y adolescentes",2016,4,1,1010,99.009900990099,0,512,0,1,498,200.803212851406
22080,52,52788,121,Tasa de exámenes médico legales por presunto delito sexual cuando la víctima está entre 18 y 28 años,2016,5,1,1752,57.0776255707763,0,894,0,1,858,116.550116550117
22081,52,52835,81,"Tasa de exámenes médico legales por presunto delito sexual contra niños, niñas y adolescentes",2016,4,3,26332,11.3929819231353,0,13283,0,3,13049,22.9902674534447
22082,52,52835,121,Tasa de exámenes médico legales por presunto delito sexual cuando la víctima está entre 18 y 28 años,2016,5,3,40416,7.4228028503563,0,20438,0,3,19978,15.016518169987
22083,52,52835,81,"Tasa de exámenes médico legales por presunto delito sexual contra niños, niñas y adolescentes",2016,1,1,5358,18.6636804777902,0,2725,0,1,2633,37.9794910748196
22084,52,52838,81,"Tasa de exámenes médico legales por presunto delito sexual contra niños, niñas y adolescentes",2016,3,3,4049,74.0923684860459,0,2067,0,3,1982,151.362260343088
22085,52,52838,81,"Tasa de exámenes médico legales por presunto delito sexual contra niños, niñas y adolescentes",2016,4,1,4256,23.4962406015038,0,2174,0,1,2082,48.030739673391
22086,52,52838,121,Tasa de exámenes médico legales por presunto delito sexual cuando la víctima está entre 18 y 28 años,2016,5,6,7690,78.0234070221066,0,3986,0,6,3704,161.987041036717
22087,54,54001,81,"Tasa de exámenes médico legales por presunto delito sexual contra niños, niñas y adolescentes",2016,2,40,55910,71.5435521373636,7,28498,24.5631272369991,33,27412,120.385232744783
22088,54,54001,81,"Tasa de exámenes médico legales por presunto delito sexual contra niños, niñas y adolescentes",2016,3,67,68482,97.8359276890278,22,34619,63.5489182240966,45,33863,132.888403272008
22089,54,54001,81,"Tasa de exámenes médico legales por presunto delito sexual contra niños, niñas y adolescentes",2016,4,68,74407,91.3892510113296,5,37467,13.3450770010943,63,36940,170.546832701678
22090,54,54001,121,Tasa de exámenes médico legales por presunto delito sexual cuando la víctima está entre 18 y 28 años,2016,5,10,130777,7.64660452526056,1,65964,1.51597841246741,9,64813,13.886103096601
22091,54,54003,81,"Tasa de exámenes médico legales por presunto delito sexual contra niños, niñas y adolescentes",2016,2,2,4153,48.1579581025765,1,2109,47.4158368895211,1,2044,48.9236790606654
22092,54,54003,81,"Tasa de exámenes médico legales por presunto delito sexual contra niños, niñas y adolescentes",2016,3,6,4705,127.523910733262,1,2370,42.1940928270042,5,2335,214.132762312634
22093,54,54003,81,"Tasa de exámenes médico legales por presunto delito sexual contra niños, niñas y adolescentes",2016,4,2,4594,43.535045711798,0,2305,0,2,2289,87.3743993010048
22094,54,54099,81,"Tasa de exámenes médico legales por presunto delito sexual contra niños, niñas y adolescentes",2016,4,5,808,618.811881188119,4,429,932.400932400932,1,379,263.852242744063
22095,54,54099,121,Tasa de exámenes médico legales por presunto delito sexual cuando la víctima está entre 18 y 28 años,2016,5,1,1297,77.1010023130301,0,663,0,1,634,157.728706624606
22096,54,54109,81,"Tasa de exámenes médico legales por presunto delito sexual contra niños, niñas y adolescentes",2016,3,1,551,181.488203266788,0,283,0,1,268,373.134328358209
22097,54,54125,81,"Tasa de exámenes médico legales por presunto delito sexual contra niños, niñas y adolescentes",2016,2,2,185,1081.08108108108,0,95,0,2,90,2222.22222222222
22098,54,54125,81,"Tasa de exámenes médico legales por presunto delito sexual contra niños, niñas y adolescentes",2016,3,2,214,934.579439252336,0,108,0,2,106,1886.79245283019
22099,54,54128,81,"Tasa de exámenes médico legales por presunto delito sexual contra niños, niñas y adolescentes",2016,4,1,1315,76.0456273764259,0,693,0,1,622,160.771704180064
22100,54,54172,81,"Tasa de exámenes médico legales por presunto delito sexual contra niños, niñas y adolescentes",2016,2,1,1576,63.4517766497462,0,806,0,1,770,129.87012987013
22101,54,54172,81,"Tasa de exámenes médico legales por presunto delito sexual contra niños, niñas y adolescentes",2016,3,6,1803,332.778702163062,2,914,218.818380743983,4,889,449.943757030371
22102,54,54172,81,"Tasa de exámenes médico legales por presunto delito sexual contra niños, niñas y adolescentes",2016,4,8,1813,441.257584114727,0,923,0,8,890,898.876404494382
22103,54,54172,121,Tasa de exámenes médico legales por presunto delito sexual cuando la víctima está entre 18 y 28 años,2016,5,1,3005,33.2778702163062,0,1583,0,1,1422,70.323488045007
22104,54,54206,81,"Tasa de exámenes médico legales por presunto delito sexual contra niños, niñas y adolescentes",2016,3,1,1555,64.3086816720257,0,795,0,1,760,131.578947368421
22105,54,54206,81,"Tasa de exámenes médico legales por presunto delito sexual contra niños, niñas y adolescentes",2016,4,1,1540,64.9350649350649,0,803,0,1,737,135.685210312076
22106,54,54239,81,"Tasa de exámenes médico legales por presunto delito sexual contra niños, niñas y adolescentes",2016,4,1,394,253.807106598985,1,211,473.9336492891,0,183,0
22107,54,54245,81,"Tasa de exámenes médico legales por presunto delito sexual contra niños, niñas y adolescentes",2016,3,1,1749,57.1755288736421,0,890,0,1,859,116.414435389988
22108,54,54245,81,"Tasa de exámenes médico legales por presunto delito sexual contra niños, niñas y adolescentes",2016,4,3,1760,170.454545454545,0,922,0,3,838,357.99522673031
22109,54,54261,81,"Tasa de exámenes médico legales por presunto delito sexual contra niños, niñas y adolescentes",2016,3,4,2791,143.317807237549,1,1436,69.6378830083566,3,1355,221.40221402214
22110,54,54261,81,"Tasa de exámenes médico legales por presunto delito sexual contra niños, niñas y adolescentes",2016,4,6,2822,212.615166548547,1,1471,67.9809653297077,5,1351,370.096225018505
22111,54,54344,81,"Tasa de exámenes médico legales por presunto delito sexual contra niños, niñas y adolescentes",2016,2,1,1404,71.2250712250712,0,706,0,1,698,143.266475644699
22112,54,54344,81,"Tasa de exámenes médico legales por presunto delito sexual contra niños, niñas y adolescentes",2016,3,1,1463,68.3526999316473,0,727,0,1,736,135.869565217391
22113,54,54347,81,"Tasa de exámenes médico legales por presunto delito sexual contra niños, niñas y adolescentes",2016,2,1,284,352.112676056338,0,148,0,1,136,735.294117647059
22114,54,54377,81,"Tasa de exámenes médico legales por presunto delito sexual contra niños, niñas y adolescentes",2016,4,1,734,136.239782016349,0,396,0,1,338,295.85798816568
22115,54,54385,81,"Tasa de exámenes médico legales por presunto delito sexual contra niños, niñas y adolescentes",2016,3,1,1719,58.173356602676,0,885,0,1,834,119.904076738609
22116,54,54398,81,"Tasa de exámenes médico legales por presunto delito sexual contra niños, niñas y adolescentes",2016,4,2,916,218.340611353712,0,456,0,2,460,434.782608695652
22117,54,54405,81,"Tasa de exámenes médico legales por presunto delito sexual contra niños, niñas y adolescentes",2016,2,2,6295,31.7712470214456,1,3210,31.1526479750779,1,3085,32.4149108589951
22118,54,54405,81,"Tasa de exámenes médico legales por presunto delito sexual contra niños, niñas y adolescentes",2016,3,3,7744,38.7396694214876,0,3882,0,3,3862,77.6799585706888
22119,54,54405,81,"Tasa de exámenes médico legales por presunto delito sexual contra niños, niñas y adolescentes",2016,4,7,8339,83.9429188152057,1,4186,23.8891543239369,6,4153,144.473874307729
22120,54,54498,81,"Tasa de exámenes médico legales por presunto delito sexual contra niños, niñas y adolescentes",2016,2,2,8773,22.7972187393138,0,4445,0,2,4328,46.2107208872458
22121,54,54498,81,"Tasa de exámenes médico legales por presunto delito sexual contra niños, niñas y adolescentes",2016,3,8,11094,72.1110510185686,1,5631,17.7588350204227,7,5463,128.134724510342
22122,54,54498,81,"Tasa de exámenes médico legales por presunto delito sexual contra niños, niñas y adolescentes",2016,4,14,10934,128.040973111396,3,5717,52.4750743396887,11,5217,210.84914701936
22123,54,54498,121,Tasa de exámenes médico legales por presunto delito sexual cuando la víctima está entre 18 y 28 años,2016,5,1,16141,6.19540301096586,1,8250,12.1212121212121,0,7891,0
22124,54,54518,81,"Tasa de exámenes médico legales por presunto delito sexual contra niños, niñas y adolescentes",2016,2,3,4068,73.7463126843658,1,2068,48.3558994197292,2,2000,100
22125,54,54518,81,"Tasa de exámenes médico legales por presunto delito sexual contra niños, niñas y adolescentes",2016,3,2,5255,38.0589914367269,0,2663,0,2,2592,77.1604938271605
22126,54,54518,81,"Tasa de exámenes médico legales por presunto delito sexual contra niños, niñas y adolescentes",2016,4,5,7554,66.190097961345,0,3755,0,5,3799,131.613582521716
22127,54,54518,121,Tasa de exámenes médico legales por presunto delito sexual cuando la víctima está entre 18 y 28 años,2016,5,5,14652,34.1250341250341,0,7521,0,5,7131,70.1163932127331
22128,54,54520,81,"Tasa de exámenes médico legales por presunto delito sexual contra niños, niñas y adolescentes",2016,3,1,540,185.185185185185,0,273,0,1,267,374.531835205993
22129,54,54553,81,"Tasa de exámenes médico legales por presunto delito sexual contra niños, niñas y adolescentes",2016,3,1,1180,84.7457627118644,0,608,0,1,572,174.825174825175
22130,54,54553,81,"Tasa de exámenes médico legales por presunto delito sexual contra niños, niñas y adolescentes",2016,4,1,1278,78.2472613458529,1,663,150.829562594268,0,615,0
22131,54,54599,81,"Tasa de exámenes médico legales por presunto delito sexual contra niños, niñas y adolescentes",2016,2,2,568,352.112676056338,0,290,0,2,278,719.424460431655
22132,54,54660,81,"Tasa de exámenes médico legales por presunto delito sexual contra niños, niñas y adolescentes",2016,3,4,1009,396.432111000991,0,511,0,4,498,803.212851405622
22133,54,54670,81,"Tasa de exámenes médico legales por presunto delito sexual contra niños, niñas y adolescentes",2016,3,1,1943,51.4668039114771,0,971,0,1,972,102.880658436214
22134,54,54673,81,"Tasa de exámenes médico legales por presunto delito sexual contra niños, niñas y adolescentes",2016,3,2,661,302.571860816944,0,337,0,2,324,617.283950617284
22135,54,54680,81,"Tasa de exámenes médico legales por presunto delito sexual contra niños, niñas y adolescentes",2016,3,1,318,314.465408805032,0,165,0,1,153,653.59477124183
22136,54,54720,81,"Tasa de exámenes médico legales por presunto delito sexual contra niños, niñas y adolescentes",2016,3,4,3040,131.578947368421,0,1597,0,4,1443,277.200277200277
22137,54,54720,81,"Tasa de exámenes médico legales por presunto delito sexual contra niños, niñas y adolescentes",2016,4,1,2838,35.2360817477097,0,1538,0,1,1300,76.9230769230769
22138,54,54810,81,"Tasa de exámenes médico legales por presunto delito sexual contra niños, niñas y adolescentes",2016,3,6,5149,116.527481064284,2,2687,74.4324525493115,4,2462,162.46953696182
22139,54,54810,81,"Tasa de exámenes médico legales por presunto delito sexual contra niños, niñas y adolescentes",2016,4,8,4888,163.66612111293,0,2589,0,8,2299,347.977381470204
22140,54,54810,121,Tasa de exámenes médico legales por presunto delito sexual cuando la víctima está entre 18 y 28 años,2016,5,1,7209,13.8715494520738,0,3804,0,1,3405,29.3685756240822
22141,54,54820,81,"Tasa de exámenes médico legales por presunto delito sexual contra niños, niñas y adolescentes",2016,4,2,1985,100.755667506297,0,1006,0,2,979,204.290091930541
22142,54,54874,81,"Tasa de exámenes médico legales por presunto delito sexual contra niños, niñas y adolescentes",2016,2,8,8069,99.1448754492502,2,4148,48.2160077145612,6,3921,153.022188217292
22143,54,54874,81,"Tasa de exámenes médico legales por presunto delito sexual contra niños, niñas y adolescentes",2016,3,6,9742,61.5889960993636,3,4979,60.2530628640289,3,4763,62.9855133319337
22144,54,54874,81,"Tasa de exámenes médico legales por presunto delito sexual contra niños, niñas y adolescentes",2016,4,10,10406,96.0984047664809,1,5307,18.8430374976446,9,5099,176.50519709747
22145,54,54874,121,Tasa de exámenes médico legales por presunto delito sexual cuando la víctima está entre 18 y 28 años,2016,5,1,18179,5.50085263215799,0,9359,0,1,8820,11.3378684807256
22146,63,63001,81,"Tasa de exámenes médico legales por presunto delito sexual contra niños, niñas y adolescentes",2016,2,34,22710,149.713782474681,6,11591,51.764299887844,28,11119,251.82120694307
22147,63,63001,81,"Tasa de exámenes médico legales por presunto delito sexual contra niños, niñas y adolescentes",2016,3,68,27186,250.128742735231,16,13794,115.992460490068,52,13392,388.291517323775
22148,63,63001,81,"Tasa de exámenes médico legales por presunto delito sexual contra niños, niñas y adolescentes",2016,4,75,27682,270.934181056282,6,14043,42.7259132663961,69,13639,505.902192242833
22149,63,63001,121,Tasa de exámenes médico legales por presunto delito sexual cuando la víctima está entre 18 y 28 años,2016,5,21,53919,38.9473098536694,3,27201,11.0290062865336,18,26718,67.370312149113
22150,63,63111,81,"Tasa de exámenes médico legales por presunto delito sexual contra niños, niñas y adolescentes",2016,3,4,274,1459.85401459854,1,142,704.225352112676,3,132,2272.72727272727
22151,63,63111,81,"Tasa de exámenes médico legales por presunto delito sexual contra niños, niñas y adolescentes",2016,4,2,274,729.92700729927,0,142,0,2,132,1515.15151515152
22152,63,63130,81,"Tasa de exámenes médico legales por presunto delito sexual contra niños, niñas y adolescentes",2016,2,8,6442,124.185035703198,1,3321,30.1114122252334,7,3121,224.287087471964
22153,63,63130,81,"Tasa de exámenes médico legales por presunto delito sexual contra niños, niñas y adolescentes",2016,3,16,7646,209.259743656814,2,3954,50.5816894284269,14,3692,379.19826652221
22154,63,63130,81,"Tasa de exámenes médico legales por presunto delito sexual contra niños, niñas y adolescentes",2016,4,25,7568,330.338266384778,6,3909,153.491941673062,19,3659,519.267559442471
22155,63,63130,121,Tasa de exámenes médico legales por presunto delito sexual cuando la víctima está entre 18 y 28 años,2016,5,2,14306,13.9801481895708,1,7386,13.5391280801516,1,6920,14.4508670520231
22156,63,63190,81,"Tasa de exámenes médico legales por presunto delito sexual contra niños, niñas y adolescentes",2016,2,2,2390,83.6820083682008,1,1224,81.6993464052288,1,1166,85.7632933104631
22157,63,63190,81,"Tasa de exámenes médico legales por presunto delito sexual contra niños, niñas y adolescentes",2016,3,3,2790,107.52688172043,0,1397,0,3,1393,215.362526920316
22158,63,63190,81,"Tasa de exámenes médico legales por presunto delito sexual contra niños, niñas y adolescentes",2016,4,5,2786,179.468772433597,0,1383,0,5,1403,356.379187455453
22159,63,63212,81,"Tasa de exámenes médico legales por presunto delito sexual contra niños, niñas y adolescentes",2016,3,3,514,583.657587548638,0,264,0,3,250,1200
22160,63,63212,81,"Tasa de exámenes médico legales por presunto delito sexual contra niños, niñas y adolescentes",2016,4,1,515,194.174757281553,0,264,0,1,251,398.406374501992
22161,63,63212,121,Tasa de exámenes médico legales por presunto delito sexual cuando la víctima está entre 18 y 28 años,2016,5,1,977,102.354145342886,0,499,0,1,478,209.205020920502
22162,63,63272,81,"Tasa de exámenes médico legales por presunto delito sexual contra niños, niñas y adolescentes",2016,3,2,1324,151.057401812689,1,677,147.710487444609,1,647,154.559505409583
22163,63,63272,81,"Tasa de exámenes médico legales por presunto delito sexual contra niños, niñas y adolescentes",2016,4,6,1371,437.636761487965,1,707,141.442715700141,5,664,753.012048192771
22164,63,63302,81,"Tasa de exámenes médico legales por presunto delito sexual contra niños, niñas y adolescentes",2016,3,1,758,131.926121372032,0,390,0,1,368,271.739130434783
22165,63,63302,81,"Tasa de exámenes médico legales por presunto delito sexual contra niños, niñas y adolescentes",2016,4,6,752,797.872340425532,1,385,259.74025974026,5,367,1362.39782016349
22166,63,63302,121,Tasa de exámenes médico legales por presunto delito sexual cuando la víctima está entre 18 y 28 años,2016,5,1,1433,69.7836706210747,1,731,136.798905608755,0,702,0
22167,63,63401,81,"Tasa de exámenes médico legales por presunto delito sexual contra niños, niñas y adolescentes",2016,2,5,4134,120.948234155781,2,2130,93.8967136150235,3,2004,149.700598802395
22168,63,63401,81,"Tasa de exámenes médico legales por presunto delito sexual contra niños, niñas y adolescentes",2016,3,12,4751,252.578404546411,2,2474,80.8407437348424,10,2277,439.174352217831
22169,63,63401,81,"Tasa de exámenes médico legales por presunto delito sexual contra niños, niñas y adolescentes",2016,4,10,4812,207.813798836243,1,2475,40.4040404040404,9,2337,385.109114249037
22170,63,63401,121,Tasa de exámenes médico legales por presunto delito sexual cuando la víctima está entre 18 y 28 años,2016,5,3,8204,36.5675280351048,0,4075,0,3,4129,72.6568176313878
22171,63,63470,81,"Tasa de exámenes médico legales por presunto delito sexual contra niños, niñas y adolescentes",2016,2,4,3574,111.919418019026,0,1836,0,4,1738,230.149597238205
22172,63,63470,81,"Tasa de exámenes médico legales por presunto delito sexual contra niños, niñas y adolescentes",2016,3,9,4189,214.848412508952,2,2167,92.2934933087217,7,2022,346.191889218595
22173,63,63470,81,"Tasa de exámenes médico legales por presunto delito sexual contra niños, niñas y adolescentes",2016,4,8,4206,190.20446980504,3,2216,135.379061371841,5,1990,251.256281407035
22174,63,63470,121,Tasa de exámenes médico legales por presunto delito sexual cuando la víctima está entre 18 y 28 años,2016,5,4,7937,50.3968753937256,0,4197,0,4,3740,106.951871657754
22175,63,63548,81,"Tasa de exámenes médico legales por presunto delito sexual contra niños, niñas y adolescentes",2016,3,3,595,504.201680672269,0,306,0,3,289,1038.06228373702
22176,63,63548,81,"Tasa de exámenes médico legales por presunto delito sexual contra niños, niñas y adolescentes",2016,4,3,585,512.820512820513,0,301,0,3,284,1056.33802816901
22177,63,63594,81,"Tasa de exámenes médico legales por presunto delito sexual contra niños, niñas y adolescentes",2016,2,3,2910,103.092783505155,0,1496,0,3,1414,212.164073550212
22178,63,63594,81,"Tasa de exámenes médico legales por presunto delito sexual contra niños, niñas y adolescentes",2016,3,14,3389,413.1012097964,3,1752,171.232876712329,11,1637,671.960904092853
22179,63,63594,81,"Tasa de exámenes médico legales por presunto delito sexual contra niños, niñas y adolescentes",2016,4,8,3363,237.88284269997,2,1742,114.810562571757,6,1621,370.141887723627
22180,63,63690,81,"Tasa de exámenes médico legales por presunto delito sexual contra niños, niñas y adolescentes",2016,2,2,632,316.455696202532,1,328,304.878048780488,1,304,328.947368421053
22181,63,63690,81,"Tasa de exámenes médico legales por presunto delito sexual contra niños, niñas y adolescentes",2016,3,4,733,545.702592087312,0,383,0,4,350,1142.85714285714
22182,63,63690,81,"Tasa de exámenes médico legales por presunto delito sexual contra niños, niñas y adolescentes",2016,4,6,708,847.457627118644,2,367,544.959128065395,4,341,1173.02052785924
22183,63,63690,121,Tasa de exámenes médico legales por presunto delito sexual cuando la víctima está entre 18 y 28 años,2016,5,2,1267,157.85319652723,0,657,0,2,610,327.868852459016
22184,66,66001,81,"Tasa de exámenes médico legales por presunto delito sexual contra niños, niñas y adolescentes",2016,2,69,33975,203.090507726269,13,17399,74.7169377550434,56,16576,337.837837837838
22185,66,66001,81,"Tasa de exámenes médico legales por presunto delito sexual contra niños, niñas y adolescentes",2016,3,96,41150,233.292831105711,23,21082,109.097808557063,73,20068,363.763205102651
22186,66,66001,81,"Tasa de exámenes médico legales por presunto delito sexual contra niños, niñas y adolescentes",2016,4,118,42775,275.862068965517,14,21837,64.111370609516,104,20938,496.704556309103
22187,66,66001,121,Tasa de exámenes médico legales por presunto delito sexual cuando la víctima está entre 18 y 28 años,2016,5,25,84640,29.5368620037807,1,43106,2.31986266413028,24,41534,57.783984205711
22188,66,66001,81,"Tasa de exámenes médico legales por presunto delito sexual contra niños, niñas y adolescentes",2016,1,2,6732,29.708853238265,0,3449,0,2,3283,60.9198903441974
22189,66,66045,81,"Tasa de exámenes médico legales por presunto delito sexual contra niños, niñas y adolescentes",2016,2,2,1825,109.58904109589,0,936,0,2,889,224.971878515186
22190,66,66045,81,"Tasa de exámenes médico legales por presunto delito sexual contra niños, niñas y adolescentes",2016,3,10,2171,460.617227084293,5,1117,447.62757385855,5,1054,474.38330170778
22191,66,66045,81,"Tasa de exámenes médico legales por presunto delito sexual contra niños, niñas y adolescentes",2016,4,6,2039,294.261893084846,0,1060,0,6,979,612.870275791624
22192,66,66045,121,Tasa de exámenes médico legales por presunto delito sexual cuando la víctima está entre 18 y 28 años,2016,5,1,3383,29.5595625184747,0,1751,0,1,1632,61.2745098039216
22193,66,66075,81,"Tasa de exámenes médico legales por presunto delito sexual contra niños, niñas y adolescentes",2016,3,1,658,151.975683890578,0,336,0,1,322,310.55900621118
22194,66,66075,81,"Tasa de exámenes médico legales por presunto delito sexual contra niños, niñas y adolescentes",2016,4,3,644,465.83850931677,0,332,0,3,312,961.538461538462
22195,66,66088,81,"Tasa de exámenes médico legales por presunto delito sexual contra niños, niñas y adolescentes",2016,3,3,3005,99.8336106489185,2,1537,130.123617436565,1,1468,68.1198910081744
22196,66,66088,81,"Tasa de exámenes médico legales por presunto delito sexual contra niños, niñas y adolescentes",2016,4,11,2983,368.756285618505,3,1527,196.463654223969,8,1456,549.45054945055
22197,66,66088,121,Tasa de exámenes médico legales por presunto delito sexual cuando la víctima está entre 18 y 28 años,2016,5,1,5061,19.7589409207666,0,2658,0,1,2403,41.6146483562214
22198,66,66170,81,"Tasa de exámenes médico legales por presunto delito sexual contra niños, niñas y adolescentes",2016,2,15,15198,98.6971969996052,4,7803,51.2623349993592,11,7395,148.749154834348
22199,66,66170,81,"Tasa de exámenes médico legales por presunto delito sexual contra niños, niñas y adolescentes",2016,3,19,18474,102.847244776443,3,9457,31.7225335730147,16,9017,177.442608406344
22200,66,66170,81,"Tasa de exámenes médico legales por presunto delito sexual contra niños, niñas y adolescentes",2016,4,29,19503,148.695072552941,3,9893,30.324471848782,26,9610,270.551508844953
22201,66,66170,121,Tasa de exámenes médico legales por presunto delito sexual cuando la víctima está entre 18 y 28 años,2016,5,10,38359,26.0695012904403,0,19573,0,10,18786,53.2311295645694
22202,66,66318,81,"Tasa de exámenes médico legales por presunto delito sexual contra niños, niñas y adolescentes",2016,2,1,1348,74.1839762611276,1,681,146.842878120411,0,667,0
22203,66,66318,81,"Tasa de exámenes médico legales por presunto delito sexual contra niños, niñas y adolescentes",2016,3,3,1540,194.805194805195,2,768,260.416666666667,1,772,129.533678756477
22204,66,66318,81,"Tasa de exámenes médico legales por presunto delito sexual contra niños, niñas y adolescentes",2016,4,3,1489,201.477501678979,2,738,271.0027100271,1,751,133.155792276964
22205,66,66383,81,"Tasa de exámenes médico legales por presunto delito sexual contra niños, niñas y adolescentes",2016,3,1,913,109.529025191676,0,473,0,1,440,227.272727272727
22206,66,66383,81,"Tasa de exámenes médico legales por presunto delito sexual contra niños, niñas y adolescentes",2016,4,1,899,111.234705228031,0,469,0,1,430,232.558139534884
22207,66,66400,81,"Tasa de exámenes médico legales por presunto delito sexual contra niños, niñas y adolescentes",2016,2,12,2773,432.744320230797,3,1403,213.827512473272,9,1370,656.934306569343
22208,66,66400,81,"Tasa de exámenes médico legales por presunto delito sexual contra niños, niñas y adolescentes",2016,3,5,3252,153.751537515375,1,1642,60.9013398294762,4,1610,248.447204968944
22209,66,66400,81,"Tasa de exámenes médico legales por presunto delito sexual contra niños, niñas y adolescentes",2016,4,8,3212,249.06600249066,1,1578,63.3713561470215,7,1634,428.396572827417
22210,66,66400,121,Tasa de exámenes médico legales por presunto delito sexual cuando la víctima está entre 18 y 28 años,2016,5,1,5903,16.9405387091309,0,2838,0,1,3065,32.626427406199
22211,66,66440,81,"Tasa de exámenes médico legales por presunto delito sexual contra niños, niñas y adolescentes",2016,2,5,1880,265.957446808511,1,965,103.626943005181,4,915,437.158469945355
22212,66,66440,81,"Tasa de exámenes médico legales por presunto delito sexual contra niños, niñas y adolescentes",2016,3,5,2307,216.731686172518,0,1181,0,5,1126,444.04973357016
22213,66,66440,81,"Tasa de exámenes médico legales por presunto delito sexual contra niños, niñas y adolescentes",2016,4,13,2378,546.677880571909,4,1210,330.578512396694,9,1168,770.547945205479
22214,66,66456,81,"Tasa de exámenes médico legales por presunto delito sexual contra niños, niñas y adolescentes",2016,2,1,2187,45.7247370827618,0,1114,0,1,1073,93.1966449207828
22215,66,66456,81,"Tasa de exámenes médico legales por presunto delito sexual contra niños, niñas y adolescentes",2016,3,5,2351,212.675457252233,4,1178,339.55857385399,1,1173,85.2514919011083
22216,66,66456,81,"Tasa de exámenes médico legales por presunto delito sexual contra niños, niñas y adolescentes",2016,4,2,2126,94.0733772342427,0,1078,0,2,1048,190.839694656489
22217,66,66572,81,"Tasa de exámenes médico legales por presunto delito sexual contra niños, niñas y adolescentes",2016,2,1,1803,55.4631170271769,0,918,0,1,885,112.994350282486
22218,66,66572,121,Tasa de exámenes médico legales por presunto delito sexual cuando la víctima está entre 18 y 28 años,2016,5,1,2646,37.7928949357521,0,1417,0,1,1229,81.366965012205
22219,66,66594,81,"Tasa de exámenes médico legales por presunto delito sexual contra niños, niñas y adolescentes",2016,3,1,3909,25.5819902788437,0,1969,0,1,1940,51.5463917525773
22220,66,66594,81,"Tasa de exámenes médico legales por presunto delito sexual contra niños, niñas y adolescentes",2016,4,1,3669,27.2553829381303,0,1846,0,1,1823,54.8546352166758
22221,66,66682,81,"Tasa de exámenes médico legales por presunto delito sexual contra niños, niñas y adolescentes",2016,2,4,5846,68.4228532329798,0,3000,0,4,2846,140.548137737175
22222,66,66682,81,"Tasa de exámenes médico legales por presunto delito sexual contra niños, niñas y adolescentes",2016,3,11,7156,153.717160424818,0,3675,0,11,3481,316.001149095088
22223,66,66682,81,"Tasa de exámenes médico legales por presunto delito sexual contra niños, niñas y adolescentes",2016,4,9,7337,122.665939757394,1,3731,26.8024658268561,8,3606,221.852468108708
22224,66,66682,121,Tasa de exámenes médico legales por presunto delito sexual cuando la víctima está entre 18 y 28 años,2016,5,2,13431,14.8909239818331,0,6941,0,2,6490,30.8166409861325
22225,66,66687,81,"Tasa de exámenes médico legales por presunto delito sexual contra niños, niñas y adolescentes",2016,2,1,1452,68.870523415978,0,738,0,1,714,140.056022408964
22226,66,66687,81,"Tasa de exámenes médico legales por presunto delito sexual contra niños, niñas y adolescentes",2016,3,2,1662,120.336943441637,1,850,117.647058823529,1,812,123.152709359606
22227,66,66687,81,"Tasa de exámenes médico legales por presunto delito sexual contra niños, niñas y adolescentes",2016,4,4,1632,245.098039215686,1,843,118.623962040332,3,789,380.228136882129
22228,66,66687,121,Tasa de exámenes médico legales por presunto delito sexual cuando la víctima está entre 18 y 28 años,2016,5,1,2786,35.8937544867193,0,1443,0,1,1343,74.4601638123604
22229,68,68001,81,"Tasa de exámenes médico legales por presunto delito sexual contra niños, niñas y adolescentes",2016,2,58,34866,166.351173062582,17,17814,95.4305602335242,41,17052,240.441003987802
22230,68,68001,81,"Tasa de exámenes médico legales por presunto delito sexual contra niños, niñas y adolescentes",2016,3,83,45330,183.101698654313,22,23170,94.9503668536901,61,22160,275.270758122744
22231,68,68001,81,"Tasa de exámenes médico legales por presunto delito sexual contra niños, niñas y adolescentes",2016,4,125,50064,249.680409076382,8,25543,31.3197353482363,117,24521,477.142041515436
22232,68,68001,121,Tasa de exámenes médico legales por presunto delito sexual cuando la víctima está entre 18 y 28 años,2016,5,38,97203,39.0934436179953,4,49639,8.05818006003344,34,47564,71.4826339248171
22233,68,68051,81,"Tasa de exámenes médico legales por presunto delito sexual contra niños, niñas y adolescentes",2016,2,1,730,136.986301369863,0,380,0,1,350,285.714285714286
22234,68,68051,81,"Tasa de exámenes médico legales por presunto delito sexual contra niños, niñas y adolescentes",2016,3,3,854,351.288056206089,0,463,0,3,391,767.263427109975
22235,68,68051,81,"Tasa de exámenes médico legales por presunto delito sexual contra niños, niñas y adolescentes",2016,4,2,861,232.288037166086,0,483,0,2,378,529.100529100529
22236,68,68077,81,"Tasa de exámenes médico legales por presunto delito sexual contra niños, niñas y adolescentes",2016,2,3,2499,120.048019207683,1,1294,77.2797527047914,2,1205,165.97510373444
22237,68,68077,81,"Tasa de exámenes médico legales por presunto delito sexual contra niños, niñas y adolescentes",2016,3,5,2963,168.747890651367,1,1534,65.1890482398957,4,1429,279.916025192442
22238,68,68077,81,"Tasa de exámenes médico legales por presunto delito sexual contra niños, niñas y adolescentes",2016,4,10,2915,343.053173241853,1,1526,65.5307994757536,9,1389,647.948164146868
22239,68,68077,121,Tasa de exámenes médico legales por presunto delito sexual cuando la víctima está entre 18 y 28 años,2016,5,2,5283,37.8572780617074,1,2683,37.2717107715244,1,2600,38.4615384615385
22240,68,68079,81,"Tasa de exámenes médico legales por presunto delito sexual contra niños, niñas y adolescentes",2016,4,3,752,398.936170212766,0,383,0,3,369,813.008130081301
22241,68,68081,81,"Tasa de exámenes médico legales por presunto delito sexual contra niños, niñas y adolescentes",2016,2,35,15526,225.428313796213,8,7968,100.401606425703,27,7558,357.237364382112
22242,68,68081,81,"Tasa de exámenes médico legales por presunto delito sexual contra niños, niñas y adolescentes",2016,3,64,18890,338.803599788248,10,9732,102.75380189067,54,9158,589.648394846036
22243,68,68081,81,"Tasa de exámenes médico legales por presunto delito sexual contra niños, niñas y adolescentes",2016,4,98,19471,503.31261876637,5,10032,49.8405103668262,93,9439,985.273863756754
22244,68,68081,121,Tasa de exámenes médico legales por presunto delito sexual cuando la víctima está entre 18 y 28 años,2016,5,14,36589,38.2628658886551,2,18980,10.5374077976818,12,17609,68.1469702992788
22245,68,68092,81,"Tasa de exámenes médico legales por presunto delito sexual contra niños, niñas y adolescentes",2016,2,1,527,189.753320683112,0,271,0,1,256,390625
22246,68,68092,81,"Tasa de exámenes médico legales por presunto delito sexual contra niños, niñas y adolescentes",2016,4,1,564,177.304964539007,0,286,0,1,278,359.712230215827
22247,68,68101,81,"Tasa de exámenes médico legales por presunto delito sexual contra niños, niñas y adolescentes",2016,3,1,1389,71.9942404607631,0,694,0,1,695,143.884892086331
22248,68,68101,81,"Tasa de exámenes médico legales por presunto delito sexual contra niños, niñas y adolescentes",2016,4,2,1323,151.171579743008,0,658,0,2,665,300.751879699248
22249,68,68101,121,Tasa de exámenes médico legales por presunto delito sexual cuando la víctima está entre 18 y 28 años,2016,5,1,2244,44.5632798573975,0,1170,0,1,1074,93.1098696461825
22250,68,68132,81,"Tasa de exámenes médico legales por presunto delito sexual contra niños, niñas y adolescentes",2016,2,1,195,512.820512820513,1,100,1000,0,95,0
22251,68,68132,81,"Tasa de exámenes médico legales por presunto delito sexual contra niños, niñas y adolescentes",2016,3,1,222,450.45045045045,0,114,0,1,108,925.925925925926
22252,68,68147,81,"Tasa de exámenes médico legales por presunto delito sexual contra niños, niñas y adolescentes",2016,2,1,475,210.526315789474,1,242,413.223140495868,0,233,0
22253,68,68147,81,"Tasa de exámenes médico legales por presunto delito sexual contra niños, niñas y adolescentes",2016,3,1,537,186.219739292365,0,275,0,1,262,381.679389312977
22254,68,68147,81,"Tasa de exámenes médico legales por presunto delito sexual contra niños, niñas y adolescentes",2016,4,3,524,572.519083969466,1,264,378.787878787879,2,260,769.230769230769
22255,68,68152,81,"Tasa de exámenes médico legales por presunto delito sexual contra niños, niñas y adolescentes",2016,4,1,463,215.982721382289,0,233,0,1,230,434.782608695652
22256,68,68160,81,"Tasa de exámenes médico legales por presunto delito sexual contra niños, niñas y adolescentes",2016,3,1,201,497.512437810945,0,103,0,1,98,1020.40816326531
22257,68,68162,81,"Tasa de exámenes médico legales por presunto delito sexual contra niños, niñas y adolescentes",2016,3,1,624,160.25641025641,0,312,0,1,312,320.512820512821
22258,68,68162,81,"Tasa de exámenes médico legales por presunto delito sexual contra niños, niñas y adolescentes",2016,4,1,620,161.290322580645,0,313,0,1,307,325.732899022801
22259,68,68167,81,"Tasa de exámenes médico legales por presunto delito sexual contra niños, niñas y adolescentes",2016,3,6,1111,540.05400540054,1,570,175.438596491228,5,541,924.214417744917
22260,68,68167,81,"Tasa de exámenes médico legales por presunto delito sexual contra niños, niñas y adolescentes",2016,4,2,1101,181.653042688465,1,566,176.678445229682,1,535,186.915887850467
22261,68,68167,121,Tasa de exámenes médico legales por presunto delito sexual cuando la víctima está entre 18 y 28 años,2016,5,2,2004,99.8003992015968,2,1072,186.567164179104,0,932,0
22262,68,68169,81,"Tasa de exámenes médico legales por presunto delito sexual contra niños, niñas y adolescentes",2016,4,2,227,881.057268722467,0,112,0,2,115,1739.13043478261
22263,68,68176,81,"Tasa de exámenes médico legales por presunto delito sexual contra niños, niñas y adolescentes",2016,3,1,249,401.606425702811,0,124,0,1,125,800
22264,68,68190,81,"Tasa de exámenes médico legales por presunto delito sexual contra niños, niñas y adolescentes",2016,2,10,4936,202.59319286872,0,2552,0,10,2384,419.463087248322
22265,68,68190,81,"Tasa de exámenes médico legales por presunto delito sexual contra niños, niñas y adolescentes",2016,3,5,5572,89.7343862167983,0,2881,0,5,2691,185.804533630621
22266,68,68190,81,"Tasa de exámenes médico legales por presunto delito sexual contra niños, niñas y adolescentes",2016,4,24,5363,447.510721611039,0,2755,0,24,2608,920.245398773006
22267,68,68190,121,Tasa de exámenes médico legales por presunto delito sexual cuando la víctima está entre 18 y 28 años,2016,5,3,8812,34.044484793463504,1,4447,22.4870699347875,2,4365,45.8190148911798
22268,68,68207,81,"Tasa de exámenes médico legales por presunto delito sexual contra niños, niñas y adolescentes",2016,3,1,511,195.694716242661,0,259,0,1,252,396.825396825397
22269,68,68207,81,"Tasa de exámenes médico legales por presunto delito sexual contra niños, niñas y adolescentes",2016,4,1,517,193.423597678917,0,261,0,1,256,390625
22270,68,68211,81,"Tasa de exámenes médico legales por presunto delito sexual contra niños, niñas y adolescentes",2016,3,1,413,242.130750605327,0,212,0,1,201,497.512437810945
22271,68,68217,81,"Tasa de exámenes médico legales por presunto delito sexual contra niños, niñas y adolescentes",2016,3,1,793,126.103404791929,0,409,0,1,384,260.416666666667
22272,68,68217,121,Tasa de exámenes médico legales por presunto delito sexual cuando la víctima está entre 18 y 28 años,2016,5,1,1545,64.7249190938511,0,837,0,1,708,141.242937853107
22273,68,68229,81,"Tasa de exámenes médico legales por presunto delito sexual contra niños, niñas y adolescentes",2016,3,1,1172,85.3242320819113,0,594,0,1,578,173.010380622837
22274,68,68229,81,"Tasa de exámenes médico legales por presunto delito sexual contra niños, niñas y adolescentes",2016,4,5,1182,423.011844331641,1,592,168.918918918919,4,590,677.966101694915
22275,68,68235,81,"Tasa de exámenes médico legales por presunto delito sexual contra niños, niñas y adolescentes",2016,2,2,1879,106.439595529537,1,966,103.51966873706,1,913,109.529025191676
22276,68,68235,81,"Tasa de exámenes médico legales por presunto delito sexual contra niños, niñas y adolescentes",2016,3,5,2106,237.416904083571,1,1086,92.0810313075507,4,1020,392.156862745098
22277,68,68245,81,"Tasa de exámenes médico legales por presunto delito sexual contra niños, niñas y adolescentes",2016,4,1,190,526.315789473684,0,99,0,1,91,1098.9010989011
22278,68,68250,81,"Tasa de exámenes médico legales por presunto delito sexual contra niños, niñas y adolescentes",2016,3,1,645,155.038759689922,0,328,0,1,317,315.457413249211
22279,68,68250,81,"Tasa de exámenes médico legales por presunto delito sexual contra niños, niñas y adolescentes",2016,4,1,654,152.905198776758,0,339,0,1,315,317.460317460317
22280,68,68255,81,"Tasa de exámenes médico legales por presunto delito sexual contra niños, niñas y adolescentes",2016,2,3,1217,246.507806080526,0,636,0,3,581,516.351118760757
22281,68,68255,81,"Tasa de exámenes médico legales por presunto delito sexual contra niños, niñas y adolescentes",2016,3,3,1355,221.40221402214,0,730,0,3,625,480
22282,68,68255,81,"Tasa de exámenes médico legales por presunto delito sexual contra niños, niñas y adolescentes",2016,4,2,1278,156.494522691706,0,701,0,2,577,346.620450606586
22283,68,68255,121,Tasa de exámenes médico legales por presunto delito sexual cuando la víctima está entre 18 y 28 años,2016,5,2,2210,90.4977375565611,1,1205,82.9875518672199,1,1005,99.5024875621891
22284,68,68266,81,"Tasa de exámenes médico legales por presunto delito sexual contra niños, niñas y adolescentes",2016,4,1,310,322.58064516129,0,156,0,1,154,649.350649350649
22285,68,68271,81,"Tasa de exámenes médico legales por presunto delito sexual contra niños, niñas y adolescentes",2016,4,1,727,137.551581843191,0,386,0,1,341,293.255131964809
22286,68,68276,81,"Tasa de exámenes médico legales por presunto delito sexual contra niños, niñas y adolescentes",2016,2,29,17853,162.437685543046,6,9155,65.5379574003277,23,8698,264.428604276845
22287,68,68276,81,"Tasa de exámenes médico legales por presunto delito sexual contra niños, niñas y adolescentes",2016,3,34,22692,149.832540102239,10,11702,85.4554776961203,24,10990,218.380345768881
22288,68,68276,81,"Tasa de exámenes médico legales por presunto delito sexual contra niños, niñas y adolescentes",2016,4,51,24677,206.670178708919,8,12698,63.0020475665459,43,11979,358.961515986309
22289,68,68276,121,Tasa de exámenes médico legales por presunto delito sexual cuando la víctima está entre 18 y 28 años,2016,5,2,48191,4.15015251810504,0,24462,0,2,23729,8.42850520460197
22290,68,68276,81,"Tasa de exámenes médico legales por presunto delito sexual contra niños, niñas y adolescentes",2016,1,1,3431,29.146021568056,0,1766,0,1,1665,60.0600600600601
22291,68,68298,81,"Tasa de exámenes médico legales por presunto delito sexual contra niños, niñas y adolescentes",2016,2,1,536,186.567164179104,0,276,0,1,260,384.615384615385
22292,68,68298,81,"Tasa de exámenes médico legales por presunto delito sexual contra niños, niñas y adolescentes",2016,4,1,515,194.174757281553,0,261,0,1,254,393.700787401575
22293,68,68307,81,"Tasa de exámenes médico legales por presunto delito sexual contra niños, niñas y adolescentes",2016,2,15,14998,100.013335111348,1,7661,13.0531262237306,14,7337,190.813684067057
22294,68,68307,81,"Tasa de exámenes médico legales por presunto delito sexual contra niños, niñas y adolescentes",2016,3,33,18075,182.572614107884,3,9168,32.7225130890052,30,8907,336.813742000674
22295,68,68307,81,"Tasa de exámenes médico legales por presunto delito sexual contra niños, niñas y adolescentes",2016,4,41,18931,216.575986477207,2,9626,20.7770621234158,39,9305,419.129500268673
22296,68,68307,121,Tasa de exámenes médico legales por presunto delito sexual cuando la víctima está entre 18 y 28 años,2016,5,6,35303,16.9957227431097,1,18028,5.54692700244065,5,17275,28.9435600578871
22297,68,68318,121,Tasa de exámenes médico legales por presunto delito sexual cuando la víctima está entre 18 y 28 años,2016,5,1,1132,88.339222614841,0,506,0,1,626,159.744408945687
22298,68,68324,81,"Tasa de exámenes médico legales por presunto delito sexual contra niños, niñas y adolescentes",2016,4,1,378,264.550264550265,0,194,0,1,184,543.478260869565
22299,68,68327,81,"Tasa de exámenes médico legales por presunto delito sexual contra niños, niñas y adolescentes",2016,3,5,362,1381.21546961326,0,185,0,5,177,2824.85875706215
22300,68,68327,81,"Tasa de exámenes médico legales por presunto delito sexual contra niños, niñas y adolescentes",2016,4,2,377,530.503978779841,0,192,0,2,185,1081.08108108108
22301,68,68368,81,"Tasa de exámenes médico legales por presunto delito sexual contra niños, niñas y adolescentes",2016,3,3,336,892.857142857143,1,175,571.428571428571,2,161,1242.23602484472
22302,68,68368,81,"Tasa de exámenes médico legales por presunto delito sexual contra niños, niñas y adolescentes",2016,4,1,341,293.255131964809,0,179,0,1,162,617.283950617284
22303,68,68368,121,Tasa de exámenes médico legales por presunto delito sexual cuando la víctima está entre 18 y 28 años,2016,5,1,595,168.067226890756,0,317,0,1,278,359.712230215827
22304,68,68377,81,"Tasa de exámenes médico legales por presunto delito sexual contra niños, niñas y adolescentes",2016,3,2,929,215.285252960172,1,485,206.185567010309,1,444,225.225225225225
22305,68,68377,81,"Tasa de exámenes médico legales por presunto delito sexual contra niños, niñas y adolescentes",2016,4,1,941,106.269925611052,0,495,0,1,446,224.215246636771
22306,68,68385,81,"Tasa de exámenes médico legales por presunto delito sexual contra niños, niñas y adolescentes",2016,3,4,1761,227.143668370244,0,917,0,4,844,473.9336492891
22307,68,68385,81,"Tasa de exámenes médico legales por presunto delito sexual contra niños, niñas y adolescentes",2016,4,3,1700,176.470588235294,0,896,0,3,804,373.134328358209
22308,68,68385,121,Tasa de exámenes médico legales por presunto delito sexual cuando la víctima está entre 18 y 28 años,2016,5,1,2903,34.447123665174,0,1580,0,1,1323,75.5857898715042
22309,68,68397,121,Tasa de exámenes médico legales por presunto delito sexual cuando la víctima está entre 18 y 28 años,2016,5,1,942,106.157112526539,1,491,203.665987780041,0,451,0
22310,68,68406,81,"Tasa de exámenes médico legales por presunto delito sexual contra niños, niñas y adolescentes",2016,2,2,3696,54.1125541125541,0,1899,0,2,1797,111.296605453534
22311,68,68406,81,"Tasa de exámenes médico legales por presunto delito sexual contra niños, niñas y adolescentes",2016,3,9,4218,213.371266002845,2,2192,91.2408759124088,7,2026,345.508390918065
22312,68,68406,81,"Tasa de exámenes médico legales por presunto delito sexual contra niños, niñas y adolescentes",2016,4,7,4261,164.280685285144,0,2213,0,7,2048,341.796875
22313,68,68406,121,Tasa de exámenes médico legales por presunto delito sexual cuando la víctima está entre 18 y 28 años,2016,5,3,7415,40.4585300067431,0,3814,0,3,3601,83.3101916134407
22314,68,68418,81,"Tasa de exámenes médico legales por presunto delito sexual contra niños, niñas y adolescentes",2016,3,3,1267,236.779794790845,1,659,151.745068285281,2,608,328.947368421053
22315,68,68418,81,"Tasa de exámenes médico legales por presunto delito sexual contra niños, niñas y adolescentes",2016,4,1,1290,77.5193798449612,0,677,0,1,613,163.132137030995
22316,68,68432,81,"Tasa de exámenes médico legales por presunto delito sexual contra niños, niñas y adolescentes",2016,2,2,1490,134.228187919463,0,761,0,2,729,274.348422496571
22317,68,68432,81,"Tasa de exámenes médico legales por presunto delito sexual contra niños, niñas y adolescentes",2016,3,4,1716,233.100233100233,0,868,0,4,848,471.698113207547
22318,68,68432,81,"Tasa de exámenes médico legales por presunto delito sexual contra niños, niñas y adolescentes",2016,4,1,1810,55.2486187845304,0,911,0,1,899,111.234705228031
22319,68,68444,81,"Tasa de exámenes médico legales por presunto delito sexual contra niños, niñas y adolescentes",2016,3,1,535,186.915887850467,0,272,0,1,263,380.228136882129
22320,68,68444,81,"Tasa de exámenes médico legales por presunto delito sexual contra niños, niñas y adolescentes",2016,4,1,519,192.678227360308,0,265,0,1,254,393.700787401575
22321,68,68444,121,Tasa de exámenes médico legales por presunto delito sexual cuando la víctima está entre 18 y 28 años,2016,5,1,953,104.931794333683,0,501,0,1,452,221.238938053097
22322,68,68464,81,"Tasa de exámenes médico legales por presunto delito sexual contra niños, niñas y adolescentes",2016,3,1,1250,80,0,649,0,1,601,166.389351081531
22323,68,68464,81,"Tasa de exámenes médico legales por presunto delito sexual contra niños, niñas y adolescentes",2016,4,6,1139,526.777875329236,1,589,169.779286926995,5,550,909.090909090909
22324,68,68464,121,Tasa de exámenes médico legales por presunto delito sexual cuando la víctima está entre 18 y 28 años,2016,5,1,2139,46.7508181393174,0,1121,0,1,1018,98.2318271119843
22325,68,68468,81,"Tasa de exámenes médico legales por presunto delito sexual contra niños, niñas y adolescentes",2016,4,1,543,184.162062615101,0,285,0,1,258,387.596899224806
22326,68,68498,81,"Tasa de exámenes médico legales por presunto delito sexual contra niños, niñas y adolescentes",2016,3,6,501,1197.60479041916,3,261,1149.42528735632,3,240,1250
22327,68,68498,81,"Tasa de exámenes médico legales por presunto delito sexual contra niños, niñas y adolescentes",2016,4,5,467,1070.66381156317,3,245,1224.48979591837,2,222,900.900900900901
22328,68,68500,81,"Tasa de exámenes médico legales por presunto delito sexual contra niños, niñas y adolescentes",2016,3,2,1417,141.143260409315,0,728,0,2,689,290.275761973875
22329,68,68500,81,"Tasa de exámenes médico legales por presunto delito sexual contra niños, niñas y adolescentes",2016,4,2,1284,155.763239875389,0,660,0,2,624,320.512820512821
22330,68,68533,81,"Tasa de exámenes médico legales por presunto delito sexual contra niños, niñas y adolescentes",2016,3,1,525,190.47619047619,0,269,0,1,256,390625
22331,68,68547,81,"Tasa de exámenes médico legales por presunto delito sexual contra niños, niñas y adolescentes",2016,2,18,12158,148.050666227998,4,6207,64.4433703882713,14,5951,235.254579062342
22332,68,68547,81,"Tasa de exámenes médico legales por presunto delito sexual contra niños, niñas y adolescentes",2016,3,30,14613,205.296653664545,10,7394,135.244793075467,20,7219,277.046682365979
22333,68,68547,81,"Tasa de exámenes médico legales por presunto delito sexual contra niños, niñas y adolescentes",2016,4,39,15207,256.460840402446,6,7770,77.2200772200772,33,7437,443.727309398951
22334,68,68547,121,Tasa de exámenes médico legales por presunto delito sexual cuando la víctima está entre 18 y 28 años,2016,5,7,28883,24.2357095869543,1,14440,6.92520775623269,6,14443,41.5426158000415
22335,68,68547,81,"Tasa de exámenes médico legales por presunto delito sexual contra niños, niñas y adolescentes",2016,1,1,2417,41.3736036408771,0,1240,0,1,1177,84.9617672047579
22336,68,68549,81,"Tasa de exámenes médico legales por presunto delito sexual contra niños, niñas y adolescentes",2016,3,2,543,368.324125230203,0,272,0,2,271,738.007380073801
22337,68,68549,121,Tasa de exámenes médico legales por presunto delito sexual cuando la víctima está entre 18 y 28 años,2016,5,1,1006,99.403578528827,0,472,0,1,534,187.265917602996
22338,68,68572,81,"Tasa de exámenes médico legales por presunto delito sexual contra niños, niñas y adolescentes",2016,2,1,1055,94.7867298578199,0,541,0,1,514,194.552529182879
22339,68,68572,81,"Tasa de exámenes médico legales por presunto delito sexual contra niños, niñas y adolescentes",2016,3,1,1248,80.1282051282051,0,644,0,1,604,165.562913907285
22340,68,68572,81,"Tasa de exámenes médico legales por presunto delito sexual contra niños, niñas y adolescentes",2016,4,2,1148,174.216027874564,0,588,0,2,560,357.142857142857
22341,68,68572,121,Tasa de exámenes médico legales por presunto delito sexual cuando la víctima está entre 18 y 28 años,2016,5,1,2061,48.5201358563804,1,988,101.214574898785,0,1073,0
22342,68,68573,81,"Tasa de exámenes médico legales por presunto delito sexual contra niños, niñas y adolescentes",2016,2,1,931,107.411385606874,0,481,0,1,450,222.222222222222
22343,68,68573,81,"Tasa de exámenes médico legales por presunto delito sexual contra niños, niñas y adolescentes",2016,3,9,1015,886.699507389163,1,526,190.114068441065,8,489,1635.9918200409
22344,68,68573,81,"Tasa de exámenes médico legales por presunto delito sexual contra niños, niñas y adolescentes",2016,4,6,1001,599.400599400599,0,526,0,6,475,1263.15789473684
22345,68,68573,121,Tasa de exámenes médico legales por presunto delito sexual cuando la víctima está entre 18 y 28 años,2016,5,1,1539,64.9772579597141,0,813,0,1,726,137.741046831956
22346,68,68575,81,"Tasa de exámenes médico legales por presunto delito sexual contra niños, niñas y adolescentes",2016,2,2,3456,57.8703703703704,1,1759,56.8504832291075,1,1697,58.9275191514437
22347,68,68575,81,"Tasa de exámenes médico legales por presunto delito sexual contra niños, niñas y adolescentes",2016,3,8,3782,211.528291909043,3,1895,158.311345646438,5,1887,264.970853206147
22348,68,68575,81,"Tasa de exámenes médico legales por presunto delito sexual contra niños, niñas y adolescentes",2016,4,12,3570,336.134453781513,0,1770,0,12,1800,666.666666666667
22349,68,68575,121,Tasa de exámenes médico legales por presunto delito sexual cuando la víctima está entre 18 y 28 años,2016,5,1,6259,15.976993129893,0,3133,0,1,3126,31.9897632757518
22350,68,68615,81,"Tasa de exámenes médico legales por presunto delito sexual contra niños, niñas y adolescentes",2016,2,3,2616,114.678899082569,0,1345,0,3,1271,236.0346184107
22351,68,68615,81,"Tasa de exámenes médico legales por presunto delito sexual contra niños, niñas y adolescentes",2016,3,4,2941,136.008160489629,0,1521,0,4,1420,281.69014084507
22352,68,68615,81,"Tasa de exámenes médico legales por presunto delito sexual contra niños, niñas y adolescentes",2016,4,9,2930,307.167235494881,1,1525,65.5737704918033,8,1405,569.395017793594
22353,68,68615,121,Tasa de exámenes médico legales por presunto delito sexual cuando la víctima está entre 18 y 28 años,2016,5,2,5215,38.3509108341323,0,2733,0,2,2482,80.58017727639
22354,68,68655,81,"Tasa de exámenes médico legales por presunto delito sexual contra niños, niñas y adolescentes",2016,2,1,1730,57.8034682080925,1,886,112.866817155756,0,844,0
22355,68,68655,81,"Tasa de exámenes médico legales por presunto delito sexual contra niños, niñas y adolescentes",2016,3,8,1942,411.946446961895,1,998,100.200400801603,7,944,741.525423728814
22356,68,68655,81,"Tasa de exámenes médico legales por presunto delito sexual contra niños, niñas y adolescentes",2016,4,12,1921,624.67464862051,0,992,0,12,929,1291.71151776103
22357,68,68655,121,Tasa de exámenes médico legales por presunto delito sexual cuando la víctima está entre 18 y 28 años,2016,5,1,3680,27.1739130434783,0,1954,0,1,1726,57.9374275782155
22358,68,68669,81,"Tasa de exámenes médico legales por presunto delito sexual contra niños, niñas y adolescentes",2016,4,4,754,530.503978779841,0,397,0,4,357,1120.44817927171
22359,68,68673,81,"Tasa de exámenes médico legales por presunto delito sexual contra niños, niñas y adolescentes",2016,4,1,410,243.90243902439,0,212,0,1,198,505.050505050505
22360,68,68673,121,Tasa de exámenes médico legales por presunto delito sexual cuando la víctima está entre 18 y 28 años,2016,5,1,809,123.609394313968,0,438,0,1,371,269.541778975741
22361,68,68679,81,"Tasa de exámenes médico legales por presunto delito sexual contra niños, niñas y adolescentes",2016,2,5,3210,155.763239875389,3,1643,182.592818015825,2,1567,127.632418634333
22362,68,68679,81,"Tasa de exámenes médico legales por presunto delito sexual contra niños, niñas y adolescentes",2016,3,5,3971,125.91286829514,3,1993,150.526843953838,2,1978,101.112234580384
22363,68,68679,81,"Tasa de exámenes médico legales por presunto delito sexual contra niños, niñas y adolescentes",2016,4,12,4008,299.40119760479,0,1957,0,12,2051,585.080448561677
22364,68,68679,121,Tasa de exámenes médico legales por presunto delito sexual cuando la víctima está entre 18 y 28 años,2016,5,3,7969,37.6458777763835,0,3995,0,3,3974,75.4906894816306
22365,68,68682,81,"Tasa de exámenes médico legales por presunto delito sexual contra niños, niñas y adolescentes",2016,4,1,230,434.782608695652,0,122,0,1,108,925.925925925926
22366,68,68684,81,"Tasa de exámenes médico legales por presunto delito sexual contra niños, niñas y adolescentes",2016,1,1,85,1176.47058823529,1,44,2272.72727272727,0,41,0
22367,68,68686,81,"Tasa de exámenes médico legales por presunto delito sexual contra niños, niñas y adolescentes",2016,4,1,231,432.900432900433,0,124,0,1,107,934.579439252336
22368,68,68689,81,"Tasa de exámenes médico legales por presunto delito sexual contra niños, niñas y adolescentes",2016,2,5,3331,150.105073551486,1,1705,58.6510263929619,4,1626,246.0024600246
22369,68,68689,81,"Tasa de exámenes médico legales por presunto delito sexual contra niños, niñas y adolescentes",2016,3,13,3880,335.051546391753,3,1974,151.975683890578,10,1906,524.658971668416
22370,68,68689,81,"Tasa de exámenes médico legales por presunto delito sexual contra niños, niñas y adolescentes",2016,4,22,3736,588.865096359743,2,1895,105.540897097625,20,1841,1086.36610537751
22371,68,68689,121,Tasa de exámenes médico legales por presunto delito sexual cuando la víctima está entre 18 y 28 años,2016,5,1,6611,15.1263046437755,0,3373,0,1,3238,30.8832612723904
22372,68,68689,81,"Tasa de exámenes médico legales por presunto delito sexual contra niños, niñas y adolescentes",2016,1,1,675,148.148148148148,0,346,0,1,329,303.951367781155
22373,68,68720,81,"Tasa de exámenes médico legales por presunto delito sexual contra niños, niñas y adolescentes",2016,3,1,512,195.3125,0,264,0,1,248,403.225806451613
22374,68,68745,121,Tasa de exámenes médico legales por presunto delito sexual cuando la víctima está entre 18 y 28 años,2016,5,1,1503,66.5335994677312,0,819,0,1,684,146.198830409357
22375,68,68755,81,"Tasa de exámenes médico legales por presunto delito sexual contra niños, niñas y adolescentes",2016,2,1,2360,42.3728813559322,0,1212,0,1,1148,87.1080139372822
22376,68,68755,81,"Tasa de exámenes médico legales por presunto delito sexual contra niños, niñas y adolescentes",2016,3,1,2792,35.8166189111748,0,1397,0,1,1395,71.6845878136201
22377,68,68755,81,"Tasa de exámenes médico legales por presunto delito sexual contra niños, niñas y adolescentes",2016,4,1,3249,30.7787011388119,0,1796,0,1,1453,68.8231245698555
22378,68,68770,81,"Tasa de exámenes médico legales por presunto delito sexual contra niños, niñas y adolescentes",2016,4,6,964,622.406639004149,0,505,0,6,459,1307.18954248366
22379,68,68773,81,"Tasa de exámenes médico legales por presunto delito sexual contra niños, niñas y adolescentes",2016,3,1,929,107.642626480086,0,488,0,1,441,226.757369614512
22380,68,68855,81,"Tasa de exámenes médico legales por presunto delito sexual contra niños, niñas y adolescentes",2016,2,1,387,258.397932816538,0,200,0,1,187,534.75935828877
22381,68,68855,81,"Tasa de exámenes médico legales por presunto delito sexual contra niños, niñas y adolescentes",2016,3,1,432,231.481481481481,0,224,0,1,208,480.769230769231
22382,68,68855,81,"Tasa de exámenes médico legales por presunto delito sexual contra niños, niñas y adolescentes",2016,4,1,481,207.900207900208,0,252,0,1,229,436.681222707424
22383,68,68861,81,"Tasa de exámenes médico legales por presunto delito sexual contra niños, niñas y adolescentes",2016,2,2,1977,101.163378856854,1,1024,97.65625,1,953,104.931794333683
22384,68,68861,81,"Tasa de exámenes médico legales por presunto delito sexual contra niños, niñas y adolescentes",2016,3,4,2218,180.34265103697,1,1144,87.4125874125874,3,1074,279.329608938548
22385,68,68861,81,"Tasa de exámenes médico legales por presunto delito sexual contra niños, niñas y adolescentes",2016,4,5,2174,229.990800367985,1,1131,88.4173297966401,4,1043,383.509108341323
22386,68,68861,121,Tasa de exámenes médico legales por presunto delito sexual cuando la víctima está entre 18 y 28 años,2016,5,3,3989,75.2068187515668,0,2243,0,3,1746,171.821305841924
22387,68,68895,81,"Tasa de exámenes médico legales por presunto delito sexual contra niños, niñas y adolescentes",2016,2,1,755,132.450331125828,0,386,0,1,369,271.0027100271
22388,68,68895,81,"Tasa de exámenes médico legales por presunto delito sexual contra niños, niñas y adolescentes",2016,3,1,847,118.063754427391,0,430,0,1,417,239.808153477218
22389,70,70001,81,"Tasa de exámenes médico legales por presunto delito sexual contra niños, niñas y adolescentes",2016,2,16,23681,67.5647143279422,4,12108,33.0360092500826,12,11573,103.689622396958
22390,70,70001,81,"Tasa de exámenes médico legales por presunto delito sexual contra niños, niñas y adolescentes",2016,3,61,29644,205.775199028471,12,15118,79.375578780262,49,14526,337.326173757401
22391,70,70001,81,"Tasa de exámenes médico legales por presunto delito sexual contra niños, niñas y adolescentes",2016,4,100,31214,320.369065163068,9,15762,57.0993528740008,91,15452,588.920528086979
22392,70,70001,121,Tasa de exámenes médico legales por presunto delito sexual cuando la víctima está entre 18 y 28 años,2016,5,19,55920,33.9771101573677,5,28284,17.6778390609532,14,27636,50.6585612968592
22393,70,70110,81,"Tasa de exámenes médico legales por presunto delito sexual contra niños, niñas y adolescentes",2016,2,1,988,101.214574898785,1,502,199.203187250996,0,486,0
22394,70,70124,81,"Tasa de exámenes médico legales por presunto delito sexual contra niños, niñas y adolescentes",2016,3,1,1424,70.2247191011236,0,730,0,1,694,144.092219020173
22395,70,70124,81,"Tasa de exámenes médico legales por presunto delito sexual contra niños, niñas y adolescentes",2016,4,1,1438,69.5410292072323,0,743,0,1,695,143.884892086331
22396,70,70204,81,"Tasa de exámenes médico legales por presunto delito sexual contra niños, niñas y adolescentes",2016,3,1,658,151.975683890578,0,336,0,1,322,310.55900621118
22397,70,70215,81,"Tasa de exámenes médico legales por presunto delito sexual contra niños, niñas y adolescentes",2016,2,3,5218,57.4932924492143,2,2667,74.9906261717285,1,2551,39.2003136025088
22398,70,70215,81,"Tasa de exámenes médico legales por presunto delito sexual contra niños, niñas y adolescentes",2016,3,11,6537,168.272908061802,5,3323,150.466445982546,6,3214,186.683260734288
22399,70,70215,81,"Tasa de exámenes médico legales por presunto delito sexual contra niños, niñas y adolescentes",2016,4,25,6914,361.585189470639,2,3521,56.8020448736155,23,3393,677.866195107574
22400,70,70215,121,Tasa de exámenes médico legales por presunto delito sexual cuando la víctima está entre 18 y 28 años,2016,5,5,13666,36.5871505927118,2,7604,26.3019463440295,3,6062,49.4886176179479
22401,70,70221,81,"Tasa de exámenes médico legales por presunto delito sexual contra niños, niñas y adolescentes",2016,2,3,1489,201.477501678979,1,770,129.87012987013,2,719,278.164116828929
22402,70,70221,81,"Tasa de exámenes médico legales por presunto delito sexual contra niños, niñas y adolescentes",2016,3,7,1725,405.797101449275,3,884,339.366515837104,4,841,475.624256837099
22403,70,70221,81,"Tasa de exámenes médico legales por presunto delito sexual contra niños, niñas y adolescentes",2016,4,6,1706,351.699882766706,0,852,0,6,854,702.576112412178
22404,70,70221,121,Tasa de exámenes médico legales por presunto delito sexual cuando la víctima está entre 18 y 28 años,2016,5,1,2758,36.2581580855693,0,1357,0,1,1401,71.3775874375446
22405,70,70230,81,"Tasa de exámenes médico legales por presunto delito sexual contra niños, niñas y adolescentes",2016,3,1,539,185.528756957328,0,281,0,1,258,387.596899224806
22406,70,70230,81,"Tasa de exámenes médico legales por presunto delito sexual contra niños, niñas y adolescentes",2016,4,1,523,191.204588910134,0,274,0,1,249,401.606425702811
22407,70,70235,81,"Tasa de exámenes médico legales por presunto delito sexual contra niños, niñas y adolescentes",2016,3,1,2552,39.1849529780564,1,1299,76.9822940723634,0,1253,0
22408,70,70235,81,"Tasa de exámenes médico legales por presunto delito sexual contra niños, niñas y adolescentes",2016,4,5,2489,200.883889112093,1,1264,79.1139240506329,4,1225,326.530612244898
22409,70,70400,81,"Tasa de exámenes médico legales por presunto delito sexual contra niños, niñas y adolescentes",2016,2,1,1209,82.7129859387924,1,621,161.030595813205,0,588,0
22410,70,70400,81,"Tasa de exámenes médico legales por presunto delito sexual contra niños, niñas y adolescentes",2016,3,1,1397,71.5819613457409,0,723,0,1,674,148.367952522255
22411,70,70400,81,"Tasa de exámenes médico legales por presunto delito sexual contra niños, niñas y adolescentes",2016,4,3,1316,227.963525835866,1,685,145.985401459854,2,631,316.957210776545
22412,70,70418,81,"Tasa de exámenes médico legales por presunto delito sexual contra niños, niñas y adolescentes",2016,3,2,2043,97.8952520802741,0,1046,0,2,997,200.601805416249
22413,70,70418,81,"Tasa de exámenes médico legales por presunto delito sexual contra niños, niñas y adolescentes",2016,4,2,2053,97.4184120798831,0,1049,0,2,1004,199.203187250996
22414,70,70429,81,"Tasa de exámenes médico legales por presunto delito sexual contra niños, niñas y adolescentes",2016,2,1,3641,27.4649821477616,0,1859,0,1,1782,56.1167227833895
22415,70,70429,81,"Tasa de exámenes médico legales por presunto delito sexual contra niños, niñas y adolescentes",2016,3,1,4093,24.4319569997557,0,2094,0,1,1999,50.0250125062531
22416,70,70429,81,"Tasa de exámenes médico legales por presunto delito sexual contra niños, niñas y adolescentes",2016,4,1,4022,24.8632521133764,0,2069,0,1,1953,51.2032770097286
22417,70,70473,81,"Tasa de exámenes médico legales por presunto delito sexual contra niños, niñas y adolescentes",2016,2,1,1417,70.5716302046577,0,734,0,1,683,146.412884333821
22418,70,70473,81,"Tasa de exámenes médico legales por presunto delito sexual contra niños, niñas y adolescentes",2016,3,2,1659,120.554550934298,0,870,0,2,789,253.485424588086
22419,70,70473,81,"Tasa de exámenes médico legales por presunto delito sexual contra niños, niñas y adolescentes",2016,4,3,1676,178.997613365155,1,876,114.155251141553,2,800,250
22420,70,70473,121,Tasa de exámenes médico legales por presunto delito sexual cuando la víctima está entre 18 y 28 años,2016,5,1,2983,33.5232986925914,0,1562,0,1,1421,70.3729767769177
22421,70,70508,81,"Tasa de exámenes médico legales por presunto delito sexual contra niños, niñas y adolescentes",2016,3,1,2550,39.2156862745098,0,1320,0,1,1230,81.3008130081301
22422,70,70508,81,"Tasa de exámenes médico legales por presunto delito sexual contra niños, niñas y adolescentes",2016,4,4,2468,162.074554294976,0,1282,0,4,1186,337.268128161889
22423,70,70523,81,"Tasa de exámenes médico legales por presunto delito sexual contra niños, niñas y adolescentes",2016,3,2,1988,100.603621730382,1,1042,95.9692898272553,1,946,105.708245243129
22424,70,70523,81,"Tasa de exámenes médico legales por presunto delito sexual contra niños, niñas y adolescentes",2016,4,1,1884,53.0785562632696,0,998,0,1,886,112.866817155756
22425,70,70670,81,"Tasa de exámenes médico legales por presunto delito sexual contra niños, niñas y adolescentes",2016,2,2,3962,50.4795557799091,1,2022,49.4559841740851,1,1940,51.5463917525773
22426,70,70670,81,"Tasa de exámenes médico legales por presunto delito sexual contra niños, niñas y adolescentes",2016,3,5,4632,107.944732297064,0,2375,0,5,2257,221.533008418254
22427,70,70670,81,"Tasa de exámenes médico legales por presunto delito sexual contra niños, niñas y adolescentes",2016,4,10,4548,219.876868953386,0,2365,0,10,2183,458.085203847916
22428,70,70678,81,"Tasa de exámenes médico legales por presunto delito sexual contra niños, niñas y adolescentes",2016,3,2,3361,59.506099375186,0,1731,0,2,1630,122.699386503067
22429,70,70678,81,"Tasa de exámenes médico legales por presunto delito sexual contra niños, niñas y adolescentes",2016,4,5,3173,157.579577686732,0,1636,0,5,1537,325.309043591412
22430,70,70678,121,Tasa de exámenes médico legales por presunto delito sexual cuando la víctima está entre 18 y 28 años,2016,5,2,5097,39.2387679026879,1,2659,37.6081233546446,1,2438,41.0172272354389
22431,70,70702,81,"Tasa de exámenes médico legales por presunto delito sexual contra niños, niñas y adolescentes",2016,2,1,1059,94.4287063267233,0,542,0,1,517,193.423597678917
22432,70,70702,81,"Tasa de exámenes médico legales por presunto delito sexual contra niños, niñas y adolescentes",2016,3,2,1273,157.109190887667,0,651,0,2,622,321.543408360129
22433,70,70702,81,"Tasa de exámenes médico legales por presunto delito sexual contra niños, niñas y adolescentes",2016,4,2,1329,150.489089541008,1,678,147.492625368732,1,651,153.609831029186
22434,70,70708,81,"Tasa de exámenes médico legales por presunto delito sexual contra niños, niñas y adolescentes",2016,2,1,6223,16.0694198939418,0,3169,0,1,3054,32.7439423706614
22435,70,70708,81,"Tasa de exámenes médico legales por presunto delito sexual contra niños, niñas y adolescentes",2016,3,1,7048,14.1884222474461,0,3519,0,1,3529,28.336639274582
22436,70,70708,81,"Tasa de exámenes médico legales por presunto delito sexual contra niños, niñas y adolescentes",2016,4,4,6919,57.8118225177049,0,3423,0,4,3496,114.41647597254
22437,70,70713,81,"Tasa de exámenes médico legales por presunto delito sexual contra niños, niñas y adolescentes",2016,2,1,6221,16.0745860794085,0,3185,0,1,3036,32.9380764163373
22438,70,70713,81,"Tasa de exámenes médico legales por presunto delito sexual contra niños, niñas y adolescentes",2016,3,1,6838,14.6241591108511,1,3515,28.4495021337127,0,3323,0
22439,70,70713,81,"Tasa de exámenes médico legales por presunto delito sexual contra niños, niñas y adolescentes",2016,4,6,6529,91.8976872415378,0,3391,0,6,3138,191.204588910134
22440,70,70713,121,Tasa de exámenes médico legales por presunto delito sexual cuando la víctima está entre 18 y 28 años,2016,5,2,10379,19.269679159842,0,5509,0,2,4870,41.0677618069815
22441,70,70717,81,"Tasa de exámenes médico legales por presunto delito sexual contra niños, niñas y adolescentes",2016,2,1,1441,69.3962526023595,0,739,0,1,702,142.450142450142
22442,70,70717,81,"Tasa de exámenes médico legales por presunto delito sexual contra niños, niñas y adolescentes",2016,3,3,1708,175.644028103045,0,888,0,3,820,365.853658536585
22443,70,70717,81,"Tasa de exámenes médico legales por presunto delito sexual contra niños, niñas y adolescentes",2016,4,5,1693,295.333727111636,0,891,0,5,802,623.441396508728
22444,70,70717,121,Tasa de exámenes médico legales por presunto delito sexual cuando la víctima está entre 18 y 28 años,2016,5,1,3174,31.5059861373661,0,1675,0,1,1499,66.711140760507
22445,70,70742,81,"Tasa de exámenes médico legales por presunto delito sexual contra niños, niñas y adolescentes",2016,3,2,3878,51.5729757607014,0,2021,0,2,1857,107.700592353258
22446,70,70742,81,"Tasa de exámenes médico legales por presunto delito sexual contra niños, niñas y adolescentes",2016,4,4,3874,103.252452245741,1,2016,49.6031746031746,3,1858,161.463939720129
22447,70,70742,121,Tasa de exámenes médico legales por presunto delito sexual cuando la víctima está entre 18 y 28 años,2016,5,1,6284,15.9134309357097,0,3181,0,1,3103,32.2268772155978
22448,70,70771,81,"Tasa de exámenes médico legales por presunto delito sexual contra niños, niñas y adolescentes",2016,4,1,2422,41.2881915772089,0,1235,0,1,1187,84.24599831508
22449,70,70771,121,Tasa de exámenes médico legales por presunto delito sexual cuando la víctima está entre 18 y 28 años,2016,5,2,4610,43.3839479392625,0,2369,0,2,2241,89.2458723784025
22450,70,70820,81,"Tasa de exámenes médico legales por presunto delito sexual contra niños, niñas y adolescentes",2016,2,2,3526,56.7214974475326,0,1808,0,2,1718,116.414435389988
22451,70,70820,81,"Tasa de exámenes médico legales por presunto delito sexual contra niños, niñas y adolescentes",2016,3,3,4093,73.295870999267,0,2101,0,3,1992,150.602409638554
22452,70,70820,81,"Tasa de exámenes médico legales por presunto delito sexual contra niños, niñas y adolescentes",2016,4,13,4131,314.693778746066,2,2105,95.0118764845606,11,2026,542.94175715696
22453,70,70823,81,"Tasa de exámenes médico legales por presunto delito sexual contra niños, niñas y adolescentes",2016,3,7,2214,316.16982836495,3,1162,258.175559380379,4,1052,380.228136882129
22454,70,70823,81,"Tasa de exámenes médico legales por presunto delito sexual contra niños, niñas y adolescentes",2016,4,6,2168,276.752767527675,0,1139,0,6,1029,583.090379008746
22455,73,73001,81,"Tasa de exámenes médico legales por presunto delito sexual contra niños, niñas y adolescentes",2016,2,44,43991,100.020458730195,14,22519,62.1697233447311,30,21472,139.716840536513
22456,73,73001,81,"Tasa de exámenes médico legales por presunto delito sexual contra niños, niñas y adolescentes",2016,3,70,55535,126.046637255785,10,28271,35.3719359060521,60,27264,220.070422535211
22457,73,73001,81,"Tasa de exámenes médico legales por presunto delito sexual contra niños, niñas y adolescentes",2016,4,160,59441,269.174475530358,11,30397,36.1877816889825,149,29044,513.014736262223
22458,73,73001,121,Tasa de exámenes médico legales por presunto delito sexual cuando la víctima está entre 18 y 28 años,2016,5,27,106885,25.2607943116434,4,55340,7.22804481387785,23,51545,44.6212047725289
22459,73,73001,81,"Tasa de exámenes médico legales por presunto delito sexual contra niños, niñas y adolescentes",2016,1,2,8567,23.3453951208124,0,4409,0,2,4158,48.1000481000481
22460,73,73024,81,"Tasa de exámenes médico legales por presunto delito sexual contra niños, niñas y adolescentes",2016,2,1,444,225.225225225225,1,228,438.59649122807,0,216,0
22461,73,73026,81,"Tasa de exámenes médico legales por presunto delito sexual contra niños, niñas y adolescentes",2016,2,3,818,366.748166259169,1,426,234.741784037559,2,392,510.204081632653
22462,73,73026,81,"Tasa de exámenes médico legales por presunto delito sexual contra niños, niñas y adolescentes",2016,4,4,925,432.432432432432,0,486,0,4,439,911.161731207289
22463,73,73030,81,"Tasa de exámenes médico legales por presunto delito sexual contra niños, niñas y adolescentes",2016,3,1,664,150.602409638554,1,346,289.017341040462,0,318,0
22464,73,73030,81,"Tasa de exámenes médico legales por presunto delito sexual contra niños, niñas y adolescentes",2016,4,2,692,289.017341040462,0,361,0,2,331,604.229607250755
22465,73,73043,81,"Tasa de exámenes médico legales por presunto delito sexual contra niños, niñas y adolescentes",2016,4,1,2370,42.1940928270042,0,1301,0,1,1069,93.5453695042096
22466,73,73055,81,"Tasa de exámenes médico legales por presunto delito sexual contra niños, niñas y adolescentes",2016,3,2,1270,157.48031496063,0,653,0,2,617,324.149108589951
22467,73,73055,81,"Tasa de exámenes médico legales por presunto delito sexual contra niños, niñas y adolescentes",2016,4,4,1233,324.41200324412,0,647,0,4,586,682.59385665529
22468,73,73067,81,"Tasa de exámenes médico legales por presunto delito sexual contra niños, niñas y adolescentes",2016,4,3,2774,108.147080028839,1,1422,70.323488045007,2,1352,147.92899408284
22469,73,73124,81,"Tasa de exámenes médico legales por presunto delito sexual contra niños, niñas y adolescentes",2016,3,6,2220,270.27027027027,1,1160,86.2068965517241,5,1060,471.698113207547
22470,73,73124,81,"Tasa de exámenes médico legales por presunto delito sexual contra niños, niñas y adolescentes",2016,4,6,2149,279.19962773383,0,1144,0,6,1005,597.014925373134
22471,73,73148,81,"Tasa de exámenes médico legales por presunto delito sexual contra niños, niñas y adolescentes",2016,2,1,735,136.054421768707,1,376,265.957446808511,0,359,0
22472,73,73148,81,"Tasa de exámenes médico legales por presunto delito sexual contra niños, niñas y adolescentes",2016,3,3,869,345.224395857307,2,440,454.545454545455,1,429,233.100233100233
22473,73,73148,81,"Tasa de exámenes médico legales por presunto delito sexual contra niños, niñas y adolescentes",2016,4,1,914,109.409190371991,1,462,216.450216450216,0,452,0
22474,73,73152,81,"Tasa de exámenes médico legales por presunto delito sexual contra niños, niñas y adolescentes",2016,4,2,749,267.022696929239,0,397,0,2,352,568.181818181818
22475,73,73168,81,"Tasa de exámenes médico legales por presunto delito sexual contra niños, niñas y adolescentes",2016,2,3,5345,56.1272217025257,1,2735,36.563071297989,2,2610,76.6283524904215
22476,73,73168,81,"Tasa de exámenes médico legales por presunto delito sexual contra niños, niñas y adolescentes",2016,3,14,6034,232.018561484919,5,3090,161.812297734628,9,2944,305.70652173913
22477,73,73168,81,"Tasa de exámenes médico legales por presunto delito sexual contra niños, niñas y adolescentes",2016,4,16,5798,275.957226629872,1,2963,33.7495781302734,15,2835,529.100529100529
22478,73,73168,121,Tasa de exámenes médico legales por presunto delito sexual cuando la víctima está entre 18 y 28 años,2016,5,2,9328,21.4408233276158,0,4660,0,2,4668,42.8449014567267
22479,73,73200,121,Tasa de exámenes médico legales por presunto delito sexual cuando la víctima está entre 18 y 28 años,2016,5,1,1719,58.173356602676,1,911,109.769484083425,0,808,0
22480,73,73217,81,"Tasa de exámenes médico legales por presunto delito sexual contra niños, niñas y adolescentes",2016,3,1,3681,27.1665308340125,0,1913,0,1,1768,56.5610859728507
22481,73,73217,81,"Tasa de exámenes médico legales por presunto delito sexual contra niños, niñas y adolescentes",2016,4,1,3440,29.0697674418605,0,1832,0,1,1608,62.1890547263682
22482,73,73226,81,"Tasa de exámenes médico legales por presunto delito sexual contra niños, niñas y adolescentes",2016,2,1,1008,99.2063492063492,0,519,0,1,489,204.498977505113
22483,73,73226,81,"Tasa de exámenes médico legales por presunto delito sexual contra niños, niñas y adolescentes",2016,3,1,1161,86.1326442721792,0,609,0,1,552,181.159420289855
22484,73,73226,81,"Tasa de exámenes médico legales por presunto delito sexual contra niños, niñas y adolescentes",2016,4,1,1048,95.4198473282443,0,559,0,1,489,204.498977505113
22485,73,73268,81,"Tasa de exámenes médico legales por presunto delito sexual contra niños, niñas y adolescentes",2016,2,3,6538,45.8855919241358,0,3317,0,3,3221,93.1387767773983
22486,73,73268,81,"Tasa de exámenes médico legales por presunto delito sexual contra niños, niñas y adolescentes",2016,3,6,8194,73.2243104710764,1,4220,23.696682464455,5,3974,125.817815802718
22487,73,73268,81,"Tasa de exámenes médico legales por presunto delito sexual contra niños, niñas y adolescentes",2016,4,21,8297,253.10353139689,1,4273,23.4027615258601,20,4024,497.017892644135
22488,73,73268,121,Tasa de exámenes médico legales por presunto delito sexual cuando la víctima está entre 18 y 28 años,2016,5,6,13965,42.9645542427497,2,7417,26.9650802211137,4,6548,61.0873549175321
22489,73,73275,81,"Tasa de exámenes médico legales por presunto delito sexual contra niños, niñas y adolescentes",2016,2,1,2403,41.6146483562214,0,1228,0,1,1175,85.1063829787234
22490,73,73275,81,"Tasa de exámenes médico legales por presunto delito sexual contra niños, niñas y adolescentes",2016,3,5,2985,167.50418760469,2,1536,130.208333333333,3,1449,207.03933747412
22491,73,73275,81,"Tasa de exámenes médico legales por presunto delito sexual contra niños, niñas y adolescentes",2016,4,2,3095,64.6203554119548,0,1600,0,2,1495,133.779264214047
22492,73,73275,121,Tasa de exámenes médico legales por presunto delito sexual cuando la víctima está entre 18 y 28 años,2016,5,1,5477,18.2581705313128,0,2805,0,1,2672,37.4251497005988
22493,73,73283,81,"Tasa de exámenes médico legales por presunto delito sexual contra niños, niñas y adolescentes",2016,4,3,3323,90.2798675895275,0,1749,0,3,1574,190.597204574333
22494,73,73283,121,Tasa de exámenes médico legales por presunto delito sexual cuando la víctima está entre 18 y 28 años,2016,5,2,5648,35.4107648725213,0,2953,0,2,2695,74.2115027829314
22495,73,73319,81,"Tasa de exámenes médico legales por presunto delito sexual contra niños, niñas y adolescentes",2016,2,1,2739,36.5096750638919,0,1394,0,1,1345,74.3494423791822
22496,73,73319,81,"Tasa de exámenes médico legales por presunto delito sexual contra niños, niñas y adolescentes",2016,3,3,3343,89.7397547113371,0,1695,0,3,1648,182.038834951456
22497,73,73319,81,"Tasa de exámenes médico legales por presunto delito sexual contra niños, niñas y adolescentes",2016,4,3,3309,90.6618313689937,1,1680,59.5238095238095,2,1629,122.774708410068
22498,73,73319,121,Tasa de exámenes médico legales por presunto delito sexual cuando la víctima está entre 18 y 28 años,2016,5,1,5685,17.5901495162709,0,2886,0,1,2799,35.7270453733476
22499,73,73347,81,"Tasa de exámenes médico legales por presunto delito sexual contra niños, niñas y adolescentes",2016,4,1,849,117.785630153121,0,441,0,1,408,245.098039215686
22500,73,73349,81,"Tasa de exámenes médico legales por presunto delito sexual contra niños, niñas y adolescentes",2016,2,1,1956,51.1247443762781,0,1011,0,1,945,105.820105820106
22501,73,73349,81,"Tasa de exámenes médico legales por presunto delito sexual contra niños, niñas y adolescentes",2016,3,2,2350,85.1063829787234,0,1188,0,2,1162,172.117039586919
22502,73,73349,81,"Tasa de exámenes médico legales por presunto delito sexual contra niños, niñas y adolescentes",2016,4,5,2560,195.3125,1,1426,70.1262272089762,4,1134,352.733686067019
22503,73,73349,121,Tasa de exámenes médico legales por presunto delito sexual cuando la víctima está entre 18 y 28 años,2016,5,1,5272,18.9681335356601,0,3148,0,1,2124,47.0809792843691
22504,73,73352,81,"Tasa de exámenes médico legales por presunto delito sexual contra niños, niñas y adolescentes",2016,4,2,1138,175.746924428823,0,582,0,2,556,359.712230215827
22505,73,73408,81,"Tasa de exámenes médico legales por presunto delito sexual contra niños, niñas y adolescentes",2016,2,1,1439,69.4927032661571,1,737,135.685210312076,0,702,0
22506,73,73408,81,"Tasa de exámenes médico legales por presunto delito sexual contra niños, niñas y adolescentes",2016,3,1,1754,57.0125427594071,0,894,0,1,860,116.279069767442
22507,73,73408,81,"Tasa de exámenes médico legales por presunto delito sexual contra niños, niñas y adolescentes",2016,4,2,1726,115.874855156431,0,881,0,2,845,236.686390532544
22508,73,73411,81,"Tasa de exámenes médico legales por presunto delito sexual contra niños, niñas y adolescentes",2016,3,10,4339,230.467849734962,3,2243,133.749442710655,7,2096,333.969465648855
22509,73,73411,81,"Tasa de exámenes médico legales por presunto delito sexual contra niños, niñas y adolescentes",2016,4,7,4264,164.165103189493,0,2215,0,7,2049,341.630063445583
22510,73,73411,121,Tasa de exámenes médico legales por presunto delito sexual cuando la víctima está entre 18 y 28 años,2016,5,3,7565,39.6563119629874,0,3888,0,3,3677,81.588251291814
22511,73,73443,81,"Tasa de exámenes médico legales por presunto delito sexual contra niños, niñas y adolescentes",2016,2,2,2820,70.9219858156028,1,1451,68.9179875947622,1,1369,73.0460189919649
22512,73,73443,81,"Tasa de exámenes médico legales por presunto delito sexual contra niños, niñas y adolescentes",2016,3,10,3455,289.435600578871,3,1768,169.683257918552,7,1687,414.9377593361
22513,73,73443,81,"Tasa de exámenes médico legales por presunto delito sexual contra niños, niñas y adolescentes",2016,4,11,3355,327.868852459016,0,1709,0,11,1646,668.286755771567
22514,73,73443,121,Tasa de exámenes médico legales por presunto delito sexual cuando la víctima está entre 18 y 28 años,2016,5,3,6160,48.7012987012987,0,3086,0,3,3074,97.5927130774236
22515,73,73449,81,"Tasa de exámenes médico legales por presunto delito sexual contra niños, niñas y adolescentes",2016,2,2,3172,63.0517023959647,1,1629,61.3873542050338,1,1543,64.8088139987038
22516,73,73449,81,"Tasa de exámenes médico legales por presunto delito sexual contra niños, niñas y adolescentes",2016,3,2,3950,50.6329113924051,2,2059,97.1345313258863,0,1891,0
22517,73,73449,81,"Tasa de exámenes médico legales por presunto delito sexual contra niños, niñas y adolescentes",2016,4,8,4135,193.470374848851,0,2174,0,8,1961,407.955124936257
22518,73,73449,121,Tasa de exámenes médico legales por presunto delito sexual cuando la víctima está entre 18 y 28 años,2016,5,3,6806,44.0787540405525,0,3659,0,3,3147,95.3288846520496
22519,73,73461,81,"Tasa de exámenes médico legales por presunto delito sexual contra niños, niñas y adolescentes",2016,3,1,620,161.290322580645,0,319,0,1,301,332.225913621262
22520,73,73483,81,"Tasa de exámenes médico legales por presunto delito sexual contra niños, niñas y adolescentes",2016,2,1,1832,54.5851528384279,0,943,0,1,889,112.485939257593
22521,73,73483,81,"Tasa de exámenes médico legales por presunto delito sexual contra niños, niñas y adolescentes",2016,3,1,2282,43.8212094653812,0,1178,0,1,1104,90.5797101449275
22522,73,73483,81,"Tasa de exámenes médico legales por presunto delito sexual contra niños, niñas y adolescentes",2016,4,7,2218,315.599639314698,4,1147,348.7358326068,3,1071,280.112044817927
22523,73,73483,121,Tasa de exámenes médico legales por presunto delito sexual cuando la víctima está entre 18 y 28 años,2016,5,1,3780,26.4550264550265,0,1918,0,1,1862,53.7056928034372
22524,73,73504,81,"Tasa de exámenes médico legales por presunto delito sexual contra niños, niñas y adolescentes",2016,2,3,3814,78.6575773466177,1,1940,51.5463917525773,2,1874,106.723585912487
22525,73,73504,81,"Tasa de exámenes médico legales por presunto delito sexual contra niños, niñas y adolescentes",2016,3,3,4092,73.3137829912023,1,2069,48.3325277912035,2,2023,98.8630746416213
22526,73,73504,81,"Tasa de exámenes médico legales por presunto delito sexual contra niños, niñas y adolescentes",2016,4,9,3738,240.770465489567,0,1904,0,9,1834,490.730643402399
22527,73,73504,121,Tasa de exámenes médico legales por presunto delito sexual cuando la víctima está entre 18 y 28 años,2016,5,1,6575,15.2091254752852,0,3485,0,1,3090,32.3624595469256
22528,73,73520,81,"Tasa de exámenes médico legales por presunto delito sexual contra niños, niñas y adolescentes",2016,2,2,858,233.100233100233,0,442,0,2,416,480.769230769231
22529,73,73520,81,"Tasa de exámenes médico legales por presunto delito sexual contra niños, niñas y adolescentes",2016,4,1,1009,99.1080277502478,0,531,0,1,478,209.205020920502
22530,73,73547,81,"Tasa de exámenes médico legales por presunto delito sexual contra niños, niñas y adolescentes",2016,3,2,676,295.85798816568,0,350,0,2,326,613.496932515337
22531,73,73555,81,"Tasa de exámenes médico legales por presunto delito sexual contra niños, niñas y adolescentes",2016,4,2,4033,49.5908752789487,0,2136,0,2,1897,105.429625724829
22532,73,73585,81,"Tasa de exámenes médico legales por presunto delito sexual contra niños, niñas y adolescentes",2016,4,2,2897,69.0369347600966,0,1498,0,2,1399,142.959256611866
22533,73,73616,81,"Tasa de exámenes médico legales por presunto delito sexual contra niños, niñas y adolescentes",2016,3,2,3485,57.3888091822095,0,1803,0,2,1682,118.906064209275
22534,73,73616,81,"Tasa de exámenes médico legales por presunto delito sexual contra niños, niñas y adolescentes",2016,4,1,3270,30.5810397553517,1,1716,58.2750582750583,0,1554,0
22535,73,73624,81,"Tasa de exámenes médico legales por presunto delito sexual contra niños, niñas y adolescentes",2016,4,3,2366,126.796280642435,0,1205,0,3,1161,258.397932816538
22536,73,73671,81,"Tasa de exámenes médico legales por presunto delito sexual contra niños, niñas y adolescentes",2016,3,2,1559,128.287363694676,0,816,0,2,743,269.179004037685
22537,73,73671,81,"Tasa de exámenes médico legales por presunto delito sexual contra niños, niñas y adolescentes",2016,4,3,1534,195.567144719687,0,798,0,3,736,407.608695652174
22538,73,73675,81,"Tasa de exámenes médico legales por presunto delito sexual contra niños, niñas y adolescentes",2016,4,1,1648,60.6796116504854,0,839,0,1,809,123.609394313968
22539,73,73854,81,"Tasa de exámenes médico legales por presunto delito sexual contra niños, niñas y adolescentes",2016,4,1,705,141.843971631206,0,367,0,1,338,295.85798816568
22540,73,73854,121,Tasa de exámenes médico legales por presunto delito sexual cuando la víctima está entre 18 y 28 años,2016,5,1,1122,89.126559714795,0,585,0,1,537,186.219739292365
22541,73,73861,81,"Tasa de exámenes médico legales por presunto delito sexual contra niños, niñas y adolescentes",2016,3,3,2220,135.135135135135,2,1173,170.502983802217,1,1047,95.5109837631328
22542,73,73870,81,"Tasa de exámenes médico legales por presunto delito sexual contra niños, niñas y adolescentes",2016,2,1,1044,95.7854406130268,0,538,0,1,506,197.628458498024
22543,73,73870,121,Tasa de exámenes médico legales por presunto delito sexual cuando la víctima está entre 18 y 28 años,2016,5,1,1972,50.709939148073,0,1073,0,1,899,111.234705228031
22544,73,73873,81,"Tasa de exámenes médico legales por presunto delito sexual contra niños, niñas y adolescentes",2016,4,1,549,182.149362477231,0,285,0,1,264,378.787878787879
22545,76,76001,81,"Tasa de exámenes médico legales por presunto delito sexual contra niños, niñas y adolescentes",2016,2,180,176657,101.892367695591,39,90334,43.1731131135564,141,86323,163.34001366959
22546,76,76001,81,"Tasa de exámenes médico legales por presunto delito sexual contra niños, niñas y adolescentes",2016,3,310,215250,144.018583042973,68,109333,62.1953115710719,242,105917,228.480791563205
22547,76,76001,81,"Tasa de exámenes médico legales por presunto delito sexual contra niños, niñas y adolescentes",2016,4,367,229278,160.067690750966,42,115881,36.2440779765449,325,113397,286.603702037973
22548,76,76001,121,Tasa de exámenes médico legales por presunto delito sexual cuando la víctima está entre 18 y 28 años,2016,5,78,447996,17.4108697399084,12,226528,5.29735838395254,66,221468,29.8011450864233
22549,76,76020,81,"Tasa de exámenes médico legales por presunto delito sexual contra niños, niñas y adolescentes",2016,2,1,1933,51.7330574236937,0,986,0,1,947,105.596620908131
22550,76,76020,81,"Tasa de exámenes médico legales por presunto delito sexual contra niños, niñas y adolescentes",2016,3,1,2170,46.0829493087558,1,1105,90.4977375565611,0,1065,0
22551,76,76020,81,"Tasa de exámenes médico legales por presunto delito sexual contra niños, niñas y adolescentes",2016,4,1,2239,44.6627958910228,0,1132,0,1,1107,90.3342366757001
22552,76,76036,81,"Tasa de exámenes médico legales por presunto delito sexual contra niños, niñas y adolescentes",2016,3,1,1534,65.1890482398957,1,790,126.582278481013,0,744,0
22553,76,76036,81,"Tasa de exámenes médico legales por presunto delito sexual contra niños, niñas y adolescentes",2016,4,1,1625,61.5384615384615,0,835,0,1,790,126.582278481013
22554,76,76041,81,"Tasa de exámenes médico legales por presunto delito sexual contra niños, niñas y adolescentes",2016,3,4,2024,197.628458498024,1,1028,97.2762645914397,3,996,301.204819277108
22555,76,76041,81,"Tasa de exámenes médico legales por presunto delito sexual contra niños, niñas y adolescentes",2016,4,2,1977,101.163378856854,0,1002,0,2,975,205.128205128205
22556,76,76041,121,Tasa de exámenes médico legales por presunto delito sexual cuando la víctima está entre 18 y 28 años,2016,5,2,3691,54.1858574911948,0,1916,0,2,1775,112.676056338028
22557,76,76054,81,"Tasa de exámenes médico legales por presunto delito sexual contra niños, niñas y adolescentes",2016,4,1,626,159.744408945687,0,332,0,1,294,340.136054421769
22558,76,76100,81,"Tasa de exámenes médico legales por presunto delito sexual contra niños, niñas y adolescentes",2016,2,2,1259,158.856235107228,0,642,0,2,617,324.149108589951
22559,76,76100,81,"Tasa de exámenes médico legales por presunto delito sexual contra niños, niñas y adolescentes",2016,3,1,1392,71.8390804597701,0,725,0,1,667,149.925037481259
22560,76,76100,121,Tasa de exámenes médico legales por presunto delito sexual cuando la víctima está entre 18 y 28 años,2016,5,1,2349,42.571306939123,0,1255,0,1,1094,91.4076782449726
22561,76,76109,81,"Tasa de exámenes médico legales por presunto delito sexual contra niños, niñas y adolescentes",2016,2,10,42816,23.355754857997,2,21935,9.11784818782767,8,20881,38.3123413629616
22562,76,76109,81,"Tasa de exámenes médico legales por presunto delito sexual contra niños, niñas y adolescentes",2016,3,31,47862,64.7695457774435,5,24396,20.4951631414986,26,23466,110.798602233018
22563,76,76109,81,"Tasa de exámenes médico legales por presunto delito sexual contra niños, niñas y adolescentes",2016,4,50,47054,106.260891741404,7,23813,29.3957082265989,43,23241,185.017856374511
22564,76,76109,121,Tasa de exámenes médico legales por presunto delito sexual cuando la víctima está entre 18 y 28 años,2016,5,22,83877,26.2288827688162,3,41802,7.17669011052103,19,42075,45.1574569221628
22565,76,76111,81,"Tasa de exámenes médico legales por presunto delito sexual contra niños, niñas y adolescentes",2016,2,13,7850,165.605095541401,5,4043,123.670541676973,8,3807,210.139217231416
22566,76,76111,81,"Tasa de exámenes médico legales por presunto delito sexual contra niños, niñas y adolescentes",2016,3,29,9444,307.073274036425,6,4886,122.799836266885,23,4558,504.607283896446
22567,76,76111,81,"Tasa de exámenes médico legales por presunto delito sexual contra niños, niñas y adolescentes",2016,4,21,9821,213.827512473272,1,5150,19.4174757281553,20,4671,428.173838578463
22568,76,76111,121,Tasa de exámenes médico legales por presunto delito sexual cuando la víctima está entre 18 y 28 años,2016,5,5,20358,24.5603693879556,0,10722,0,5,9636,51.8887505188875
22569,76,76113,81,"Tasa de exámenes médico legales por presunto delito sexual contra niños, niñas y adolescentes",2016,2,3,1590,188.679245283019,1,820,121.951219512195,2,770,259.74025974026
22570,76,76113,81,"Tasa de exámenes médico legales por presunto delito sexual contra niños, niñas y adolescentes",2016,3,3,1864,160.944206008584,1,977,102.354145342886,2,887,225.479143179256
22571,76,76113,81,"Tasa de exámenes médico legales por presunto delito sexual contra niños, niñas y adolescentes",2016,4,1,1893,52.8262017960909,1,1010,99.009900990099,0,883,0
22572,76,76122,81,"Tasa de exámenes médico legales por presunto delito sexual contra niños, niñas y adolescentes",2016,2,2,2322,86.1326442721792,0,1193,0,2,1129,177.147918511958
22573,76,76122,81,"Tasa de exámenes médico legales por presunto delito sexual contra niños, niñas y adolescentes",2016,3,4,2640,151.515151515152,1,1366,73.2064421669107,3,1274,235.478806907378
22574,76,76122,81,"Tasa de exámenes médico legales por presunto delito sexual contra niños, niñas y adolescentes",2016,4,6,2716,220.913107511046,1,1406,71.1237553342817,5,1310,381.679389312977
22575,76,76122,121,Tasa de exámenes médico legales por presunto delito sexual cuando la víctima está entre 18 y 28 años,2016,5,2,5537,36.1206429474445,1,2818,35.486160397445,1,2719,36.7782272894447
22576,76,76126,81,"Tasa de exámenes médico legales por presunto delito sexual contra niños, niñas y adolescentes",2016,3,3,1375,218.181818181818,0,702,0,3,673,445.765230312036
22577,76,76126,81,"Tasa de exámenes médico legales por presunto delito sexual contra niños, niñas y adolescentes",2016,4,10,1339,746.825989544436,0,681,0,10,658,1519.75683890578
22578,76,76130,81,"Tasa de exámenes médico legales por presunto delito sexual contra niños, niñas y adolescentes",2016,2,7,6096,114.829396325459,2,3131,63.8773554774832,5,2965,168.634064080944
22579,76,76130,81,"Tasa de exámenes médico legales por presunto delito sexual contra niños, niñas y adolescentes",2016,3,7,6887,101.640772469871,0,3571,0,7,3316,211.097708082027
22580,76,76130,81,"Tasa de exámenes médico legales por presunto delito sexual contra niños, niñas y adolescentes",2016,4,16,7195,222.376650451703,2,3751,53.3191149026926,14,3444,406.50406504065
22581,76,76130,121,Tasa de exámenes médico legales por presunto delito sexual cuando la víctima está entre 18 y 28 años,2016,5,3,15430,19.4426441996111,0,7706,0,3,7724,38.8399792853444
22582,76,76147,81,"Tasa de exámenes médico legales por presunto delito sexual contra niños, niñas y adolescentes",2016,2,13,9962,130.49588436057,2,5098,39.2310710082385,11,4864,226.151315789474
22583,76,76147,81,"Tasa de exámenes médico legales por presunto delito sexual contra niños, niñas y adolescentes",2016,3,13,11988,108.441775108442,1,6048,16.5343915343915,12,5940,202.020202020202
22584,76,76147,81,"Tasa de exámenes médico legales por presunto delito sexual contra niños, niñas y adolescentes",2016,4,19,11904,159.610215053763,1,6042,16.5508109897385,18,5862,307.062436028659
22585,76,76147,121,Tasa de exámenes médico legales por presunto delito sexual cuando la víctima está entre 18 y 28 años,2016,5,4,23356,17.1262202431923,0,11909,0,4,11447,34.9436533589587
22586,76,76233,81,"Tasa de exámenes médico legales por presunto delito sexual contra niños, niñas y adolescentes",2016,2,3,2954,101.55721056195,0,1514,0,3,1440,208.333333333333
22587,76,76233,81,"Tasa de exámenes médico legales por presunto delito sexual contra niños, niñas y adolescentes",2016,3,6,3247,184.785956267324,0,1660,0,6,1587,378.071833648393
22588,76,76233,81,"Tasa de exámenes médico legales por presunto delito sexual contra niños, niñas y adolescentes",2016,4,9,3156,285.171102661597,0,1618,0,9,1538,585.1755526658
22589,76,76233,121,Tasa de exámenes médico legales por presunto delito sexual cuando la víctima está entre 18 y 28 años,2016,5,8,6471,123.628496368413,0,3396,0,8,3075,260.162601626016
22590,76,76243,81,"Tasa de exámenes médico legales por presunto delito sexual contra niños, niñas y adolescentes",2016,3,3,1102,272.232304900182,1,569,175.746924428823,2,533,375.234521575985
22591,76,76243,81,"Tasa de exámenes médico legales por presunto delito sexual contra niños, niñas y adolescentes",2016,4,1,1079,92.678405931418,1,559,178.890876565295,0,520,0
22592,76,76246,81,"Tasa de exámenes médico legales por presunto delito sexual contra niños, niñas y adolescentes",2016,2,2,944,211.864406779661,2,485,412.371134020619,0,459,0
22593,76,76246,81,"Tasa de exámenes médico legales por presunto delito sexual contra niños, niñas y adolescentes",2016,3,1,1051,95.1474785918173,0,538,0,1,513,194.931773879142
22594,76,76246,81,"Tasa de exámenes médico legales por presunto delito sexual contra niños, niñas y adolescentes",2016,4,1,1012,98.8142292490119,0,515,0,1,497,201.207243460765
22595,76,76248,81,"Tasa de exámenes médico legales por presunto delito sexual contra niños, niñas y adolescentes",2016,2,1,4320,23.1481481481482,0,2211,0,1,2109,47.4158368895211
22596,76,76248,81,"Tasa de exámenes médico legales por presunto delito sexual contra niños, niñas y adolescentes",2016,3,5,5047,99.0687537150783,1,2581,38.7446726075165,4,2466,162.20600162206
22597,76,76248,81,"Tasa de exámenes médico legales por presunto delito sexual contra niños, niñas y adolescentes",2016,4,7,5099,137.281819964699,0,2572,0,7,2527,277.008310249308
22598,76,76250,81,"Tasa de exámenes médico legales por presunto delito sexual contra niños, niñas y adolescentes",2016,3,2,889,224.971878515186,0,454,0,2,435,459.770114942529
22599,76,76250,81,"Tasa de exámenes médico legales por presunto delito sexual contra niños, niñas y adolescentes",2016,4,1,832,120.192307692308,0,422,0,1,410,243.90243902439
22600,76,76275,81,"Tasa de exámenes médico legales por presunto delito sexual contra niños, niñas y adolescentes",2016,2,2,5098,39.2310710082385,0,2617,0,2,2481,80.6126561870214
22601,76,76275,81,"Tasa de exámenes médico legales por presunto delito sexual contra niños, niñas y adolescentes",2016,3,2,5837,34.2641768031523,0,2993,0,2,2844,70.323488045007
22602,76,76275,81,"Tasa de exámenes médico legales por presunto delito sexual contra niños, niñas y adolescentes",2016,4,8,5813,137.622570101497,0,2979,0,8,2834,282.286520818631
22603,76,76275,121,Tasa de exámenes médico legales por presunto delito sexual cuando la víctima está entre 18 y 28 años,2016,5,2,11090,18.034265103697,0,5557,0,2,5533,36.1467558286644
22604,76,76306,81,"Tasa de exámenes médico legales por presunto delito sexual contra niños, niñas y adolescentes",2016,2,5,1552,322.164948453608,1,792,126.262626262626,4,760,526.315789473684
22605,76,76306,81,"Tasa de exámenes médico legales por presunto delito sexual contra niños, niñas y adolescentes",2016,3,3,1724,174.013921113689,0,869,0,3,855,350.877192982456
22606,76,76306,81,"Tasa de exámenes médico legales por presunto delito sexual contra niños, niñas y adolescentes",2016,4,1,1682,59.4530321046373,1,840,119.047619047619,0,842,0
22607,76,76306,121,Tasa de exámenes médico legales por presunto delito sexual cuando la víctima está entre 18 y 28 años,2016,5,1,3742,26.7236771779797,0,1894,0,1,1848,54.1125541125541
22608,76,76318,81,"Tasa de exámenes médico legales por presunto delito sexual contra niños, niñas y adolescentes",2016,2,3,2676,112.107623318386,0,1360,0,3,1316,227.963525835866
22609,76,76318,81,"Tasa de exámenes médico legales por presunto delito sexual contra niños, niñas y adolescentes",2016,3,2,3090,64.7249190938511,0,1571,0,2,1519,131.665569453588
22610,76,76318,81,"Tasa de exámenes médico legales por presunto delito sexual contra niños, niñas y adolescentes",2016,4,4,3128,127.877237851662,1,1603,62.3830318153462,3,1525,196.72131147541
22611,76,76318,121,Tasa de exámenes médico legales por presunto delito sexual cuando la víctima está entre 18 y 28 años,2016,5,3,6365,47.132757266300104,0,3221,0,3,3144,95.4198473282443
22612,76,76364,81,"Tasa de exámenes médico legales por presunto delito sexual contra niños, niñas y adolescentes",2016,2,12,10095,118.87072808321,1,5167,19.3535900909619,11,4928,223.214285714286
22613,76,76364,81,"Tasa de exámenes médico legales por presunto delito sexual contra niños, niñas y adolescentes",2016,3,15,11803,127.086333982886,2,6085,32.8677074774035,13,5718,227.352221056313
22614,76,76364,81,"Tasa de exámenes médico legales por presunto delito sexual contra niños, niñas y adolescentes",2016,4,19,12310,154.346060113729,2,6321,31.640563202025,17,5989,283.85373184171
22615,76,76364,121,Tasa de exámenes médico legales por presunto delito sexual cuando la víctima está entre 18 y 28 años,2016,5,9,23591,38.1501420033064,0,11911,0,9,11680,77.0547945205479
22616,76,76377,81,"Tasa de exámenes médico legales por presunto delito sexual contra niños, niñas y adolescentes",2016,2,1,871,114.810562571757,0,453,0,1,418,239.234449760766
22617,76,76377,81,"Tasa de exámenes médico legales por presunto delito sexual contra niños, niñas y adolescentes",2016,3,1,1017,98.3284169124877,0,532,0,1,485,206.185567010309
22618,76,76377,81,"Tasa de exámenes médico legales por presunto delito sexual contra niños, niñas y adolescentes",2016,4,5,981,509.683995922528,1,516,193.798449612403,4,465,860.215053763441
22619,76,76377,121,Tasa de exámenes médico legales por presunto delito sexual cuando la víctima está entre 18 y 28 años,2016,5,1,2032,49.2125984251969,0,1082,0,1,950,105.263157894737
22620,76,76400,81,"Tasa de exámenes médico legales por presunto delito sexual contra niños, niñas y adolescentes",2016,2,5,3084,162.1271076524,2,1570,127.388535031847,3,1514,198.150594451783
22621,76,76400,81,"Tasa de exámenes médico legales por presunto delito sexual contra niños, niñas y adolescentes",2016,3,10,3586,278.862242052426,3,1858,161.463939720129,7,1728,405.092592592593
22622,76,76400,81,"Tasa de exámenes médico legales por presunto delito sexual contra niños, niñas y adolescentes",2016,4,5,3533,141.522785168412,1,1811,55.2181115405853,4,1722,232.288037166086
22623,76,76400,121,Tasa de exámenes médico legales por presunto delito sexual cuando la víctima está entre 18 y 28 años,2016,5,1,7077,14.1302811925957,0,3597,0,1,3480,28.735632183908
22624,76,76403,81,"Tasa de exámenes médico legales por presunto delito sexual contra niños, niñas y adolescentes",2016,2,1,939,106.496272630458,0,489,0,1,450,222.222222222222
22625,76,76403,81,"Tasa de exámenes médico legales por presunto delito sexual contra niños, niñas y adolescentes",2016,4,2,1131,176.83465959328,0,607,0,2,524,381.679389312977
22626,76,76497,81,"Tasa de exámenes médico legales por presunto delito sexual contra niños, niñas y adolescentes",2016,2,1,1445,69.204152249135,0,744,0,1,701,142.65335235378
22627,76,76497,121,Tasa de exámenes médico legales por presunto delito sexual cuando la víctima está entre 18 y 28 años,2016,5,1,2921,34.2348510783978,1,1516,65.9630606860158,0,1405,0
22628,76,76520,81,"Tasa de exámenes médico legales por presunto delito sexual contra niños, niñas y adolescentes",2016,2,17,21004,80.9369643877357,3,10716,27.9955207166853,14,10288,136.080870917574
22629,76,76520,81,"Tasa de exámenes médico legales por presunto delito sexual contra niños, niñas y adolescentes",2016,3,42,25346,165.706620374024,12,12974,92.4926776630183,30,12372,242.483026188167
22630,76,76520,81,"Tasa de exámenes médico legales por presunto delito sexual contra niños, niñas y adolescentes",2016,4,45,27013,166.586458371895,4,13911,28.7542232765437,41,13102,312.929323767364
22631,76,76520,121,Tasa de exámenes médico legales por presunto delito sexual cuando la víctima está entre 18 y 28 años,2016,5,18,56506,31.8550242452129,1,28871,3.4636832808008,17,27635,61.5161932332187
22632,76,76563,81,"Tasa de exámenes médico legales por presunto delito sexual contra niños, niñas y adolescentes",2016,2,2,5341,37.4461711290021,0,2741,0,2,2600,76.9230769230769
22633,76,76563,81,"Tasa de exámenes médico legales por presunto delito sexual contra niños, niñas y adolescentes",2016,3,4,6043,66.1922885983783,2,3108,64.3500643500643,2,2935,68.1431005110733
22634,76,76563,81,"Tasa de exámenes médico legales por presunto delito sexual contra niños, niñas y adolescentes",2016,4,3,5898,50.8646998982706,0,3021,0,3,2877,104.275286757039
22635,76,76606,81,"Tasa de exámenes médico legales por presunto delito sexual contra niños, niñas y adolescentes",2016,3,1,1556,64.26735218509,0,807,0,1,749,133.51134846462
22636,76,76616,81,"Tasa de exámenes médico legales por presunto delito sexual contra niños, niñas y adolescentes",2016,2,2,1198,166.944908180301,1,622,160.771704180064,1,576,173.611111111111
22637,76,76616,81,"Tasa de exámenes médico legales por presunto delito sexual contra niños, niñas y adolescentes",2016,3,3,1357,221.075902726603,0,718,0,3,639,469.483568075117
22638,76,76616,81,"Tasa de exámenes médico legales por presunto delito sexual contra niños, niñas y adolescentes",2016,4,1,1252,79.8722044728435,0,664,0,1,588,170.068027210884
22639,76,76622,81,"Tasa de exámenes médico legales por presunto delito sexual contra niños, niñas y adolescentes",2016,2,1,2576,38.8198757763975,1,1319,75.8150113722517,0,1257,0
22640,76,76622,81,"Tasa de exámenes médico legales por presunto delito sexual contra niños, niñas y adolescentes",2016,3,1,2940,34.0136054421769,0,1514,0,1,1426,70.1262272089762
22641,76,76622,81,"Tasa de exámenes médico legales por presunto delito sexual contra niños, niñas y adolescentes",2016,4,8,2962,270.087778528022,0,1534,0,8,1428,560.224089635854
22642,76,76622,121,Tasa de exámenes médico legales por presunto delito sexual cuando la víctima está entre 18 y 28 años,2016,5,2,5782,34.5901072293324,0,2900,0,2,2882,69.3962526023595
22643,76,76670,81,"Tasa de exámenes médico legales por presunto delito sexual contra niños, niñas y adolescentes",2016,2,1,1376,72.6744186046512,1,717,139.470013947001,0,659,0
22644,76,76670,81,"Tasa de exámenes médico legales por presunto delito sexual contra niños, niñas y adolescentes",2016,3,1,1590,62.8930817610063,0,848,0,1,742,134.770889487871
22645,76,76670,81,"Tasa de exámenes médico legales por presunto delito sexual contra niños, niñas y adolescentes",2016,4,1,1724,58.0046403712297,0,938,0,1,786,127.226463104326
22646,76,76670,121,Tasa de exámenes médico legales por presunto delito sexual cuando la víctima está entre 18 y 28 años,2016,5,1,3408,29.3427230046948,0,1821,0,1,1587,63.0119722747322
22647,76,76736,81,"Tasa de exámenes médico legales por presunto delito sexual contra niños, niñas y adolescentes",2016,2,1,3607,27.7238702522872,0,1858,0,1,1749,57.1755288736421
22648,76,76736,81,"Tasa de exámenes médico legales por presunto delito sexual contra niños, niñas y adolescentes",2016,3,10,4303,232.396002788752,3,2316,129.533678756477,7,1987,352.289884247609
22649,76,76736,81,"Tasa de exámenes médico legales por presunto delito sexual contra niños, niñas y adolescentes",2016,4,9,4249,211.814544598729,2,2314,86.4304235090752,7,1935,361.757105943152
22650,76,76823,81,"Tasa de exámenes médico legales por presunto delito sexual contra niños, niñas y adolescentes",2016,3,3,1733,173.110213502597,1,897,111.482720178372,2,836,239.234449760766
22651,76,76823,81,"Tasa de exámenes médico legales por presunto delito sexual contra niños, niñas y adolescentes",2016,4,3,1698,176.678445229682,0,878,0,3,820,365.853658536585
22652,76,76828,81,"Tasa de exámenes médico legales por presunto delito sexual contra niños, niñas y adolescentes",2016,2,1,1637,61.0873549175321,1,845,118.343195266272,0,792,0
22653,76,76828,81,"Tasa de exámenes médico legales por presunto delito sexual contra niños, niñas y adolescentes",2016,3,2,1894,105.596620908131,0,981,0,2,913,219.058050383352
22654,76,76828,81,"Tasa de exámenes médico legales por presunto delito sexual contra niños, niñas y adolescentes",2016,4,3,1746,171.821305841924,0,911,0,3,835,359.281437125749
22655,76,76834,81,"Tasa de exámenes médico legales por presunto delito sexual contra niños, niñas y adolescentes",2016,2,16,16223,98.6254083708316,4,8344,47.9386385426654,12,7879,152.303591826374
22656,76,76834,81,"Tasa de exámenes médico legales por presunto delito sexual contra niños, niñas y adolescentes",2016,3,29,19239,150.735485212329,6,9886,60.6918875177018,23,9353,245.910403079226
22657,76,76834,81,"Tasa de exámenes médico legales por presunto delito sexual contra niños, niñas y adolescentes",2016,4,29,19716,147.088658957192,3,10148,29.5624753646039,26,9568,271.739130434783
22658,76,76834,121,Tasa de exámenes médico legales por presunto delito sexual cuando la víctima está entre 18 y 28 años,2016,5,5,40058,12.4819012431974,0,20347,0,5,19711,25.3665465983461
22659,76,76834,81,"Tasa de exámenes médico legales por presunto delito sexual contra niños, niñas y adolescentes",2016,1,1,3272,30.5623471882641,0,1672,0,1,1600,62.5
22660,76,76863,81,"Tasa de exámenes médico legales por presunto delito sexual contra niños, niñas y adolescentes",2016,3,3,675,444.444444444444,2,348,574.712643678161,1,327,305.810397553517
22661,76,76863,81,"Tasa de exámenes médico legales por presunto delito sexual contra niños, niñas y adolescentes",2016,4,1,643,155.52099533437,0,338,0,1,305,327.868852459016
22662,76,76869,81,"Tasa de exámenes médico legales por presunto delito sexual contra niños, niñas y adolescentes",2016,2,1,858,116.550116550117,0,435,0,1,423,236.406619385343
22663,76,76869,81,"Tasa de exámenes médico legales por presunto delito sexual contra niños, niñas y adolescentes",2016,3,2,992,201.612903225806,0,505,0,2,487,410.677618069815
22664,76,76869,81,"Tasa de exámenes médico legales por presunto delito sexual contra niños, niñas y adolescentes",2016,4,1,913,109.529025191676,0,469,0,1,444,225.225225225225
22665,76,76869,121,Tasa de exámenes médico legales por presunto delito sexual cuando la víctima está entre 18 y 28 años,2016,5,1,1872,53.4188034188034,0,980,0,1,892,112.107623318386
22666,76,76890,81,"Tasa de exámenes médico legales por presunto delito sexual contra niños, niñas y adolescentes",2016,2,2,1228,162.866449511401,0,636,0,2,592,337.837837837838
22667,76,76890,81,"Tasa de exámenes médico legales por presunto delito sexual contra niños, niñas y adolescentes",2016,3,5,1409,354.86160397445,3,738,406.50406504065,2,671,298.06259314456
22668,76,76890,81,"Tasa de exámenes médico legales por presunto delito sexual contra niños, niñas y adolescentes",2016,4,7,1478,473.61299052774,0,783,0,7,695,1007.19424460432
22669,76,76892,81,"Tasa de exámenes médico legales por presunto delito sexual contra niños, niñas y adolescentes",2016,2,9,9414,95.6022944550669,0,4827,0,9,4587,196.206671026815
22670,76,76892,81,"Tasa de exámenes médico legales por presunto delito sexual contra niños, niñas y adolescentes",2016,3,29,11057,262.277290404269,3,5651,53.0879490355689,26,5406,480.94709581946
22671,76,76892,81,"Tasa de exámenes médico legales por presunto delito sexual contra niños, niñas y adolescentes",2016,4,20,11477,174.261566611484,3,5941,50.4965494024575,17,5536,307.080924855491
22672,76,76892,121,Tasa de exámenes médico legales por presunto delito sexual cuando la víctima está entre 18 y 28 años,2016,5,1,22803,4.38538788755866,0,11835,0,1,10968,9.11743253099927
22673,76,76895,81,"Tasa de exámenes médico legales por presunto delito sexual contra niños, niñas y adolescentes",2016,2,2,3643,54.8998078506725,0,1860,0,2,1783,112.170499158721
22674,76,76895,81,"Tasa de exámenes médico legales por presunto delito sexual contra niños, niñas y adolescentes",2016,3,2,4255,47.0035252643948,0,2179,0,2,2076,96.3391136801541
22675,76,76895,81,"Tasa de exámenes médico legales por presunto delito sexual contra niños, niñas y adolescentes",2016,4,9,4271,210.723483961602,1,2148,46.5549348230912,8,2123,376.825247291569
22676,76,76895,121,Tasa de exámenes médico legales por presunto delito sexual cuando la víctima está entre 18 y 28 años,2016,5,1,8283,12.0729204394543,0,4136,0,1,4147,24.1138172172655
22677,8,8001,81,"Tasa de exámenes médico legales por presunto delito sexual contra niños, niñas y adolescentes",2016,2,76,96512,78.7466843501326,18,49346,36.4771207392696,58,47166,122.969935970826
22678,8,8001,81,"Tasa de exámenes médico legales por presunto delito sexual contra niños, niñas y adolescentes",2016,3,172,119013,144.522027005453,31,60782,51.0019413642197,141,58231,242.139066820079
22679,8,8001,81,"Tasa de exámenes médico legales por presunto delito sexual contra niños, niñas y adolescentes",2016,4,258,121898,211.652365092126,18,62077,28.9962465969683,240,59821,401.196904097223
22680,8,8001,121,Tasa de exámenes médico legales por presunto delito sexual cuando la víctima está entre 18 y 28 años,2016,5,66,223178,29.5728073555637,5,113819,4.39293966736661,61,109359,55.7795883283497
22681,8,8078,81,"Tasa de exámenes médico legales por presunto delito sexual contra niños, niñas y adolescentes",2016,2,5,5167,96.7679504548094,1,2636,37.9362670713202,4,2531,158.040300276571
22682,8,8078,81,"Tasa de exámenes médico legales por presunto delito sexual contra niños, niñas y adolescentes",2016,3,8,6075,131.687242798354,2,3107,64.3707756678468,6,2968,202.156334231806
22683,8,8078,81,"Tasa de exámenes médico legales por presunto delito sexual contra niños, niñas y adolescentes",2016,4,12,5974,200.870438567124,0,3055,0,12,2919,411.099691675231
22684,8,8078,121,Tasa de exámenes médico legales por presunto delito sexual cuando la víctima está entre 18 y 28 años,2016,5,1,10692,9.35278713056491,0,5529,0,1,5163,19.3685841564982
22685,8,8137,81,"Tasa de exámenes médico legales por presunto delito sexual contra niños, niñas y adolescentes",2016,3,2,2199,90.9504320145521,0,1135,0,2,1064,187.96992481203
22686,8,8141,81,"Tasa de exámenes médico legales por presunto delito sexual contra niños, niñas y adolescentes",2016,3,2,1553,128.783000643915,0,828,0,2,725,275.862068965517
22687,8,8141,121,Tasa de exámenes médico legales por presunto delito sexual cuando la víctima está entre 18 y 28 años,2016,5,1,2514,39.7772474144789,0,1344,0,1,1170,85.4700854700855
22688,8,8296,81,"Tasa de exámenes médico legales por presunto delito sexual contra niños, niñas y adolescentes",2016,2,1,4355,22.9621125143513,0,2237,0,1,2118,47.2143531633617
22689,8,8296,81,"Tasa de exámenes médico legales por presunto delito sexual contra niños, niñas y adolescentes",2016,3,9,5204,172.943889315911,2,2696,74.1839762611276,7,2508,279.106858054226
22690,8,8296,81,"Tasa de exámenes médico legales por presunto delito sexual contra niños, niñas y adolescentes",2016,4,5,5140,97.2762645914397,0,2672,0,5,2468,202.59319286872
22691,8,8296,121,Tasa de exámenes médico legales por presunto delito sexual cuando la víctima está entre 18 y 28 años,2016,5,2,8484,23.5737859500236,0,4386,0,2,4098,48.8042947779405
22692,8,8372,81,"Tasa de exámenes médico legales por presunto delito sexual contra niños, niñas y adolescentes",2016,4,3,1827,164.203612479475,0,978,0,3,849,353.356890459364
22693,8,8421,81,"Tasa de exámenes médico legales por presunto delito sexual contra niños, niñas y adolescentes",2016,2,2,2851,70.1508242721852,0,1464,0,2,1387,144.196106705119
22694,8,8421,81,"Tasa de exámenes médico legales por presunto delito sexual contra niños, niñas y adolescentes",2016,4,4,2975,134.453781512605,0,1508,0,4,1467,272.66530334015
22695,8,8421,121,Tasa de exámenes médico legales por presunto delito sexual cuando la víctima está entre 18 y 28 años,2016,5,1,5182,19.2975685063682,0,2645,0,1,2537,39.4166338194718
22696,8,8433,81,"Tasa de exámenes médico legales por presunto delito sexual contra niños, niñas y adolescentes",2016,2,7,11910,58.7741393786734,1,6125,16.3265306122449,6,5785,103.71650821089
22697,8,8433,81,"Tasa de exámenes médico legales por presunto delito sexual contra niños, niñas y adolescentes",2016,3,24,13879,172.923121262339,4,7128,56.1167227833895,20,6751,296.252407050807
22698,8,8433,81,"Tasa de exámenes médico legales por presunto delito sexual contra niños, niñas y adolescentes",2016,4,24,13640,175.95307917888599,4,6975,57.3476702508961,20,6665,300.075018754689
22699,8,8433,121,Tasa de exámenes médico legales por presunto delito sexual cuando la víctima está entre 18 y 28 años,2016,5,2,24116,8.29324929507381,0,12709,0,2,11407,17.5330937143859
22700,8,8436,81,"Tasa de exámenes médico legales por presunto delito sexual contra niños, niñas y adolescentes",2016,4,1,1454,68.7757909215956,0,765,0,1,689,145.137880986938
22701,8,8520,81,"Tasa de exámenes médico legales por presunto delito sexual contra niños, niñas y adolescentes",2016,2,3,2266,132.391879964696,0,1174,0,3,1092,274.725274725275
22702,8,8520,81,"Tasa de exámenes médico legales por presunto delito sexual contra niños, niñas y adolescentes",2016,3,4,2719,147.112909157779,0,1419,0,4,1300,307.692307692308
22703,8,8520,81,"Tasa de exámenes médico legales por presunto delito sexual contra niños, niñas y adolescentes",2016,4,6,2798,214.438884917798,1,1457,68.6341798215511,5,1341,372.856077554064
22704,8,8520,121,Tasa de exámenes médico legales por presunto delito sexual cuando la víctima está entre 18 y 28 años,2016,5,1,5078,19.6927924379677,0,2655,0,1,2423,41.2711514651259
22705,8,8549,81,"Tasa de exámenes médico legales por presunto delito sexual contra niños, niñas y adolescentes",2016,2,1,553,180.831826401447,0,281,0,1,272,367.647058823529
22706,8,8558,81,"Tasa de exámenes médico legales por presunto delito sexual contra niños, niñas y adolescentes",2016,2,1,1373,72.8332119446468,1,707,141.442715700141,0,666,0
22707,8,8558,81,"Tasa de exámenes médico legales por presunto delito sexual contra niños, niñas y adolescentes",2016,3,3,1611,186.219739292365,1,835,119.760479041916,2,776,257.731958762887
22708,8,8558,81,"Tasa de exámenes médico legales por presunto delito sexual contra niños, niñas y adolescentes",2016,4,5,1581,316.255534471853,1,817,122.399020807834,4,764,523.560209424084
22709,8,8560,81,"Tasa de exámenes médico legales por presunto delito sexual contra niños, niñas y adolescentes",2016,2,1,2382,41.9815281276239,0,1217,0,1,1165,85.8369098712446
22710,8,8560,81,"Tasa de exámenes médico legales por presunto delito sexual contra niños, niñas y adolescentes",2016,3,1,2759,36.2450163102573,1,1419,70.4721634954193,0,1340,0
22711,8,8560,81,"Tasa de exámenes médico legales por presunto delito sexual contra niños, niñas y adolescentes",2016,4,3,2586,116.009280742459,0,1338,0,3,1248,240.384615384615
22712,8,8560,121,Tasa de exámenes médico legales por presunto delito sexual cuando la víctima está entre 18 y 28 años,2016,5,1,4302,23.2450023245002,0,2268,0,1,2034,49.1642084562439
22713,8,8573,81,"Tasa de exámenes médico legales por presunto delito sexual contra niños, niñas y adolescentes",2016,2,3,2138,140.318054256314,1,1110,90.0900900900901,2,1028,194.552529182879
22714,8,8573,81,"Tasa de exámenes médico legales por presunto delito sexual contra niños, niñas y adolescentes",2016,3,11,2569,428.182172051382,1,1355,73.8007380073801,10,1214,823.723228995058
22715,8,8573,81,"Tasa de exámenes médico legales por presunto delito sexual contra niños, niñas y adolescentes",2016,4,12,2703,443.951165371809,1,1451,68.9179875947622,11,1252,878.594249201278
22716,8,8573,121,Tasa de exámenes médico legales por presunto delito sexual cuando la víctima está entre 18 y 28 años,2016,5,2,5040,39.6825396825397,0,2677,0,2,2363,84.6381718154888
22717,8,8606,81,"Tasa de exámenes médico legales por presunto delito sexual contra niños, niñas y adolescentes",2016,3,1,3247,30.7976593778873,0,1646,0,1,1601,62.4609618988132
22718,8,8606,81,"Tasa de exámenes médico legales por presunto delito sexual contra niños, niñas y adolescentes",2016,4,6,3047,196.914998359042,0,1541,0,6,1506,398.406374501992
22719,8,8606,121,Tasa de exámenes médico legales por presunto delito sexual cuando la víctima está entre 18 y 28 años,2016,5,2,5277,37.9003221527383,0,2695,0,2,2582,77.4593338497289
22720,8,8634,81,"Tasa de exámenes médico legales por presunto delito sexual contra niños, niñas y adolescentes",2016,2,2,2843,70.3482237073514,1,1440,69.4444444444444,1,1403,71.2758374910905
22721,8,8634,81,"Tasa de exámenes médico legales por presunto delito sexual contra niños, niñas y adolescentes",2016,3,2,3268,61.1995104039168,0,1652,0,2,1616,123.762376237624
22722,8,8634,81,"Tasa de exámenes médico legales por presunto delito sexual contra niños, niñas y adolescentes",2016,4,5,3393,147.362216327734,0,1747,0,5,1646,303.766707168894
22723,8,8634,121,Tasa de exámenes médico legales por presunto delito sexual cuando la víctima está entre 18 y 28 años,2016,5,1,6291,15.8957240502305,0,3357,0,1,2934,34.0831629175188
22724,8,8638,81,"Tasa de exámenes médico legales por presunto delito sexual contra niños, niñas y adolescentes",2016,2,4,9834,40.6752084604434,1,5059,19.7667523225934,3,4775,62.8272251308901
22725,8,8638,81,"Tasa de exámenes médico legales por presunto delito sexual contra niños, niñas y adolescentes",2016,3,11,11691,94.0894705328885,6,6057,99.0589400693413,5,5634,88.746893858715
22726,8,8638,81,"Tasa de exámenes médico legales por presunto delito sexual contra niños, niñas y adolescentes",2016,4,15,11087,135.293587083972,2,5744,34.8189415041783,13,5343,243.30900243309
22727,8,8638,121,Tasa de exámenes médico legales por presunto delito sexual cuando la víctima está entre 18 y 28 años,2016,5,3,18158,16.5216433527922,1,9293,10.7607876896589,2,8865,22.5606316976875
22728,8,8675,81,"Tasa de exámenes médico legales por presunto delito sexual contra niños, niñas y adolescentes",2016,4,1,1446,69.1562932226833,0,744,0,1,702,142.450142450142
22729,8,8685,81,"Tasa de exámenes médico legales por presunto delito sexual contra niños, niñas y adolescentes",2016,3,1,2450,40.8163265306122,0,1247,0,1,1203,83.1255195344971
22730,8,8685,81,"Tasa de exámenes médico legales por presunto delito sexual contra niños, niñas y adolescentes",2016,4,7,2591,270.165959089155,0,1316,0,7,1275,549.019607843137
22731,8,8758,81,"Tasa de exámenes médico legales por presunto delito sexual contra niños, niñas y adolescentes",2016,2,29,57657,50.2974487052743,3,29465,10.1815713558459,26,28192,92.2247446083996
22732,8,8758,81,"Tasa de exámenes médico legales por presunto delito sexual contra niños, niñas y adolescentes",2016,3,45,69087,65.1352642320552,6,35200,17.0454545454545,39,33887,115.088381975389
22733,8,8758,81,"Tasa de exámenes médico legales por presunto delito sexual contra niños, niñas y adolescentes",2016,4,82,69738,117.582953339643,7,35493,19.7221987434142,75,34245,219.010074463425
22734,8,8758,121,Tasa de exámenes médico legales por presunto delito sexual cuando la víctima está entre 18 y 28 años,2016,5,14,122482,11.4302509756536,0,62475,0,14,60007,23.3306114286667
22735,8,8758,81,"Tasa de exámenes médico legales por presunto delito sexual contra niños, niñas y adolescentes",2016,1,1,11730,8.52514919011083,0,6001,0,1,5729,17.4550532379124
22736,8,8770,81,"Tasa de exámenes médico legales por presunto delito sexual contra niños, niñas y adolescentes",2016,4,1,940,106.382978723404,1,482,207.46887966805,0,458,0
22737,8,8832,81,"Tasa de exámenes médico legales por presunto delito sexual contra niños, niñas y adolescentes",2016,3,3,1108,270.758122743682,0,573,0,3,535,560.747663551402
22738,8,8832,81,"Tasa de exámenes médico legales por presunto delito sexual contra niños, niñas y adolescentes",2016,4,1,1105,90.4977375565611,0,578,0,1,527,189.753320683112
22739,8,8849,81,"Tasa de exámenes médico legales por presunto delito sexual contra niños, niñas y adolescentes",2016,3,2,1016,196.850393700787,0,517,0,2,499,400.801603206413
22740,8,8849,81,"Tasa de exámenes médico legales por presunto delito sexual contra niños, niñas y adolescentes",2016,4,3,967,310.23784901758,0,496,0,3,471,636.942675159236
22741,81,81001,81,"Tasa de exámenes médico legales por presunto delito sexual contra niños, niñas y adolescentes",2016,2,20,10961,182.465103548946,5,5542,90.2201371346085,15,5419,276.803838346558
22742,81,81001,81,"Tasa de exámenes médico legales por presunto delito sexual contra niños, niñas y adolescentes",2016,3,34,13590,250.18395879323,6,6852,87.5656742556918,28,6738,415.553576729
22743,81,81001,81,"Tasa de exámenes médico legales por presunto delito sexual contra niños, niñas y adolescentes",2016,4,42,12038,348.895165309852,2,5962,33.5457900033546,40,6076,658.327847267939
22744,81,81001,121,Tasa de exámenes médico legales por presunto delito sexual cuando la víctima está entre 18 y 28 años,2016,5,4,15756,25.3871541000254,0,7424,0,4,8332,48.0076812289966
22745,81,81001,81,"Tasa de exámenes médico legales por presunto delito sexual contra niños, niñas y adolescentes",2016,1,2,2260,88.4955752212389,0,1151,0,2,1109,180.34265103697
22746,81,81065,81,"Tasa de exámenes médico legales por presunto delito sexual contra niños, niñas y adolescentes",2016,2,3,5201,57.6812151509325,0,2638,0,3,2563,117.050331642606
22747,81,81065,81,"Tasa de exámenes médico legales por presunto delito sexual contra niños, niñas y adolescentes",2016,3,13,6024,215.803452855246,3,3059,98.0712651193201,10,2965,337.268128161889
22748,81,81065,81,"Tasa de exámenes médico legales por presunto delito sexual contra niños, niñas y adolescentes",2016,4,13,5713,227.551199019779,0,2918,0,13,2795,465.116279069767
22749,81,81065,121,Tasa de exámenes médico legales por presunto delito sexual cuando la víctima está entre 18 y 28 años,2016,5,3,7797,38.4763370527126,0,3872,0,3,3925,76.4331210191083
22750,81,81220,81,"Tasa de exámenes médico legales por presunto delito sexual contra niños, niñas y adolescentes",2016,3,1,478,209.205020920502,1,241,414.9377593361,0,237,0
22751,81,81220,81,"Tasa de exámenes médico legales por presunto delito sexual contra niños, niñas y adolescentes",2016,4,1,451,221.729490022173,0,224,0,1,227,440.528634361234
22752,81,81300,81,"Tasa de exámenes médico legales por presunto delito sexual contra niños, niñas y adolescentes",2016,3,3,3741,80.1924619085806,1,1875,53.3333333333333,2,1866,107.181136120043
22753,81,81300,81,"Tasa de exámenes médico legales por presunto delito sexual contra niños, niñas y adolescentes",2016,4,5,3519,142.08581983518,0,1739,0,5,1780,280.898876404494
22754,81,81591,81,"Tasa de exámenes médico legales por presunto delito sexual contra niños, niñas y adolescentes",2016,3,1,526,190.114068441065,0,264,0,1,262,381.679389312977
22755,81,81591,121,Tasa de exámenes médico legales por presunto delito sexual cuando la víctima está entre 18 y 28 años,2016,5,1,855,116.959064327485,0,486,0,1,369,271.0027100271
22756,81,81736,81,"Tasa de exámenes médico legales por presunto delito sexual contra niños, niñas y adolescentes",2016,2,5,6067,82.4130542277897,1,3091,32.3519896473633,4,2976,134.408602150538
22757,81,81736,81,"Tasa de exámenes médico legales por presunto delito sexual contra niños, niñas y adolescentes",2016,3,7,6700,104.477611940299,2,3380,59.1715976331361,5,3320,150.602409638554
22758,81,81736,81,"Tasa de exámenes médico legales por presunto delito sexual contra niños, niñas y adolescentes",2016,4,9,6626,135.828554180501,0,3417,0,9,3209,280.461202866937
22759,81,81736,121,Tasa de exámenes médico legales por presunto delito sexual cuando la víctima está entre 18 y 28 años,2016,5,2,10016,19.9680511182109,0,5324,0,2,4692,42.6257459505541
22760,81,81794,81,"Tasa de exámenes médico legales por presunto delito sexual contra niños, niñas y adolescentes",2016,2,7,6525,107.27969348659,1,3373,29.6471983397569,6,3152,190.355329949239
22761,81,81794,81,"Tasa de exámenes médico legales por presunto delito sexual contra niños, niñas y adolescentes",2016,3,24,7371,325.600325600326,5,3851,129.836406128278,19,3520,539.772727272727
22762,81,81794,81,"Tasa de exámenes médico legales por presunto delito sexual contra niños, niñas y adolescentes",2016,4,14,6978,200.630553167097,1,3650,27.3972602739726,13,3328,390625
22763,81,81794,121,Tasa de exámenes médico legales por presunto delito sexual cuando la víctima está entre 18 y 28 años,2016,5,3,10533,28.4819139846198,0,5634,0,3,4899,61.2369871402327
22764,85,85001,81,"Tasa de exámenes médico legales por presunto delito sexual contra niños, niñas y adolescentes",2016,2,15,13273,113.011376478566,1,6788,14.7318797878609,14,6485,215.882806476484
22765,85,85001,81,"Tasa de exámenes médico legales por presunto delito sexual contra niños, niñas y adolescentes",2016,3,48,16696,287.494010541447,13,8596,151.233131689158,35,8100,432.098765432099
22766,85,85001,81,"Tasa de exámenes médico legales por presunto delito sexual contra niños, niñas y adolescentes",2016,4,54,17003,317.591013350585,2,8643,23.1401133865556,52,8360,622.009569377991
22767,85,85001,121,Tasa de exámenes médico legales por presunto delito sexual cuando la víctima está entre 18 y 28 años,2016,5,11,29048,37.8683558248416,0,14356,0,11,14692,74.8706779199564
22768,85,85010,81,"Tasa de exámenes médico legales por presunto delito sexual contra niños, niñas y adolescentes",2016,2,1,3901,25.6344527044348,0,1992,0,1,1909,52.3834468308015
22769,85,85010,81,"Tasa de exámenes médico legales por presunto delito sexual contra niños, niñas y adolescentes",2016,3,10,4685,213.447171824973,2,2389,83.7170364169108,8,2296,348.432055749129
22770,85,85010,81,"Tasa de exámenes médico legales por presunto delito sexual contra niños, niñas y adolescentes",2016,4,3,4879,61.4880098380816,1,2448,40.8496732026144,2,2431,82.2706705059646
22771,85,85125,81,"Tasa de exámenes médico legales por presunto delito sexual contra niños, niñas y adolescentes",2016,4,2,1628,122.850122850123,0,851,0,2,777,257.400257400257
22772,85,85136,81,"Tasa de exámenes médico legales por presunto delito sexual contra niños, niñas y adolescentes",2016,4,1,174,574.712643678161,0,90,0,1,84,1190.47619047619
22773,85,85139,81,"Tasa de exámenes médico legales por presunto delito sexual contra niños, niñas y adolescentes",2016,2,1,1096,91.2408759124088,0,560,0,1,536,186.567164179104
22774,85,85139,81,"Tasa de exámenes médico legales por presunto delito sexual contra niños, niñas y adolescentes",2016,3,4,1300,307.692307692308,0,679,0,4,621,644.122383252818
22775,85,85139,81,"Tasa de exámenes médico legales por presunto delito sexual contra niños, niñas y adolescentes",2016,4,5,1291,387.296669248645,0,687,0,5,604,827.814569536424
22776,85,85139,121,Tasa de exámenes médico legales por presunto delito sexual cuando la víctima está entre 18 y 28 años,2016,5,1,2283,43.8020148926851,0,1209,0,1,1074,93.1098696461825
22777,85,85162,81,"Tasa de exámenes médico legales por presunto delito sexual contra niños, niñas y adolescentes",2016,3,1,1775,56.3380281690141,0,886,0,1,889,112.485939257593
22778,85,85162,81,"Tasa de exámenes médico legales por presunto delito sexual contra niños, niñas y adolescentes",2016,4,2,1770,112.994350282486,0,871,0,2,899,222.469410456062
22779,85,85225,81,"Tasa de exámenes médico legales por presunto delito sexual contra niños, niñas y adolescentes",2016,3,3,1150,260.869565217391,0,580,0,3,570,526.315789473684
22780,85,85225,81,"Tasa de exámenes médico legales por presunto delito sexual contra niños, niñas y adolescentes",2016,4,2,1090,183.48623853211,0,531,0,2,559,357.78175313059
22781,85,85250,81,"Tasa de exámenes médico legales por presunto delito sexual contra niños, niñas y adolescentes",2016,2,4,2896,138.121546961326,0,1476,0,4,1420,281.69014084507
22782,85,85250,81,"Tasa de exámenes médico legales por presunto delito sexual contra niños, niñas y adolescentes",2016,3,18,3474,518.134715025907,7,1805,387.811634349031,11,1669,659.077291791492
22783,85,85250,81,"Tasa de exámenes médico legales por presunto delito sexual contra niños, niñas y adolescentes",2016,4,28,3294,850.030358227079,4,1695,235.988200589971,24,1599,1500.93808630394
22784,85,85250,121,Tasa de exámenes médico legales por presunto delito sexual cuando la víctima está entre 18 y 28 años,2016,5,2,5256,38.0517503805175,0,2598,0,2,2658,75.2445447705041
22785,85,85263,81,"Tasa de exámenes médico legales por presunto delito sexual contra niños, niñas y adolescentes",2016,3,1,962,103.950103950104,0,503,0,1,459,217.864923747277
22786,85,85263,81,"Tasa de exámenes médico legales por presunto delito sexual contra niños, niñas y adolescentes",2016,4,6,954,628.930817610063,0,499,0,6,455,1318.68131868132
22787,85,85410,81,"Tasa de exámenes médico legales por presunto delito sexual contra niños, niñas y adolescentes",2016,2,5,2242,223.015165031222,3,1134,264.550264550265,2,1108,180.505415162455
22788,85,85410,81,"Tasa de exámenes médico legales por presunto delito sexual contra niños, niñas y adolescentes",2016,3,7,2689,260.31982149498,0,1348,0,7,1341,521.99850857569
22789,85,85410,81,"Tasa de exámenes médico legales por presunto delito sexual contra niños, niñas y adolescentes",2016,4,7,2530,276.679841897233,0,1381,0,7,1149,609.225413402959
22790,85,85410,121,Tasa de exámenes médico legales por presunto delito sexual cuando la víctima está entre 18 y 28 años,2016,5,2,5405,37.0027752081406,0,3131,0,2,2274,87.9507475813545
22791,85,85430,81,"Tasa de exámenes médico legales por presunto delito sexual contra niños, niñas y adolescentes",2016,3,1,2000,50,0,997,0,1,1003,99.7008973080758
22792,85,85430,81,"Tasa de exámenes médico legales por presunto delito sexual contra niños, niñas y adolescentes",2016,4,3,1952,153.688524590164,1,963,103.842159916926,2,989,202.224469160768
22793,85,85440,81,"Tasa de exámenes médico legales por presunto delito sexual contra niños, niñas y adolescentes",2016,2,1,2427,41.2031314379893,0,1244,0,1,1183,84.530853761623
22794,85,85440,81,"Tasa de exámenes médico legales por presunto delito sexual contra niños, niñas y adolescentes",2016,4,2,2941,68.0040802448147,0,1501,0,2,1440,138.888888888889
22795,86,86001,81,"Tasa de exámenes médico legales por presunto delito sexual contra niños, niñas y adolescentes",2016,2,4,4316,92.678405931418,1,2231,44.8229493500672,3,2085,143.884892086331
22796,86,86001,81,"Tasa de exámenes médico legales por presunto delito sexual contra niños, niñas y adolescentes",2016,3,8,5262,152.033447358419,1,2723,36.7242012486228,7,2539,275.699094131548
22797,86,86001,81,"Tasa de exámenes médico legales por presunto delito sexual contra niños, niñas y adolescentes",2016,4,16,4982,321.156162183862,1,2547,39.2618767177071,15,2435,616.016427104723
22798,86,86001,121,Tasa de exámenes médico legales por presunto delito sexual cuando la víctima está entre 18 y 28 años,2016,5,5,8622,57.9911853398284,0,4210,0,5,4412,113.327289211242
22799,86,86320,81,"Tasa de exámenes médico legales por presunto delito sexual contra niños, niñas y adolescentes",2016,3,4,7759,51.5530351849465,0,3915,0,4,3844,104.058272632674
22800,86,86320,81,"Tasa de exámenes médico legales por presunto delito sexual contra niños, niñas y adolescentes",2016,4,8,7768,102.986611740474,0,4000,0,8,3768,212.314225053079
22801,86,86320,121,Tasa de exámenes médico legales por presunto delito sexual cuando la víctima está entre 18 y 28 años,2016,5,2,11287,17.7195003100913,0,5802,0,2,5485,36.4630811303555
22802,86,86568,81,"Tasa de exámenes médico legales por presunto delito sexual contra niños, niñas y adolescentes",2016,2,8,6738,118.729593351143,3,3424,87.6168224299065,5,3314,150.875075437538
22803,86,86568,81,"Tasa de exámenes médico legales por presunto delito sexual contra niños, niñas y adolescentes",2016,3,24,8038,298.581736750435,4,4082,97.9911807937286,20,3956,505.561172901921
22804,86,86568,81,"Tasa de exámenes médico legales por presunto delito sexual contra niños, niñas y adolescentes",2016,4,9,7816,115.148413510747,0,3932,0,9,3884,231.719876416066
22805,86,86568,121,Tasa de exámenes médico legales por presunto delito sexual cuando la víctima está entre 18 y 28 años,2016,5,4,12801,31.24755878447,0,6413,0,4,6388,62.6174076393237
22806,86,86569,81,"Tasa de exámenes médico legales por presunto delito sexual contra niños, niñas y adolescentes",2016,2,1,1600,62.5,0,811,0,1,789,126.742712294043
22807,86,86569,81,"Tasa de exámenes médico legales por presunto delito sexual contra niños, niñas y adolescentes",2016,3,1,1842,54.2888165038002,0,924,0,1,918,108.932461873638
22808,86,86569,81,"Tasa de exámenes médico legales por presunto delito sexual contra niños, niñas y adolescentes",2016,4,1,1875,53.3333333333333,0,936,0,1,939,106.496272630458
22809,86,86571,81,"Tasa de exámenes médico legales por presunto delito sexual contra niños, niñas y adolescentes",2016,3,1,3336,29.9760191846523,0,1736,0,1,1600,62.5
22810,86,86571,81,"Tasa de exámenes médico legales por presunto delito sexual contra niños, niñas y adolescentes",2016,4,4,3326,120.264582080577,0,1738,0,4,1588,251.889168765743
22811,86,86573,81,"Tasa de exámenes médico legales por presunto delito sexual contra niños, niñas y adolescentes",2016,2,5,1683,297.08853238265,3,861,348.432055749129,2,822,243.30900243309
22812,86,86573,81,"Tasa de exámenes médico legales por presunto delito sexual contra niños, niñas y adolescentes",2016,3,13,2009,647.088103534097,1,1036,96.5250965250965,12,973,1233.29907502569
22813,86,86573,81,"Tasa de exámenes médico legales por presunto delito sexual contra niños, niñas y adolescentes",2016,4,12,1939,618.875709128417,0,1000,0,12,939,1277.9552715655
22814,86,86573,121,Tasa de exámenes médico legales por presunto delito sexual cuando la víctima está entre 18 y 28 años,2016,5,1,3226,30.9981401115933,0,1658,0,1,1568,63.7755102040816
22815,86,86757,81,"Tasa de exámenes médico legales por presunto delito sexual contra niños, niñas y adolescentes",2016,2,3,3499,85.7387825092884,1,1770,56.4971751412429,2,1729,115.673799884326
22816,86,86757,81,"Tasa de exámenes médico legales por presunto delito sexual contra niños, niñas y adolescentes",2016,3,6,3929,152.71061338763,1,1976,50.6072874493927,5,1953,256.016385048643
22817,86,86757,81,"Tasa de exámenes médico legales por presunto delito sexual contra niños, niñas y adolescentes",2016,4,5,3918,127.616130678918,1,2005,49.8753117206983,4,1913,209.095661265029
22818,86,86865,81,"Tasa de exámenes médico legales por presunto delito sexual contra niños, niñas y adolescentes",2016,2,1,5642,17.7242112725984,0,2883,0,1,2759,36.2450163102573
22819,86,86865,81,"Tasa de exámenes médico legales por presunto delito sexual contra niños, niñas y adolescentes",2016,3,7,6640,105.421686746988,2,3388,59.0318772136954,5,3252,153.751537515375
22820,86,86865,81,"Tasa de exámenes médico legales por presunto delito sexual contra niños, niñas y adolescentes",2016,4,13,6969,186.540393169752,0,3520,0,13,3449,376.920846622209
22821,86,86865,121,Tasa de exámenes médico legales por presunto delito sexual cuando la víctima está entre 18 y 28 años,2016,5,2,10842,18.4467810367091,0,5551,0,2,5291,37.8000378000378
22822,86,86885,81,"Tasa de exámenes médico legales por presunto delito sexual contra niños, niñas y adolescentes",2016,2,4,2318,172.562553925798,0,1176,0,4,1142,350.262697022767
22823,86,86885,81,"Tasa de exámenes médico legales por presunto delito sexual contra niños, niñas y adolescentes",2016,3,6,2674,224.382946896036,1,1340,74.6268656716418,5,1334,374.812593703148
22824,86,86885,81,"Tasa de exámenes médico legales por presunto delito sexual contra niños, niñas y adolescentes",2016,4,17,2720,625,0,1358,0,17,1362,1248.1644640235
22825,86,86885,121,Tasa de exámenes médico legales por presunto delito sexual cuando la víctima está entre 18 y 28 años,2016,5,1,4680,21.3675213675214,0,2336,0,1,2344,42.6621160409556
22826,88,88001,81,"Tasa de exámenes médico legales por presunto delito sexual contra niños, niñas y adolescentes",2016,2,1,5944,16.8236877523553,1,3042,32.8731097961867,0,2902,0
22827,88,88001,81,"Tasa de exámenes médico legales por presunto delito sexual contra niños, niñas y adolescentes",2016,3,3,7035,42.6439232409382,0,3592,0,3,3443,87.1333139703747
22828,88,88001,81,"Tasa de exámenes médico legales por presunto delito sexual contra niños, niñas y adolescentes",2016,4,12,7199,166.689818030282,2,3665,54.5702592087312,10,3534,282.965478211658
22829,88,88001,121,Tasa de exámenes médico legales por presunto delito sexual cuando la víctima está entre 18 y 28 años,2016,5,4,13423,29.799597705431,0,6867,0,4,6556,61.012812690665
22830,91,91001,81,"Tasa de exámenes médico legales por presunto delito sexual contra niños, niñas y adolescentes",2016,2,9,4857,185.299567634342,1,2492,40.1284109149278,8,2365,338.266384778013
22831,91,91001,81,"Tasa de exámenes médico legales por presunto delito sexual contra niños, niñas y adolescentes",2016,3,12,5564,215.672178289001,3,2844,105.485232067511,9,2720,330.882352941176
22832,91,91001,81,"Tasa de exámenes médico legales por presunto delito sexual contra niños, niñas y adolescentes",2016,4,29,5405,536.540240518039,1,2730,36.6300366300366,28,2675,1046.72897196262
22833,91,91001,121,Tasa de exámenes médico legales por presunto delito sexual cuando la víctima está entre 18 y 28 años,2016,5,5,9774,51.1561285041948,2,4818,41.51100041511,3,4956,60.5326876513317
22834,91,91405,81,"Tasa de exámenes médico legales por presunto delito sexual contra niños, niñas y adolescentes",2016,2,1,563,177.619893428064,0,280,0,1,283,353.356890459364
22835,91,91405,81,"Tasa de exámenes médico legales por presunto delito sexual contra niños, niñas y adolescentes",2016,3,1,619,161.550888529887,0,313,0,1,306,326.797385620915
22836,91,91536,81,"Tasa de exámenes médico legales por presunto delito sexual contra niños, niñas y adolescentes",2016,4,1,219,456.62100456621,0,102,0,1,117,854.700854700855
22837,91,91540,121,Tasa de exámenes médico legales por presunto delito sexual cuando la víctima está entre 18 y 28 años,2016,5,1,1690,59.1715976331361,0,861,0,1,829,120.627261761158
22838,91,91669,81,"Tasa de exámenes médico legales por presunto delito sexual contra niños, niñas y adolescentes",2016,4,1,391,255.754475703325,0,206,0,1,185,540.540540540541
22839,91,91798,81,"Tasa de exámenes médico legales por presunto delito sexual contra niños, niñas y adolescentes",2016,3,2,673,297.176820208024,0,326,0,2,347,576.368876080692
22840,94,94001,81,"Tasa de exámenes médico legales por presunto delito sexual contra niños, niñas y adolescentes",2016,2,3,2352,127.551020408163,1,1218,82.1018062397373,2,1134,176.36684303351
22841,94,94001,81,"Tasa de exámenes médico legales por presunto delito sexual contra niños, niñas y adolescentes",2016,3,8,2699,296.406076324565,0,1393,0,8,1306,612.557427258806
22842,94,94001,81,"Tasa de exámenes médico legales por presunto delito sexual contra niños, niñas y adolescentes",2016,4,15,2736,548.245614035088,1,1411,70.871722182849,14,1325,1056.60377358491
22843,94,94001,121,Tasa de exámenes médico legales por presunto delito sexual cuando la víctima está entre 18 y 28 años,2016,5,5,4788,104.427736006683,1,2433,41.101520756268,4,2355,169.851380042463
22844,94,94343,81,"Tasa de exámenes médico legales por presunto delito sexual contra niños, niñas y adolescentes",2016,3,1,708,141.242937853107,0,364,0,1,344,290.697674418605
22845,94,94343,81,"Tasa de exámenes médico legales por presunto delito sexual contra niños, niñas y adolescentes",2016,4,1,698,143.266475644699,0,372,0,1,326,306.748466257669
22846,95,95001,81,"Tasa de exámenes médico legales por presunto delito sexual contra niños, niñas y adolescentes",2016,2,15,8737,171.683644271489,3,4480,66.9642857142857,12,4257,281.888653981677
22847,95,95001,81,"Tasa de exámenes médico legales por presunto delito sexual contra niños, niñas y adolescentes",2016,3,10,9840,101.626016260163,1,5006,19.9760287654814,9,4834,186.181216383947
22848,95,95001,81,"Tasa de exámenes médico legales por presunto delito sexual contra niños, niñas y adolescentes",2016,4,21,8818,238.149240190519,1,4445,22.4971878515186,20,4373,457.351932311914
22849,95,95001,121,Tasa de exámenes médico legales por presunto delito sexual cuando la víctima está entre 18 y 28 años,2016,5,2,14372,13.9159476760367,1,7108,14.0686550365785,1,7264,13.7665198237885
22850,95,95001,81,"Tasa de exámenes médico legales por presunto delito sexual contra niños, niñas y adolescentes",2016,1,1,1775,56.3380281690141,1,907,110.253583241455,0,868,0
22851,95,95015,81,"Tasa de exámenes médico legales por presunto delito sexual contra niños, niñas y adolescentes",2016,2,2,1245,160.642570281125,0,647,0,2,598,334.448160535117
22852,95,95015,81,"Tasa de exámenes médico legales por presunto delito sexual contra niños, niñas y adolescentes",2016,4,1,1130,88.4955752212389,1,609,164.203612479475,0,521,0
22853,95,95025,81,"Tasa de exámenes médico legales por presunto delito sexual contra niños, niñas y adolescentes",2016,3,2,3511,56.9638279692395,2,1725,115.942028985507,0,1786,0
22854,95,95025,81,"Tasa de exámenes médico legales por presunto delito sexual contra niños, niñas y adolescentes",2016,4,2,3401,58.8062334607468,1,1676,59.6658711217184,1,1725,57.9710144927536
22855,95,95200,81,"Tasa de exámenes médico legales por presunto delito sexual contra niños, niñas y adolescentes",2016,4,1,1626,61.5006150061501,0,834,0,1,792,126.262626262626
22856,99,99001,81,"Tasa de exámenes médico legales por presunto delito sexual contra niños, niñas y adolescentes",2016,3,3,2302,130.321459600348,0,1238,0,3,1064,281.954887218045
22857,99,99001,81,"Tasa de exámenes médico legales por presunto delito sexual contra niños, niñas y adolescentes",2016,4,7,2229,314.042171377299,0,1187,0,7,1042,671.785028790787
22858,99,99001,121,Tasa de exámenes médico legales por presunto delito sexual cuando la víctima está entre 18 y 28 años,2016,5,1,4024,24.8508946322068,0,2126,0,1,1898,52.6870389884089
22859,99,99773,81,"Tasa de exámenes médico legales por presunto delito sexual contra niños, niñas y adolescentes",2016,4,1,5521,18.1126607498642,0,2774,0,1,2747,36.4033491081179
