id,cdep,cmun,cindica,nomind,periodo,edadR,casos,poblacion,tasa,casosh,poblacionh,tasah,casosm,poblacionm,tasam
18403,11,11001,81,"Tasa de exámenes médico legales por presunto delito sexual contra niños, niñas y adolescentes",2015,2,790,601717,131.290955715062,199,308475,64.5109003971148,591,293242,201.540024962318
18404,11,11001,81,"Tasa de exámenes médico legales por presunto delito sexual contra niños, niñas y adolescentes",2015,3,1368,717693,190.610748606995,265,367809,72.0482641805937,1103,349884,315.247339118108
18405,11,11001,81,"Tasa de exámenes médico legales por presunto delito sexual contra niños, niñas y adolescentes",2015,4,1754,746193,235.059830365602,199,380195,52.3415615670906,1555,365998,424.865709648687
18406,11,11001,121,Tasa de exámenes médico legales por presunto delito sexual cuando la víctima está entre 18 y 28 años,2015,5,400,1439041,27.7962893343553,22,727325,3.02478259375107,378,711716,53.1110723940448
18407,11,11001,81,"Tasa de exámenes médico legales por presunto delito sexual contra niños, niñas y adolescentes",2015,1,11,121438,9.05812019302031,6,62367,9.62047236519313,5,59071,8.46439030996597
18408,13,13001,81,"Tasa de exámenes médico legales por presunto delito sexual contra niños, niñas y adolescentes",2015,2,78,83077,93.888801954813,19,42397,44.8144915913862,59,40680,145.034414945919
18409,13,13001,81,"Tasa de exámenes médico legales por presunto delito sexual contra niños, niñas y adolescentes",2015,3,134,104703,127.981051163768,28,53009,52.8212190382765,106,51694,205.052810771076
18410,13,13001,81,"Tasa de exámenes médico legales por presunto delito sexual contra niños, niñas y adolescentes",2015,4,209,109917,190.143471892428,18,55069,32.6862663204344,191,54848,348.23512252042
18411,13,13001,121,Tasa de exámenes médico legales por presunto delito sexual cuando la víctima está entre 18 y 28 años,2015,5,53,192016,27.6018665111241,1,96724,1.03386956701543,52,95292,54.569113881543
18412,13,13001,81,"Tasa de exámenes médico legales por presunto delito sexual contra niños, niñas y adolescentes",2015,1,3,16152,18.5735512630015,0,8233,0,3,7919,37.8835711579745
18413,13,13006,81,"Tasa de exámenes médico legales por presunto delito sexual contra niños, niñas y adolescentes",2015,4,1,2683,37.2717107715244,0,1376,0,1,1307,76.5110941086458
18414,13,13030,81,"Tasa de exámenes médico legales por presunto delito sexual contra niños, niñas y adolescentes",2015,3,1,1657,60.3500301750151,0,860,0,1,797,125.470514429109
18415,13,13042,81,"Tasa de exámenes médico legales por presunto delito sexual contra niños, niñas y adolescentes",2015,4,3,2595,115.606936416185,0,1393,0,3,1202,249.584026622296
18416,13,13052,81,"Tasa de exámenes médico legales por presunto delito sexual contra niños, niñas y adolescentes",2015,2,1,7405,13.5043889264011,1,3789,26.3921879123779,0,3616,0
18417,13,13052,81,"Tasa de exámenes médico legales por presunto delito sexual contra niños, niñas y adolescentes",2015,3,11,8940,123.042505592841,3,4539,66.0938532716457,8,4401,181.776868893433
18418,13,13052,81,"Tasa de exámenes médico legales por presunto delito sexual contra niños, niñas y adolescentes",2015,4,12,8997,133.377792597533,0,4596,0,12,4401,272.66530334015
18419,13,13052,121,Tasa de exámenes médico legales por presunto delito sexual cuando la víctima está entre 18 y 28 años,2015,5,4,14221,28.1274171999156,0,7476,0,4,6745,59.3031875463306
18420,13,13062,81,"Tasa de exámenes médico legales por presunto delito sexual contra niños, niñas y adolescentes",2015,2,1,1095,91.324200913242,0,565,0,1,530,188.679245283019
18421,13,13062,81,"Tasa de exámenes médico legales por presunto delito sexual contra niños, niñas y adolescentes",2015,3,1,1275,78.4313725490196,0,683,0,1,592,168.918918918919
18422,13,13062,81,"Tasa de exámenes médico legales por presunto delito sexual contra niños, niñas y adolescentes",2015,4,1,1267,78.9265982636148,0,672,0,1,595,168.067226890756
18423,13,13062,121,Tasa de exámenes médico legales por presunto delito sexual cuando la víctima está entre 18 y 28 años,2015,5,1,1937,51.6262261228704,0,1034,0,1,903,110.741971207087
18424,13,13074,81,"Tasa de exámenes médico legales por presunto delito sexual contra niños, niñas y adolescentes",2015,4,1,2372,42.1585160202361,0,1214,0,1,1158,86.3557858376511
18425,13,13140,81,"Tasa de exámenes médico legales por presunto delito sexual contra niños, niñas y adolescentes",2015,2,1,2580,38.7596899224806,1,1331,75.1314800901578,0,1249,0
18426,13,13140,81,"Tasa de exámenes médico legales por presunto delito sexual contra niños, niñas y adolescentes",2015,3,5,2999,166.722240746916,1,1605,62.3052959501558,4,1394,286.944045911047
18427,13,13140,81,"Tasa de exámenes médico legales por presunto delito sexual contra niños, niñas y adolescentes",2015,4,5,2979,167.841557569654,0,1581,0,5,1398,357.653791130186
18428,13,13160,121,Tasa de exámenes médico legales por presunto delito sexual cuando la víctima está entre 18 y 28 años,2015,5,1,1784,56.0538116591928,0,911,0,1,873,114.54753722795
18429,13,13188,81,"Tasa de exámenes médico legales por presunto delito sexual contra niños, niñas y adolescentes",2015,2,1,1170,85.4700854700855,0,599,0,1,571,175.131348511384
18430,13,13188,81,"Tasa de exámenes médico legales por presunto delito sexual contra niños, niñas y adolescentes",2015,3,2,1367,146.30577907827401,0,700,0,2,667,299.850074962519
18431,13,13188,81,"Tasa de exámenes médico legales por presunto delito sexual contra niños, niñas y adolescentes",2015,4,3,1348,222.551928783383,0,692,0,3,656,457.317073170732
18432,13,13212,81,"Tasa de exámenes médico legales por presunto delito sexual contra niños, niñas y adolescentes",2015,3,2,1650,121.212121212121,0,858,0,2,792,252.525252525253
18433,13,13212,81,"Tasa de exámenes médico legales por presunto delito sexual contra niños, niñas y adolescentes",2015,4,2,1606,124.53300124533,0,837,0,2,769,260.078023407022
18434,13,13222,81,"Tasa de exámenes médico legales por presunto delito sexual contra niños, niñas y adolescentes",2015,2,1,1464,68.3060109289618,0,759,0,1,705,141.843971631206
18435,13,13222,81,"Tasa de exámenes médico legales por presunto delito sexual contra niños, niñas y adolescentes",2015,3,1,1663,60.1322910402886,1,878,113.895216400911,0,785,0
18436,13,13222,81,"Tasa de exámenes médico legales por presunto delito sexual contra niños, niñas y adolescentes",2015,4,3,1679,178.677784395473,0,899,0,3,780,384.615384615385
18437,13,13222,121,Tasa de exámenes médico legales por presunto delito sexual cuando la víctima está entre 18 y 28 años,2015,5,1,2646,37.7928949357521,0,1421,0,1,1225,81.6326530612245
18438,13,13244,81,"Tasa de exámenes médico legales por presunto delito sexual contra niños, niñas y adolescentes",2015,2,4,9091,43.9995600044,1,4638,21.5610176800345,3,4453,67.3703121491129
18439,13,13244,81,"Tasa de exámenes médico legales por presunto delito sexual contra niños, niñas y adolescentes",2015,3,11,10006,109.934039576254,3,5200,57.6923076923077,8,4806,166.458593424886
18440,13,13244,81,"Tasa de exámenes médico legales por presunto delito sexual contra niños, niñas y adolescentes",2015,4,19,9538,199.203187250996,0,4967,0,19,4571,415.663968497047
18441,13,13244,121,Tasa de exámenes médico legales por presunto delito sexual cuando la víctima está entre 18 y 28 años,2015,5,2,14993,13.339558460615,0,7892,0,2,7101,28.165047176454
18442,13,13248,81,"Tasa de exámenes médico legales por presunto delito sexual contra niños, niñas y adolescentes",2015,4,1,844,118.483412322275,0,441,0,1,403,248.138957816377
18443,13,13268,81,"Tasa de exámenes médico legales por presunto delito sexual contra niños, niñas y adolescentes",2015,2,1,1198,83.4724540901503,0,615,0,1,583,171.526586620926
18444,13,13268,81,"Tasa de exámenes médico legales por presunto delito sexual contra niños, niñas y adolescentes",2015,3,2,1263,158.353127474268,0,660,0,2,603,331.67495854063
18445,13,13268,81,"Tasa de exámenes médico legales por presunto delito sexual contra niños, niñas y adolescentes",2015,4,3,1228,244.299674267101,1,657,152.20700152207,2,571,350.262697022767
18446,13,13300,81,"Tasa de exámenes médico legales por presunto delito sexual contra niños, niñas y adolescentes",2015,3,2,1693,118.133490844654,0,882,0,2,811,246.609124537608
18447,13,13300,121,Tasa de exámenes médico legales por presunto delito sexual cuando la víctima está entre 18 y 28 años,2015,5,1,2559,39.0777647518562,1,1391,71.8907260963336,0,1168,0
18448,13,13430,81,"Tasa de exámenes médico legales por presunto delito sexual contra niños, niñas y adolescentes",2015,2,12,12838,93.4725035052189,6,6578,91.2131346913956,6,6260,95.8466453674121
18449,13,13430,81,"Tasa de exámenes médico legales por presunto delito sexual contra niños, niñas y adolescentes",2015,3,27,14831,182.051109163239,6,7604,78.9058390320884,21,7227,290.57700290577
18450,13,13430,81,"Tasa de exámenes médico legales por presunto delito sexual contra niños, niñas y adolescentes",2015,4,37,14400,256.944444444444,3,7390,40.595399188092,34,7010,485.021398002853
18451,13,13430,121,Tasa de exámenes médico legales por presunto delito sexual cuando la víctima está entre 18 y 28 años,2015,5,5,24305,20.571898786258,0,12414,0,5,11891,42.0486081910689
18452,13,13433,81,"Tasa de exámenes médico legales por presunto delito sexual contra niños, niñas y adolescentes",2015,2,4,2637,151.687523701176,1,1358,73.6377025036819,3,1279,234.558248631744
18453,13,13433,81,"Tasa de exámenes médico legales por presunto delito sexual contra niños, niñas y adolescentes",2015,3,5,3006,166.333998669328,0,1540,0,5,1466,341.06412005457
18454,13,13433,81,"Tasa de exámenes médico legales por presunto delito sexual contra niños, niñas y adolescentes",2015,4,5,2942,169.952413324269,0,1511,0,5,1431,349.406009783368
18455,13,13433,121,Tasa de exámenes médico legales por presunto delito sexual cuando la víctima está entre 18 y 28 años,2015,5,1,4785,20.8986415882968,0,2520,0,1,2265,44.1501103752759
18456,13,13440,81,"Tasa de exámenes médico legales por presunto delito sexual contra niños, niñas y adolescentes",2015,2,1,1115,89.6860986547085,0,569,0,1,546,183.150183150183
18457,13,13440,121,Tasa de exámenes médico legales por presunto delito sexual cuando la víctima está entre 18 y 28 años,2015,5,1,2098,47.6644423260248,0,1073,0,1,1025,97.5609756097561
18458,13,13442,81,"Tasa de exámenes médico legales por presunto delito sexual contra niños, niñas y adolescentes",2015,2,2,5749,34.7886588971995,0,2957,0,2,2792,71.6332378223496
18459,13,13442,81,"Tasa de exámenes médico legales por presunto delito sexual contra niños, niñas y adolescentes",2015,3,7,6300,111.111111111111,1,3279,30.4971027752364,6,3021,198.609731876862
18460,13,13442,81,"Tasa de exámenes médico legales por presunto delito sexual contra niños, niñas y adolescentes",2015,4,13,6078,213.886146758802,0,3185,0,13,2893,449.360525406153
18461,13,13442,121,Tasa de exámenes médico legales por presunto delito sexual cuando la víctima está entre 18 y 28 años,2015,5,1,9766,10.2396067990989,0,5103,0,1,4663,21.4454214025306
18462,13,13458,121,Tasa de exámenes médico legales por presunto delito sexual cuando la víctima está entre 18 y 28 años,2015,5,1,4405,22.7014755959137,0,2338,0,1,2067,48.3792936623125
18463,13,13468,81,"Tasa de exámenes médico legales por presunto delito sexual contra niños, niñas y adolescentes",2015,2,2,4999,40.0080016003201,0,2552,0,2,2447,81.732733959951
18464,13,13468,81,"Tasa de exámenes médico legales por presunto delito sexual contra niños, niñas y adolescentes",2015,3,4,5588,71.5819613457409,0,2847,0,4,2741,145.932141554177
18465,13,13468,81,"Tasa de exámenes médico legales por presunto delito sexual contra niños, niñas y adolescentes",2015,4,13,5519,235.54991846349,1,2780,35.9712230215827,12,2739,438.116100766703
18466,13,13468,121,Tasa de exámenes médico legales por presunto delito sexual cuando la víctima está entre 18 y 28 años,2015,5,1,9360,10.6837606837607,0,4798,0,1,4562,21.9202104340202
18467,13,13473,81,"Tasa de exámenes médico legales por presunto delito sexual contra niños, niñas y adolescentes",2015,4,1,2712,36.8731563421829,0,1396,0,1,1316,75.9878419452887
18468,13,13549,81,"Tasa de exámenes médico legales por presunto delito sexual contra niños, niñas y adolescentes",2015,2,1,3351,29.8418382572366,0,1717,0,1,1634,61.1995104039168
18469,13,13580,81,"Tasa de exámenes médico legales por presunto delito sexual contra niños, niñas y adolescentes",2015,3,2,1515,132.013201320132,0,771,0,2,744,268.817204301075
18470,13,13600,81,"Tasa de exámenes médico legales por presunto delito sexual contra niños, niñas y adolescentes",2015,3,3,2427,123.609394313968,0,1225,0,3,1202,249.584026622296
18471,13,13620,81,"Tasa de exámenes médico legales por presunto delito sexual contra niños, niñas y adolescentes",2015,2,2,607,329.489291598023,1,305,327.868852459016,1,302,331.12582781457
18472,13,13647,81,"Tasa de exámenes médico legales por presunto delito sexual contra niños, niñas y adolescentes",2015,2,1,1796,55.6792873051225,0,909,0,1,887,112.739571589628
18473,13,13647,81,"Tasa de exámenes médico legales por presunto delito sexual contra niños, niñas y adolescentes",2015,3,1,2105,47.5059382422803,0,1070,0,1,1035,96.6183574879227
18474,13,13650,81,"Tasa de exámenes médico legales por presunto delito sexual contra niños, niñas y adolescentes",2015,3,1,1764,56.6893424036281,0,923,0,1,841,118.906064209275
18475,13,13654,81,"Tasa de exámenes médico legales por presunto delito sexual contra niños, niñas y adolescentes",2015,3,1,2317,43.1592576607682,0,1201,0,1,1116,89.6057347670251
18476,13,13654,81,"Tasa de exámenes médico legales por presunto delito sexual contra niños, niñas y adolescentes",2015,4,4,2455,162.932790224033,0,1273,0,4,1182,338.409475465313
18477,13,13654,121,Tasa de exámenes médico legales por presunto delito sexual cuando la víctima está entre 18 y 28 años,2015,5,1,4288,23.3208955223881,0,2220,0,1,2068,48.3558994197292
18478,13,13657,81,"Tasa de exámenes médico legales por presunto delito sexual contra niños, niñas y adolescentes",2015,2,2,3224,62.0347394540943,0,1645,0,2,1579,126.66244458518
18479,13,13657,81,"Tasa de exámenes médico legales por presunto delito sexual contra niños, niñas y adolescentes",2015,3,2,3717,53.8068334678504,0,1921,0,2,1796,111.358574610245
18480,13,13657,81,"Tasa de exámenes médico legales por presunto delito sexual contra niños, niñas y adolescentes",2015,4,3,3756,79.872204472843407,0,1914,0,3,1842,162.866449511401
18481,13,13657,121,Tasa de exámenes médico legales por presunto delito sexual cuando la víctima está entre 18 y 28 años,2015,5,4,6628,60.3500301750151,0,3449,0,4,3179,125.825731362064
18482,13,13667,81,"Tasa de exámenes médico legales por presunto delito sexual contra niños, niñas y adolescentes",2015,4,1,2219,45.0653447498873,0,1114,0,1,1105,90.4977375565611
18483,13,13670,81,"Tasa de exámenes médico legales por presunto delito sexual contra niños, niñas y adolescentes",2015,3,1,4200,23.8095238095238,0,2032,0,1,2168,46.1254612546125
18484,13,13670,121,Tasa de exámenes médico legales por presunto delito sexual cuando la víctima está entre 18 y 28 años,2015,5,1,6242,16.0205062479974,0,3167,0,1,3075,32.520325203252
18485,13,13673,81,"Tasa de exámenes médico legales por presunto delito sexual contra niños, niñas y adolescentes",2015,2,1,1531,65.3167864141084,0,777,0,1,754,132.62599469496
18486,13,13673,81,"Tasa de exámenes médico legales por presunto delito sexual contra niños, niñas y adolescentes",2015,3,1,1708,58.5480093676815,0,868,0,1,840,119.047619047619
18487,13,13673,81,"Tasa de exámenes médico legales por presunto delito sexual contra niños, niñas y adolescentes",2015,4,1,1581,63.2511068943707,0,806,0,1,775,129.032258064516
18488,13,13683,81,"Tasa de exámenes médico legales por presunto delito sexual contra niños, niñas y adolescentes",2015,2,1,2512,39.8089171974522,0,1286,0,1,1226,81.5660685154976
18489,13,13683,81,"Tasa de exámenes médico legales por presunto delito sexual contra niños, niñas y adolescentes",2015,3,2,2950,67.7966101694915,0,1515,0,2,1435,139.372822299652
18490,13,13683,81,"Tasa de exámenes médico legales por presunto delito sexual contra niños, niñas y adolescentes",2015,4,5,2866,174.459176552687,0,1476,0,5,1390,359.712230215827
18491,13,13683,121,Tasa de exámenes médico legales por presunto delito sexual cuando la víctima está entre 18 y 28 años,2015,5,4,4371,91.5122397620682,0,2312,0,4,2059,194.269062651773
18492,13,13688,81,"Tasa de exámenes médico legales por presunto delito sexual contra niños, niñas y adolescentes",2015,4,1,6057,16.5098233448902,0,3144,0,1,2913,34.3288705801579
18493,13,13760,81,"Tasa de exámenes médico legales por presunto delito sexual contra niños, niñas y adolescentes",2015,4,5,952,525.210084033613,0,482,0,5,470,1063.82978723404
18494,13,13780,81,"Tasa de exámenes médico legales por presunto delito sexual contra niños, niñas y adolescentes",2015,3,1,1547,64.6412411118293,0,811,0,1,736,135.869565217391
18495,13,13780,81,"Tasa de exámenes médico legales por presunto delito sexual contra niños, niñas y adolescentes",2015,4,1,1474,67.842605156038,0,783,0,1,691,144.717800289436
18496,13,13810,81,"Tasa de exámenes médico legales por presunto delito sexual contra niños, niñas y adolescentes",2015,3,2,3239,61.7474529175672,1,1645,60.790273556231,1,1594,62.7352572145546
18497,13,13810,81,"Tasa de exámenes médico legales por presunto delito sexual contra niños, niñas y adolescentes",2015,4,4,3083,129.743756081739,1,1583,63.1711939355654,3,1500,200
18498,13,13810,121,Tasa de exámenes médico legales por presunto delito sexual cuando la víctima está entre 18 y 28 años,2015,5,1,4567,21.8962119553317,0,2512,0,1,2055,48.661800486618
18499,13,13836,81,"Tasa de exámenes médico legales por presunto delito sexual contra niños, niñas y adolescentes",2015,2,5,6194,80.7232805941233,0,3169,0,5,3025,165.289256198347
18500,13,13836,81,"Tasa de exámenes médico legales por presunto delito sexual contra niños, niñas y adolescentes",2015,3,9,7622,118.079244292837,0,3875,0,9,3747,240.192153722978
18501,13,13836,81,"Tasa de exámenes médico legales por presunto delito sexual contra niños, niñas y adolescentes",2015,4,14,8126,172.286487816884,1,4106,24.3546030199708,13,4020,323.383084577114
18502,13,13836,121,Tasa de exámenes médico legales por presunto delito sexual cuando la víctima está entre 18 y 28 años,2015,5,6,13786,43.5224140432323,1,7080,14.1242937853107,5,6706,74.5600954369222
18503,13,13838,81,"Tasa de exámenes médico legales por presunto delito sexual contra niños, niñas y adolescentes",2015,2,2,1679,119.118522930316,0,859,0,2,820,243.90243902439
18504,13,13838,81,"Tasa de exámenes médico legales por presunto delito sexual contra niños, niñas y adolescentes",2015,3,3,2045,146.699266503668,0,1052,0,3,993,302.114803625378
18505,13,13838,81,"Tasa de exámenes médico legales por presunto delito sexual contra niños, niñas y adolescentes",2015,4,4,1910,209.424083769634,0,982,0,4,928,431.034482758621
18506,13,13873,81,"Tasa de exámenes médico legales por presunto delito sexual contra niños, niñas y adolescentes",2015,2,2,2028,98.6193293885602,1,1038,96.3391136801541,1,990,101.010101010101
18507,13,13873,81,"Tasa de exámenes médico legales por presunto delito sexual contra niños, niñas y adolescentes",2015,3,5,2392,209.030100334448,1,1216,82.2368421052632,4,1176,340.136054421769
18508,13,13873,81,"Tasa de exámenes médico legales por presunto delito sexual contra niños, niñas y adolescentes",2015,4,3,2371,126.528890763391,0,1209,0,3,1162,258.175559380379
18509,13,13873,121,Tasa de exámenes médico legales por presunto delito sexual cuando la víctima está entre 18 y 28 años,2015,5,2,3752,53.3049040511727,0,1906,0,2,1846,108.342361863489
18510,13,13894,81,"Tasa de exámenes médico legales por presunto delito sexual contra niños, niñas y adolescentes",2015,2,1,1332,75.0750750750751,0,686,0,1,646,154.798761609907
18511,13,13894,81,"Tasa de exámenes médico legales por presunto delito sexual contra niños, niñas y adolescentes",2015,4,3,1405,213.523131672598,0,739,0,3,666,450.45045045045
18512,15,15001,81,"Tasa de exámenes médico legales por presunto delito sexual contra niños, niñas y adolescentes",2015,2,12,14670,81.799591002045,6,7505,79.9467021985343,6,7165,83.7404047452896
18513,15,15001,81,"Tasa de exámenes médico legales por presunto delito sexual contra niños, niñas y adolescentes",2015,3,25,19672,127.084180561204,5,9925,50.3778337531486,20,9747,205.191340925413
18514,15,15001,81,"Tasa de exámenes médico legales por presunto delito sexual contra niños, niñas y adolescentes",2015,4,48,21343,224.898093051586,4,10723,37.3029935652336,44,10620,414.312617702448
18515,15,15001,121,Tasa de exámenes médico legales por presunto delito sexual cuando la víctima está entre 18 y 28 años,2015,5,14,34319,40.7937294210204,0,17767,0,14,16552,84.5819236346061
18516,15,15022,81,"Tasa de exámenes médico legales por presunto delito sexual contra niños, niñas y adolescentes",2015,4,1,181,552.486187845304,0,92,0,1,89,1123.59550561798
18517,15,15022,121,Tasa de exámenes médico legales por presunto delito sexual cuando la víctima está entre 18 y 28 años,2015,5,1,290,344.827586206897,0,152,0,1,138,724.63768115942
18518,15,15051,81,"Tasa de exámenes médico legales por presunto delito sexual contra niños, niñas y adolescentes",2015,3,2,592,337.837837837838,0,312,0,2,280,714.285714285714
18519,15,15051,81,"Tasa de exámenes médico legales por presunto delito sexual contra niños, niñas y adolescentes",2015,4,1,527,189.753320683112,0,282,0,1,245,408.163265306122
18520,15,15087,81,"Tasa de exámenes médico legales por presunto delito sexual contra niños, niñas y adolescentes",2015,2,1,595,168.067226890756,0,305,0,1,290,344.827586206897
18521,15,15087,81,"Tasa de exámenes médico legales por presunto delito sexual contra niños, niñas y adolescentes",2015,3,2,762,262.46719160105,1,393,254.452926208651,1,369,271.0027100271
18522,15,15087,81,"Tasa de exámenes médico legales por presunto delito sexual contra niños, niñas y adolescentes",2015,4,1,768,130.208333333333,0,398,0,1,370,270.27027027027
18523,15,15087,121,Tasa de exámenes médico legales por presunto delito sexual cuando la víctima está entre 18 y 28 años,2015,5,1,1247,80.1924619085806,0,656,0,1,591,169.204737732656
18524,15,15097,81,"Tasa de exámenes médico legales por presunto delito sexual contra niños, niñas y adolescentes",2015,2,1,528,189.393939393939,0,269,0,1,259,386.100386100386
18525,15,15097,81,"Tasa de exámenes médico legales por presunto delito sexual contra niños, niñas y adolescentes",2015,3,1,693,144.300144300144,0,350,0,1,343,291.545189504373
18526,15,15097,81,"Tasa de exámenes médico legales por presunto delito sexual contra niños, niñas y adolescentes",2015,4,2,714,280.11204481792703,0,361,0,2,353,566.57223796034
18527,15,15097,121,Tasa de exámenes médico legales por presunto delito sexual cuando la víctima está entre 18 y 28 años,2015,5,1,1160,86.2068965517241,0,595,0,1,565,176.991150442478
18528,15,15104,121,Tasa de exámenes médico legales por presunto delito sexual cuando la víctima está entre 18 y 28 años,2015,5,1,751,133.155792276964,0,390,0,1,361,277.008310249307
18529,15,15109,81,"Tasa de exámenes médico legales por presunto delito sexual contra niños, niñas y adolescentes",2015,4,1,651,153.609831029186,0,352,0,1,299,334.448160535117
18530,15,15162,81,"Tasa de exámenes médico legales por presunto delito sexual contra niños, niñas y adolescentes",2015,3,1,381,262.46719160105,0,200,0,1,181,552.486187845304
18531,15,15162,81,"Tasa de exámenes médico legales por presunto delito sexual contra niños, niñas y adolescentes",2015,4,2,365,547.945205479452,0,195,0,2,170,1176.47058823529
18532,15,15172,81,"Tasa de exámenes médico legales por presunto delito sexual contra niños, niñas y adolescentes",2015,3,1,341,293.255131964809,1,178,561.797752808989,0,163,0
18533,15,15172,81,"Tasa de exámenes médico legales por presunto delito sexual contra niños, niñas y adolescentes",2015,4,2,371,539.083557951482,2,193,1036.26943005181,0,178,0
18534,15,15176,81,"Tasa de exámenes médico legales por presunto delito sexual contra niños, niñas y adolescentes",2015,2,5,5661,88.3236177353824,3,2897,103.555402140145,2,2764,72.3589001447178
18535,15,15176,81,"Tasa de exámenes médico legales por presunto delito sexual contra niños, niñas y adolescentes",2015,3,8,7646,104.629871828407,2,3992,50.1002004008016,6,3654,164.203612479475
18536,15,15176,81,"Tasa de exámenes médico legales por presunto delito sexual contra niños, niñas y adolescentes",2015,4,12,8089,148.349610582272,1,4227,23.6574402649633,11,3862,284.826514759192
18537,15,15176,121,Tasa de exámenes médico legales por presunto delito sexual cuando la víctima está entre 18 y 28 años,2015,5,2,11959,16.7238063383226,0,6406,0,2,5553,36.0165676211057
18538,15,15176,81,"Tasa de exámenes médico legales por presunto delito sexual contra niños, niñas y adolescentes",2015,1,1,1073,93.1966449207828,0,556,0,1,517,193.423597678917
18539,15,15183,81,"Tasa de exámenes médico legales por presunto delito sexual contra niños, niñas y adolescentes",2015,4,1,1226,81.5660685154976,0,657,0,1,569,175.746924428822
18540,15,15185,81,"Tasa de exámenes médico legales por presunto delito sexual contra niños, niñas y adolescentes",2015,4,2,569,351.493848857645,0,312,0,2,257,778.210116731517
18541,15,15204,81,"Tasa de exámenes médico legales por presunto delito sexual contra niños, niñas y adolescentes",2015,3,3,1135,264.31718061674,0,584,0,3,551,544.464609800363
18542,15,15204,81,"Tasa de exámenes médico legales por presunto delito sexual contra niños, niñas y adolescentes",2015,4,2,1221,163.800163800164,0,677,0,2,544,367.647058823529
18543,15,15204,121,Tasa de exámenes médico legales por presunto delito sexual cuando la víctima está entre 18 y 28 años,2015,5,4,2192,182.481751824818,2,1370,145.985401459854,2,822,243.30900243309
18544,15,15215,81,"Tasa de exámenes médico legales por presunto delito sexual contra niños, niñas y adolescentes",2015,2,1,179,558.659217877095,0,89,0,1,90,1111.11111111111
18545,15,15215,81,"Tasa de exámenes médico legales por presunto delito sexual contra niños, niñas y adolescentes",2015,3,2,220,909.090909090909,1,109,917.431192660551,1,111,900.900900900901
18546,15,15215,81,"Tasa de exámenes médico legales por presunto delito sexual contra niños, niñas y adolescentes",2015,4,1,220,454.545454545455,0,106,0,1,114,877.19298245614
18547,15,15223,81,"Tasa de exámenes médico legales por presunto delito sexual contra niños, niñas y adolescentes",2015,4,2,920,217.391304347826,0,485,0,2,435,459.770114942529
18548,15,15224,81,"Tasa de exámenes médico legales por presunto delito sexual contra niños, niñas y adolescentes",2015,3,1,589,169.779286926995,0,312,0,1,277,361.01083032491
18549,15,15224,81,"Tasa de exámenes médico legales por presunto delito sexual contra niños, niñas y adolescentes",2015,4,1,587,170.357751277683,0,320,0,1,267,374.531835205993
18550,15,15224,121,Tasa de exámenes médico legales por presunto delito sexual cuando la víctima está entre 18 y 28 años,2015,5,1,822,121.654501216545,0,457,0,1,365,273.972602739726
18551,15,15232,81,"Tasa de exámenes médico legales por presunto delito sexual contra niños, niñas y adolescentes",2015,4,1,672,148.809523809524,0,368,0,1,304,328.947368421053
18552,15,15238,81,"Tasa de exámenes médico legales por presunto delito sexual contra niños, niñas y adolescentes",2015,2,14,9079,154.20200462606,3,4630,64.7948164146868,11,4449,247.24657226343
18553,15,15238,81,"Tasa de exámenes médico legales por presunto delito sexual contra niños, niñas y adolescentes",2015,3,26,12028,216.162287994679,7,5991,116.841929561008,19,6037,314.725857213848
18554,15,15238,81,"Tasa de exámenes médico legales por presunto delito sexual contra niños, niñas y adolescentes",2015,4,34,12833,264.941946544066,3,6243,48.0538202787122,31,6590,470.40971168437
18555,15,15238,121,Tasa de exámenes médico legales por presunto delito sexual cuando la víctima está entre 18 y 28 años,2015,5,6,19018,31.5490587864129,0,9528,0,6,9490,63.2244467860906
18556,15,15238,81,"Tasa de exámenes médico legales por presunto delito sexual contra niños, niñas y adolescentes",2015,1,1,1738,57.5373993095512,0,894,0,1,844,118.483412322275
18557,15,15272,81,"Tasa de exámenes médico legales por presunto delito sexual contra niños, niñas y adolescentes",2015,3,1,580,172.413793103448,0,304,0,1,276,362.31884057971
18558,15,15272,81,"Tasa de exámenes médico legales por presunto delito sexual contra niños, niñas y adolescentes",2015,4,1,558,179.21146953405,0,293,0,1,265,377.358490566038
18559,15,15276,81,"Tasa de exámenes médico legales por presunto delito sexual contra niños, niñas y adolescentes",2015,4,1,435,229.885057471264,1,228,438.59649122807,0,207,0
18560,15,15293,81,"Tasa de exámenes médico legales por presunto delito sexual contra niños, niñas y adolescentes",2015,2,2,246,813.008130081301,0,128,0,2,118,1694.91525423729
18561,15,15293,81,"Tasa de exámenes médico legales por presunto delito sexual contra niños, niñas y adolescentes",2015,3,2,301,664.451827242525,2,158,1265.82278481013,0,143,0
18562,15,15293,81,"Tasa de exámenes médico legales por presunto delito sexual contra niños, niñas y adolescentes",2015,4,3,270,1111.11111111111,1,145,689.655172413793,2,125,1600
18563,15,15293,121,Tasa de exámenes médico legales por presunto delito sexual cuando la víctima está entre 18 y 28 años,2015,5,1,417,239.808153477218,1,223,448.430493273543,0,194,0
18564,15,15296,81,"Tasa de exámenes médico legales por presunto delito sexual contra niños, niñas y adolescentes",2015,4,1,570,175.438596491228,0,308,0,1,262,381.679389312977
18565,15,15296,121,Tasa de exámenes médico legales por presunto delito sexual cuando la víctima está entre 18 y 28 años,2015,5,1,813,123.0012300123,1,453,220.75055187638,0,360,0
18566,15,15299,81,"Tasa de exámenes médico legales por presunto delito sexual contra niños, niñas y adolescentes",2015,2,1,1517,65.9195781147001,0,771,0,1,746,134.048257372654
18567,15,15299,81,"Tasa de exámenes médico legales por presunto delito sexual contra niños, niñas y adolescentes",2015,3,8,1941,412.158681092221,2,977,204.708290685773,6,964,622.406639004149
18568,15,15299,81,"Tasa de exámenes médico legales por presunto delito sexual contra niños, niñas y adolescentes",2015,4,5,1983,252.143217347453,1,988,101.214574898785,4,995,402.010050251256
18569,15,15299,121,Tasa de exámenes médico legales por presunto delito sexual cuando la víctima está entre 18 y 28 años,2015,5,1,2774,36.0490266762797,0,1440,0,1,1334,74.9625187406297
18570,15,15322,81,"Tasa de exámenes médico legales por presunto delito sexual contra niños, niñas y adolescentes",2015,3,1,932,107.296137339056,0,498,0,1,434,230.414746543779
18571,15,15322,81,"Tasa de exámenes médico legales por presunto delito sexual contra niños, niñas y adolescentes",2015,4,2,959,208.550573514077,0,518,0,2,441,453.514739229025
18572,15,15325,81,"Tasa de exámenes médico legales por presunto delito sexual contra niños, niñas y adolescentes",2015,4,5,389,1285.3470437018,0,213,0,5,176,2840.90909090909
18573,15,15362,81,"Tasa de exámenes médico legales por presunto delito sexual contra niños, niñas y adolescentes",2015,3,1,209,478.468899521531,0,112,0,1,97,1030.92783505155
18574,15,15367,81,"Tasa de exámenes médico legales por presunto delito sexual contra niños, niñas y adolescentes",2015,4,4,815,490.79754601227,0,412,0,4,403,992.555831265509
18575,15,15368,121,Tasa de exámenes médico legales por presunto delito sexual cuando la víctima está entre 18 y 28 años,2015,5,1,694,144.092219020173,0,389,0,1,305,327.868852459016
18576,15,15380,121,Tasa de exámenes médico legales por presunto delito sexual cuando la víctima está entre 18 y 28 años,2015,5,1,375,266.666666666667,0,207,0,1,168,595.238095238095
18577,15,15401,121,Tasa de exámenes médico legales por presunto delito sexual cuando la víctima está entre 18 y 28 años,2015,5,1,277,361.01083032491,0,156,0,1,121,826.446280991736
18578,15,15407,81,"Tasa de exámenes médico legales por presunto delito sexual contra niños, niñas y adolescentes",2015,3,3,1676,178.997613365155,1,895,111.731843575419,2,781,256.081946222791
18579,15,15407,81,"Tasa de exámenes médico legales por presunto delito sexual contra niños, niñas y adolescentes",2015,4,4,1822,219.53896816685,0,987,0,4,835,479.041916167665
18580,15,15407,121,Tasa de exámenes médico legales por presunto delito sexual cuando la víctima está entre 18 y 28 años,2015,5,1,2745,36.4298724954463,1,1431,69.8812019566736,0,1314,0
18581,15,15425,81,"Tasa de exámenes médico legales por presunto delito sexual contra niños, niñas y adolescentes",2015,3,1,488,204.918032786885,0,248,0,1,240,416.666666666667
18582,15,15425,81,"Tasa de exámenes médico legales por presunto delito sexual contra niños, niñas y adolescentes",2015,4,2,491,407.331975560081,0,249,0,2,242,826.446280991736
18583,15,15464,81,"Tasa de exámenes médico legales por presunto delito sexual contra niños, niñas y adolescentes",2015,4,1,531,188.323917137476,0,285,0,1,246,406.50406504065
18584,15,15464,121,Tasa de exámenes médico legales por presunto delito sexual cuando la víctima está entre 18 y 28 años,2015,5,1,776,128.865979381443,0,402,0,1,374,267.379679144385
18585,15,15469,81,"Tasa de exámenes médico legales por presunto delito sexual contra niños, niñas y adolescentes",2015,2,1,1850,54.0540540540541,1,952,105.042016806723,0,898,0
18586,15,15469,81,"Tasa de exámenes médico legales por presunto delito sexual contra niños, niñas y adolescentes",2015,3,8,2237,357.621814930711,1,1151,86.8809730668983,7,1086,644.567219152854
18587,15,15469,81,"Tasa de exámenes médico legales por presunto delito sexual contra niños, niñas y adolescentes",2015,4,6,2234,268.57654431513,0,1145,0,6,1089,550.964187327824
18588,15,15476,81,"Tasa de exámenes médico legales por presunto delito sexual contra niños, niñas y adolescentes",2015,4,1,818,122.249388753056,0,439,0,1,379,263.852242744063
18589,15,15480,81,"Tasa de exámenes médico legales por presunto delito sexual contra niños, niñas y adolescentes",2015,3,1,1080,92.5925925925926,0,564,0,1,516,193.798449612403
18590,15,15480,81,"Tasa de exámenes médico legales por presunto delito sexual contra niños, niñas y adolescentes",2015,4,1,1131,88.4173297966401,0,604,0,1,527,189.753320683112
18591,15,15491,81,"Tasa de exámenes médico legales por presunto delito sexual contra niños, niñas y adolescentes",2015,2,1,1397,71.5819613457409,0,722,0,1,675,148.148148148148
18592,15,15491,81,"Tasa de exámenes médico legales por presunto delito sexual contra niños, niñas y adolescentes",2015,3,1,1892,52.8541226215645,0,975,0,1,917,109.051254089422
18593,15,15494,81,"Tasa de exámenes médico legales por presunto delito sexual contra niños, niñas y adolescentes",2015,3,1,757,132.100396301189,1,377,265.25198938992,0,380,0
18594,15,15494,81,"Tasa de exámenes médico legales por presunto delito sexual contra niños, niñas y adolescentes",2015,4,1,734,136.239782016349,1,364,274.725274725275,0,370,0
18595,15,15500,81,"Tasa de exámenes médico legales por presunto delito sexual contra niños, niñas y adolescentes",2015,2,1,289,346.020761245675,0,150,0,1,139,719.424460431655
18596,15,15500,81,"Tasa de exámenes médico legales por presunto delito sexual contra niños, niñas y adolescentes",2015,4,3,355,845.070422535211,0,187,0,3,168,1785.71428571429
18597,15,15507,81,"Tasa de exámenes médico legales por presunto delito sexual contra niños, niñas y adolescentes",2015,3,1,1437,69.589422407794,1,741,134.952766531714,0,696,0
18598,15,15516,81,"Tasa de exámenes médico legales por presunto delito sexual contra niños, niñas y adolescentes",2015,2,1,2633,37.9794910748196,1,1352,73.9644970414201,0,1281,0
18599,15,15516,81,"Tasa de exámenes médico legales por presunto delito sexual contra niños, niñas y adolescentes",2015,3,1,3324,30.0842358604091,1,1702,58.7544065804935,0,1622,0
18600,15,15516,81,"Tasa de exámenes médico legales por presunto delito sexual contra niños, niñas y adolescentes",2015,4,5,3466,144.258511252164,0,1787,0,5,1679,297.796307325789
18601,15,15516,121,Tasa de exámenes médico legales por presunto delito sexual cuando la víctima está entre 18 y 28 años,2015,5,1,4991,20.0360649168503,0,2527,0,1,2464,40.5844155844156
18602,15,15537,81,"Tasa de exámenes médico legales por presunto delito sexual contra niños, niñas y adolescentes",2015,4,1,549,182.149362477231,0,283,0,1,266,375.93984962406
18603,15,15550,81,"Tasa de exámenes médico legales por presunto delito sexual contra niños, niñas y adolescentes",2015,2,1,159,628.930817610063,0,85,0,1,74,1351.35135135135
18604,15,15550,81,"Tasa de exámenes médico legales por presunto delito sexual contra niños, niñas y adolescentes",2015,4,1,128,781.25,1,74,1351.35135135135,0,54,0
18605,15,15572,81,"Tasa de exámenes médico legales por presunto delito sexual contra niños, niñas y adolescentes",2015,2,7,5023,139.358948835357,1,2583,38.7146728610143,6,2440,245.901639344262
18606,15,15572,81,"Tasa de exámenes médico legales por presunto delito sexual contra niños, niñas y adolescentes",2015,3,15,6597,227.37608003638,5,3351,149.209191286183,10,3246,308.071472581639
18607,15,15572,81,"Tasa de exámenes médico legales por presunto delito sexual contra niños, niñas y adolescentes",2015,4,15,6473,231.731809052989,2,3328,60.0961538461538,13,3145,413.35453100159
18608,15,15572,121,Tasa de exámenes médico legales por presunto delito sexual cuando la víctima está entre 18 y 28 años,2015,5,3,9353,32.0752699668556,0,5005,0,3,4348,68.9972401103956
18609,15,15580,81,"Tasa de exámenes médico legales por presunto delito sexual contra niños, niñas y adolescentes",2015,3,1,825,121.212121212121,0,445,0,1,380,263.157894736842
18610,15,15599,81,"Tasa de exámenes médico legales por presunto delito sexual contra niños, niñas y adolescentes",2015,2,2,965,207.253886010363,0,494,0,2,471,424.628450106157
18611,15,15599,81,"Tasa de exámenes médico legales por presunto delito sexual contra niños, niñas y adolescentes",2015,4,5,1224,408.496732026144,1,643,155.52099533437,4,581,688.468158347676
18612,15,15600,81,"Tasa de exámenes médico legales por presunto delito sexual contra niños, niñas y adolescentes",2015,4,2,2084,95.9692898272553,0,1156,0,2,928,215.51724137931
18613,15,15632,81,"Tasa de exámenes médico legales por presunto delito sexual contra niños, niñas y adolescentes",2015,2,1,1163,85.9845227858985,0,599,0,1,564,177.304964539007
18614,15,15632,81,"Tasa de exámenes médico legales por presunto delito sexual contra niños, niñas y adolescentes",2015,4,1,1427,70.0770847932726,0,756,0,1,671,149.03129657228
18615,15,15632,121,Tasa de exámenes médico legales por presunto delito sexual cuando la víctima está entre 18 y 28 años,2015,5,1,2098,47.6644423260248,0,1122,0,1,976,102.459016393443
18616,15,15638,81,"Tasa de exámenes médico legales por presunto delito sexual contra niños, niñas y adolescentes",2015,4,1,483,207.03933747412,0,250,0,1,233,429.184549356223
18617,15,15646,81,"Tasa de exámenes médico legales por presunto delito sexual contra niños, niñas y adolescentes",2015,2,1,2100,47.6190476190476,1,1082,92.4214417744917,0,1018,0
18618,15,15646,81,"Tasa de exámenes médico legales por presunto delito sexual contra niños, niñas y adolescentes",2015,3,3,2639,113.679424024252,0,1369,0,3,1270,236.220472440945
18619,15,15646,81,"Tasa de exámenes médico legales por presunto delito sexual contra niños, niñas y adolescentes",2015,4,9,2505,359.281437125748,0,1313,0,9,1192,755.03355704698
18620,15,15676,81,"Tasa de exámenes médico legales por presunto delito sexual contra niños, niñas y adolescentes",2015,3,1,529,189.035916824197,0,276,0,1,253,395.256916996047
18621,15,15681,81,"Tasa de exámenes médico legales por presunto delito sexual contra niños, niñas y adolescentes",2015,4,4,1183,338.123415046492,0,639,0,4,544,735.294117647059
18622,15,15686,81,"Tasa de exámenes médico legales por presunto delito sexual contra niños, niñas y adolescentes",2015,2,1,750,133.333333333333,0,388,0,1,362,276.243093922652
18623,15,15686,81,"Tasa de exámenes médico legales por presunto delito sexual contra niños, niñas y adolescentes",2015,3,2,920,217.391304347826,0,484,0,2,436,458.715596330275
18624,15,15686,81,"Tasa de exámenes médico legales por presunto delito sexual contra niños, niñas y adolescentes",2015,4,3,883,339.750849377123,0,466,0,3,417,719.424460431655
18625,15,15690,81,"Tasa de exámenes médico legales por presunto delito sexual contra niños, niñas y adolescentes",2015,2,1,379,263.852242744063,1,192,520.833333333333,0,187,0
18626,15,15693,81,"Tasa de exámenes médico legales por presunto delito sexual contra niños, niñas y adolescentes",2015,3,1,1041,96.0614793467819,0,491,0,1,550,181.818181818182
18627,15,15693,121,Tasa de exámenes médico legales por presunto delito sexual cuando la víctima está entre 18 y 28 años,2015,5,1,2869,34.8553502962705,1,1821,54.9148819330038,0,1048,0
18628,15,15740,81,"Tasa de exámenes médico legales por presunto delito sexual contra niños, niñas y adolescentes",2015,3,2,1124,177.935943060498,0,578,0,2,546,366.300366300366
18629,15,15740,81,"Tasa de exámenes médico legales por presunto delito sexual contra niños, niñas y adolescentes",2015,4,2,1046,191.204588910134,0,546,0,2,500,400
18630,15,15740,121,Tasa de exámenes médico legales por presunto delito sexual cuando la víctima está entre 18 y 28 años,2015,5,1,1632,61.2745098039216,0,896,0,1,736,135.869565217391
18631,15,15755,81,"Tasa de exámenes médico legales por presunto delito sexual contra niños, niñas y adolescentes",2015,3,1,802,124.688279301746,0,420,0,1,382,261.780104712042
18632,15,15757,121,Tasa de exámenes médico legales por presunto delito sexual cuando la víctima está entre 18 y 28 años,2015,5,1,1130,88.4955752212389,0,613,0,1,517,193.423597678917
18633,15,15759,81,"Tasa de exámenes médico legales por presunto delito sexual contra niños, niñas y adolescentes",2015,2,3,8453,35.4903584526204,1,4244,23.5626767200754,2,4209,47.5172249940603
18634,15,15759,81,"Tasa de exámenes médico legales por presunto delito sexual contra niños, niñas y adolescentes",2015,3,8,11540,69.3240901213172,0,5777,0,8,5763,138.816588582336
18635,15,15759,81,"Tasa de exámenes médico legales por presunto delito sexual contra niños, niñas y adolescentes",2015,4,11,12173,90.3639201511542,0,6093,0,11,6080,180.921052631579
18636,15,15759,121,Tasa de exámenes médico legales por presunto delito sexual cuando la víctima está entre 18 y 28 años,2015,5,8,18859,42.4200646905987,1,9757,10.2490519626935,7,9102,76.9061744671501
18637,15,15762,81,"Tasa de exámenes médico legales por presunto delito sexual contra niños, niñas y adolescentes",2015,4,1,359,278.551532033426,0,188,0,1,171,584.795321637427
18638,15,15763,81,"Tasa de exámenes médico legales por presunto delito sexual contra niños, niñas y adolescentes",2015,3,4,1047,382.043935052531,2,524,381.679389312977,2,523,382.409177820268
18639,15,15763,81,"Tasa de exámenes médico legales por presunto delito sexual contra niños, niñas y adolescentes",2015,4,2,964,207.46887966805,0,486,0,2,478,418.410041841004
18640,15,15764,81,"Tasa de exámenes médico legales por presunto delito sexual contra niños, niñas y adolescentes",2015,4,2,633,315.955766192733,0,328,0,2,305,655.737704918033
18641,15,15774,81,"Tasa de exámenes médico legales por presunto delito sexual contra niños, niñas y adolescentes",2015,4,1,374,267.379679144385,0,200,0,1,174,574.712643678161
18642,15,15776,81,"Tasa de exámenes médico legales por presunto delito sexual contra niños, niñas y adolescentes",2015,4,1,665,150.375939849624,0,346,0,1,319,313.479623824451
18643,15,15778,81,"Tasa de exámenes médico legales por presunto delito sexual contra niños, niñas y adolescentes",2015,3,1,367,272.479564032698,0,181,0,1,186,537.634408602151
18644,15,15804,81,"Tasa de exámenes médico legales por presunto delito sexual contra niños, niñas y adolescentes",2015,3,2,982,203.665987780041,0,509,0,2,473,422.832980972516
18645,15,15804,81,"Tasa de exámenes médico legales por presunto delito sexual contra niños, niñas y adolescentes",2015,4,1,969,103.199174406605,1,508,196.850393700787,0,461,0
18646,15,15806,81,"Tasa de exámenes médico legales por presunto delito sexual contra niños, niñas y adolescentes",2015,2,1,1218,82.1018062397373,0,626,0,1,592,168.918918918919
18647,15,15806,81,"Tasa de exámenes médico legales por presunto delito sexual contra niños, niñas y adolescentes",2015,3,2,1607,124.455507156192,1,828,120.772946859903,1,779,128.369704749679
18648,15,15806,81,"Tasa de exámenes médico legales por presunto delito sexual contra niños, niñas y adolescentes",2015,4,3,1611,186.219739292365,0,833,0,3,778,385.60411311054
18649,15,15814,81,"Tasa de exámenes médico legales por presunto delito sexual contra niños, niñas y adolescentes",2015,4,2,1184,168.918918918919,1,624,160.25641025641,1,560,178.571428571429
18650,15,15814,121,Tasa de exámenes médico legales por presunto delito sexual cuando la víctima está entre 18 y 28 años,2015,5,1,1671,59.8444045481747,0,896,0,1,775,129.032258064516
18651,15,15816,81,"Tasa de exámenes médico legales por presunto delito sexual contra niños, niñas y adolescentes",2015,2,1,505,198.019801980198,0,259,0,1,246,406.50406504065
18652,15,15820,81,"Tasa de exámenes médico legales por presunto delito sexual contra niños, niñas y adolescentes",2015,4,3,424,707.547169811321,0,206,0,3,218,1376.14678899083
18653,15,15835,81,"Tasa de exámenes médico legales por presunto delito sexual contra niños, niñas y adolescentes",2015,3,2,695,287.769784172662,0,361,0,2,334,598.802395209581
18654,15,15835,81,"Tasa de exámenes médico legales por presunto delito sexual contra niños, niñas y adolescentes",2015,4,1,686,145.772594752187,1,363,275.482093663912,0,323,0
18655,15,15837,81,"Tasa de exámenes médico legales por presunto delito sexual contra niños, niñas y adolescentes",2015,2,1,895,111.731843575419,1,471,212.314225053079,0,424,0
18656,15,15837,81,"Tasa de exámenes médico legales por presunto delito sexual contra niños, niñas y adolescentes",2015,3,2,1115,179.372197309417,0,581,0,2,534,374.531835205993
18657,15,15837,81,"Tasa de exámenes médico legales por presunto delito sexual contra niños, niñas y adolescentes",2015,4,3,1055,284.36018957346,0,542,0,3,513,584.795321637427
18658,15,15842,81,"Tasa de exámenes médico legales por presunto delito sexual contra niños, niñas y adolescentes",2015,4,1,1280,78125,0,676,0,1,604,165.562913907285
18659,15,15861,81,"Tasa de exámenes médico legales por presunto delito sexual contra niños, niñas y adolescentes",2015,3,1,1913,52.2739153162572,0,969,0,1,944,105.932203389831
18660,15,15861,81,"Tasa de exámenes médico legales por presunto delito sexual contra niños, niñas y adolescentes",2015,4,3,1913,156.821745948772,0,949,0,3,964,311.203319502075
18661,15,15861,121,Tasa de exámenes médico legales por presunto delito sexual cuando la víctima está entre 18 y 28 años,2015,5,2,2531,79.0201501382853,2,1284,155.763239875389,0,1247,0
18662,15,15879,81,"Tasa de exámenes médico legales por presunto delito sexual contra niños, niñas y adolescentes",2015,4,2,376,531.914893617021,0,212,0,2,164,1219.51219512195
18663,17,17001,81,"Tasa de exámenes médico legales por presunto delito sexual contra niños, niñas y adolescentes",2015,2,56,25683,218.043063505042,13,13134,98.9797472209532,43,12549,342.656785401227
18664,17,17001,81,"Tasa de exámenes médico legales por presunto delito sexual contra niños, niñas y adolescentes",2015,3,61,32588,187.185467043083,18,16575,108.597285067873,43,16013,268.531817897958
18665,17,17001,81,"Tasa de exámenes médico legales por presunto delito sexual contra niños, niñas y adolescentes",2015,4,99,35138,281.746257612841,30,17868,167.897918065816,69,17270,399.536768963521
18666,17,17001,121,Tasa de exámenes médico legales por presunto delito sexual cuando la víctima está entre 18 y 28 años,2015,5,18,76180,23.6282488842216,1,39364,2.54039223656132,17,36816,46.1755758365928
18667,17,17001,81,"Tasa de exámenes médico legales por presunto delito sexual contra niños, niñas y adolescentes",2015,1,1,5041,19.8373338623289,0,2585,0,1,2456,40.7166123778502
18668,17,17013,81,"Tasa de exámenes médico legales por presunto delito sexual contra niños, niñas y adolescentes",2015,4,1,2277,43.9174352217831,0,1167,0,1,1110,90.0900900900901
18669,17,17042,81,"Tasa de exámenes médico legales por presunto delito sexual contra niños, niñas y adolescentes",2015,2,5,2799,178.635226866738,1,1431,69.8812019566736,4,1368,292.397660818713
18670,17,17042,81,"Tasa de exámenes médico legales por presunto delito sexual contra niños, niñas y adolescentes",2015,3,13,3443,377.577693871624,4,1720,232.558139534884,9,1723,522.344747533372
18671,17,17042,81,"Tasa de exámenes médico legales por presunto delito sexual contra niños, niñas y adolescentes",2015,4,7,3316,211.097708082027,1,1646,60.7533414337788,6,1670,359.281437125748
18672,17,17042,121,Tasa de exámenes médico legales por presunto delito sexual cuando la víctima está entre 18 y 28 años,2015,5,3,5514,54.4069640914037,0,2776,0,3,2738,109.569028487947
18673,17,17050,81,"Tasa de exámenes médico legales por presunto delito sexual contra niños, niñas y adolescentes",2015,3,1,1275,78.4313725490196,0,652,0,1,623,160.513643659711
18674,17,17050,81,"Tasa de exámenes médico legales por presunto delito sexual contra niños, niñas y adolescentes",2015,4,2,1190,168.067226890756,0,610,0,2,580,344.827586206897
18675,17,17050,121,Tasa de exámenes médico legales por presunto delito sexual cuando la víctima está entre 18 y 28 años,2015,5,2,2135,93.6768149882904,0,1095,0,2,1040,192.307692307692
18676,17,17088,81,"Tasa de exámenes médico legales por presunto delito sexual contra niños, niñas y adolescentes",2015,2,1,990,101.010101010101,0,513,0,1,477,209.643605870021
18677,17,17088,121,Tasa de exámenes médico legales por presunto delito sexual cuando la víctima está entre 18 y 28 años,2015,5,1,2019,49.5294700346706,0,1046,0,1,973,102.774922918808
18678,17,17174,81,"Tasa de exámenes médico legales por presunto delito sexual contra niños, niñas y adolescentes",2015,2,12,4405,272.417707150965,0,2250,0,12,2155,556.844547563805
18679,17,17174,81,"Tasa de exámenes médico legales por presunto delito sexual contra niños, niñas y adolescentes",2015,3,18,5420,332.10332103321,5,2749,181.884321571481,13,2671,486.709097716211
18680,17,17174,81,"Tasa de exámenes médico legales por presunto delito sexual contra niños, niñas y adolescentes",2015,4,18,5311,338.919224251553,1,2667,37.4953130858643,17,2644,642.965204236006
18681,17,17174,121,Tasa de exámenes médico legales por presunto delito sexual cuando la víctima está entre 18 y 28 años,2015,5,1,9595,10.4220948410631,1,4699,21.2811236433284,0,4896,0
18682,17,17272,81,"Tasa de exámenes médico legales por presunto delito sexual contra niños, niñas y adolescentes",2015,2,1,1014,98.6193293885602,0,519,0,1,495,202.020202020202
18683,17,17272,81,"Tasa de exámenes médico legales por presunto delito sexual contra niños, niñas y adolescentes",2015,3,1,1216,82.2368421052632,0,628,0,1,588,170.068027210884
18684,17,17380,81,"Tasa de exámenes médico legales por presunto delito sexual contra niños, niñas y adolescentes",2015,2,6,7040,85.2272727272727,2,3614,55.3403431101273,4,3426,116.754232340922
18685,17,17380,81,"Tasa de exámenes médico legales por presunto delito sexual contra niños, niñas y adolescentes",2015,3,13,8281,156.985871271586,4,4200,95.2380952380952,9,4081,220.534182798334
18686,17,17380,81,"Tasa de exámenes médico legales por presunto delito sexual contra niños, niñas y adolescentes",2015,4,12,7939,151.152538103036,3,4023,74.5712155108128,9,3916,229.826353421859
18687,17,17380,121,Tasa de exámenes médico legales por presunto delito sexual cuando la víctima está entre 18 y 28 años,2015,5,1,14983,6.67423079490089,1,7685,13.0123617436565,0,7298,0
18688,17,17433,81,"Tasa de exámenes médico legales por presunto delito sexual contra niños, niñas y adolescentes",2015,2,2,2158,92.678405931418,1,1104,90.5797101449275,1,1054,94.876660341556
18689,17,17433,81,"Tasa de exámenes médico legales por presunto delito sexual contra niños, niñas y adolescentes",2015,3,2,2535,78.8954635108481,0,1304,0,2,1231,162.46953696182
18690,17,17433,81,"Tasa de exámenes médico legales por presunto delito sexual contra niños, niñas y adolescentes",2015,4,4,2587,154.619250096637,1,1337,74.794315632012,3,1250,240
18691,17,17442,81,"Tasa de exámenes médico legales por presunto delito sexual contra niños, niñas y adolescentes",2015,3,1,1129,88.5739592559787,0,581,0,1,548,182.481751824818
18692,17,17442,81,"Tasa de exámenes médico legales por presunto delito sexual contra niños, niñas y adolescentes",2015,4,1,1102,90.7441016333938,0,576,0,1,526,190.114068441065
18693,17,17486,81,"Tasa de exámenes médico legales por presunto delito sexual contra niños, niñas y adolescentes",2015,2,1,3190,31.3479623824451,0,1640,0,1,1550,64.5161290322581
18694,17,17486,81,"Tasa de exámenes médico legales por presunto delito sexual contra niños, niñas y adolescentes",2015,3,3,3818,78.5751702462022,0,1969,0,3,1849,162.249864791779
18695,17,17486,81,"Tasa de exámenes médico legales por presunto delito sexual contra niños, niñas y adolescentes",2015,4,3,3563,84.1987089531294,0,1838,0,3,1725,173.913043478261
18696,17,17495,81,"Tasa de exámenes médico legales por presunto delito sexual contra niños, niñas y adolescentes",2015,4,1,784,127.551020408163,1,417,239.808153477218,0,367,0
18697,17,17495,121,Tasa de exámenes médico legales por presunto delito sexual cuando la víctima está entre 18 y 28 años,2015,5,1,1322,75.642965204236,0,730,0,1,592,168.918918918919
18698,17,17513,81,"Tasa de exámenes médico legales por presunto delito sexual contra niños, niñas y adolescentes",2015,3,1,1772,56.4334085778781,0,933,0,1,839,119.189511323004
18699,17,17524,81,"Tasa de exámenes médico legales por presunto delito sexual contra niños, niñas y adolescentes",2015,3,3,2042,146.914789422135,0,1056,0,3,986,304.259634888438
18700,17,17524,81,"Tasa de exámenes médico legales por presunto delito sexual contra niños, niñas y adolescentes",2015,4,4,1906,209.863588667366,0,994,0,4,912,438.59649122807
18701,17,17541,81,"Tasa de exámenes médico legales por presunto delito sexual contra niños, niñas y adolescentes",2015,4,1,2714,36.8459837877671,0,1424,0,1,1290,77.5193798449612
18702,17,17541,121,Tasa de exámenes médico legales por presunto delito sexual cuando la víctima está entre 18 y 28 años,2015,5,1,4725,21.1640211640212,1,2440,40.9836065573771,0,2285,0
18703,17,17614,81,"Tasa de exámenes médico legales por presunto delito sexual contra niños, niñas y adolescentes",2015,2,3,5193,57.7700751010976,0,2659,0,3,2534,118.389897395422
18704,17,17614,81,"Tasa de exámenes médico legales por presunto delito sexual contra niños, niñas y adolescentes",2015,3,14,6084,230.111768573307,2,3152,63.4517766497462,12,2932,409.276944065484
18705,17,17614,81,"Tasa de exámenes médico legales por presunto delito sexual contra niños, niñas y adolescentes",2015,4,12,5863,204.673375405083,2,3057,65.4236179260713,10,2806,356.379187455453
18706,17,17614,121,Tasa de exámenes médico legales por presunto delito sexual cuando la víctima está entre 18 y 28 años,2015,5,5,10799,46.3005833873507,0,5436,0,5,5363,93.231400335633
18707,17,17616,81,"Tasa de exámenes médico legales por presunto delito sexual contra niños, niñas y adolescentes",2015,3,2,1111,180.01800180018,0,589,0,2,522,383.141762452107
18708,17,17616,81,"Tasa de exámenes médico legales por presunto delito sexual contra niños, niñas y adolescentes",2015,4,2,1045,191.387559808612,0,561,0,2,484,413.223140495868
18709,17,17653,81,"Tasa de exámenes médico legales por presunto delito sexual contra niños, niñas y adolescentes",2015,2,4,1588,251.889168765743,2,816,245.098039215686,2,772,259.067357512953
18710,17,17653,81,"Tasa de exámenes médico legales por presunto delito sexual contra niños, niñas y adolescentes",2015,3,8,1950,410.25641025641,2,1008,198.412698412698,6,942,636.942675159236
18711,17,17653,81,"Tasa de exámenes médico legales por presunto delito sexual contra niños, niñas y adolescentes",2015,4,11,1850,594.594594594595,2,972,205.761316872428,9,878,1025.0569476082
18712,17,17653,121,Tasa de exámenes médico legales por presunto delito sexual cuando la víctima está entre 18 y 28 años,2015,5,2,2946,67.8886625933469,0,1585,0,2,1361,146.95077149155
18713,17,17662,81,"Tasa de exámenes médico legales por presunto delito sexual contra niños, niñas y adolescentes",2015,2,1,2533,39.4788787998421,0,1296,0,1,1237,80.8407437348424
18714,17,17662,81,"Tasa de exámenes médico legales por presunto delito sexual contra niños, niñas y adolescentes",2015,3,1,2873,34.8068221371389,1,1491,67.0690811535882,0,1382,0
18715,17,17662,81,"Tasa de exámenes médico legales por presunto delito sexual contra niños, niñas y adolescentes",2015,4,1,2806,35.6379187455453,0,1492,0,1,1314,76.103500761035
18716,17,17662,121,Tasa de exámenes médico legales por presunto delito sexual cuando la víctima está entre 18 y 28 años,2015,5,1,5285,18.9214758751183,0,2888,0,1,2397,41.7188151856487
18717,17,17665,81,"Tasa de exámenes médico legales por presunto delito sexual contra niños, niñas y adolescentes",2015,4,3,781,384.122919334187,0,397,0,3,384,781.25
18718,17,17777,81,"Tasa de exámenes médico legales por presunto delito sexual contra niños, niñas y adolescentes",2015,2,1,2390,41.8410041841004,0,1220,0,1,1170,85.4700854700855
18719,17,17777,81,"Tasa de exámenes médico legales por presunto delito sexual contra niños, niñas y adolescentes",2015,4,6,2748,218.340611353712,0,1392,0,6,1356,442.477876106195
18720,17,17873,81,"Tasa de exámenes médico legales por presunto delito sexual contra niños, niñas y adolescentes",2015,2,6,4461,134.498991257566,1,2304,43.4027777777778,5,2157,231.803430690774
18721,17,17873,81,"Tasa de exámenes médico legales por presunto delito sexual contra niños, niñas y adolescentes",2015,3,10,5396,185.322461082283,1,2775,36.036036036036,9,2621,343.380389164441
18722,17,17873,81,"Tasa de exámenes médico legales por presunto delito sexual contra niños, niñas y adolescentes",2015,4,16,5364,298.284862043251,1,2763,36.1925443358668,15,2601,576.701268742791
18723,17,17873,121,Tasa de exámenes médico legales por presunto delito sexual cuando la víctima está entre 18 y 28 años,2015,5,2,10977,18.2199143664025,0,5507,0,2,5470,36.563071297989
18724,17,17877,81,"Tasa de exámenes médico legales por presunto delito sexual contra niños, niñas y adolescentes",2015,4,4,1400,285.714285714286,0,720,0,4,680,588.235294117647
18725,18,18001,81,"Tasa de exámenes médico legales por presunto delito sexual contra niños, niñas y adolescentes",2015,2,13,16655,78.0546382467727,3,8403,35.7015351660121,10,8252,121.182743577315
18726,18,18001,81,"Tasa de exámenes médico legales por presunto delito sexual contra niños, niñas y adolescentes",2015,3,50,20120,248.508946322068,10,10140,98.6193293885602,40,9980,400.801603206413
18727,18,18001,81,"Tasa de exámenes médico legales por presunto delito sexual contra niños, niñas y adolescentes",2015,4,42,20523,204.648443210057,1,10358,9.65437343116432,41,10165,403.344810624693
18728,18,18001,121,Tasa de exámenes médico legales por presunto delito sexual cuando la víctima está entre 18 y 28 años,2015,5,11,35108,31.3318901674832,2,17936,11.1507582515611,9,17172,52.4109014675052
18729,18,18001,81,"Tasa de exámenes médico legales por presunto delito sexual contra niños, niñas y adolescentes",2015,1,1,3384,29.5508274231678,0,1728,0,1,1656,60.3864734299517
18730,18,18029,121,Tasa de exámenes médico legales por presunto delito sexual cuando la víctima está entre 18 y 28 años,2015,5,1,1309,76.3941940412529,0,661,0,1,648,154.320987654321
18731,18,18150,81,"Tasa de exámenes médico legales por presunto delito sexual contra niños, niñas y adolescentes",2015,3,4,5005,79.9200799200799,2,2550,78.4313725490196,2,2455,81.4663951120163
18732,18,18150,81,"Tasa de exámenes médico legales por presunto delito sexual contra niños, niñas y adolescentes",2015,4,1,4555,21.953896816685,0,2275,0,1,2280,43.859649122807
18733,18,18150,121,Tasa de exámenes médico legales por presunto delito sexual cuando la víctima está entre 18 y 28 años,2015,5,1,6292,15.8931977113795,0,3104,0,1,3188,31.3676286072773
18734,18,18247,81,"Tasa de exámenes médico legales por presunto delito sexual contra niños, niñas y adolescentes",2015,4,1,2745,36.4298724954463,0,1407,0,1,1338,74.7384155455904
18735,18,18410,81,"Tasa de exámenes médico legales por presunto delito sexual contra niños, niñas y adolescentes",2015,2,1,2843,35.1741118536757,1,1455,68.7285223367698,0,1388,0
18736,18,18410,81,"Tasa de exámenes médico legales por presunto delito sexual contra niños, niñas y adolescentes",2015,3,1,3354,29.8151460942159,0,1720,0,1,1634,61.1995104039168
18737,18,18410,121,Tasa de exámenes médico legales por presunto delito sexual cuando la víctima está entre 18 y 28 años,2015,5,1,4883,20.4792135981978,0,2505,0,1,2378,42.0521446593776
18738,18,18460,81,"Tasa de exámenes médico legales por presunto delito sexual contra niños, niñas y adolescentes",2015,4,1,1633,61.2369871402327,0,832,0,1,801,124.843945068664
18739,18,18460,121,Tasa de exámenes médico legales por presunto delito sexual cuando la víctima está entre 18 y 28 años,2015,5,2,2319,86.244070720138,0,1180,0,2,1139,175.592625109745
18740,18,18592,81,"Tasa de exámenes médico legales por presunto delito sexual contra niños, niñas y adolescentes",2015,4,3,4409,68.0426400544341,0,2288,0,3,2121,141.442715700141
18741,18,18610,81,"Tasa de exámenes médico legales por presunto delito sexual contra niños, niñas y adolescentes",2015,3,1,2047,48.8519785051295,0,1061,0,1,986,101.419878296146
18742,18,18610,81,"Tasa de exámenes médico legales por presunto delito sexual contra niños, niñas y adolescentes",2015,4,3,1959,153.139356814701,1,1031,96.9932104752667,2,928,215.51724137931
18743,18,18753,81,"Tasa de exámenes médico legales por presunto delito sexual contra niños, niñas y adolescentes",2015,3,8,9305,85.9752821063944,1,4731,21.137180300148,7,4574,153.038915609969
18744,18,18753,81,"Tasa de exámenes médico legales por presunto delito sexual contra niños, niñas y adolescentes",2015,4,6,8924,67.2344240251009,1,4554,21.9587176108915,5,4370,114.41647597254
18745,18,18753,121,Tasa de exámenes médico legales por presunto delito sexual cuando la víctima está entre 18 y 28 años,2015,5,3,14051,21.3507935378265,0,7278,0,3,6773,44.2935183818101
18746,18,18785,81,"Tasa de exámenes médico legales por presunto delito sexual contra niños, niñas y adolescentes",2015,2,1,1085,92.1658986175115,0,555,0,1,530,188.679245283019
18747,18,18860,81,"Tasa de exámenes médico legales por presunto delito sexual contra niños, niñas y adolescentes",2015,4,1,1525,65.5737704918033,0,792,0,1,733,136.425648021828
18748,19,19001,81,"Tasa de exámenes médico legales por presunto delito sexual contra niños, niñas y adolescentes",2015,2,27,18708,144.323284156511,7,9521,73.521688898225,20,9187,217.698922390334
18749,19,19001,81,"Tasa de exámenes médico legales por presunto delito sexual contra niños, niñas y adolescentes",2015,3,46,23888,192.565304755526,17,12140,140.03294892916,29,11748,246.850527749404
18750,19,19001,81,"Tasa de exámenes médico legales por presunto delito sexual contra niños, niñas y adolescentes",2015,4,81,26711,303.245853768111,7,13498,51.8595347458883,74,13213,560.05449178839
18751,19,19001,121,Tasa de exámenes médico legales por presunto delito sexual cuando la víctima está entre 18 y 28 años,2015,5,27,52188,51.7360312715567,3,26095,11.4964552596283,24,26093,91.9786916031119
18752,19,19050,81,"Tasa de exámenes médico legales por presunto delito sexual contra niños, niñas y adolescentes",2015,4,2,3192,62.65664160401,0,1599,0,2,1593,125.549278091651
18753,19,19100,81,"Tasa de exámenes médico legales por presunto delito sexual contra niños, niñas y adolescentes",2015,3,3,4590,65.359477124183,0,2354,0,3,2236,134.168157423971
18754,19,19100,81,"Tasa de exámenes médico legales por presunto delito sexual contra niños, niñas y adolescentes",2015,4,1,4861,20.571898786258,0,2528,0,1,2333,42.863266180883
18755,19,19110,81,"Tasa de exámenes médico legales por presunto delito sexual contra niños, niñas y adolescentes",2015,3,1,3704,26.9978401727862,0,1880,0,1,1824,54.8245614035088
18756,19,19110,81,"Tasa de exámenes médico legales por presunto delito sexual contra niños, niñas y adolescentes",2015,4,1,3950,25.3164556962025,1,2012,49.7017892644135,0,1938,0
18757,19,19130,81,"Tasa de exámenes médico legales por presunto delito sexual contra niños, niñas y adolescentes",2015,3,1,4582,21.8245307725884,0,2386,0,1,2196,45.5373406193078
18758,19,19130,81,"Tasa de exámenes médico legales por presunto delito sexual contra niños, niñas y adolescentes",2015,4,2,4559,43.8692695766616,0,2436,0,2,2123,94.2063118228921
18759,19,19130,121,Tasa de exámenes médico legales por presunto delito sexual cuando la víctima está entre 18 y 28 años,2015,5,2,7364,27.1591526344378,0,4008,0,2,3356,59.5947556615018
18760,19,19137,81,"Tasa de exámenes médico legales por presunto delito sexual contra niños, niñas y adolescentes",2015,4,5,4357,114.757860913473,0,2217,0,5,2140,233.644859813084
18761,19,19142,81,"Tasa de exámenes médico legales por presunto delito sexual contra niños, niñas y adolescentes",2015,2,1,1516,65.9630606860158,0,768,0,1,748,133.689839572193
18762,19,19142,81,"Tasa de exámenes médico legales por presunto delito sexual contra niños, niñas y adolescentes",2015,4,2,1998,100.1001001001,0,1026,0,2,972,205.761316872428
18763,19,19142,121,Tasa de exámenes médico legales por presunto delito sexual cuando la víctima está entre 18 y 28 años,2015,5,1,3579,27.9407655769768,0,1778,0,1,1801,55.5247084952804
18764,19,19212,81,"Tasa de exámenes médico legales por presunto delito sexual contra niños, niñas y adolescentes",2015,2,17,3118,545.221295702373,13,1590,817.610062893082,4,1528,261.780104712042
18765,19,19212,81,"Tasa de exámenes médico legales por presunto delito sexual contra niños, niñas y adolescentes",2015,3,8,3598,222.345747637576,0,1820,0,8,1778,449.943757030371
18766,19,19212,81,"Tasa de exámenes médico legales por presunto delito sexual contra niños, niñas y adolescentes",2015,4,7,3959,176.812326345037,0,2025,0,7,1934,361.944157187177
18767,19,19212,121,Tasa de exámenes médico legales por presunto delito sexual cuando la víctima está entre 18 y 28 años,2015,5,1,6723,14.8743120630671,0,3545,0,1,3178,31.4663310258024
18768,19,19256,81,"Tasa de exámenes médico legales por presunto delito sexual contra niños, niñas y adolescentes",2015,2,2,4498,44.4642063139173,1,2312,43.2525951557093,1,2186,45.7456541628545
18769,19,19256,81,"Tasa de exámenes médico legales por presunto delito sexual contra niños, niñas y adolescentes",2015,3,3,5268,56.9476082004556,1,2720,36.7647058823529,2,2548,78.4929356357928
18770,19,19256,81,"Tasa de exámenes médico legales por presunto delito sexual contra niños, niñas y adolescentes",2015,4,4,4802,83.298625572678,0,2494,0,4,2308,173.310225303293
18771,19,19256,121,Tasa de exámenes médico legales por presunto delito sexual cuando la víctima está entre 18 y 28 años,2015,5,1,8050,12.4223602484472,0,4226,0,1,3824,26.1506276150628
18772,19,19300,81,"Tasa de exámenes médico legales por presunto delito sexual contra niños, niñas y adolescentes",2015,2,3,2221,135.074290859973,0,1124,0,3,1097,273.473108477666
18773,19,19300,81,"Tasa de exámenes médico legales por presunto delito sexual contra niños, niñas y adolescentes",2015,3,3,2513,119.379228014326,0,1254,0,3,1259,238.284352660842
18774,19,19300,81,"Tasa de exámenes médico legales por presunto delito sexual contra niños, niñas y adolescentes",2015,4,2,2493,80.2246289610911,0,1212,0,2,1281,156.128024980484
18775,19,19355,81,"Tasa de exámenes médico legales por presunto delito sexual contra niños, niñas y adolescentes",2015,4,2,4183,47.812574707148,0,2154,0,2,2029,98.570724494825
18776,19,19392,81,"Tasa de exámenes médico legales por presunto delito sexual contra niños, niñas y adolescentes",2015,2,1,841,118.906064209275,0,430,0,1,411,243.30900243309
18777,19,19392,81,"Tasa de exámenes médico legales por presunto delito sexual contra niños, niñas y adolescentes",2015,3,10,967,1034.12616339193,0,503,0,10,464,2155.1724137931
18778,19,19418,81,"Tasa de exámenes médico legales por presunto delito sexual contra niños, niñas y adolescentes",2015,4,1,2952,33.8753387533875,0,1463,0,1,1489,67.1591672263264
18779,19,19418,121,Tasa de exámenes médico legales por presunto delito sexual cuando la víctima está entre 18 y 28 años,2015,5,2,4435,45.0958286358512,0,2232,0,2,2203,90.7852927825692
18780,19,19450,81,"Tasa de exámenes médico legales por presunto delito sexual contra niños, niñas y adolescentes",2015,3,1,1994,50.1504513540622,0,1015,0,1,979,102.145045965271
18781,19,19455,81,"Tasa de exámenes médico legales por presunto delito sexual contra niños, niñas y adolescentes",2015,2,2,4229,47.2925041380941,1,2164,46.2107208872458,1,2065,48.4261501210654
18782,19,19455,81,"Tasa de exámenes médico legales por presunto delito sexual contra niños, niñas y adolescentes",2015,3,4,4988,80.1924619085806,1,2508,39.8724082934609,3,2480,120.967741935484
18783,19,19455,81,"Tasa de exámenes médico legales por presunto delito sexual contra niños, niñas y adolescentes",2015,4,4,5079,78.755660563103,0,2601,0,4,2478,161.420500403551
18784,19,19455,121,Tasa de exámenes médico legales por presunto delito sexual cuando la víctima está entre 18 y 28 años,2015,5,2,8042,24.869435463815,0,4147,0,2,3895,51.3478818998716
18785,19,19473,81,"Tasa de exámenes médico legales por presunto delito sexual contra niños, niñas y adolescentes",2015,3,1,3096,32.2997416020672,0,1592,0,1,1504,66.4893617021277
18786,19,19513,81,"Tasa de exámenes médico legales por presunto delito sexual contra niños, niñas y adolescentes",2015,3,3,901,332.963374028857,0,454,0,3,447,671.140939597315
18787,19,19517,81,"Tasa de exámenes médico legales por presunto delito sexual contra niños, niñas y adolescentes",2015,3,1,4876,20.5086136177194,0,2512,0,1,2364,42.3011844331641
18788,19,19532,81,"Tasa de exámenes médico legales por presunto delito sexual contra niños, niñas y adolescentes",2015,2,3,3598,83.3796553640912,1,1849,54.0832882639264,2,1749,114.351057747284
18789,19,19532,81,"Tasa de exámenes médico legales por presunto delito sexual contra niños, niñas y adolescentes",2015,3,4,4205,95.1248513674197,0,2178,0,4,2027,197.335964479526
18790,19,19532,81,"Tasa de exámenes médico legales por presunto delito sexual contra niños, niñas y adolescentes",2015,4,2,4584,43.630017452007,0,2399,0,2,2185,91.533180778032
18791,19,19533,81,"Tasa de exámenes médico legales por presunto delito sexual contra niños, niñas y adolescentes",2015,4,1,998,100.200400801603,0,524,0,1,474,210.970464135021
18792,19,19548,81,"Tasa de exámenes médico legales por presunto delito sexual contra niños, niñas y adolescentes",2015,3,2,4707,42.4899086466964,0,2407,0,2,2300,86.9565217391304
18793,19,19548,81,"Tasa de exámenes médico legales por presunto delito sexual contra niños, niñas y adolescentes",2015,4,4,4931,81.119448387751,0,2527,0,4,2404,166.389351081531
18794,19,19548,121,Tasa de exámenes médico legales por presunto delito sexual cuando la víctima está entre 18 y 28 años,2015,5,1,8556,11.6877045348294,0,4336,0,1,4220,23.696682464455
18795,19,19573,81,"Tasa de exámenes médico legales por presunto delito sexual contra niños, niñas y adolescentes",2015,3,2,4785,41.7972831765935,0,2422,0,2,2363,84.6381718154888
18796,19,19573,81,"Tasa de exámenes médico legales por presunto delito sexual contra niños, niñas y adolescentes",2015,4,10,5229,191.241155096577,1,2648,37.7643504531722,9,2581,348.702053467648
18797,19,19573,121,Tasa de exámenes médico legales por presunto delito sexual cuando la víctima está entre 18 y 28 años,2015,5,2,9377,21.3287831929188,0,4675,0,2,4702,42.5350914504466
18798,19,19585,81,"Tasa de exámenes médico legales por presunto delito sexual contra niños, niñas y adolescentes",2015,3,2,1755,113.960113960114,0,903,0,2,852,234.741784037559
18799,19,19585,81,"Tasa de exámenes médico legales por presunto delito sexual contra niños, niñas y adolescentes",2015,4,3,1931,155.359917141378,0,996,0,3,935,320.855614973262
18800,19,19622,81,"Tasa de exámenes médico legales por presunto delito sexual contra niños, niñas y adolescentes",2015,2,1,1102,90.7441016333938,1,561,178.25311942959,0,541,0
18801,19,19693,81,"Tasa de exámenes médico legales por presunto delito sexual contra niños, niñas y adolescentes",2015,4,1,1394,71.7360114777618,0,737,0,1,657,152.20700152207
18802,19,19698,81,"Tasa de exámenes médico legales por presunto delito sexual contra niños, niñas y adolescentes",2015,2,9,8063,111.620984745132,5,4076,122.669283611384,4,3987,100.326059694006
18803,19,19698,81,"Tasa de exámenes médico legales por presunto delito sexual contra niños, niñas y adolescentes",2015,3,15,9786,153.280196198651,3,4942,60.7041683528936,12,4844,247.729149463253
18804,19,19698,81,"Tasa de exámenes médico legales por presunto delito sexual contra niños, niñas y adolescentes",2015,4,8,10649,75.1244248286224,2,5474,36.5363536719035,6,5175,115.942028985507
18805,19,19698,121,Tasa de exámenes médico legales por presunto delito sexual cuando la víctima está entre 18 y 28 años,2015,5,3,18985,15.8019489070319,0,9420,0,3,9565,31.3643491897543
18806,19,19785,81,"Tasa de exámenes médico legales por presunto delito sexual contra niños, niñas y adolescentes",2015,2,1,760,131.578947368421,0,387,0,1,373,268.096514745308
18807,19,19785,81,"Tasa de exámenes médico legales por presunto delito sexual contra niños, niñas y adolescentes",2015,3,1,909,110.01100110011,0,468,0,1,441,226.757369614512
18808,19,19785,81,"Tasa de exámenes médico legales por presunto delito sexual contra niños, niñas y adolescentes",2015,4,2,962,207.900207900208,0,501,0,2,461,433.839479392625
18809,19,19807,81,"Tasa de exámenes médico legales por presunto delito sexual contra niños, niñas y adolescentes",2015,2,1,2676,37.3692077727952,0,1377,0,1,1299,76.9822940723633
18810,19,19807,81,"Tasa de exámenes médico legales por presunto delito sexual contra niños, niñas y adolescentes",2015,3,3,3237,92.678405931418,0,1689,0,3,1548,193.798449612403
18811,19,19807,81,"Tasa de exámenes médico legales por presunto delito sexual contra niños, niñas y adolescentes",2015,4,6,3432,174.825174825175,1,1817,55.0357732526142,5,1615,309.597523219814
18812,19,19821,81,"Tasa de exámenes médico legales por presunto delito sexual contra niños, niñas y adolescentes",2015,3,1,3849,25.980774227072,0,1959,0,1,1890,52.9100529100529
18813,19,19824,81,"Tasa de exámenes médico legales por presunto delito sexual contra niños, niñas y adolescentes",2015,3,4,2690,148.698884758364,1,1372,72.8862973760933,3,1318,227.617602427921
18814,19,19824,81,"Tasa de exámenes médico legales por presunto delito sexual contra niños, niñas y adolescentes",2015,4,2,2685,74.487895716946,0,1364,0,2,1321,151.400454201363
18815,19,19824,121,Tasa de exámenes médico legales por presunto delito sexual cuando la víctima está entre 18 y 28 años,2015,5,3,3906,76.8049155145929,0,2011,0,3,1895,158.311345646438
18816,19,19845,81,"Tasa de exámenes médico legales por presunto delito sexual contra niños, niñas y adolescentes",2015,4,7,2001,349.825087456272,0,1020,0,7,981,713.557594291539
18817,20,20001,81,"Tasa de exámenes médico legales por presunto delito sexual contra niños, niñas y adolescentes",2015,2,56,44253,126.545092988046,13,22532,57.6957216403337,43,21721,197.965102895815
18818,20,20001,81,"Tasa de exámenes médico legales por presunto delito sexual contra niños, niñas y adolescentes",2015,3,120,54393,220.616623462578,22,27528,79.9186283057251,98,26865,364.786897450214
18819,20,20001,81,"Tasa de exámenes médico legales por presunto delito sexual contra niños, niñas y adolescentes",2015,4,124,55297,224.243629853337,5,28067,17.8145152670396,119,27230,437.017994858612
18820,20,20001,121,Tasa de exámenes médico legales por presunto delito sexual cuando la víctima está entre 18 y 28 años,2015,5,38,92015,41.2976145193718,4,46766,8.5532224265492,34,45249,75.1397820946319
18821,20,20001,81,"Tasa de exámenes médico legales por presunto delito sexual contra niños, niñas y adolescentes",2015,1,4,8820,45.3514739229025,1,4527,22.0896841175171,3,4293,69.8812019566736
18822,20,20011,81,"Tasa de exámenes médico legales por presunto delito sexual contra niños, niñas y adolescentes",2015,2,8,9646,82.9359319925358,3,4905,61.1620795107034,5,4741,105.462982493145
18823,20,20011,81,"Tasa de exámenes médico legales por presunto delito sexual contra niños, niñas y adolescentes",2015,3,12,11506,104.2934121328,2,5850,34.1880341880342,10,5656,176.803394625177
18824,20,20011,81,"Tasa de exámenes médico legales por presunto delito sexual contra niños, niñas y adolescentes",2015,4,19,11418,166.403923629357,2,5717,34.9833828931258,17,5701,298.193299421154
18825,20,20011,121,Tasa de exámenes médico legales por presunto delito sexual cuando la víctima está entre 18 y 28 años,2015,5,6,19097,31.4185474158245,0,9522,0,6,9575,62.6631853785901
18826,20,20013,81,"Tasa de exámenes médico legales por presunto delito sexual contra niños, niñas y adolescentes",2015,2,8,5808,137.741046831956,1,2973,33.6360578540195,7,2835,246.913580246914
18827,20,20013,81,"Tasa de exámenes médico legales por presunto delito sexual contra niños, niñas y adolescentes",2015,3,7,6900,101.449275362319,4,3518,113.700966458215,3,3382,88.7049083382614
18828,20,20013,81,"Tasa de exámenes médico legales por presunto delito sexual contra niños, niñas y adolescentes",2015,4,28,6667,419.979001049947,1,3388,29.5159386068477,27,3279,823.421774931381
18829,20,20013,121,Tasa de exámenes médico legales por presunto delito sexual cuando la víctima está entre 18 y 28 años,2015,5,2,10064,19.8728139904611,0,5238,0,2,4826,41.4421881475342
18830,20,20032,81,"Tasa de exámenes médico legales por presunto delito sexual contra niños, niñas y adolescentes",2015,3,1,2895,34.5423143350604,0,1513,0,1,1382,72.3589001447178
18831,20,20032,81,"Tasa de exámenes médico legales por presunto delito sexual contra niños, niñas y adolescentes",2015,4,5,2574,194.250194250194,0,1349,0,5,1225,408.163265306122
18832,20,20045,81,"Tasa de exámenes médico legales por presunto delito sexual contra niños, niñas y adolescentes",2015,3,2,1854,107.874865156419,0,980,0,2,874,228.83295194508
18833,20,20045,81,"Tasa de exámenes médico legales por presunto delito sexual contra niños, niñas y adolescentes",2015,4,1,1853,53.9665407447383,0,990,0,1,863,115.874855156431
18834,20,20045,121,Tasa de exámenes médico legales por presunto delito sexual cuando la víctima está entre 18 y 28 años,2015,5,1,2679,37.3273609555804,0,1432,0,1,1247,80.1924619085806
18835,20,20060,81,"Tasa de exámenes médico legales por presunto delito sexual contra niños, niñas y adolescentes",2015,3,4,5404,74.019245003701,1,2787,35.880875493362,3,2617,114.63507833397
18836,20,20060,81,"Tasa de exámenes médico legales por presunto delito sexual contra niños, niñas y adolescentes",2015,4,5,5004,99.9200639488409,0,2585,0,5,2419,206.69698222406
18837,20,20060,121,Tasa de exámenes médico legales por presunto delito sexual cuando la víctima está entre 18 y 28 años,2015,5,1,7355,13.5961930659415,0,3790,0,1,3565,28.0504908835905
18838,20,20175,81,"Tasa de exámenes médico legales por presunto delito sexual contra niños, niñas y adolescentes",2015,2,2,3995,50.0625782227785,1,2059,48.5672656629432,1,1936,51.6528925619835
18839,20,20175,81,"Tasa de exámenes médico legales por presunto delito sexual contra niños, niñas y adolescentes",2015,3,3,4546,65.992080950286,1,2392,41.8060200668896,2,2154,92.8505106778087
18840,20,20175,81,"Tasa de exámenes médico legales por presunto delito sexual contra niños, niñas y adolescentes",2015,4,1,4227,23.6574402649633,0,2264,0,1,1963,50.9424350483953
18841,20,20178,81,"Tasa de exámenes médico legales por presunto delito sexual contra niños, niñas y adolescentes",2015,2,1,2296,43.5540069686411,0,1175,0,1,1121,89.2060660124888
18842,20,20178,81,"Tasa de exámenes médico legales por presunto delito sexual contra niños, niñas y adolescentes",2015,3,6,2736,219.298245614035,0,1400,0,6,1336,449.101796407186
18843,20,20178,81,"Tasa de exámenes médico legales por presunto delito sexual contra niños, niñas y adolescentes",2015,4,10,2532,394.944707740916,0,1297,0,10,1235,809.716599190283
18844,20,20178,121,Tasa de exámenes médico legales por presunto delito sexual cuando la víctima está entre 18 y 28 años,2015,5,1,3846,26.0010400416017,0,1970,0,1,1876,53.3049040511727
18845,20,20228,81,"Tasa de exámenes médico legales por presunto delito sexual contra niños, niñas y adolescentes",2015,2,1,2836,35.2609308885755,0,1450,0,1,1386,72.1500721500721
18846,20,20228,81,"Tasa de exámenes médico legales por presunto delito sexual contra niños, niñas y adolescentes",2015,3,2,3214,62.2277535780958,1,1642,60.9013398294762,1,1572,63.6132315521629
18847,20,20228,81,"Tasa de exámenes médico legales por presunto delito sexual contra niños, niñas y adolescentes",2015,4,3,3064,97.911227154047,0,1542,0,3,1522,197.109067017083
18848,20,20238,81,"Tasa de exámenes médico legales por presunto delito sexual contra niños, niñas y adolescentes",2015,3,5,3616,138.274336283186,1,1837,54.4365813826892,4,1779,224.845418774592
18849,20,20238,81,"Tasa de exámenes médico legales por presunto delito sexual contra niños, niñas y adolescentes",2015,4,6,3501,171.379605826907,1,1771,56.4652738565782,5,1730,289.017341040462
18850,20,20238,121,Tasa de exámenes médico legales por presunto delito sexual cuando la víctima está entre 18 y 28 años,2015,5,3,5328,56.3063063063063,0,2755,0,3,2573,116.595413913719
18851,20,20250,81,"Tasa de exámenes médico legales por presunto delito sexual contra niños, niñas y adolescentes",2015,2,1,2852,35.0631136044881,1,1463,68.3526999316473,0,1389,0
18852,20,20250,81,"Tasa de exámenes médico legales por presunto delito sexual contra niños, niñas y adolescentes",2015,3,3,3284,91.3520097442144,0,1679,0,3,1605,186.915887850467
18853,20,20250,81,"Tasa de exámenes médico legales por presunto delito sexual contra niños, niñas y adolescentes",2015,4,4,3134,127.632418634333,1,1589,62.9326620516048,3,1545,194.174757281553
18854,20,20295,81,"Tasa de exámenes médico legales por presunto delito sexual contra niños, niñas y adolescentes",2015,3,2,1840,108.695652173913,0,941,0,2,899,222.469410456062
18855,20,20295,81,"Tasa de exámenes médico legales por presunto delito sexual contra niños, niñas y adolescentes",2015,4,2,1895,105.540897097625,0,975,0,2,920,217.391304347826
18856,20,20383,81,"Tasa de exámenes médico legales por presunto delito sexual contra niños, niñas y adolescentes",2015,3,1,1729,57.8368999421631,0,907,0,1,822,121.654501216545
18857,20,20383,81,"Tasa de exámenes médico legales por presunto delito sexual contra niños, niñas y adolescentes",2015,4,1,1631,61.3120784794605,0,865,0,1,766,130.548302872063
18858,20,20400,81,"Tasa de exámenes médico legales por presunto delito sexual contra niños, niñas y adolescentes",2015,2,1,2517,39.7298371076679,0,1296,0,1,1221,81.9000819000819
18859,20,20400,81,"Tasa de exámenes médico legales por presunto delito sexual contra niños, niñas y adolescentes",2015,4,4,2788,143.472022955524,0,1478,0,4,1310,305.343511450382
18860,20,20400,121,Tasa de exámenes médico legales por presunto delito sexual cuando la víctima está entre 18 y 28 años,2015,5,1,4460,22.4215246636771,0,2348,0,1,2112,47.3484848484849
18861,20,20443,81,"Tasa de exámenes médico legales por presunto delito sexual contra niños, niñas y adolescentes",2015,3,1,1976,50.6072874493927,0,1022,0,1,954,104.82180293501
18862,20,20443,81,"Tasa de exámenes médico legales por presunto delito sexual contra niños, niñas y adolescentes",2015,4,2,1916,104.384133611691,0,992,0,2,924,216.450216450216
18863,20,20517,121,Tasa de exámenes médico legales por presunto delito sexual cuando la víctima está entre 18 y 28 años,2015,5,1,3408,29.3427230046948,0,1735,0,1,1673,59.7728631201434
18864,20,20550,81,"Tasa de exámenes médico legales por presunto delito sexual contra niños, niñas y adolescentes",2015,2,1,2067,48.3792936623125,0,1055,0,1,1012,98.8142292490118
18865,20,20550,81,"Tasa de exámenes médico legales por presunto delito sexual contra niños, niñas y adolescentes",2015,3,2,2414,82.8500414250207,0,1238,0,2,1176,170.068027210884
18866,20,20550,81,"Tasa de exámenes médico legales por presunto delito sexual contra niños, niñas y adolescentes",2015,4,4,2300,173.913043478261,0,1175,0,4,1125,355.555555555556
18867,20,20570,81,"Tasa de exámenes médico legales por presunto delito sexual contra niños, niñas y adolescentes",2015,2,2,3049,65.5952771400459,0,1574,0,2,1475,135.593220338983
18868,20,20570,81,"Tasa de exámenes médico legales por presunto delito sexual contra niños, niñas y adolescentes",2015,3,10,3372,296.55990510083,0,1772,0,10,1600,625
18869,20,20570,81,"Tasa de exámenes médico legales por presunto delito sexual contra niños, niñas y adolescentes",2015,4,14,3349,418.035234398328,0,1781,0,14,1568,892.857142857143
18870,20,20614,121,Tasa de exámenes médico legales por presunto delito sexual cuando la víctima está entre 18 y 28 años,2015,5,1,2805,35.650623885918,0,1519,0,1,1286,77.7604976671851
18871,20,20621,81,"Tasa de exámenes médico legales por presunto delito sexual contra niños, niñas y adolescentes",2015,2,4,2595,154.142581888247,2,1332,150.15015015015,2,1263,158.353127474268
18872,20,20621,81,"Tasa de exámenes médico legales por presunto delito sexual contra niños, niñas y adolescentes",2015,3,7,3098,225.952227243383,2,1598,125.156445556946,5,1500,333.333333333333
18873,20,20621,81,"Tasa de exámenes médico legales por presunto delito sexual contra niños, niñas y adolescentes",2015,4,7,3016,232.09549071618,1,1555,64.3086816720257,6,1461,410.677618069815
18874,20,20621,121,Tasa de exámenes médico legales por presunto delito sexual cuando la víctima está entre 18 y 28 años,2015,5,1,4287,23.3263354327035,0,2220,0,1,2067,48.3792936623125
18875,20,20621,81,"Tasa de exámenes médico legales por presunto delito sexual contra niños, niñas y adolescentes",2015,1,1,533,187.617260787993,1,271,369.0036900369,0,262,0
18876,20,20710,81,"Tasa de exámenes médico legales por presunto delito sexual contra niños, niñas y adolescentes",2015,2,3,2514,119.331742243437,1,1280,78125,2,1234,162.074554294976
18877,20,20710,81,"Tasa de exámenes médico legales por presunto delito sexual contra niños, niñas y adolescentes",2015,3,7,2906,240.880935994494,2,1470,136.054421768707,5,1436,348.189415041783
18878,20,20710,81,"Tasa de exámenes médico legales por presunto delito sexual contra niños, niñas y adolescentes",2015,4,3,2840,105.633802816901,2,1428,140.056022408964,1,1412,70.8215297450425
18879,20,20750,81,"Tasa de exámenes médico legales por presunto delito sexual contra niños, niñas y adolescentes",2015,4,3,1686,177.935943060498,0,895,0,3,791,379.266750948167
18880,20,20750,121,Tasa de exámenes médico legales por presunto delito sexual cuando la víctima está entre 18 y 28 años,2015,5,1,2600,38.4615384615385,0,1354,0,1,1246,80.2568218298555
18881,20,20770,81,"Tasa de exámenes médico legales por presunto delito sexual contra niños, niñas y adolescentes",2015,3,3,2300,130.434782608696,2,1184,168.918918918919,1,1116,89.6057347670251
18882,20,20770,81,"Tasa de exámenes médico legales por presunto delito sexual contra niños, niñas y adolescentes",2015,4,4,2284,175.131348511384,0,1173,0,4,1111,360.03600360036
18883,20,20770,121,Tasa de exámenes médico legales por presunto delito sexual cuando la víctima está entre 18 y 28 años,2015,5,2,3867,51.7196793379881,0,1963,0,2,1904,105.042016806723
18884,23,23001,81,"Tasa de exámenes médico legales por presunto delito sexual contra niños, niñas y adolescentes",2015,2,22,40618,54.1631788862081,2,20682,9.67024465718983,20,19936,100.321027287319
18885,23,23001,81,"Tasa de exámenes médico legales por presunto delito sexual contra niños, niñas y adolescentes",2015,3,67,49318,135.853035402896,11,24870,44.2299959790913,56,24448,229.057591623037
18886,23,23001,81,"Tasa de exámenes médico legales por presunto delito sexual contra niños, niñas y adolescentes",2015,4,100,49080,203.748981255094,10,24669,40.5367059872715,90,24411,368.686248002949
18887,23,23001,121,Tasa de exámenes médico legales por presunto delito sexual cuando la víctima está entre 18 y 28 años,2015,5,20,88550,22.5861095426313,1,44885,2.22791578478334,19,43665,43.5131111874499
18888,23,23068,81,"Tasa de exámenes médico legales por presunto delito sexual contra niños, niñas y adolescentes",2015,4,1,6381,15.6715248393669,0,3447,0,1,2934,34.0831629175187
18889,23,23079,81,"Tasa de exámenes médico legales por presunto delito sexual contra niños, niñas y adolescentes",2015,4,4,2696,148.367952522255,0,1457,0,4,1239,322.841000807102
18890,23,23090,81,"Tasa de exámenes médico legales por presunto delito sexual contra niños, niñas y adolescentes",2015,3,2,2684,74.5156482861401,1,1447,69.1085003455425,1,1237,80.8407437348424
18891,23,23090,81,"Tasa de exámenes médico legales por presunto delito sexual contra niños, niñas y adolescentes",2015,4,3,2644,113.464447806354,0,1466,0,3,1178,254.668930390492
18892,23,23162,81,"Tasa de exámenes médico legales por presunto delito sexual contra niños, niñas y adolescentes",2015,2,5,8185,61.0873549175321,1,4188,23.8777459407832,4,3997,100.075056292219
18893,23,23162,81,"Tasa de exámenes médico legales por presunto delito sexual contra niños, niñas y adolescentes",2015,3,12,9882,121.432908318154,2,4950,40.4040404040404,10,4932,202.757502027575
18894,23,23162,81,"Tasa de exámenes médico legales por presunto delito sexual contra niños, niñas y adolescentes",2015,4,21,9888,212.378640776699,1,4926,20.3004466098254,20,4962,403.063280935107
18895,23,23168,81,"Tasa de exámenes médico legales por presunto delito sexual contra niños, niñas y adolescentes",2015,2,1,1459,68.5400959561343,0,754,0,1,705,141.843971631206
18896,23,23168,81,"Tasa de exámenes médico legales por presunto delito sexual contra niños, niñas y adolescentes",2015,3,1,1767,56.5930956423316,0,911,0,1,856,116.822429906542
18897,23,23168,81,"Tasa de exámenes médico legales por presunto delito sexual contra niños, niñas y adolescentes",2015,4,1,1650,60.6060606060606,0,855,0,1,795,125.786163522013
18898,23,23168,121,Tasa de exámenes médico legales por presunto delito sexual cuando la víctima está entre 18 y 28 años,2015,5,1,2647,37.7786173026067,0,1407,0,1,1240,80.6451612903226
18899,23,23182,81,"Tasa de exámenes médico legales por presunto delito sexual contra niños, niñas y adolescentes",2015,3,1,5083,19.6734212079481,1,2547,39.2618767177071,0,2536,0
18900,23,23182,81,"Tasa de exámenes médico legales por presunto delito sexual contra niños, niñas y adolescentes",2015,4,9,4954,181.671376665321,1,2491,40.1445202729827,8,2463,324.807145757207
18901,23,23182,121,Tasa de exámenes médico legales por presunto delito sexual cuando la víctima está entre 18 y 28 años,2015,5,1,9542,10.4799832320268,0,4898,0,1,4644,21.5331610680448
18902,23,23189,81,"Tasa de exámenes médico legales por presunto delito sexual contra niños, niñas y adolescentes",2015,2,1,6444,15.5183116076971,1,3315,30.1659125188537,0,3129,0
18903,23,23189,81,"Tasa de exámenes médico legales por presunto delito sexual contra niños, niñas y adolescentes",2015,3,4,7596,52.6592943654555,0,3923,0,4,3673,108.902804247209
18904,23,23189,81,"Tasa de exámenes médico legales por presunto delito sexual contra niños, niñas y adolescentes",2015,4,7,7394,94.6713551528266,0,3816,0,7,3578,195.64002235886
18905,23,23189,121,Tasa de exámenes médico legales por presunto delito sexual cuando la víctima está entre 18 y 28 años,2015,5,1,12626,7.92016473942658,0,6554,0,1,6072,16.4690382081686
18906,23,23300,81,"Tasa de exámenes médico legales por presunto delito sexual contra niños, niñas y adolescentes",2015,3,1,1532,65.2741514360313,0,790,0,1,742,134.770889487871
18907,23,23300,121,Tasa de exámenes médico legales por presunto delito sexual cuando la víctima está entre 18 y 28 años,2015,5,1,2864,34.9162011173184,0,1462,0,1,1402,71.3266761768902
18908,23,23417,81,"Tasa de exámenes médico legales por presunto delito sexual contra niños, niñas y adolescentes",2015,2,2,12133,16.483969339817,0,6214,0,2,5919,33.7894914681534
18909,23,23417,81,"Tasa de exámenes médico legales por presunto delito sexual contra niños, niñas y adolescentes",2015,3,16,14181,112.827022071786,1,7284,13.728720483251,15,6897,217.485863418878
18910,23,23417,81,"Tasa de exámenes médico legales por presunto delito sexual contra niños, niñas y adolescentes",2015,4,13,13466,96.5394326451805,1,6872,14.5518044237485,12,6594,181.983621474067
18911,23,23417,121,Tasa de exámenes médico legales por presunto delito sexual cuando la víctima está entre 18 y 28 años,2015,5,5,23512,21.2657366451174,0,12129,0,5,11383,43.9251515417728
18912,23,23419,81,"Tasa de exámenes médico legales por presunto delito sexual contra niños, niñas y adolescentes",2015,3,1,3411,29.3169158604515,0,1748,0,1,1663,60.1322910402886
18913,23,23419,81,"Tasa de exámenes médico legales por presunto delito sexual contra niños, niñas y adolescentes",2015,4,2,3157,63.351282863478,0,1637,0,2,1520,131.578947368421
18914,23,23464,81,"Tasa de exámenes médico legales por presunto delito sexual contra niños, niñas y adolescentes",2015,3,2,1695,117.994100294985,0,873,0,2,822,243.30900243309
18915,23,23464,81,"Tasa de exámenes médico legales por presunto delito sexual contra niños, niñas y adolescentes",2015,4,5,1698,294.464075382803,1,863,115.874855156431,4,835,479.041916167665
18916,23,23464,121,Tasa de exámenes médico legales por presunto delito sexual cuando la víctima está entre 18 y 28 años,2015,5,1,2854,35.0385423966363,0,1423,0,1,1431,69.8812019566736
18917,23,23466,81,"Tasa de exámenes médico legales por presunto delito sexual contra niños, niñas y adolescentes",2015,2,5,9077,55.0842789467886,0,4621,0,5,4456,112.208258527828
18918,23,23466,81,"Tasa de exámenes médico legales por presunto delito sexual contra niños, niñas y adolescentes",2015,3,5,10395,48.1000481000481,1,5240,19.0839694656489,4,5155,77.5945683802134
18919,23,23466,81,"Tasa de exámenes médico legales por presunto delito sexual contra niños, niñas y adolescentes",2015,4,9,9904,90.8723747980614,0,4910,0,9,4994,180.216259511414
18920,23,23466,121,Tasa de exámenes médico legales por presunto delito sexual cuando la víctima está entre 18 y 28 años,2015,5,1,17145,5.83260425780111,0,8496,0,1,8649,11.5620302925194
18921,23,23500,81,"Tasa de exámenes médico legales por presunto delito sexual contra niños, niñas y adolescentes",2015,3,2,3774,52.9941706412295,0,1944,0,2,1830,109.289617486339
18922,23,23500,81,"Tasa de exámenes médico legales por presunto delito sexual contra niños, niñas y adolescentes",2015,4,2,3407,58.7026709715292,0,1757,0,2,1650,121.212121212121
18923,23,23555,81,"Tasa de exámenes médico legales por presunto delito sexual contra niños, niñas y adolescentes",2015,3,7,8083,86.6015093405914,1,4112,24.3190661478599,6,3971,151.095441954168
18924,23,23555,81,"Tasa de exámenes médico legales por presunto delito sexual contra niños, niñas y adolescentes",2015,4,11,7758,141.78912090745,0,3948,0,11,3810,288.713910761155
18925,23,23570,81,"Tasa de exámenes médico legales por presunto delito sexual contra niños, niñas y adolescentes",2015,3,2,4957,40.3469840629413,1,2543,39.3236335037357,1,2414,41.4250207125104
18926,23,23570,81,"Tasa de exámenes médico legales por presunto delito sexual contra niños, niñas y adolescentes",2015,4,1,4601,21.7344055640078,0,2388,0,1,2213,45.1875282422052
18927,23,23574,81,"Tasa de exámenes médico legales por presunto delito sexual contra niños, niñas y adolescentes",2015,2,1,3659,27.3298715496037,0,1884,0,1,1775,56.3380281690141
18928,23,23574,81,"Tasa de exámenes médico legales por presunto delito sexual contra niños, niñas y adolescentes",2015,3,1,3961,25.2461499621308,0,2086,0,1,1875,53.3333333333333
18929,23,23574,81,"Tasa de exámenes médico legales por presunto delito sexual contra niños, niñas y adolescentes",2015,4,4,3680,108.695652173913,0,1969,0,4,1711,233.781414377557
18930,23,23586,81,"Tasa de exámenes médico legales por presunto delito sexual contra niños, niñas y adolescentes",2015,2,1,1610,62.111801242236,0,828,0,1,782,127.877237851662
18931,23,23586,81,"Tasa de exámenes médico legales por presunto delito sexual contra niños, niñas y adolescentes",2015,3,1,1870,53.475935828877,0,976,0,1,894,111.856823266219
18932,23,23586,81,"Tasa de exámenes médico legales por presunto delito sexual contra niños, niñas y adolescentes",2015,4,3,1792,167.410714285714,0,932,0,3,860,348.837209302326
18933,23,23586,121,Tasa de exámenes médico legales por presunto delito sexual cuando la víctima está entre 18 y 28 años,2015,5,1,2980,33.5570469798658,0,1513,0,1,1467,68.1663258350375
18934,23,23660,81,"Tasa de exámenes médico legales por presunto delito sexual contra niños, niñas y adolescentes",2015,2,1,8532,11.7205813408345,0,4356,0,1,4176,23.9463601532567
18935,23,23660,81,"Tasa de exámenes médico legales por presunto delito sexual contra niños, niñas y adolescentes",2015,3,5,10099,49.5098524606397,1,5142,19.4476857253987,4,4957,80.6939681258826
18936,23,23660,81,"Tasa de exámenes médico legales por presunto delito sexual contra niños, niñas y adolescentes",2015,4,1,9939,10.0613743837408,0,5065,0,1,4874,20.5170291341814
18937,23,23670,81,"Tasa de exámenes médico legales por presunto delito sexual contra niños, niñas y adolescentes",2015,2,1,5555,18.001800180018,0,2779,0,1,2776,36.0230547550432
18938,23,23670,81,"Tasa de exámenes médico legales por presunto delito sexual contra niños, niñas y adolescentes",2015,3,3,5753,52.1467060664001,0,2934,0,3,2819,106.420716566158
18939,23,23670,81,"Tasa de exámenes médico legales por presunto delito sexual contra niños, niñas y adolescentes",2015,4,2,5452,36.6837857666911,0,2850,0,2,2602,76.8639508070715
18940,23,23672,81,"Tasa de exámenes médico legales por presunto delito sexual contra niños, niñas y adolescentes",2015,2,2,3221,62.0925178515989,1,1639,61.012812690665,1,1582,63.2111251580278
18941,23,23672,81,"Tasa de exámenes médico legales por presunto delito sexual contra niños, niñas y adolescentes",2015,3,3,3675,81.6326530612245,0,1866,0,3,1809,165.837479270315
18942,23,23672,81,"Tasa de exámenes médico legales por presunto delito sexual contra niños, niñas y adolescentes",2015,4,9,3583,251.1861568518,1,1839,54.3773790103317,8,1744,458.715596330275
18943,23,23672,121,Tasa de exámenes médico legales por presunto delito sexual cuando la víctima está entre 18 y 28 años,2015,5,1,6489,15.4106950223455,0,3314,0,1,3175,31.496062992126
18944,23,23675,81,"Tasa de exámenes médico legales por presunto delito sexual contra niños, niñas y adolescentes",2015,2,1,3839,26.048450117218,0,1978,0,1,1861,53.7345513164965
18945,23,23675,81,"Tasa de exámenes médico legales por presunto delito sexual contra niños, niñas y adolescentes",2015,4,1,3938,25.3936008125952,0,2085,0,1,1853,53.9665407447383
18946,23,23675,121,Tasa de exámenes médico legales por presunto delito sexual cuando la víctima está entre 18 y 28 años,2015,5,1,6983,14.3204926249463,0,3675,0,1,3308,30.229746070133
18947,23,23678,81,"Tasa de exámenes médico legales por presunto delito sexual contra niños, niñas y adolescentes",2015,3,1,3347,29.8775022408127,0,1703,0,1,1644,60.8272506082725
18948,23,23678,81,"Tasa de exámenes médico legales por presunto delito sexual contra niños, niñas y adolescentes",2015,4,3,3110,96.4630225080386,2,1586,126.103404791929,1,1524,65.6167979002625
18949,23,23686,81,"Tasa de exámenes médico legales por presunto delito sexual contra niños, niñas y adolescentes",2015,3,5,4721,105.909764880322,0,2410,0,5,2311,216.356555603635
18950,23,23686,81,"Tasa de exámenes médico legales por presunto delito sexual contra niños, niñas y adolescentes",2015,4,5,4738,105.529759392149,0,2409,0,5,2329,214.68441391155
18951,23,23807,81,"Tasa de exámenes médico legales por presunto delito sexual contra niños, niñas y adolescentes",2015,3,8,13945,57.368232341341,2,7123,28.0780569984557,6,6822,87.9507475813544
18952,23,23807,81,"Tasa de exámenes médico legales por presunto delito sexual contra niños, niñas y adolescentes",2015,4,4,13015,30.7337687283903,0,6659,0,4,6356,62.9326620516048
18953,23,23807,121,Tasa de exámenes médico legales por presunto delito sexual cuando la víctima está entre 18 y 28 años,2015,5,1,20957,4.77167533521019,0,10722,0,1,10235,9.77039570102589
18954,23,23815,81,"Tasa de exámenes médico legales por presunto delito sexual contra niños, niñas y adolescentes",2015,2,2,5612,35.6379187455453,1,2899,34.494653328734,1,2713,36.8595650571323
18955,23,23815,81,"Tasa de exámenes médico legales por presunto delito sexual contra niños, niñas y adolescentes",2015,3,1,6032,16.57824933687,0,3080,0,1,2952,33.8753387533875
18956,23,23815,81,"Tasa de exámenes médico legales por presunto delito sexual contra niños, niñas y adolescentes",2015,4,3,5358,55.9910414333707,1,2720,36.7647058823529,2,2638,75.8150113722517
18957,23,23815,121,Tasa de exámenes médico legales por presunto delito sexual cuando la víctima está entre 18 y 28 años,2015,5,1,7429,13.4607618791224,0,3965,0,1,3464,28.8683602771363
18958,23,23855,81,"Tasa de exámenes médico legales por presunto delito sexual contra niños, niñas y adolescentes",2015,3,2,5745,34.8128807658834,0,2973,0,2,2772,72.1500721500721
18959,23,23855,81,"Tasa de exámenes médico legales por presunto delito sexual contra niños, niñas y adolescentes",2015,4,2,5393,37.0851103282032,0,2808,0,2,2585,77.3694390715667
18960,25,25001,81,"Tasa de exámenes médico legales por presunto delito sexual contra niños, niñas y adolescentes",2015,3,1,1077,92.8505106778087,1,558,179.21146953405,0,519,0
18961,25,25019,81,"Tasa de exámenes médico legales por presunto delito sexual contra niños, niñas y adolescentes",2015,2,1,542,184.50184501845,0,280,0,1,262,381.679389312977
18962,25,25019,81,"Tasa de exámenes médico legales por presunto delito sexual contra niños, niñas y adolescentes",2015,4,1,635,157.48031496063,0,309,0,1,326,306.748466257669
18963,25,25035,81,"Tasa de exámenes médico legales por presunto delito sexual contra niños, niñas y adolescentes",2015,2,1,1063,94.0733772342427,0,541,0,1,522,191.570881226054
18964,25,25035,81,"Tasa de exámenes médico legales por presunto delito sexual contra niños, niñas y adolescentes",2015,3,1,1197,83.5421888053467,0,611,0,1,586,170.648464163823
18965,25,25035,81,"Tasa de exámenes médico legales por presunto delito sexual contra niños, niñas y adolescentes",2015,4,6,1324,453.172205438066,0,677,0,6,647,927.357032457496
18966,25,25040,81,"Tasa de exámenes médico legales por presunto delito sexual contra niños, niñas y adolescentes",2015,3,4,1204,332.225913621262,0,617,0,4,587,681.431005110733
18967,25,25040,81,"Tasa de exámenes médico legales por presunto delito sexual contra niños, niñas y adolescentes",2015,4,4,1135,352.422907488987,0,592,0,4,543,736.648250460405
18968,25,25040,121,Tasa de exámenes médico legales por presunto delito sexual cuando la víctima está entre 18 y 28 años,2015,5,1,2216,45.1263537906137,0,1183,0,1,1033,96.8054211035818
18969,25,25053,81,"Tasa de exámenes médico legales por presunto delito sexual contra niños, niñas y adolescentes",2015,2,2,1275,156.862745098039,0,649,0,2,626,319.488817891374
18970,25,25053,81,"Tasa de exámenes médico legales por presunto delito sexual contra niños, niñas y adolescentes",2015,3,4,1484,269.541778975741,1,758,131.926121372032,3,726,413.223140495868
18971,25,25053,81,"Tasa de exámenes médico legales por presunto delito sexual contra niños, niñas y adolescentes",2015,4,5,1434,348.675034867503,0,719,0,5,715,699.300699300699
18972,25,25095,81,"Tasa de exámenes médico legales por presunto delito sexual contra niños, niñas y adolescentes",2015,2,1,246,406.50406504065,1,129,775.193798449612,0,117,0
18973,25,25095,121,Tasa de exámenes médico legales por presunto delito sexual cuando la víctima está entre 18 y 28 años,2015,5,1,523,191.204588910134,1,283,353.356890459364,0,240,0
18974,25,25099,81,"Tasa de exámenes médico legales por presunto delito sexual contra niños, niñas y adolescentes",2015,4,2,1408,142.045454545455,0,716,0,2,692,289.017341040462
18975,25,25099,121,Tasa de exámenes médico legales por presunto delito sexual cuando la víctima está entre 18 y 28 años,2015,5,1,2198,45.4959053685168,0,1114,0,1,1084,92.2509225092251
18976,25,25120,81,"Tasa de exámenes médico legales por presunto delito sexual contra niños, niñas y adolescentes",2015,3,2,576,347.222222222222,0,297,0,2,279,716.845878136201
18977,25,25120,81,"Tasa de exámenes médico legales por presunto delito sexual contra niños, niñas y adolescentes",2015,4,1,512,195.3125,0,255,0,1,257,389.105058365759
18978,25,25123,81,"Tasa de exámenes médico legales por presunto delito sexual contra niños, niñas y adolescentes",2015,3,2,1271,157.3564122738,0,643,0,2,628,318.471337579618
18979,25,25123,81,"Tasa de exámenes médico legales por presunto delito sexual contra niños, niñas y adolescentes",2015,4,1,1243,80.450522928399,0,634,0,1,609,164.203612479475
18980,25,25123,121,Tasa de exámenes médico legales por presunto delito sexual cuando la víctima está entre 18 y 28 años,2015,5,2,2084,95.9692898272553,1,1091,91.6590284142988,1,993,100.704934541793
18981,25,25126,81,"Tasa de exámenes médico legales por presunto delito sexual contra niños, niñas y adolescentes",2015,2,3,4869,61.6142945163278,1,2485,40.2414486921529,2,2384,83.8926174496644
18982,25,25126,81,"Tasa de exámenes médico legales por presunto delito sexual contra niños, niñas y adolescentes",2015,3,2,6193,32.2945260778298,0,3248,0,2,2945,67.911714770798
18983,25,25126,81,"Tasa de exámenes médico legales por presunto delito sexual contra niños, niñas y adolescentes",2015,4,7,6191,113.067355839121,3,3235,92.7357032457496,4,2956,135.31799729364
18984,25,25126,121,Tasa de exámenes médico legales por presunto delito sexual cuando la víctima está entre 18 y 28 años,2015,5,3,11376,26.3713080168776,0,5881,0,3,5495,54.5950864422202
18985,25,25148,81,"Tasa de exámenes médico legales por presunto delito sexual contra niños, niñas y adolescentes",2015,3,2,1703,117.439812096301,0,882,0,2,821,243.605359317905
18986,25,25148,81,"Tasa de exámenes médico legales por presunto delito sexual contra niños, niñas y adolescentes",2015,4,2,1688,118.483412322275,0,889,0,2,799,250.312891113892
18987,25,25151,81,"Tasa de exámenes médico legales por presunto delito sexual contra niños, niñas y adolescentes",2015,2,4,1490,268.456375838926,1,762,131.233595800525,3,728,412.087912087912
18988,25,25151,81,"Tasa de exámenes médico legales por presunto delito sexual contra niños, niñas y adolescentes",2015,3,9,1770,508.474576271186,3,911,329.308452250274,6,859,698.48661233993
18989,25,25151,81,"Tasa de exámenes médico legales por presunto delito sexual contra niños, niñas y adolescentes",2015,4,5,1734,288.350634371396,1,899,111.234705228031,4,835,479.041916167665
18990,25,25151,121,Tasa de exámenes médico legales por presunto delito sexual cuando la víctima está entre 18 y 28 años,2015,5,1,3334,29.99400119976,0,1739,0,1,1595,62.6959247648903
18991,25,25154,81,"Tasa de exámenes médico legales por presunto delito sexual contra niños, niñas y adolescentes",2015,4,2,914,218.818380743982,0,484,0,2,430,465.116279069767
18992,25,25168,81,"Tasa de exámenes médico legales por presunto delito sexual contra niños, niñas y adolescentes",2015,2,1,385,259.74025974026,0,198,0,1,187,534.75935828877
18993,25,25168,81,"Tasa de exámenes médico legales por presunto delito sexual contra niños, niñas y adolescentes",2015,4,1,429,233.100233100233,0,224,0,1,205,487.80487804878
18994,25,25175,81,"Tasa de exámenes médico legales por presunto delito sexual contra niños, niñas y adolescentes",2015,2,3,10259,29.2426162393996,1,5243,19.0730497806599,2,5016,39.8724082934609
18995,25,25175,81,"Tasa de exámenes médico legales por presunto delito sexual contra niños, niñas y adolescentes",2015,3,16,12724,125.746620559572,3,6507,46.1041954817888,13,6217,209.104069486891
18996,25,25175,81,"Tasa de exámenes médico legales por presunto delito sexual contra niños, niñas y adolescentes",2015,4,11,12761,86.2001410547763,1,6399,15.6274417877793,10,6362,157.183275699466
18997,25,25175,121,Tasa de exámenes médico legales por presunto delito sexual cuando la víctima está entre 18 y 28 años,2015,5,4,24266,16.483969339817,2,11961,16.7210099490009,2,12305,16.253555465258
18998,25,25178,81,"Tasa de exámenes médico legales por presunto delito sexual contra niños, niñas y adolescentes",2015,4,3,912,328.947368421053,2,481,415.800415800416,1,431,232.018561484919
18999,25,25181,81,"Tasa de exámenes médico legales por presunto delito sexual contra niños, niñas y adolescentes",2015,2,1,1015,98.5221674876847,0,519,0,1,496,201.612903225806
19000,25,25181,81,"Tasa de exámenes médico legales por presunto delito sexual contra niños, niñas y adolescentes",2015,3,1,1224,81.6993464052288,1,623,160.513643659711,0,601,0
19001,25,25181,81,"Tasa de exámenes médico legales por presunto delito sexual contra niños, niñas y adolescentes",2015,4,2,1125,177.777777777778,0,574,0,2,551,362.976406533575
19002,25,25183,81,"Tasa de exámenes médico legales por presunto delito sexual contra niños, niñas y adolescentes",2015,2,4,2338,171.086398631309,1,1196,83.6120401337793,3,1142,262.697022767075
19003,25,25183,81,"Tasa de exámenes médico legales por presunto delito sexual contra niños, niñas y adolescentes",2015,3,4,2688,148.809523809524,1,1362,73.4214390602056,3,1326,226.244343891403
19004,25,25183,81,"Tasa de exámenes médico legales por presunto delito sexual contra niños, niñas y adolescentes",2015,4,7,2634,265.755504935459,0,1329,0,7,1305,536.39846743295
19005,25,25183,121,Tasa de exámenes médico legales por presunto delito sexual cuando la víctima está entre 18 y 28 años,2015,5,2,4744,42.1585160202361,0,2401,0,2,2343,85.3606487409304
19006,25,25200,81,"Tasa de exámenes médico legales por presunto delito sexual contra niños, niñas y adolescentes",2015,3,3,2435,123.203285420945,0,1210,0,3,1225,244.897959183673
19007,25,25200,81,"Tasa de exámenes médico legales por presunto delito sexual contra niños, niñas y adolescentes",2015,4,4,2477,161.485668146952,0,1265,0,4,1212,330.03300330033
19008,25,25200,121,Tasa de exámenes médico legales por presunto delito sexual cuando la víctima está entre 18 y 28 años,2015,5,1,4407,22.691173133651,0,2232,0,1,2175,45.9770114942529
19009,25,25214,81,"Tasa de exámenes médico legales por presunto delito sexual contra niños, niñas y adolescentes",2015,2,1,2116,47.2589792060491,0,1085,0,1,1031,96.9932104752667
19010,25,25214,81,"Tasa de exámenes médico legales por presunto delito sexual contra niños, niñas y adolescentes",2015,3,3,2602,115.29592621060701,1,1320,75.7575757575758,2,1282,156.00624024961
19011,25,25214,81,"Tasa de exámenes médico legales por presunto delito sexual contra niños, niñas y adolescentes",2015,4,1,2587,38.6548125241593,0,1295,0,1,1292,77.3993808049536
19012,25,25214,121,Tasa de exámenes médico legales por presunto delito sexual cuando la víctima está entre 18 y 28 años,2015,5,1,4941,20.2388180530257,0,2472,0,1,2469,40.5022276225192
19013,25,25224,81,"Tasa de exámenes médico legales por presunto delito sexual contra niños, niñas y adolescentes",2015,3,2,1007,198.609731876862,1,521,191.938579654511,1,486,205.761316872428
19014,25,25224,81,"Tasa de exámenes médico legales por presunto delito sexual contra niños, niñas y adolescentes",2015,4,1,896,111.607142857143,0,465,0,1,431,232.018561484919
19015,25,25245,81,"Tasa de exámenes médico legales por presunto delito sexual contra niños, niñas y adolescentes",2015,2,2,1733,115.406809001731,1,889,112.485939257593,1,844,118.483412322275
19016,25,25245,81,"Tasa de exámenes médico legales por presunto delito sexual contra niños, niñas y adolescentes",2015,3,5,2145,233.100233100233,1,1087,91.9963201471941,4,1058,378.071833648393
19017,25,25245,81,"Tasa de exámenes médico legales por presunto delito sexual contra niños, niñas y adolescentes",2015,4,6,2194,273.473108477666,3,1119,268.096514745308,3,1075,279.06976744186
19018,25,25245,121,Tasa de exámenes médico legales por presunto delito sexual cuando la víctima está entre 18 y 28 años,2015,5,3,4035,74.3494423791822,0,2013,0,3,2022,148.367952522255
19019,25,25258,81,"Tasa de exámenes médico legales por presunto delito sexual contra niños, niñas y adolescentes",2015,4,1,452,221.238938053097,0,237,0,1,215,465.116279069767
19020,25,25258,121,Tasa de exámenes médico legales por presunto delito sexual cuando la víctima está entre 18 y 28 años,2015,5,1,893,111.982082866741,0,449,0,1,444,225.225225225225
19021,25,25260,81,"Tasa de exámenes médico legales por presunto delito sexual contra niños, niñas y adolescentes",2015,2,1,1756,56.9476082004556,0,897,0,1,859,116.414435389988
19022,25,25260,81,"Tasa de exámenes médico legales por presunto delito sexual contra niños, niñas y adolescentes",2015,3,3,2149,139.599813866915,0,1083,0,3,1066,281.425891181989
19023,25,25260,81,"Tasa de exámenes médico legales por presunto delito sexual contra niños, niñas y adolescentes",2015,4,2,2120,94.3396226415094,0,1059,0,2,1061,188.501413760603
19024,25,25269,81,"Tasa de exámenes médico legales por presunto delito sexual contra niños, niñas y adolescentes",2015,2,6,11975,50.1043841336117,3,6151,48.7725573077548,3,5824,51.510989010989
19025,25,25269,81,"Tasa de exámenes médico legales por presunto delito sexual contra niños, niñas y adolescentes",2015,3,27,14726,183.349178324053,0,7539,0,27,7187,375.678308056213
19026,25,25269,81,"Tasa de exámenes médico legales por presunto delito sexual contra niños, niñas y adolescentes",2015,4,31,14403,215.232937582448,2,7412,26.9832703723691,29,6991,414.819053068231
19027,25,25269,121,Tasa de exámenes médico legales por presunto delito sexual cuando la víctima está entre 18 y 28 años,2015,5,4,25828,15.4870682979712,0,13146,0,4,12682,31.5407664406245
19028,25,25269,81,"Tasa de exámenes médico legales por presunto delito sexual contra niños, niñas y adolescentes",2015,1,1,2358,42.4088210347752,0,1201,0,1,1157,86.4304235090752
19029,25,25279,81,"Tasa de exámenes médico legales por presunto delito sexual contra niños, niñas y adolescentes",2015,3,1,1186,84.3170320404722,1,621,161.030595813205,0,565,0
19030,25,25281,81,"Tasa de exámenes médico legales por presunto delito sexual contra niños, niñas y adolescentes",2015,2,1,726,137.741046831956,0,370,0,1,356,280.898876404494
19031,25,25281,81,"Tasa de exámenes médico legales por presunto delito sexual contra niños, niñas y adolescentes",2015,4,1,876,114.155251141553,1,458,218.340611353712,0,418,0
19032,25,25286,81,"Tasa de exámenes médico legales por presunto delito sexual contra niños, niñas y adolescentes",2015,2,9,6604,136.281041792853,2,3380,59.1715976331361,7,3224,217.12158808933
19033,25,25286,81,"Tasa de exámenes médico legales por presunto delito sexual contra niños, niñas y adolescentes",2015,3,6,7971,75.2728641324802,2,3981,50.2386335091686,4,3990,100.250626566416
19034,25,25286,81,"Tasa de exámenes médico legales por presunto delito sexual contra niños, niñas y adolescentes",2015,4,19,8052,235.966219572777,3,3961,75.7384498863923,16,4091,391.102419946223
19035,25,25286,121,Tasa de exámenes médico legales por presunto delito sexual cuando la víctima está entre 18 y 28 años,2015,5,3,15057,19.9242877067145,1,7180,13.9275766016713,2,7877,25.3903770470992
19036,25,25288,81,"Tasa de exámenes médico legales por presunto delito sexual contra niños, niñas y adolescentes",2015,4,3,600,500,0,314,0,3,286,1048.95104895105
19037,25,25290,81,"Tasa de exámenes médico legales por presunto delito sexual contra niños, niñas y adolescentes",2015,2,11,10537,104.39404004935,0,5349,0,11,5188,212.027756360833
19038,25,25290,81,"Tasa de exámenes médico legales por presunto delito sexual contra niños, niñas y adolescentes",2015,3,31,12814,241.92289683159,7,6661,105.089325927038,24,6153,390.053632374451
19039,25,25290,81,"Tasa de exámenes médico legales por presunto delito sexual contra niños, niñas y adolescentes",2015,4,34,12127,280.366125175229,0,5936,0,34,6191,549.184299790018
19040,25,25290,121,Tasa de exámenes médico legales por presunto delito sexual cuando la víctima está entre 18 y 28 años,2015,5,7,25644,27.2968335673062,2,13041,15.3362472203052,5,12603,39.6730937078473
19041,25,25293,81,"Tasa de exámenes médico legales por presunto delito sexual contra niños, niñas y adolescentes",2015,3,3,759,395.256916996047,2,390,512.820512820513,1,369,271.0027100271
19042,25,25295,81,"Tasa de exámenes médico legales por presunto delito sexual contra niños, niñas y adolescentes",2015,2,2,1638,122.100122100122,0,839,0,2,799,250.312891113892
19043,25,25295,81,"Tasa de exámenes médico legales por presunto delito sexual contra niños, niñas y adolescentes",2015,4,4,1832,218.340611353712,0,930,0,4,902,443.458980044346
19044,25,25297,81,"Tasa de exámenes médico legales por presunto delito sexual contra niños, niñas y adolescentes",2015,4,1,1111,90.00900090009,1,518,193.050193050193,0,593,0
19045,25,25299,81,"Tasa de exámenes médico legales por presunto delito sexual contra niños, niñas y adolescentes",2015,2,1,296,337.837837837838,0,152,0,1,144,694.444444444444
19046,25,25307,81,"Tasa de exámenes médico legales por presunto delito sexual contra niños, niñas y adolescentes",2015,2,15,7783,192.727739946036,7,3912,178.936605316973,8,3871,206.664944458796
19047,25,25307,81,"Tasa de exámenes médico legales por presunto delito sexual contra niños, niñas y adolescentes",2015,3,33,9528,346.347607052897,6,4690,127.931769722815,27,4838,558.081852004961
19048,25,25307,81,"Tasa de exámenes médico legales por presunto delito sexual contra niños, niñas y adolescentes",2015,4,36,9737,369.723734209716,5,4720,105.932203389831,31,5017,617.899142914092
19049,25,25307,121,Tasa de exámenes médico legales por presunto delito sexual cuando la víctima está entre 18 y 28 años,2015,5,3,19688,15.2377082486794,2,9582,20.8724692131079,1,10106,9.89511181476351
19050,25,25312,81,"Tasa de exámenes médico legales por presunto delito sexual contra niños, niñas y adolescentes",2015,3,3,1031,290.9796314258,0,515,0,3,516,581.395348837209
19051,25,25312,81,"Tasa de exámenes médico legales por presunto delito sexual contra niños, niñas y adolescentes",2015,4,5,941,531.34962805526,1,469,213.219616204691,4,472,847.457627118644
19052,25,25312,121,Tasa de exámenes médico legales por presunto delito sexual cuando la víctima está entre 18 y 28 años,2015,5,1,1769,56.5291124929339,0,866,0,1,903,110.741971207087
19053,25,25317,81,"Tasa de exámenes médico legales por presunto delito sexual contra niños, niñas y adolescentes",2015,2,2,1047,191.021967526266,2,532,375.93984962406,0,515,0
19054,25,25317,81,"Tasa de exámenes médico legales por presunto delito sexual contra niños, niñas y adolescentes",2015,3,5,1191,419.815281276238,3,605,495.867768595041,2,586,341.296928327645
19055,25,25317,81,"Tasa de exámenes médico legales por presunto delito sexual contra niños, niñas y adolescentes",2015,4,2,1156,173.010380622837,1,593,168.634064080944,1,563,177.619893428064
19056,25,25320,81,"Tasa de exámenes médico legales por presunto delito sexual contra niños, niñas y adolescentes",2015,2,3,3667,81.8107444777747,2,1880,106.382978723404,1,1787,55.9597090095132
19057,25,25320,81,"Tasa de exámenes médico legales por presunto delito sexual contra niños, niñas y adolescentes",2015,3,3,4361,68.7915615684476,1,2222,45.004500450045,2,2139,93.5016362786349
19058,25,25320,81,"Tasa de exámenes médico legales por presunto delito sexual contra niños, niñas y adolescentes",2015,4,3,4149,72.3065798987708,0,2078,0,3,2071,144.857556735876
19059,25,25320,121,Tasa de exámenes médico legales por presunto delito sexual cuando la víctima está entre 18 y 28 años,2015,5,2,7038,28.4171639670361,0,3455,0,2,3583,55.8191459670667
19060,25,25322,81,"Tasa de exámenes médico legales por presunto delito sexual contra niños, niñas y adolescentes",2015,3,4,1710,233.918128654971,1,874,114.41647597254,3,836,358.851674641148
19061,25,25322,81,"Tasa de exámenes médico legales por presunto delito sexual contra niños, niñas y adolescentes",2015,4,5,1721,290.528762347472,0,900,0,5,821,609.013398294762
19062,25,25322,81,"Tasa de exámenes médico legales por presunto delito sexual contra niños, niñas y adolescentes",2015,1,1,285,350.877192982456,0,147,0,1,138,724.63768115942
19063,25,25324,81,"Tasa de exámenes médico legales por presunto delito sexual contra niños, niñas y adolescentes",2015,4,1,298,335.570469798658,0,152,0,1,146,684.931506849315
19064,25,25328,81,"Tasa de exámenes médico legales por presunto delito sexual contra niños, niñas y adolescentes",2015,4,1,414,241.545893719807,0,221,0,1,193,518.134715025907
19065,25,25335,81,"Tasa de exámenes médico legales por presunto delito sexual contra niños, niñas y adolescentes",2015,3,1,468,213.675213675214,1,234,427.350427350427,0,234,0
19066,25,25339,81,"Tasa de exámenes médico legales por presunto delito sexual contra niños, niñas y adolescentes",2015,4,1,452,221.238938053097,0,223,0,1,229,436.681222707424
19067,25,25377,81,"Tasa de exámenes médico legales por presunto delito sexual contra niños, niñas y adolescentes",2015,2,1,2247,44.5037828215398,0,1151,0,1,1096,91.2408759124088
19068,25,25377,81,"Tasa de exámenes médico legales por presunto delito sexual contra niños, niñas y adolescentes",2015,4,5,2811,177.872643187478,1,1446,69.1562932226833,4,1365,293.040293040293
19069,25,25377,121,Tasa de exámenes médico legales por presunto delito sexual cuando la víctima está entre 18 y 28 años,2015,5,1,5349,18.6950831931202,0,2750,0,1,2599,38.4763370527126
19070,25,25386,81,"Tasa de exámenes médico legales por presunto delito sexual contra niños, niñas y adolescentes",2015,2,3,2491,120.433560818948,0,1278,0,3,1213,247.320692497939
19071,25,25386,81,"Tasa de exámenes médico legales por presunto delito sexual contra niños, niñas y adolescentes",2015,3,6,3079,194.868463786944,1,1560,64.1025641025641,5,1519,329.16392363397
19072,25,25386,81,"Tasa de exámenes médico legales por presunto delito sexual contra niños, niñas y adolescentes",2015,4,9,3150,285.714285714286,1,1607,62.2277535780958,8,1543,518.470511989631
19073,25,25386,121,Tasa de exámenes médico legales por presunto delito sexual cuando la víctima está entre 18 y 28 años,2015,5,2,5796,34.5065562456867,0,2893,0,2,2903,68.8942473303479
19074,25,25394,81,"Tasa de exámenes médico legales por presunto delito sexual contra niños, niñas y adolescentes",2015,3,1,1035,96.6183574879227,0,529,0,1,506,197.628458498024
19075,25,25394,81,"Tasa de exámenes médico legales por presunto delito sexual contra niños, niñas y adolescentes",2015,4,1,1086,92.0810313075506,0,546,0,1,540,185.185185185185
19076,25,25398,81,"Tasa de exámenes médico legales por presunto delito sexual contra niños, niñas y adolescentes",2015,4,2,710,281.69014084507,0,357,0,2,353,566.57223796034
19077,25,25402,81,"Tasa de exámenes médico legales por presunto delito sexual contra niños, niñas y adolescentes",2015,2,1,1184,84.4594594594595,0,605,0,1,579,172.711571675302
19078,25,25402,81,"Tasa de exámenes médico legales por presunto delito sexual contra niños, niñas y adolescentes",2015,3,5,1369,365.230094959825,3,699,429.184549356223,2,670,298.507462686567
19079,25,25402,81,"Tasa de exámenes médico legales por presunto delito sexual contra niños, niñas y adolescentes",2015,4,1,1441,69.3962526023595,0,725,0,1,716,139.664804469274
19080,25,25402,121,Tasa de exámenes médico legales por presunto delito sexual cuando la víctima está entre 18 y 28 años,2015,5,1,2788,35.8680057388809,0,1397,0,1,1391,71.8907260963336
19081,25,25407,81,"Tasa de exámenes médico legales por presunto delito sexual contra niños, niñas y adolescentes",2015,2,1,1030,97.0873786407767,1,531,188.323917137476,0,499,0
19082,25,25407,81,"Tasa de exámenes médico legales por presunto delito sexual contra niños, niñas y adolescentes",2015,3,2,1122,178.25311942959,0,582,0,2,540,370.37037037037
19083,25,25407,81,"Tasa de exámenes médico legales por presunto delito sexual contra niños, niñas y adolescentes",2015,4,4,1128,354.609929078014,2,584,342.465753424658,2,544,367.647058823529
19084,25,25426,81,"Tasa de exámenes médico legales por presunto delito sexual contra niños, niñas y adolescentes",2015,3,1,634,157.728706624606,0,309,0,1,325,307.692307692308
19085,25,25426,81,"Tasa de exámenes médico legales por presunto delito sexual contra niños, niñas y adolescentes",2015,4,2,634,315.457413249211,0,296,0,2,338,591.715976331361
19086,25,25430,81,"Tasa de exámenes médico legales por presunto delito sexual contra niños, niñas y adolescentes",2015,2,5,7113,70.2938282018839,4,3647,109.679188374006,1,3466,28.8517022504328
19087,25,25430,81,"Tasa de exámenes médico legales por presunto delito sexual contra niños, niñas y adolescentes",2015,3,6,8765,68.4540787221905,3,4441,67.5523530736321,3,4324,69.3802035152636
19088,25,25430,81,"Tasa de exámenes médico legales por presunto delito sexual contra niños, niñas y adolescentes",2015,4,17,8574,198.27385117798,2,4377,45.6933973040896,15,4197,357.398141529664
19089,25,25430,121,Tasa de exámenes médico legales por presunto delito sexual cuando la víctima está entre 18 y 28 años,2015,5,2,15495,12.9073894804776,0,7850,0,2,7645,26.160889470242
19090,25,25436,81,"Tasa de exámenes médico legales por presunto delito sexual contra niños, niñas y adolescentes",2015,3,3,537,558.659217877095,0,274,0,3,263,1140.68441064639
19091,25,25438,81,"Tasa de exámenes médico legales por presunto delito sexual contra niños, niñas y adolescentes",2015,2,1,1121,89.2060660124888,1,578,173.010380622837,0,543,0
19092,25,25438,81,"Tasa de exámenes médico legales por presunto delito sexual contra niños, niñas y adolescentes",2015,4,4,1192,335.570469798658,0,641,0,4,551,725.952813067151
19093,25,25473,81,"Tasa de exámenes médico legales por presunto delito sexual contra niños, niñas y adolescentes",2015,2,2,7491,26.698705112802,1,3832,26.0960334029228,1,3659,27.3298715496037
19094,25,25473,81,"Tasa de exámenes médico legales por presunto delito sexual contra niños, niñas y adolescentes",2015,3,3,9055,33.1308669243512,1,4651,21.5007525263384,2,4404,45.4132606721163
19095,25,25473,81,"Tasa de exámenes médico legales por presunto delito sexual contra niños, niñas y adolescentes",2015,4,7,9604,72.8862973760933,0,4987,0,7,4617,151.613601906
19096,25,25473,121,Tasa de exámenes médico legales por presunto delito sexual cuando la víctima está entre 18 y 28 años,2015,5,4,16907,23.6588395339209,0,8426,0,4,8481,47.1642494988798
19097,25,25483,81,"Tasa de exámenes médico legales por presunto delito sexual contra niños, niñas y adolescentes",2015,3,1,234,427.350427350427,0,120,0,1,114,877.19298245614
19098,25,25483,81,"Tasa de exámenes médico legales por presunto delito sexual contra niños, niñas y adolescentes",2015,4,2,245,816.326530612245,0,125,0,2,120,1666.66666666667
19099,25,25486,81,"Tasa de exámenes médico legales por presunto delito sexual contra niños, niñas y adolescentes",2015,2,3,1381,217.233888486604,0,700,0,3,681,440.528634361234
19100,25,25486,81,"Tasa de exámenes médico legales por presunto delito sexual contra niños, niñas y adolescentes",2015,3,2,1669,119.83223487118,0,843,0,2,826,242.130750605327
19101,25,25486,81,"Tasa de exámenes médico legales por presunto delito sexual contra niños, niñas y adolescentes",2015,4,5,1616,309.405940594059,1,830,120.481927710843,4,786,508.905852417303
19102,25,25488,81,"Tasa de exámenes médico legales por presunto delito sexual contra niños, niñas y adolescentes",2015,3,2,1385,144.404332129964,1,671,149.03129657228,1,714,140.056022408964
19103,25,25488,81,"Tasa de exámenes médico legales por presunto delito sexual contra niños, niñas y adolescentes",2015,4,1,2450,40.8163265306122,1,1775,56.3380281690141,0,675,0
19104,25,25489,81,"Tasa de exámenes médico legales por presunto delito sexual contra niños, niñas y adolescentes",2015,2,1,656,152.439024390244,0,334,0,1,322,310.55900621118
19105,25,25489,81,"Tasa de exámenes médico legales por presunto delito sexual contra niños, niñas y adolescentes",2015,4,1,721,138.69625520111,0,356,0,1,365,273.972602739726
19106,25,25513,81,"Tasa de exámenes médico legales por presunto delito sexual contra niños, niñas y adolescentes",2015,3,3,2960,101.351351351351,0,1472,0,3,1488,201.612903225806
19107,25,25513,81,"Tasa de exámenes médico legales por presunto delito sexual contra niños, niñas y adolescentes",2015,4,8,3010,265.78073089701,1,1537,65.0618087182824,7,1473,475.220638153428
19108,25,25513,121,Tasa de exámenes médico legales por presunto delito sexual cuando la víctima está entre 18 y 28 años,2015,5,4,5358,74.6547219111609,0,2715,0,4,2643,151.343170639425
19109,25,25518,81,"Tasa de exámenes médico legales por presunto delito sexual contra niños, niñas y adolescentes",2015,3,2,449,445.43429844098,1,230,434.782608695652,1,219,456.62100456621
19110,25,25524,81,"Tasa de exámenes médico legales por presunto delito sexual contra niños, niñas y adolescentes",2015,4,1,602,166.112956810631,0,326,0,1,276,362.31884057971
19111,25,25530,81,"Tasa de exámenes médico legales por presunto delito sexual contra niños, niñas y adolescentes",2015,2,2,822,243.30900243309,0,419,0,2,403,496.277915632754
19112,25,25530,81,"Tasa de exámenes médico legales por presunto delito sexual contra niños, niñas y adolescentes",2015,3,5,916,545.85152838428,1,460,217.391304347826,4,456,877.19298245614
19113,25,25530,81,"Tasa de exámenes médico legales por presunto delito sexual contra niños, niñas y adolescentes",2015,4,2,857,233.372228704784,0,431,0,2,426,469.483568075117
19114,25,25530,121,Tasa de exámenes médico legales por presunto delito sexual cuando la víctima está entre 18 y 28 años,2015,5,2,1482,134.952766531714,0,787,0,2,695,287.769784172662
19115,25,25535,81,"Tasa de exámenes médico legales por presunto delito sexual contra niños, niñas y adolescentes",2015,2,1,1228,81.4332247557003,0,625,0,1,603,165.837479270315
19116,25,25535,81,"Tasa de exámenes médico legales por presunto delito sexual contra niños, niñas y adolescentes",2015,3,1,1442,69.3481276005548,0,721,0,1,721,138.69625520111
19117,25,25535,81,"Tasa de exámenes médico legales por presunto delito sexual contra niños, niñas y adolescentes",2015,4,3,1321,227.100681302044,0,659,0,3,662,453.172205438066
19118,25,25594,81,"Tasa de exámenes médico legales por presunto delito sexual contra niños, niñas y adolescentes",2015,4,1,662,151.057401812689,0,363,0,1,299,334.448160535117
19119,25,25594,121,Tasa de exámenes médico legales por presunto delito sexual cuando la víctima está entre 18 y 28 años,2015,5,1,1311,76.27765064836,0,706,0,1,605,165.289256198347
19120,25,25596,81,"Tasa de exámenes médico legales por presunto delito sexual contra niños, niñas y adolescentes",2015,3,3,1017,294.985250737463,1,528,189.393939393939,2,489,408.997955010225
19121,25,25596,81,"Tasa de exámenes médico legales por presunto delito sexual contra niños, niñas y adolescentes",2015,4,1,972,102.880658436214,1,518,193.050193050193,0,454,0
19122,25,25599,81,"Tasa de exámenes médico legales por presunto delito sexual contra niños, niñas y adolescentes",2015,2,1,685,145.985401459854,0,347,0,1,338,295.85798816568
19123,25,25599,81,"Tasa de exámenes médico legales por presunto delito sexual contra niños, niñas y adolescentes",2015,3,1,777,128.700128700129,1,391,255.754475703325,0,386,0
19124,25,25599,81,"Tasa de exámenes médico legales por presunto delito sexual contra niños, niñas y adolescentes",2015,4,1,747,133.868808567604,0,378,0,1,369,271.0027100271
19125,25,25599,121,Tasa de exámenes médico legales por presunto delito sexual cuando la víctima está entre 18 y 28 años,2015,5,1,1483,67.4308833445718,0,778,0,1,705,141.843971631206
19126,25,25612,81,"Tasa de exámenes médico legales por presunto delito sexual contra niños, niñas y adolescentes",2015,2,1,764,130.890052356021,0,385,0,1,379,263.852242744063
19127,25,25612,81,"Tasa de exámenes médico legales por presunto delito sexual contra niños, niñas y adolescentes",2015,3,2,895,223.463687150838,1,438,228.310502283105,1,457,218.818380743982
19128,25,25612,81,"Tasa de exámenes médico legales por presunto delito sexual contra niños, niñas y adolescentes",2015,4,1,948,105.485232067511,0,461,0,1,487,205.338809034908
19129,25,25645,81,"Tasa de exámenes médico legales por presunto delito sexual contra niños, niñas y adolescentes",2015,2,2,1040,192.307692307692,1,534,187.265917602996,1,506,197.628458498024
19130,25,25645,81,"Tasa de exámenes médico legales por presunto delito sexual contra niños, niñas y adolescentes",2015,3,3,1284,233.644859813084,0,650,0,3,634,473.186119873817
19131,25,25645,81,"Tasa de exámenes médico legales por presunto delito sexual contra niños, niñas y adolescentes",2015,4,4,1314,304.41400304414,0,670,0,4,644,621.11801242236
19132,25,25649,81,"Tasa de exámenes médico legales por presunto delito sexual contra niños, niñas y adolescentes",2015,2,1,970,103.092783505155,0,495,0,1,475,210.526315789474
19133,25,25649,81,"Tasa de exámenes médico legales por presunto delito sexual contra niños, niñas y adolescentes",2015,3,1,1120,89.2857142857143,0,576,0,1,544,183.823529411765
19134,25,25649,81,"Tasa de exámenes médico legales por presunto delito sexual contra niños, niñas y adolescentes",2015,4,2,1130,176.991150442478,0,566,0,2,564,354.609929078014
19135,25,25658,81,"Tasa de exámenes médico legales por presunto delito sexual contra niños, niñas y adolescentes",2015,3,1,1111,90.00900090009,1,583,171.526586620926,0,528,0
19136,25,25658,81,"Tasa de exámenes médico legales por presunto delito sexual contra niños, niñas y adolescentes",2015,4,1,1041,96.0614793467819,0,548,0,1,493,202.839756592292
19137,25,25662,81,"Tasa de exámenes médico legales por presunto delito sexual contra niños, niñas y adolescentes",2015,2,1,883,113.250283125708,0,456,0,1,427,234.192037470726
19138,25,25662,81,"Tasa de exámenes médico legales por presunto delito sexual contra niños, niñas y adolescentes",2015,3,2,1006,198.807157057654,1,498,200.803212851406,1,508,196.850393700787
19139,25,25662,81,"Tasa de exámenes médico legales por presunto delito sexual contra niños, niñas y adolescentes",2015,4,4,1061,377.002827521206,0,525,0,4,536,746.268656716418
19140,25,25718,81,"Tasa de exámenes médico legales por presunto delito sexual contra niños, niñas y adolescentes",2015,2,3,872,344.036697247706,2,442,452.488687782805,1,430,232.558139534884
19141,25,25718,81,"Tasa de exámenes médico legales por presunto delito sexual contra niños, niñas y adolescentes",2015,3,7,1024,683.59375,2,526,380.228136882129,5,498,1004.01606425703
19142,25,25718,81,"Tasa de exámenes médico legales por presunto delito sexual contra niños, niñas y adolescentes",2015,4,9,1062,847.457627118644,3,537,558.659217877095,6,525,1142.85714285714
19143,25,25736,81,"Tasa de exámenes médico legales por presunto delito sexual contra niños, niñas y adolescentes",2015,3,1,1617,61.8429189857761,0,819,0,1,798,125.31328320802
19144,25,25736,81,"Tasa de exámenes médico legales por presunto delito sexual contra niños, niñas y adolescentes",2015,4,1,1586,63.0517023959647,0,796,0,1,790,126.582278481013
19145,25,25740,81,"Tasa de exámenes médico legales por presunto delito sexual contra niños, niñas y adolescentes",2015,2,4,3345,119.581464872945,0,1704,0,4,1641,243.75380865326
19146,25,25740,81,"Tasa de exámenes médico legales por presunto delito sexual contra niños, niñas y adolescentes",2015,3,5,4035,123.915737298637,2,2056,97.2762645914397,3,1979,151.591712986357
19147,25,25740,81,"Tasa de exámenes médico legales por presunto delito sexual contra niños, niñas y adolescentes",2015,4,18,4353,413.507925568573,1,2226,44.9236298292902,17,2127,799.24776680771
19148,25,25740,121,Tasa de exámenes médico legales por presunto delito sexual cuando la víctima está entre 18 y 28 años,2015,5,4,7666,52.1784503000261,1,3956,25.2780586450961,3,3710,80.8625336927224
19149,25,25743,81,"Tasa de exámenes médico legales por presunto delito sexual contra niños, niñas y adolescentes",2015,2,2,1878,106.496272630458,0,964,0,2,914,218.818380743982
19150,25,25743,81,"Tasa de exámenes médico legales por presunto delito sexual contra niños, niñas y adolescentes",2015,3,4,2230,179.372197309417,1,1151,86.8809730668983,3,1079,278.035217794254
19151,25,25743,81,"Tasa de exámenes médico legales por presunto delito sexual contra niños, niñas y adolescentes",2015,4,8,2364,338.409475465313,0,1213,0,8,1151,695.047784535187
19152,25,25745,81,"Tasa de exámenes médico legales por presunto delito sexual contra niños, niñas y adolescentes",2015,2,1,1337,74.794315632012,1,682,146.627565982405,0,655,0
19153,25,25754,81,"Tasa de exámenes médico legales por presunto delito sexual contra niños, niñas y adolescentes",2015,2,76,47573,159.754482584659,19,24379,77.9359284630215,57,23194,245.753212037596
19154,25,25754,81,"Tasa de exámenes médico legales por presunto delito sexual contra niños, niñas y adolescentes",2015,3,124,56429,219.745166492406,15,28877,51.9444540637878,109,27552,395.61556329849
19155,25,25754,81,"Tasa de exámenes médico legales por presunto delito sexual contra niños, niñas y adolescentes",2015,4,122,56965,214.166593522338,15,29083,51.5765223670185,107,27882,383.760131984793
19156,25,25754,121,Tasa de exámenes médico legales por presunto delito sexual cuando la víctima está entre 18 y 28 años,2015,5,21,103659,20.2587329609585,2,51733,3.86600429126476,19,51926,36.5905326811231
19157,25,25754,81,"Tasa de exámenes médico legales por presunto delito sexual contra niños, niñas y adolescentes",2015,1,1,9645,10.3680663556247,0,4921,0,1,4724,21.1685012701101
19158,25,25758,81,"Tasa de exámenes médico legales por presunto delito sexual contra niños, niñas y adolescentes",2015,3,1,2888,34.6260387811634,0,1473,0,1,1415,70.6713780918728
19159,25,25758,81,"Tasa de exámenes médico legales por presunto delito sexual contra niños, niñas y adolescentes",2015,4,6,2935,204.42930153322,0,1495,0,6,1440,416.666666666667
19160,25,25769,81,"Tasa de exámenes médico legales por presunto delito sexual contra niños, niñas y adolescentes",2015,3,3,1607,186.683260734288,1,816,122.549019607843,2,791,252.844500632111
19161,25,25769,81,"Tasa de exámenes médico legales por presunto delito sexual contra niños, niñas y adolescentes",2015,4,3,1638,183.150183150183,0,836,0,3,802,374.064837905237
19162,25,25772,81,"Tasa de exámenes médico legales por presunto delito sexual contra niños, niñas y adolescentes",2015,3,1,2357,42.4268137462876,1,1168,85.6164383561644,0,1189,0
19163,25,25772,81,"Tasa de exámenes médico legales por presunto delito sexual contra niños, niñas y adolescentes",2015,4,1,2285,43.7636761487965,0,1113,0,1,1172,85.3242320819113
19164,25,25777,81,"Tasa de exámenes médico legales por presunto delito sexual contra niños, niñas y adolescentes",2015,3,1,665,150.375939849624,0,330,0,1,335,298.507462686567
19165,25,25779,81,"Tasa de exámenes médico legales por presunto delito sexual contra niños, niñas y adolescentes",2015,4,2,1469,136.147038801906,0,754,0,2,715,279.72027972028
19166,25,25785,81,"Tasa de exámenes médico legales por presunto delito sexual contra niños, niñas y adolescentes",2015,2,1,2345,42.6439232409382,0,1201,0,1,1144,87.4125874125874
19167,25,25785,81,"Tasa de exámenes médico legales por presunto delito sexual contra niños, niñas y adolescentes",2015,3,2,2870,69.6864111498258,0,1468,0,2,1402,142.65335235378
19168,25,25785,81,"Tasa de exámenes médico legales por presunto delito sexual contra niños, niñas y adolescentes",2015,4,5,3004,166.444740346205,0,1532,0,5,1472,339.673913043478
19169,25,25785,121,Tasa de exámenes médico legales por presunto delito sexual cuando la víctima está entre 18 y 28 años,2015,5,1,5236,19.0985485103132,0,2679,0,1,2557,39.1083300743058
19170,25,25793,81,"Tasa de exámenes médico legales por presunto delito sexual contra niños, niñas y adolescentes",2015,4,1,963,103.842159916926,0,521,0,1,442,226.244343891403
19171,25,25797,81,"Tasa de exámenes médico legales por presunto delito sexual contra niños, niñas y adolescentes",2015,3,3,1187,252.73799494524,0,590,0,3,597,502.51256281407
19172,25,25797,81,"Tasa de exámenes médico legales por presunto delito sexual contra niños, niñas y adolescentes",2015,4,1,1199,83.4028356964137,0,585,0,1,614,162.866449511401
19173,25,25797,121,Tasa de exámenes médico legales por presunto delito sexual cuando la víctima está entre 18 y 28 años,2015,5,1,1783,56.0852495793606,0,868,0,1,915,109.289617486339
19174,25,25799,81,"Tasa de exámenes médico legales por presunto delito sexual contra niños, niñas y adolescentes",2015,2,4,1849,216.333153055706,1,949,105.374077976818,3,900,333.333333333333
19175,25,25799,81,"Tasa de exámenes médico legales por presunto delito sexual contra niños, niñas y adolescentes",2015,3,4,2211,180.913613749435,0,1126,0,4,1085,368.663594470046
19176,25,25799,81,"Tasa de exámenes médico legales por presunto delito sexual contra niños, niñas y adolescentes",2015,4,6,2267,264.666960741067,0,1146,0,6,1121,535.236396074933
19177,25,25799,121,Tasa de exámenes médico legales por presunto delito sexual cuando la víctima está entre 18 y 28 años,2015,5,1,3896,25.6673511293634,0,1963,0,1,1933,51.7330574236937
19178,25,25805,81,"Tasa de exámenes médico legales por presunto delito sexual contra niños, niñas y adolescentes",2015,3,2,584,342.465753424658,0,290,0,2,294,680.272108843537
19179,25,25807,81,"Tasa de exámenes médico legales por presunto delito sexual contra niños, niñas y adolescentes",2015,3,1,354,282.485875706215,0,177,0,1,177,564.971751412429
19180,25,25807,81,"Tasa de exámenes médico legales por presunto delito sexual contra niños, niñas y adolescentes",2015,4,5,341,1466.27565982405,2,172,1162.79069767442,3,169,1775.14792899408
19181,25,25815,81,"Tasa de exámenes médico legales por presunto delito sexual contra niños, niñas y adolescentes",2015,2,1,1503,66.5335994677312,1,775,129.032258064516,0,728,0
19182,25,25815,81,"Tasa de exámenes médico legales por presunto delito sexual contra niños, niñas y adolescentes",2015,3,4,1804,221.729490022173,1,933,107.181136120043,3,871,344.43168771527
19183,25,25815,81,"Tasa de exámenes médico legales por presunto delito sexual contra niños, niñas y adolescentes",2015,4,5,1768,282.80542986425297,1,915,109.289617486339,4,853,468.933177022274
19184,25,25815,121,Tasa de exámenes médico legales por presunto delito sexual cuando la víctima está entre 18 y 28 años,2015,5,5,3247,153.988296889436,0,1651,0,5,1596,313.28320802005
19185,25,25817,81,"Tasa de exámenes médico legales por presunto delito sexual contra niños, niñas y adolescentes",2015,2,2,3336,59.9520383693046,1,1714,58.343057176196,1,1622,61.652281134402
19186,25,25817,81,"Tasa de exámenes médico legales por presunto delito sexual contra niños, niñas y adolescentes",2015,3,3,4014,74.7384155455904,0,2063,0,3,1951,153.767298821117
19187,25,25817,81,"Tasa de exámenes médico legales por presunto delito sexual contra niños, niñas y adolescentes",2015,4,2,3953,50.5944852011131,2,2001,99.9500249875062,0,1952,0
19188,25,25823,81,"Tasa de exámenes médico legales por presunto delito sexual contra niños, niñas y adolescentes",2015,3,2,507,394.477317554241,0,266,0,2,241,829.875518672199
19189,25,25823,81,"Tasa de exámenes médico legales por presunto delito sexual contra niños, niñas y adolescentes",2015,4,4,489,817.99591002045,0,257,0,4,232,1724.13793103448
19190,25,25839,81,"Tasa de exámenes médico legales por presunto delito sexual contra niños, niñas y adolescentes",2015,3,4,1239,322.841000807102,0,650,0,4,589,679.11714770798
19191,25,25843,81,"Tasa de exámenes médico legales por presunto delito sexual contra niños, niñas y adolescentes",2015,2,4,3798,105.318588730911,0,1928,0,4,1870,213.903743315508
19192,25,25843,81,"Tasa de exámenes médico legales por presunto delito sexual contra niños, niñas y adolescentes",2015,3,6,4416,135.869565217391,2,2210,90.4977375565611,4,2206,181.323662737987
19193,25,25843,81,"Tasa de exámenes médico legales por presunto delito sexual contra niños, niñas y adolescentes",2015,4,12,4308,278.551532033426,2,2115,94.5626477541371,10,2193,455.996352029184
19194,25,25843,121,Tasa de exámenes médico legales por presunto delito sexual cuando la víctima está entre 18 y 28 años,2015,5,3,7822,38.3533623114293,1,3744,26.7094017094017,2,4078,49.0436488474743
19195,25,25845,81,"Tasa de exámenes médico legales por presunto delito sexual contra niños, niñas y adolescentes",2015,4,4,948,421.940928270042,0,488,0,4,460,869.565217391304
19196,25,25862,81,"Tasa de exámenes médico legales por presunto delito sexual contra niños, niñas y adolescentes",2015,4,2,800,250,2,384,520.833333333333,0,416,0
19197,25,25871,81,"Tasa de exámenes médico legales por presunto delito sexual contra niños, niñas y adolescentes",2015,3,1,237,421.940928270042,0,120,0,1,117,854.700854700855
19198,25,25871,81,"Tasa de exámenes médico legales por presunto delito sexual contra niños, niñas y adolescentes",2015,4,1,237,421.940928270042,0,121,0,1,116,862.068965517241
19199,25,25873,81,"Tasa de exámenes médico legales por presunto delito sexual contra niños, niñas y adolescentes",2015,4,5,2412,207.296849087894,0,1274,0,5,1138,439.367311072056
19200,25,25873,121,Tasa de exámenes médico legales por presunto delito sexual cuando la víctima está entre 18 y 28 años,2015,5,1,3998,25.0125062531266,0,2092,0,1,1906,52.4658971668416
19201,25,25875,81,"Tasa de exámenes médico legales por presunto delito sexual contra niños, niñas y adolescentes",2015,2,4,2163,184.928340268146,2,1103,181.323662737987,2,1060,188.679245283019
19202,25,25875,81,"Tasa de exámenes médico legales por presunto delito sexual contra niños, niñas y adolescentes",2015,3,13,2592,501.543209876543,2,1314,152.20700152207,11,1278,860.719874804382
19203,25,25875,81,"Tasa de exámenes médico legales por presunto delito sexual contra niños, niñas y adolescentes",2015,4,17,2633,645.651348271933,1,1349,74.1289844329133,16,1284,1246.10591900312
19204,25,25875,121,Tasa de exámenes médico legales por presunto delito sexual cuando la víctima está entre 18 y 28 años,2015,5,2,4872,41.0509031198686,0,2487,0,2,2385,83.8574423480084
19205,25,25878,81,"Tasa de exámenes médico legales por presunto delito sexual contra niños, niñas y adolescentes",2015,2,1,1107,90.3342366757001,0,572,0,1,535,186.915887850467
19206,25,25878,81,"Tasa de exámenes médico legales por presunto delito sexual contra niños, niñas y adolescentes",2015,3,4,1321,302.800908402725,1,676,147.92899408284,3,645,465.116279069767
19207,25,25878,81,"Tasa de exámenes médico legales por presunto delito sexual contra niños, niñas y adolescentes",2015,4,2,1363,146.735143066764,0,701,0,2,662,302.114803625378
19208,25,25885,81,"Tasa de exámenes médico legales por presunto delito sexual contra niños, niñas y adolescentes",2015,2,1,1637,61.0873549175321,1,851,117.508813160987,0,786,0
19209,25,25885,81,"Tasa de exámenes médico legales por presunto delito sexual contra niños, niñas y adolescentes",2015,3,4,1845,216.80216802168,0,974,0,4,871,459.242250287026
19210,25,25885,81,"Tasa de exámenes médico legales por presunto delito sexual contra niños, niñas y adolescentes",2015,4,3,1829,164.024056861673,1,954,104.82180293501,2,875,228.571428571429
19211,25,25898,81,"Tasa de exámenes médico legales por presunto delito sexual contra niños, niñas y adolescentes",2015,3,1,680,147.058823529412,0,343,0,1,337,296.73590504451
19212,25,25898,81,"Tasa de exámenes médico legales por presunto delito sexual contra niños, niñas y adolescentes",2015,4,2,606,330.03300330033,0,303,0,2,303,660.06600660066
19213,25,25899,81,"Tasa de exámenes médico legales por presunto delito sexual contra niños, niñas y adolescentes",2015,2,8,10632,75.2445447705041,1,5443,18.3722212015433,7,5189,134.900751589902
19214,25,25899,81,"Tasa de exámenes médico legales por presunto delito sexual contra niños, niñas y adolescentes",2015,3,15,13086,114.626318202659,4,6714,59.5770032767352,11,6372,172.63025737602
19215,25,25899,81,"Tasa de exámenes médico legales por presunto delito sexual contra niños, niñas y adolescentes",2015,4,20,13063,153.104187399525,3,6593,45.5028060063704,17,6470,262.751159196291
19216,25,25899,121,Tasa de exámenes médico legales por presunto delito sexual cuando la víctima está entre 18 y 28 años,2015,5,3,23544,12.7420998980632,0,11745,0,3,11799,25.4258835494533
19217,27,27001,81,"Tasa de exámenes médico legales por presunto delito sexual contra niños, niñas y adolescentes",2015,2,11,14882,73.9147963983336,0,7573,0,11,7309,150.4993843207
19218,27,27001,81,"Tasa de exámenes médico legales por presunto delito sexual contra niños, niñas y adolescentes",2015,3,18,17408,103.400735294118,1,8867,11.2777715123492,17,8541,199.039925067322
19219,27,27001,81,"Tasa de exámenes médico legales por presunto delito sexual contra niños, niñas y adolescentes",2015,4,34,15984,212.712712712713,3,8160,36.7647058823529,31,7824,396.216768916155
19220,27,27001,121,Tasa de exámenes médico legales por presunto delito sexual cuando la víctima está entre 18 y 28 años,2015,5,12,26193,45.8137670369946,0,13603,0,12,12590,95.3137410643368
19221,27,27006,81,"Tasa de exámenes médico legales por presunto delito sexual contra niños, niñas y adolescentes",2015,4,1,1176,85.0340136054422,1,584,171.232876712329,0,592,0
19222,27,27025,81,"Tasa de exámenes médico legales por presunto delito sexual contra niños, niñas y adolescentes",2015,2,1,5381,18.5839063371121,0,2778,0,1,2603,38.4172109104879
19223,27,27025,81,"Tasa de exámenes médico legales por presunto delito sexual contra niños, niñas y adolescentes",2015,3,1,5759,17.3641257162702,0,2989,0,1,2770,36.101083032491
19224,27,27050,81,"Tasa de exámenes médico legales por presunto delito sexual contra niños, niñas y adolescentes",2015,4,1,1338,74.7384155455904,0,689,0,1,649,154.083204930663
19225,27,27073,81,"Tasa de exámenes médico legales por presunto delito sexual contra niños, niñas y adolescentes",2015,3,1,1228,81.4332247557003,0,629,0,1,599,166.944908180301
19226,27,27073,81,"Tasa de exámenes médico legales por presunto delito sexual contra niños, niñas y adolescentes",2015,4,2,1090,183.48623853211,0,562,0,2,528,378.787878787879
19227,27,27075,81,"Tasa de exámenes médico legales por presunto delito sexual contra niños, niñas y adolescentes",2015,4,1,1210,82.6446280991735,0,619,0,1,591,169.204737732656
19228,27,27077,81,"Tasa de exámenes médico legales por presunto delito sexual contra niños, niñas y adolescentes",2015,4,1,2736,36.5497076023392,0,1451,0,1,1285,77.8210116731518
19229,27,27077,121,Tasa de exámenes médico legales por presunto delito sexual cuando la víctima está entre 18 y 28 años,2015,5,1,3961,25.2461499621308,0,2141,0,1,1820,54.9450549450549
19230,27,27099,81,"Tasa de exámenes médico legales por presunto delito sexual contra niños, niñas y adolescentes",2015,3,1,1565,63.8977635782748,0,799,0,1,766,130.548302872063
19231,27,27099,81,"Tasa de exámenes médico legales por presunto delito sexual contra niños, niñas y adolescentes",2015,4,1,1363,73.3675715333822,0,697,0,1,666,150.15015015015
19232,27,27135,81,"Tasa de exámenes médico legales por presunto delito sexual contra niños, niñas y adolescentes",2015,3,1,1115,89.6860986547085,0,566,0,1,549,182.149362477231
19233,27,27160,81,"Tasa de exámenes médico legales por presunto delito sexual contra niños, niñas y adolescentes",2015,2,2,996,200.803212851406,0,503,0,2,493,405.679513184584
19234,27,27160,81,"Tasa de exámenes médico legales por presunto delito sexual contra niños, niñas y adolescentes",2015,3,1,1202,83.1946755407654,0,623,0,1,579,172.711571675302
19235,27,27160,81,"Tasa de exámenes médico legales por presunto delito sexual contra niños, niñas y adolescentes",2015,4,2,1215,164.609053497942,0,658,0,2,557,359.066427289048
19236,27,27205,81,"Tasa de exámenes médico legales por presunto delito sexual contra niños, niñas y adolescentes",2015,2,1,1770,56.4971751412429,1,888,112.612612612613,0,882,0
19237,27,27245,81,"Tasa de exámenes médico legales por presunto delito sexual contra niños, niñas y adolescentes",2015,4,1,1886,53.0222693531283,0,950,0,1,936,106.837606837607
19238,27,27250,81,"Tasa de exámenes médico legales por presunto delito sexual contra niños, niñas y adolescentes",2015,2,1,2442,40.950040950041,0,1213,0,1,1229,81.366965012205
19239,27,27361,81,"Tasa de exámenes médico legales por presunto delito sexual contra niños, niñas y adolescentes",2015,2,4,3115,128.410914927769,1,1560,64.1025641025641,3,1555,192.926045016077
19240,27,27361,81,"Tasa de exámenes médico legales por presunto delito sexual contra niños, niñas y adolescentes",2015,3,4,3544,112.866817155756,3,1736,172.811059907834,1,1808,55.3097345132743
19241,27,27361,81,"Tasa de exámenes médico legales por presunto delito sexual contra niños, niñas y adolescentes",2015,4,6,3177,188.857412653447,0,1552,0,6,1625,369.230769230769
19242,27,27413,81,"Tasa de exámenes médico legales por presunto delito sexual contra niños, niñas y adolescentes",2015,3,1,1747,57.2409845449342,0,858,0,1,889,112.485939257593
19243,27,27425,81,"Tasa de exámenes médico legales por presunto delito sexual contra niños, niñas y adolescentes",2015,2,2,3174,63.0119722747322,1,1597,62.6174076393237,1,1577,63.4115409004439
19244,27,27450,81,"Tasa de exámenes médico legales por presunto delito sexual contra niños, niñas y adolescentes",2015,2,1,2188,45.7038391224863,0,1107,0,1,1081,92.5069380203515
19245,27,27450,81,"Tasa de exámenes médico legales por presunto delito sexual contra niños, niñas y adolescentes",2015,3,2,2420,82.6446280991735,0,1228,0,2,1192,167.785234899329
19246,27,27450,81,"Tasa de exámenes médico legales por presunto delito sexual contra niños, niñas y adolescentes",2015,4,1,2078,48.1231953801732,0,1042,0,1,1036,96.5250965250965
19247,27,27491,81,"Tasa de exámenes médico legales por presunto delito sexual contra niños, niñas y adolescentes",2015,3,1,1218,82.1018062397373,0,627,0,1,591,169.204737732656
19248,27,27491,81,"Tasa de exámenes médico legales por presunto delito sexual contra niños, niñas y adolescentes",2015,4,1,1077,92.8505106778087,0,557,0,1,520,192.307692307692
19249,27,27580,81,"Tasa de exámenes médico legales por presunto delito sexual contra niños, niñas y adolescentes",2015,4,2,1307,153.022188217292,0,645,0,2,662,302.114803625378
19250,27,27600,81,"Tasa de exámenes médico legales por presunto delito sexual contra niños, niñas y adolescentes",2015,4,3,1152,260.416666666667,0,588,0,3,564,531.914893617021
19251,27,27615,81,"Tasa de exámenes médico legales por presunto delito sexual contra niños, niñas y adolescentes",2015,3,1,4585,21.8102508178844,0,2315,0,1,2270,44.0528634361234
19252,27,27615,121,Tasa de exámenes médico legales por presunto delito sexual cuando la víctima está entre 18 y 28 años,2015,5,1,6725,14.8698884758364,0,3452,0,1,3273,30.5530094714329
19253,27,27787,81,"Tasa de exámenes médico legales por presunto delito sexual contra niños, niñas y adolescentes",2015,2,2,2582,77.4593338497289,0,1306,0,2,1276,156.739811912226
19254,27,27787,81,"Tasa de exámenes médico legales por presunto delito sexual contra niños, niñas y adolescentes",2015,3,4,2905,137.693631669535,0,1450,0,4,1455,274.914089347079
19255,27,27810,81,"Tasa de exámenes médico legales por presunto delito sexual contra niños, niñas y adolescentes",2015,3,2,1500,133.333333333333,0,766,0,2,734,272.479564032698
19256,27,27810,81,"Tasa de exámenes médico legales por presunto delito sexual contra niños, niñas y adolescentes",2015,4,2,1319,151.630022744503,0,673,0,2,646,309.597523219814
19257,41,41001,81,"Tasa de exámenes médico legales por presunto delito sexual contra niños, niñas y adolescentes",2015,2,29,26361,110.01100110011,5,13411,37.2828275296398,24,12950,185.328185328185
19258,41,41001,81,"Tasa de exámenes médico legales por presunto delito sexual contra niños, niñas y adolescentes",2015,3,50,33618,148.729847105717,8,17060,46.8933177022274,42,16558,253.653822925474
19259,41,41001,81,"Tasa de exámenes médico legales por presunto delito sexual contra niños, niñas y adolescentes",2015,4,56,35629,157.175334699262,4,17811,22.4580315535343,52,17818,291.839712650129
19260,41,41001,121,Tasa de exámenes médico legales por presunto delito sexual cuando la víctima está entre 18 y 28 años,2015,5,12,68053,17.6333152102038,3,33478,8.96110878786068,9,34575,26.0303687635575
19261,41,41006,81,"Tasa de exámenes médico legales por presunto delito sexual contra niños, niñas y adolescentes",2015,2,2,4059,49.2732200049273,0,2078,0,2,1981,100.959111559818
19262,41,41006,81,"Tasa de exámenes médico legales por presunto delito sexual contra niños, niñas y adolescentes",2015,3,5,4560,109.649122807018,0,2329,0,5,2231,224.114746750336
19263,41,41006,81,"Tasa de exámenes médico legales por presunto delito sexual contra niños, niñas y adolescentes",2015,4,12,4432,270.758122743682,0,2252,0,12,2180,550.45871559633
19264,41,41006,121,Tasa de exámenes médico legales por presunto delito sexual cuando la víctima está entre 18 y 28 años,2015,5,1,6577,15.2045005321575,0,3381,0,1,3196,31.2891113892365
19265,41,41013,121,Tasa de exámenes médico legales por presunto delito sexual cuando la víctima está entre 18 y 28 años,2015,5,1,1787,55.9597090095132,0,921,0,1,866,115.473441108545
19266,41,41016,81,"Tasa de exámenes médico legales por presunto delito sexual contra niños, niñas y adolescentes",2015,3,1,3342,29.9222022740874,1,1736,57.6036866359447,0,1606,0
19267,41,41016,81,"Tasa de exámenes médico legales por presunto delito sexual contra niños, niñas y adolescentes",2015,4,1,3146,31.7863954227591,0,1596,0,1,1550,64.5161290322581
19268,41,41016,121,Tasa de exámenes médico legales por presunto delito sexual cuando la víctima está entre 18 y 28 años,2015,5,1,5087,19.657951641439,0,2597,0,1,2490,40.1606425702811
19269,41,41020,81,"Tasa de exámenes médico legales por presunto delito sexual contra niños, niñas y adolescentes",2015,2,1,2586,38.6697602474865,0,1330,0,1,1256,79.6178343949045
19270,41,41020,81,"Tasa de exámenes médico legales por presunto delito sexual contra niños, niñas y adolescentes",2015,4,2,2751,72.7008360596147,0,1418,0,2,1333,150.037509377344
19271,41,41026,81,"Tasa de exámenes médico legales por presunto delito sexual contra niños, niñas y adolescentes",2015,4,1,550,181.818181818182,0,271,0,1,279,358.4229390681
19272,41,41078,81,"Tasa de exámenes médico legales por presunto delito sexual contra niños, niñas y adolescentes",2015,3,1,1109,90.1713255184851,0,583,0,1,526,190.114068441065
19273,41,41078,81,"Tasa de exámenes médico legales por presunto delito sexual contra niños, niñas y adolescentes",2015,4,3,1120,267.857142857143,1,588,170.068027210884,2,532,375.93984962406
19274,41,41078,121,Tasa de exámenes médico legales por presunto delito sexual cuando la víctima está entre 18 y 28 años,2015,5,1,1926,51.9210799584631,0,985,0,1,941,106.269925611052
19275,41,41132,81,"Tasa de exámenes médico legales por presunto delito sexual contra niños, niñas y adolescentes",2015,4,3,3874,77.4393391843056,0,1949,0,3,1925,155.844155844156
19276,41,41206,81,"Tasa de exámenes médico legales por presunto delito sexual contra niños, niñas y adolescentes",2015,3,2,1434,139.470013947001,0,752,0,2,682,293.255131964809
19277,41,41206,81,"Tasa de exámenes médico legales por presunto delito sexual contra niños, niñas y adolescentes",2015,4,1,1443,69.3000693000693,0,760,0,1,683,146.412884333821
19278,41,41298,81,"Tasa de exámenes médico legales por presunto delito sexual contra niños, niñas y adolescentes",2015,3,5,11204,44.6269189575152,0,5740,0,5,5464,91.5080527086384
19279,41,41298,81,"Tasa de exámenes médico legales por presunto delito sexual contra niños, niñas y adolescentes",2015,4,9,11348,79.3091293620021,1,5958,16.7841557569654,8,5390,148.423005565863
19280,41,41298,121,Tasa de exámenes médico legales por presunto delito sexual cuando la víctima está entre 18 y 28 años,2015,5,1,19342,5.17009616378865,0,11003,0,1,8339,11.9918455450294
19281,41,41306,81,"Tasa de exámenes médico legales por presunto delito sexual contra niños, niñas y adolescentes",2015,4,4,3891,102.801336417373,0,1953,0,4,1938,206.398348813209
19282,41,41319,81,"Tasa de exámenes médico legales por presunto delito sexual contra niños, niñas y adolescentes",2015,4,2,2631,76.0167236792094,0,1355,0,2,1276,156.739811912226
19283,41,41349,81,"Tasa de exámenes médico legales por presunto delito sexual contra niños, niñas y adolescentes",2015,2,1,703,142.247510668563,0,366,0,1,337,296.73590504451
19284,41,41357,81,"Tasa de exámenes médico legales por presunto delito sexual contra niños, niñas y adolescentes",2015,4,1,1414,70.7213578500707,0,752,0,1,662,151.057401812689
19285,41,41359,81,"Tasa de exámenes médico legales por presunto delito sexual contra niños, niñas y adolescentes",2015,3,5,3260,153.374233128834,0,1667,0,5,1593,313.873195229127
19286,41,41359,81,"Tasa de exámenes médico legales por presunto delito sexual contra niños, niñas y adolescentes",2015,4,2,3324,60.1684717208183,0,1734,0,2,1590,125.786163522013
19287,41,41359,121,Tasa de exámenes médico legales por presunto delito sexual cuando la víctima está entre 18 y 28 años,2015,5,1,5539,18.0538003249684,0,2850,0,1,2689,37.1885459278542
19288,41,41378,81,"Tasa de exámenes médico legales por presunto delito sexual contra niños, niñas y adolescentes",2015,2,4,1667,239.95200959808,1,849,117.785630153121,3,818,366.748166259169
19289,41,41378,81,"Tasa de exámenes médico legales por presunto delito sexual contra niños, niñas y adolescentes",2015,3,4,1831,218.459858001092,1,929,107.642626480086,3,902,332.594235033259
19290,41,41378,81,"Tasa de exámenes médico legales por presunto delito sexual contra niños, niñas y adolescentes",2015,4,6,1782,336.700336700337,0,901,0,6,881,681.044267877412
19291,41,41378,121,Tasa de exámenes médico legales por presunto delito sexual cuando la víctima está entre 18 y 28 años,2015,5,1,2840,35.2112676056338,0,1413,0,1,1427,70.0770847932726
19292,41,41396,81,"Tasa de exámenes médico legales por presunto delito sexual contra niños, niñas y adolescentes",2015,2,2,7043,28.3969899190686,0,3608,0,2,3435,58.2241630276565
19293,41,41396,81,"Tasa de exámenes médico legales por presunto delito sexual contra niños, niñas y adolescentes",2015,3,17,8134,208.999262355545,5,4170,119.904076738609,12,3964,302.724520686176
19294,41,41396,81,"Tasa de exámenes médico legales por presunto delito sexual contra niños, niñas y adolescentes",2015,4,12,8058,148.920327624721,0,4163,0,12,3895,308.08729139923
19295,41,41396,121,Tasa de exámenes médico legales por presunto delito sexual cuando la víctima está entre 18 y 28 años,2015,5,5,12645,39.5413206801107,0,6515,0,5,6130,81.5660685154976
19296,41,41503,81,"Tasa de exámenes médico legales por presunto delito sexual contra niños, niñas y adolescentes",2015,3,5,2035,245.700245700246,0,1049,0,5,986,507.09939148073
19297,41,41503,81,"Tasa de exámenes médico legales por presunto delito sexual contra niños, niñas y adolescentes",2015,4,5,1971,253.678335870117,0,1017,0,5,954,524.109014675052
19298,41,41518,81,"Tasa de exámenes médico legales por presunto delito sexual contra niños, niñas y adolescentes",2015,2,1,610,163.934426229508,0,314,0,1,296,337.837837837838
19299,41,41518,81,"Tasa de exámenes médico legales por presunto delito sexual contra niños, niñas y adolescentes",2015,4,1,703,142.247510668563,0,365,0,1,338,295.85798816568
19300,41,41518,121,Tasa de exámenes médico legales por presunto delito sexual cuando la víctima está entre 18 y 28 años,2015,5,1,1037,96.4320154291225,0,525,0,1,512,195.3125
19301,41,41524,81,"Tasa de exámenes médico legales por presunto delito sexual contra niños, niñas y adolescentes",2015,2,1,3136,31.8877551020408,0,1597,0,1,1539,64.9772579597141
19302,41,41524,81,"Tasa de exámenes médico legales por presunto delito sexual contra niños, niñas y adolescentes",2015,4,5,3696,135.281385281385,1,1897,52.7148128624143,4,1799,222.345747637576
19303,41,41524,121,Tasa de exámenes médico legales por presunto delito sexual cuando la víctima está entre 18 y 28 años,2015,5,1,6149,16.2628069604814,0,3167,0,1,2982,33.5345405767941
19304,41,41530,81,"Tasa de exámenes médico legales por presunto delito sexual contra niños, niñas y adolescentes",2015,3,2,1437,139.178844815588,0,763,0,2,674,296.73590504451
19305,41,41530,81,"Tasa de exámenes médico legales por presunto delito sexual contra niños, niñas y adolescentes",2015,4,3,1445,207.612456747405,0,762,0,3,683,439.238653001464
19306,41,41530,121,Tasa de exámenes médico legales por presunto delito sexual cuando la víctima está entre 18 y 28 años,2015,5,1,2416,41.3907284768212,0,1239,0,1,1177,84.9617672047579
19307,41,41548,81,"Tasa de exámenes médico legales por presunto delito sexual contra niños, niñas y adolescentes",2015,4,3,1582,189.633375474083,0,815,0,3,767,391.134289439374
19308,41,41551,81,"Tasa de exámenes médico legales por presunto delito sexual contra niños, niñas y adolescentes",2015,2,15,12816,117.041198501873,7,6536,107.099143206854,8,6280,127.388535031847
19309,41,41551,81,"Tasa de exámenes médico legales por presunto delito sexual contra niños, niñas y adolescentes",2015,3,32,15191,210.651043380949,8,7678,104.193800468872,24,7513,319.446293091974
19310,41,41551,81,"Tasa de exámenes médico legales por presunto delito sexual contra niños, niñas y adolescentes",2015,4,31,15468,200.413757434704,2,7814,25.5950857435372,29,7654,378.886856545597
19311,41,41551,121,Tasa de exámenes médico legales por presunto delito sexual cuando la víctima está entre 18 y 28 años,2015,5,5,25624,19.5129566031845,0,12773,0,5,12851,38.9074780172749
19312,41,41615,81,"Tasa de exámenes médico legales por presunto delito sexual contra niños, niñas y adolescentes",2015,3,2,2075,96.3855421686747,0,1057,0,2,1018,196.463654223969
19313,41,41660,81,"Tasa de exámenes médico legales por presunto delito sexual contra niños, niñas y adolescentes",2015,3,1,1579,63.3312222925902,0,822,0,1,757,132.100396301189
19314,41,41668,81,"Tasa de exámenes médico legales por presunto delito sexual contra niños, niñas y adolescentes",2015,2,2,3183,62.8338045868677,0,1618,0,2,1565,127.79552715655
19315,41,41668,81,"Tasa de exámenes médico legales por presunto delito sexual contra niños, niñas y adolescentes",2015,3,12,3725,322.147651006711,1,1887,52.9941706412295,11,1838,598.476605005441
19316,41,41668,81,"Tasa de exámenes médico legales por presunto delito sexual contra niños, niñas y adolescentes",2015,4,18,3814,471.945464079706,0,1927,0,18,1887,953.89507154213
19317,41,41668,121,Tasa de exámenes médico legales por presunto delito sexual cuando la víctima está entre 18 y 28 años,2015,5,3,6915,43.3839479392625,0,3615,0,3,3300,90.9090909090909
19318,41,41676,81,"Tasa de exámenes médico legales por presunto delito sexual contra niños, niñas y adolescentes",2015,3,1,1425,70.1754385964912,1,750,133.333333333333,0,675,0
19319,41,41676,81,"Tasa de exámenes médico legales por presunto delito sexual contra niños, niñas y adolescentes",2015,4,2,1365,146.520146520147,0,725,0,2,640,312.5
19320,41,41770,81,"Tasa de exámenes médico legales por presunto delito sexual contra niños, niñas y adolescentes",2015,3,5,2465,202.839756592292,0,1264,0,5,1201,416.31973355537
19321,41,41770,81,"Tasa de exámenes médico legales por presunto delito sexual contra niños, niñas y adolescentes",2015,4,5,2328,214.776632302406,2,1202,166.389351081531,3,1126,266.429840142096
19322,41,41791,81,"Tasa de exámenes médico legales por presunto delito sexual contra niños, niñas y adolescentes",2015,3,1,2385,41.9287211740042,0,1226,0,1,1159,86.2812769628991
19323,41,41791,81,"Tasa de exámenes médico legales por presunto delito sexual contra niños, niñas y adolescentes",2015,4,3,2228,134.649910233393,0,1146,0,3,1082,277.264325323475
19324,41,41797,81,"Tasa de exámenes médico legales por presunto delito sexual contra niños, niñas y adolescentes",2015,3,1,1096,91.2408759124088,0,569,0,1,527,189.753320683112
19325,41,41797,81,"Tasa de exámenes médico legales por presunto delito sexual contra niños, niñas y adolescentes",2015,4,1,1058,94.5179584120983,0,552,0,1,506,197.628458498024
19326,41,41797,121,Tasa de exámenes médico legales por presunto delito sexual cuando la víctima está entre 18 y 28 años,2015,5,1,1793,55.7724484104852,0,933,0,1,860,116.279069767442
19327,41,41799,81,"Tasa de exámenes médico legales por presunto delito sexual contra niños, niñas y adolescentes",2015,3,4,1919,208.441896821261,1,982,101.83299389002,3,937,320.17075773746
19328,41,41799,81,"Tasa de exámenes médico legales por presunto delito sexual contra niños, niñas y adolescentes",2015,4,4,1811,220.872446162341,1,932,107.296137339056,3,879,341.296928327645
19329,41,41801,81,"Tasa de exámenes médico legales por presunto delito sexual contra niños, niñas y adolescentes",2015,2,1,891,112.233445566779,0,465,0,1,426,234.741784037559
19330,41,41801,81,"Tasa de exámenes médico legales por presunto delito sexual contra niños, niñas y adolescentes",2015,3,5,1055,473.9336492891,2,566,353.356890459364,3,489,613.496932515337
19331,41,41801,81,"Tasa de exámenes médico legales por presunto delito sexual contra niños, niñas y adolescentes",2015,4,2,1028,194.552529182879,0,558,0,2,470,425.531914893617
19332,41,41801,121,Tasa de exámenes médico legales por presunto delito sexual cuando la víctima está entre 18 y 28 años,2015,5,1,1690,59.1715976331361,0,892,0,1,798,125.31328320802
19333,41,41807,81,"Tasa de exámenes médico legales por presunto delito sexual contra niños, niñas y adolescentes",2015,2,1,2122,47.1253534401508,0,1084,0,1,1038,96.3391136801541
19334,41,41807,81,"Tasa de exámenes médico legales por presunto delito sexual contra niños, niñas y adolescentes",2015,3,2,2507,79.7766254487435,0,1270,0,2,1237,161.681487469685
19335,41,41807,81,"Tasa de exámenes médico legales por presunto delito sexual contra niños, niñas y adolescentes",2015,4,9,2522,356.859635210151,1,1263,79.1765637371338,8,1259,635.424940428912
19336,41,41807,121,Tasa de exámenes médico legales por presunto delito sexual cuando la víctima está entre 18 y 28 años,2015,5,2,4157,48.1116189559779,0,2092,0,2,2065,96.8523002421308
19337,41,41872,81,"Tasa de exámenes médico legales por presunto delito sexual contra niños, niñas y adolescentes",2015,3,2,932,214.592274678112,1,485,206.185567010309,1,447,223.713646532438
19338,41,41872,81,"Tasa de exámenes médico legales por presunto delito sexual contra niños, niñas y adolescentes",2015,4,1,875,114.285714285714,0,443,0,1,432,231.481481481481
19339,41,41885,81,"Tasa de exámenes médico legales por presunto delito sexual contra niños, niñas y adolescentes",2015,3,2,890,224.719101123596,2,450,444.444444444444,0,440,0
19340,44,44001,81,"Tasa de exámenes médico legales por presunto delito sexual contra niños, niñas y adolescentes",2015,2,13,34455,37.7303729502249,5,17654,28.3221932706469,8,16801,47.6162133206357
19341,44,44001,81,"Tasa de exámenes médico legales por presunto delito sexual contra niños, niñas y adolescentes",2015,3,24,37811,63.4735923408532,5,19346,25.8451359454151,19,18465,102.897373409152
19342,44,44001,81,"Tasa de exámenes médico legales por presunto delito sexual contra niños, niñas y adolescentes",2015,4,47,31153,150.868295188264,7,15771,44.3852640923213,40,15382,260.044207515278
19343,44,44001,121,Tasa de exámenes médico legales por presunto delito sexual cuando la víctima está entre 18 y 28 años,2015,5,17,48906,34.7605610763505,3,24081,12.4579544038869,14,24825,56.3947633434038
19344,44,44035,81,"Tasa de exámenes médico legales por presunto delito sexual contra niños, niñas y adolescentes",2015,3,1,3608,27.7161862527716,0,1875,0,1,1733,57.7034045008655
19345,44,44035,81,"Tasa de exámenes médico legales por presunto delito sexual contra niños, niñas y adolescentes",2015,4,2,3365,59.4353640416047,0,1751,0,2,1614,123.915737298637
19346,44,44035,121,Tasa de exámenes médico legales por presunto delito sexual cuando la víctima está entre 18 y 28 años,2015,5,2,5469,36.5697568111172,0,2868,0,2,2601,76.8935024990388
19347,44,44078,81,"Tasa de exámenes médico legales por presunto delito sexual contra niños, niñas y adolescentes",2015,2,5,4494,111.25945705385,0,2275,0,5,2219,225.326723749437
19348,44,44078,81,"Tasa de exámenes médico legales por presunto delito sexual contra niños, niñas y adolescentes",2015,3,10,4910,203.665987780041,1,2484,40.2576489533011,9,2426,370.981038746908
19349,44,44078,81,"Tasa de exámenes médico legales por presunto delito sexual contra niños, niñas y adolescentes",2015,4,12,4484,267.618198037467,0,2277,0,12,2207,543.724512913457
19350,44,44078,121,Tasa de exámenes médico legales por presunto delito sexual cuando la víctima está entre 18 y 28 años,2015,5,5,7184,69.5991091314031,0,3658,0,5,3526,141.803743618832
19351,44,44090,81,"Tasa de exámenes médico legales por presunto delito sexual contra niños, niñas y adolescentes",2015,3,2,4602,43.4593654932638,0,2390,0,2,2212,90.4159132007233
19352,44,44090,81,"Tasa de exámenes médico legales por presunto delito sexual contra niños, niñas y adolescentes",2015,4,3,4262,70.3894885030502,0,2246,0,3,2016,148.809523809524
19353,44,44090,121,Tasa de exámenes médico legales por presunto delito sexual cuando la víctima está entre 18 y 28 años,2015,5,1,6695,14.9365197908887,0,3476,0,1,3219,31.0655483069276
19354,44,44098,81,"Tasa de exámenes médico legales por presunto delito sexual contra niños, niñas y adolescentes",2015,2,1,1871,53.4473543559594,1,961,104.058272632674,0,910,0
19355,44,44098,81,"Tasa de exámenes médico legales por presunto delito sexual contra niños, niñas y adolescentes",2015,3,1,2022,49.4559841740851,0,1027,0,1,995,100.502512562814
19356,44,44098,81,"Tasa de exámenes médico legales por presunto delito sexual contra niños, niñas y adolescentes",2015,4,2,2007,99.6512207274539,0,1065,0,2,942,212.314225053079
19357,44,44110,81,"Tasa de exámenes médico legales por presunto delito sexual contra niños, niñas y adolescentes",2015,4,2,848,235.849056603774,0,441,0,2,407,491.400491400491
19358,44,44279,81,"Tasa de exámenes médico legales por presunto delito sexual contra niños, niñas y adolescentes",2015,2,2,3816,52.4109014675052,2,1939,103.145951521403,0,1877,0
19359,44,44279,81,"Tasa de exámenes médico legales por presunto delito sexual contra niños, niñas y adolescentes",2015,3,6,4114,145.843461351483,4,2078,192.492781520693,2,2036,98.2318271119843
19360,44,44279,81,"Tasa de exámenes médico legales por presunto delito sexual contra niños, niñas y adolescentes",2015,4,11,3659,300.628587045641,1,1856,53.8793103448276,10,1803,554.631170271769
19361,44,44279,121,Tasa de exámenes médico legales por presunto delito sexual cuando la víctima está entre 18 y 28 años,2015,5,1,7155,13.9762403913347,0,3578,0,1,3577,27.9563880346659
19362,44,44378,81,"Tasa de exámenes médico legales por presunto delito sexual contra niños, niñas y adolescentes",2015,2,1,3173,31.5159155373464,0,1630,0,1,1543,64.8088139987038
19363,44,44378,81,"Tasa de exámenes médico legales por presunto delito sexual contra niños, niñas y adolescentes",2015,3,4,3334,119.97600479904,0,1725,0,4,1609,248.601615910503
19364,44,44378,81,"Tasa de exámenes médico legales por presunto delito sexual contra niños, niñas y adolescentes",2015,4,3,3081,97.3709834469328,0,1589,0,3,1492,201.072386058981
19365,44,44420,81,"Tasa de exámenes médico legales por presunto delito sexual contra niños, niñas y adolescentes",2015,3,2,350,571.428571428571,0,189,0,2,161,1242.23602484472
19366,44,44430,81,"Tasa de exámenes médico legales por presunto delito sexual contra niños, niñas y adolescentes",2015,2,11,19617,56.0738135290819,4,10013,39.9480675122341,7,9604,72.8862973760933
19367,44,44430,81,"Tasa de exámenes médico legales por presunto delito sexual contra niños, niñas y adolescentes",2015,3,20,22643,88.3275184383695,7,11556,60.5745932848737,13,11087,117.254442139443
19368,44,44430,81,"Tasa de exámenes médico legales por presunto delito sexual contra niños, niñas y adolescentes",2015,4,40,19479,205.349350582679,2,9833,20.3396725312722,38,9646,393.945676964545
19369,44,44430,121,Tasa de exámenes médico legales por presunto delito sexual cuando la víctima está entre 18 y 28 años,2015,5,5,29378,17.0195384301178,0,14845,0,5,14533,34.4044588178628
19370,44,44560,81,"Tasa de exámenes médico legales por presunto delito sexual contra niños, niñas y adolescentes",2015,2,3,14937,20.0843542880096,1,7587,13.1804402267036,2,7350,27.2108843537415
19371,44,44560,81,"Tasa de exámenes médico legales por presunto delito sexual contra niños, niñas y adolescentes",2015,3,5,15239,32.8105518734825,1,7667,13.0429111777749,4,7572,52.8262017960909
19372,44,44560,81,"Tasa de exámenes médico legales por presunto delito sexual contra niños, niñas y adolescentes",2015,4,7,13876,50.4468146439896,0,6883,0,7,6993,100.1001001001
19373,44,44560,121,Tasa de exámenes médico legales por presunto delito sexual cuando la víctima está entre 18 y 28 años,2015,5,1,20587,4.85743430320105,0,10059,0,1,10528,9.49848024316109
19374,44,44650,81,"Tasa de exámenes médico legales por presunto delito sexual contra niños, niñas y adolescentes",2015,2,1,4125,24.2424242424242,0,2138,0,1,1987,50.3271263210871
19375,44,44650,81,"Tasa de exámenes médico legales por presunto delito sexual contra niños, niñas y adolescentes",2015,3,3,4450,67.4157303370786,0,2329,0,3,2121,141.442715700141
19376,44,44650,81,"Tasa de exámenes médico legales por presunto delito sexual contra niños, niñas y adolescentes",2015,4,5,3963,126.167045167802,2,2059,97.1345313258863,3,1904,157.563025210084
19377,44,44650,121,Tasa de exámenes médico legales por presunto delito sexual cuando la víctima está entre 18 y 28 años,2015,5,1,7363,13.5814206165965,0,3716,0,1,3647,27.4197970935015
19378,44,44847,81,"Tasa de exámenes médico legales por presunto delito sexual contra niños, niñas y adolescentes",2015,2,2,24765,8.07591358772461,0,12572,0,2,12193,16.4028540966128
19379,44,44847,81,"Tasa de exámenes médico legales por presunto delito sexual contra niños, niñas y adolescentes",2015,3,4,25373,15.7647893430024,0,12793,0,4,12580,31.7965023847377
19380,44,44847,81,"Tasa de exámenes médico legales por presunto delito sexual contra niños, niñas y adolescentes",2015,4,6,23239,25.8186668961659,0,11668,0,6,11571,51.8537723619393
19381,44,44855,81,"Tasa de exámenes médico legales por presunto delito sexual contra niños, niñas y adolescentes",2015,2,1,1899,52.6592943654555,0,969,0,1,930,107.52688172043
19382,44,44855,81,"Tasa de exámenes médico legales por presunto delito sexual contra niños, niñas y adolescentes",2015,3,2,2028,98.6193293885602,0,1032,0,2,996,200.803212851406
19383,44,44855,81,"Tasa de exámenes médico legales por presunto delito sexual contra niños, niñas y adolescentes",2015,4,1,1857,53.850296176629,1,946,105.708245243129,0,911,0
19384,44,44874,81,"Tasa de exámenes médico legales por presunto delito sexual contra niños, niñas y adolescentes",2015,2,1,2928,34.1530054644809,0,1496,0,1,1432,69.8324022346369
19385,44,44874,81,"Tasa de exámenes médico legales por presunto delito sexual contra niños, niñas y adolescentes",2015,3,3,3058,98.1033355134075,1,1570,63.6942675159236,2,1488,134.408602150538
19386,44,44874,81,"Tasa de exámenes médico legales por presunto delito sexual contra niños, niñas y adolescentes",2015,4,2,2812,71.1237553342817,0,1447,0,2,1365,146.520146520147
19387,44,44874,121,Tasa de exámenes médico legales por presunto delito sexual cuando la víctima está entre 18 y 28 años,2015,5,1,5953,16.7982529816899,0,3034,0,1,2919,34.2583076396026
19388,47,47001,81,"Tasa de exámenes médico legales por presunto delito sexual contra niños, niñas y adolescentes",2015,2,40,46920,85.2514919011083,8,23990,33.3472280116715,32,22930,139.555167902311
19389,47,47001,81,"Tasa de exámenes médico legales por presunto delito sexual contra niños, niñas y adolescentes",2015,3,79,59301,133.218664103472,11,29955,36.7217492906026,68,29346,231.718121720166
19390,47,47001,81,"Tasa de exámenes médico legales por presunto delito sexual contra niños, niñas y adolescentes",2015,4,113,60711,186.127719853074,10,30374,32.9228945808916,103,30337,339.519398753997
19391,47,47001,121,Tasa de exámenes médico legales por presunto delito sexual cuando la víctima está entre 18 y 28 años,2015,5,20,91213,21.9266990450923,1,46098,2.16929150939303,19,45115,42.1145960323617
19392,47,47053,81,"Tasa de exámenes médico legales por presunto delito sexual contra niños, niñas y adolescentes",2015,3,3,5643,53.1632110579479,0,2899,0,3,2744,109.32944606414
19393,47,47053,81,"Tasa de exámenes médico legales por presunto delito sexual contra niños, niñas y adolescentes",2015,4,6,5379,111.54489682097,0,2780,0,6,2599,230.858022316276
19394,47,47053,121,Tasa de exámenes médico legales por presunto delito sexual cuando la víctima está entre 18 y 28 años,2015,5,4,7331,54.5628154412768,0,3769,0,4,3562,112.296462661426
19395,47,47058,81,"Tasa de exámenes médico legales por presunto delito sexual contra niños, niñas y adolescentes",2015,2,1,3558,28.1056773468241,1,1828,54.7045951859956,0,1730,0
19396,47,47058,81,"Tasa de exámenes médico legales por presunto delito sexual contra niños, niñas y adolescentes",2015,3,1,4180,23.9234449760766,0,2194,0,1,1986,50.3524672708963
19397,47,47058,81,"Tasa de exámenes médico legales por presunto delito sexual contra niños, niñas y adolescentes",2015,4,1,3972,25.1762336354481,0,2122,0,1,1850,54.0540540540541
19398,47,47170,81,"Tasa de exámenes médico legales por presunto delito sexual contra niños, niñas y adolescentes",2015,2,1,2006,49.8504486540379,0,1015,0,1,991,100.908173562059
19399,47,47170,81,"Tasa de exámenes médico legales por presunto delito sexual contra niños, niñas y adolescentes",2015,3,5,2430,205.761316872428,0,1240,0,5,1190,420.168067226891
19400,47,47170,81,"Tasa de exámenes médico legales por presunto delito sexual contra niños, niñas y adolescentes",2015,4,1,2190,45.662100456621,0,1150,0,1,1040,96.1538461538462
19401,47,47189,81,"Tasa de exámenes médico legales por presunto delito sexual contra niños, niñas y adolescentes",2015,2,7,11138,62.8479080624888,1,5717,17.4916914465629,6,5421,110.680686220255
19402,47,47189,81,"Tasa de exámenes médico legales por presunto delito sexual contra niños, niñas y adolescentes",2015,3,19,13305,142.803457346862,1,6889,14.5158949049209,18,6416,280.548628428928
19403,47,47189,81,"Tasa de exámenes médico legales por presunto delito sexual contra niños, niñas y adolescentes",2015,4,21,13523,155.290985728019,0,7014,0,21,6509,322.630204332463
19404,47,47189,121,Tasa de exámenes médico legales por presunto delito sexual cuando la víctima está entre 18 y 28 años,2015,5,2,19120,10.4602510460251,0,9745,0,2,9375,21.3333333333333
19405,47,47245,81,"Tasa de exámenes médico legales por presunto delito sexual contra niños, niñas y adolescentes",2015,2,3,6755,44.4115470022206,0,3456,0,3,3299,90.93664746893
19406,47,47245,81,"Tasa de exámenes médico legales por presunto delito sexual contra niños, niñas y adolescentes",2015,3,17,7635,222.658808120498,3,3910,76.7263427109974,14,3725,375.838926174497
19407,47,47245,81,"Tasa de exámenes médico legales por presunto delito sexual contra niños, niñas y adolescentes",2015,4,17,7313,232.462737590592,0,3767,0,17,3546,479.41342357586
19408,47,47245,121,Tasa de exámenes médico legales por presunto delito sexual cuando la víctima está entre 18 y 28 años,2015,5,4,11125,35.9550561797753,0,5794,0,4,5331,75.032826861752
19409,47,47258,81,"Tasa de exámenes médico legales por presunto delito sexual contra niños, niñas y adolescentes",2015,3,1,2093,47.7783086478739,0,1064,0,1,1029,97.1817298347911
19410,47,47258,81,"Tasa de exámenes médico legales por presunto delito sexual contra niños, niñas y adolescentes",2015,4,1,2029,49.2853622474125,1,1036,96.5250965250965,0,993,0
19411,47,47268,81,"Tasa de exámenes médico legales por presunto delito sexual contra niños, niñas y adolescentes",2015,2,1,2670,37.4531835205993,0,1374,0,1,1296,77.1604938271605
19412,47,47268,81,"Tasa de exámenes médico legales por presunto delito sexual contra niños, niñas y adolescentes",2015,3,1,3056,32.7225130890052,1,1598,62.5782227784731,0,1458,0
19413,47,47268,81,"Tasa de exámenes médico legales por presunto delito sexual contra niños, niñas y adolescentes",2015,4,1,3050,32.7868852459016,0,1633,0,1,1417,70.5716302046577
19414,47,47268,121,Tasa de exámenes médico legales por presunto delito sexual cuando la víctima está entre 18 y 28 años,2015,5,1,4200,23.8095238095238,0,2292,0,1,1908,52.4109014675052
19415,47,47288,81,"Tasa de exámenes médico legales por presunto delito sexual contra niños, niñas y adolescentes",2015,2,4,6879,58.1479866259631,2,3502,57.1102227298686,2,3377,59.2241634586911
19416,47,47288,81,"Tasa de exámenes médico legales por presunto delito sexual contra niños, niñas y adolescentes",2015,3,8,8137,98.3163328007865,0,4127,0,8,4010,199.501246882793
19417,47,47288,81,"Tasa de exámenes médico legales por presunto delito sexual contra niños, niñas y adolescentes",2015,4,8,7739,103.372528750485,0,3920,0,8,3819,209.478921183556
19418,47,47288,121,Tasa de exámenes médico legales por presunto delito sexual cuando la víctima está entre 18 y 28 años,2015,5,2,10938,18.2848784055586,0,5449,0,2,5489,36.4365093824012
19419,47,47318,81,"Tasa de exámenes médico legales por presunto delito sexual contra niños, niñas y adolescentes",2015,2,1,3283,30.4599451720987,0,1682,0,1,1601,62.4609618988132
19420,47,47318,81,"Tasa de exámenes médico legales por presunto delito sexual contra niños, niñas y adolescentes",2015,4,1,3487,28.6779466590192,0,1852,0,1,1635,61.1620795107034
19421,47,47460,81,"Tasa de exámenes médico legales por presunto delito sexual contra niños, niñas y adolescentes",2015,4,4,2440,163.934426229508,0,1303,0,4,1137,351.802990325418
19422,47,47460,121,Tasa de exámenes médico legales por presunto delito sexual cuando la víctima está entre 18 y 28 años,2015,5,1,3614,27.6701715550636,0,1928,0,1,1686,59.3119810201661
19423,47,47541,81,"Tasa de exámenes médico legales por presunto delito sexual contra niños, niñas y adolescentes",2015,3,1,993,100.704934541793,1,511,195.694716242661,0,482,0
19424,47,47541,81,"Tasa de exámenes médico legales por presunto delito sexual contra niños, niñas y adolescentes",2015,4,1,971,102.986611740474,0,500,0,1,471,212.314225053079
19425,47,47551,81,"Tasa de exámenes médico legales por presunto delito sexual contra niños, niñas y adolescentes",2015,3,1,4007,24.9563264287497,0,2069,0,1,1938,51.5995872033024
19426,47,47551,81,"Tasa de exámenes médico legales por presunto delito sexual contra niños, niñas y adolescentes",2015,4,1,3978,25.1382604323781,0,2088,0,1,1890,52.9100529100529
19427,47,47555,81,"Tasa de exámenes médico legales por presunto delito sexual contra niños, niñas y adolescentes",2015,2,5,6734,74.2500742500742,3,3439,87.2346612387322,2,3295,60.6980273141123
19428,47,47555,81,"Tasa de exámenes médico legales por presunto delito sexual contra niños, niñas y adolescentes",2015,3,9,7904,113.866396761134,3,4065,73.8007380073801,6,3839,156.290700703308
19429,47,47555,81,"Tasa de exámenes médico legales por presunto delito sexual contra niños, niñas y adolescentes",2015,4,9,7474,120.41744715012,0,3877,0,9,3597,250.208507089241
19430,47,47555,121,Tasa de exámenes médico legales por presunto delito sexual cuando la víctima está entre 18 y 28 años,2015,5,3,10879,27.5760639764684,0,5644,0,3,5235,57.3065902578797
19431,47,47570,81,"Tasa de exámenes médico legales por presunto delito sexual contra niños, niñas y adolescentes",2015,3,4,4679,85.4883522120111,0,2374,0,4,2305,173.53579175705
19432,47,47570,81,"Tasa de exámenes médico legales por presunto delito sexual contra niños, niñas y adolescentes",2015,4,4,4352,91.9117647058823,0,2232,0,4,2120,188.679245283019
19433,47,47570,121,Tasa de exámenes médico legales por presunto delito sexual cuando la víctima está entre 18 y 28 años,2015,5,1,5445,18.3654729109275,0,2850,0,1,2595,38.5356454720617
19434,47,47692,81,"Tasa de exámenes médico legales por presunto delito sexual contra niños, niñas y adolescentes",2015,3,1,2263,44.1891294741494,0,1164,0,1,1099,90.9918107370337
19435,47,47692,81,"Tasa de exámenes médico legales por presunto delito sexual contra niños, niñas y adolescentes",2015,4,1,2233,44.7828034034931,0,1158,0,1,1075,93.0232558139535
19436,47,47720,81,"Tasa de exámenes médico legales por presunto delito sexual contra niños, niñas y adolescentes",2015,4,1,1850,54.0540540540541,0,951,0,1,899,111.234705228031
19437,47,47745,81,"Tasa de exámenes médico legales por presunto delito sexual contra niños, niñas y adolescentes",2015,2,2,3561,56.16399887672,0,1824,0,2,1737,115.141047783535
19438,47,47745,81,"Tasa de exámenes médico legales por presunto delito sexual contra niños, niñas y adolescentes",2015,3,5,4261,117.343346632246,1,2189,45.6829602558246,4,2072,193.050193050193
19439,47,47745,81,"Tasa de exámenes médico legales por presunto delito sexual contra niños, niñas y adolescentes",2015,4,2,4061,49.248953459739,0,2092,0,2,1969,101.574403250381
19440,47,47798,81,"Tasa de exámenes médico legales por presunto delito sexual contra niños, niñas y adolescentes",2015,4,2,1563,127.959053103007,0,801,0,2,762,262.46719160105
19441,47,47798,121,Tasa de exámenes médico legales por presunto delito sexual cuando la víctima está entre 18 y 28 años,2015,5,1,2200,45.4545454545455,0,1155,0,1,1045,95.6937799043062
19442,47,47960,81,"Tasa de exámenes médico legales por presunto delito sexual contra niños, niñas y adolescentes",2015,2,1,937,106.723585912487,0,478,0,1,459,217.864923747277
19443,47,47980,81,"Tasa de exámenes médico legales por presunto delito sexual contra niños, niñas y adolescentes",2015,3,6,9351,64.1642605068977,2,4840,41.3223140495868,4,4511,88.6721347816449
19444,47,47980,81,"Tasa de exámenes médico legales por presunto delito sexual contra niños, niñas y adolescentes",2015,4,12,8791,136.503241951996,0,4587,0,12,4204,285.442435775452
19445,47,47980,121,Tasa de exámenes médico legales por presunto delito sexual cuando la víctima está entre 18 y 28 años,2015,5,3,11663,25.722369887679,0,6117,0,3,5546,54.0930400288496
19446,5,5001,81,"Tasa de exámenes médico legales por presunto delito sexual contra niños, niñas y adolescentes",2015,2,222,146899,151.124241826017,52,75105,69.2364023700153,170,71794,236.788589575731
19447,5,5001,81,"Tasa de exámenes médico legales por presunto delito sexual contra niños, niñas y adolescentes",2015,3,390,180551,216.005449983661,101,92321,109.400894704347,289,88230,327.552986512524
19448,5,5001,81,"Tasa de exámenes médico legales por presunto delito sexual contra niños, niñas y adolescentes",2015,4,382,195803,195.094048610083,54,99867,54.0719156478116,328,95936,341.894596397598
19449,5,5001,121,Tasa de exámenes médico legales por presunto delito sexual cuando la víctima está entre 18 y 28 años,2015,5,131,433204,30.2397946464022,10,218706,4.57234826662277,121,214498,56.4107823849173
19450,5,5001,81,"Tasa de exámenes médico legales por presunto delito sexual contra niños, niñas y adolescentes",2015,1,6,28950,20.7253886010363,3,14817,20.2470135654991,3,14133,21.2269157291446
19451,5,5002,81,"Tasa de exámenes médico legales por presunto delito sexual contra niños, niñas y adolescentes",2015,2,8,1705,469.208211143695,3,878,341.685649202733,5,827,604.59492140266
19452,5,5002,81,"Tasa de exámenes médico legales por presunto delito sexual contra niños, niñas y adolescentes",2015,3,5,1927,259.470679813181,1,995,100.502512562814,4,932,429.184549356223
19453,5,5002,81,"Tasa de exámenes médico legales por presunto delito sexual contra niños, niñas y adolescentes",2015,4,16,1884,849.256900212314,1,978,102.249488752556,15,906,1655.62913907285
19454,5,5002,121,Tasa de exámenes médico legales por presunto delito sexual cuando la víctima está entre 18 y 28 años,2015,5,3,3440,87.2093023255814,0,1812,0,3,1628,184.275184275184
19455,5,5021,81,"Tasa de exámenes médico legales por presunto delito sexual contra niños, niñas y adolescentes",2015,4,1,326,306.748466257669,0,171,0,1,155,645.161290322581
19456,5,5030,81,"Tasa de exámenes médico legales por presunto delito sexual contra niños, niñas y adolescentes",2015,3,1,3301,30.2938503483793,0,1713,0,1,1588,62.9722921914358
19457,5,5030,81,"Tasa de exámenes médico legales por presunto delito sexual contra niños, niñas y adolescentes",2015,4,1,3174,31.5059861373661,0,1623,0,1,1551,64.4745325596389
19458,5,5031,81,"Tasa de exámenes médico legales por presunto delito sexual contra niños, niñas y adolescentes",2015,3,2,2636,75.8725341426404,0,1350,0,2,1286,155.52099533437
19459,5,5031,81,"Tasa de exámenes médico legales por presunto delito sexual contra niños, niñas y adolescentes",2015,4,4,2585,154.738878143133,1,1321,75.7002271006813,3,1264,237.341772151899
19460,5,5034,81,"Tasa de exámenes médico legales por presunto delito sexual contra niños, niñas y adolescentes",2015,2,2,4324,46.2534690101758,0,2198,0,2,2126,94.0733772342427
19461,5,5034,81,"Tasa de exámenes médico legales por presunto delito sexual contra niños, niñas y adolescentes",2015,3,5,5108,97.8856695379797,1,2627,38.0662352493338,4,2481,161.225312374043
19462,5,5034,81,"Tasa de exámenes médico legales por presunto delito sexual contra niños, niñas y adolescentes",2015,4,7,4954,141.299959628583,0,2574,0,7,2380,294.117647058824
19463,5,5034,81,"Tasa de exámenes médico legales por presunto delito sexual contra niños, niñas y adolescentes",2015,1,1,890,112.359550561798,0,459,0,1,431,232.018561484919
19464,5,5036,81,"Tasa de exámenes médico legales por presunto delito sexual contra niños, niñas y adolescentes",2015,3,1,852,117.370892018779,0,442,0,1,410,243.90243902439
19465,5,5040,81,"Tasa de exámenes médico legales por presunto delito sexual contra niños, niñas y adolescentes",2015,2,1,1724,58.0046403712297,0,885,0,1,839,119.189511323004
19466,5,5040,81,"Tasa de exámenes médico legales por presunto delito sexual contra niños, niñas y adolescentes",2015,3,4,1963,203.769740193581,0,1023,0,4,940,425.531914893617
19467,5,5040,81,"Tasa de exámenes médico legales por presunto delito sexual contra niños, niñas y adolescentes",2015,4,4,1910,209.424083769634,1,1010,99.009900990099,3,900,333.333333333333
19468,5,5040,121,Tasa de exámenes médico legales por presunto delito sexual cuando la víctima está entre 18 y 28 años,2015,5,1,3261,30.6654400490647,0,1741,0,1,1520,65.7894736842105
19469,5,5042,81,"Tasa de exámenes médico legales por presunto delito sexual contra niños, niñas y adolescentes",2015,3,8,2880,277.777777777778,2,1497,133.600534402138,6,1383,433.839479392625
19470,5,5042,81,"Tasa de exámenes médico legales por presunto delito sexual contra niños, niñas y adolescentes",2015,4,4,2736,146.198830409357,1,1422,70.323488045007,3,1314,228.310502283105
19471,5,5042,121,Tasa de exámenes médico legales por presunto delito sexual cuando la víctima está entre 18 y 28 años,2015,5,3,4924,60.9260763606824,0,2591,0,3,2333,128.589798542649
19472,5,5044,81,"Tasa de exámenes médico legales por presunto delito sexual contra niños, niñas y adolescentes",2015,2,3,774,387.596899224806,1,407,245.700245700246,2,367,544.959128065395
19473,5,5044,81,"Tasa de exámenes médico legales por presunto delito sexual contra niños, niñas y adolescentes",2015,3,2,882,226.757369614512,2,469,426.439232409382,0,413,0
19474,5,5044,81,"Tasa de exámenes médico legales por presunto delito sexual contra niños, niñas y adolescentes",2015,4,5,868,576.036866359447,1,470,212.765957446809,4,398,1005.02512562814
19475,5,5045,81,"Tasa de exámenes médico legales por presunto delito sexual contra niños, niñas y adolescentes",2015,2,3,21504,13.9508928571429,1,11012,9.08100254268071,2,10492,19.0621425848265
19476,5,5045,81,"Tasa de exámenes médico legales por presunto delito sexual contra niños, niñas y adolescentes",2015,3,12,23868,50.2765208647562,2,12176,16.4257555847569,10,11692,85.5285665412248
19477,5,5045,81,"Tasa de exámenes médico legales por presunto delito sexual contra niños, niñas y adolescentes",2015,4,20,23672,84.4880027036161,3,12036,24.9252243270189,17,11636,146.098315572362
19478,5,5045,121,Tasa de exámenes médico legales por presunto delito sexual cuando la víctima está entre 18 y 28 años,2015,5,7,39420,17.7574835109082,0,19793,0,7,19627,35.6651551434249
19479,5,5051,81,"Tasa de exámenes médico legales por presunto delito sexual contra niños, niñas y adolescentes",2015,3,1,5568,17.9597701149425,0,2855,0,1,2713,36.8595650571323
19480,5,5051,81,"Tasa de exámenes médico legales por presunto delito sexual contra niños, niñas y adolescentes",2015,4,3,5525,54.2986425339367,0,2809,0,3,2716,110.456553755523
19481,5,5055,81,"Tasa de exámenes médico legales por presunto delito sexual contra niños, niñas y adolescentes",2015,4,3,1024,292.96875,0,554,0,3,470,638.297872340425
19482,5,5059,81,"Tasa de exámenes médico legales por presunto delito sexual contra niños, niñas y adolescentes",2015,2,2,409,488.997555012225,0,214,0,2,195,1025.64102564103
19483,5,5059,81,"Tasa de exámenes médico legales por presunto delito sexual contra niños, niñas y adolescentes",2015,3,2,483,414.07867494824,1,255,392.156862745098,1,228,438.59649122807
19484,5,5059,81,"Tasa de exámenes médico legales por presunto delito sexual contra niños, niñas y adolescentes",2015,4,1,460,217.391304347826,0,244,0,1,216,462.962962962963
19485,5,5079,81,"Tasa de exámenes médico legales por presunto delito sexual contra niños, niñas y adolescentes",2015,2,2,4700,42.5531914893617,0,2405,0,2,2295,87.1459694989107
19486,5,5079,81,"Tasa de exámenes médico legales por presunto delito sexual contra niños, niñas y adolescentes",2015,3,1,5571,17.950098725543,1,2855,35.0262697022767,0,2716,0
19487,5,5079,81,"Tasa de exámenes médico legales por presunto delito sexual contra niños, niñas y adolescentes",2015,4,6,5472,109.649122807018,0,2778,0,6,2694,222.71714922049
19488,5,5079,121,Tasa de exámenes médico legales por presunto delito sexual cuando la víctima está entre 18 y 28 años,2015,5,2,10189,19.629011679262,0,5188,0,2,5001,39.9920015996801
19489,5,5086,81,"Tasa de exámenes médico legales por presunto delito sexual contra niños, niñas y adolescentes",2015,3,1,818,122.249388753056,0,428,0,1,390,256.410256410256
19490,5,5086,81,"Tasa de exámenes médico legales por presunto delito sexual contra niños, niñas y adolescentes",2015,4,3,815,368.098159509202,0,433,0,3,382,785.340314136126
19491,5,5086,121,Tasa de exámenes médico legales por presunto delito sexual cuando la víctima está entre 18 y 28 años,2015,5,2,1398,143.061516452074,0,765,0,2,633,315.955766192733
19492,5,5088,81,"Tasa de exámenes médico legales por presunto delito sexual contra niños, niñas y adolescentes",2015,2,48,37490,128.034142437983,8,19160,41.7536534446764,40,18330,218.221494817239
19493,5,5088,81,"Tasa de exámenes médico legales por presunto delito sexual contra niños, niñas y adolescentes",2015,3,68,45144,150.629097997519,8,22868,34.9833828931258,60,22276,269.348177410666
19494,5,5088,81,"Tasa de exámenes médico legales por presunto delito sexual contra niños, niñas y adolescentes",2015,4,71,47788,148.572863480372,6,23834,25.1741210036083,65,23954,271.353427402522
19495,5,5088,121,Tasa de exámenes médico legales por presunto delito sexual cuando la víctima está entre 18 y 28 años,2015,5,20,94324,21.2035113014715,2,46592,4.29258241758242,18,47732,37.7105505740384
19496,5,5091,81,"Tasa de exámenes médico legales por presunto delito sexual contra niños, niñas y adolescentes",2015,2,2,923,216.684723726977,0,471,0,2,452,442.477876106195
19497,5,5091,81,"Tasa de exámenes médico legales por presunto delito sexual contra niños, niñas y adolescentes",2015,3,1,1109,90.1713255184851,0,575,0,1,534,187.265917602996
19498,5,5091,81,"Tasa de exámenes médico legales por presunto delito sexual contra niños, niñas y adolescentes",2015,4,4,1055,379.14691943128,0,552,0,4,503,795.228628230616
19499,5,5093,81,"Tasa de exámenes médico legales por presunto delito sexual contra niños, niñas y adolescentes",2015,2,3,1815,165.289256198347,0,917,0,3,898,334.075723830735
19500,5,5093,81,"Tasa de exámenes médico legales por presunto delito sexual contra niños, niñas y adolescentes",2015,3,9,2120,424.528301886792,2,1055,189.57345971564,7,1065,657.276995305164
19501,5,5093,81,"Tasa de exámenes médico legales por presunto delito sexual contra niños, niñas y adolescentes",2015,4,4,1991,200.904068307383,0,999,0,4,992,403.225806451613
19502,5,5093,121,Tasa de exámenes médico legales por presunto delito sexual cuando la víctima está entre 18 y 28 años,2015,5,4,3813,104.9042748492,0,1968,0,4,1845,216.80216802168
19503,5,5101,81,"Tasa de exámenes médico legales por presunto delito sexual contra niños, niñas y adolescentes",2015,4,1,3039,32.9055610398157,0,1561,0,1,1478,67.65899864682
19504,5,5101,121,Tasa de exámenes médico legales por presunto delito sexual cuando la víctima está entre 18 y 28 años,2015,5,1,5554,18.0050414115952,0,2849,0,1,2705,36.9685767097967
19505,5,5107,81,"Tasa de exámenes médico legales por presunto delito sexual contra niños, niñas y adolescentes",2015,3,4,1070,373.831775700935,0,546,0,4,524,763.358778625954
19506,5,5107,81,"Tasa de exámenes médico legales por presunto delito sexual contra niños, niñas y adolescentes",2015,4,1,1026,97.4658869395711,0,523,0,1,503,198.807157057654
19507,5,5113,81,"Tasa de exámenes médico legales por presunto delito sexual contra niños, niñas y adolescentes",2015,2,1,679,147.275405007364,1,357,280.112044817927,0,322,0
19508,5,5113,121,Tasa de exámenes médico legales por presunto delito sexual cuando la víctima está entre 18 y 28 años,2015,5,2,1309,152.788388082506,0,716,0,2,593,337.268128161889
19509,5,5125,81,"Tasa de exámenes médico legales por presunto delito sexual contra niños, niñas y adolescentes",2015,4,2,1107,180.6684733514,0,594,0,2,513,389.863547758285
19510,5,5129,81,"Tasa de exámenes médico legales por presunto delito sexual contra niños, niñas y adolescentes",2015,2,5,5705,87.6424189307625,1,2916,34.2935528120713,4,2789,143.420580853352
19511,5,5129,81,"Tasa de exámenes médico legales por presunto delito sexual contra niños, niñas y adolescentes",2015,3,13,7115,182.712579058327,4,3633,110.10184420589,9,3482,258.47214244687
19512,5,5129,81,"Tasa de exámenes médico legales por presunto delito sexual contra niños, niñas y adolescentes",2015,4,5,7405,67.5219446320054,1,3767,26.5463233342182,4,3638,109.950522264981
19513,5,5129,121,Tasa de exámenes médico legales por presunto delito sexual cuando la víctima está entre 18 y 28 años,2015,5,2,14789,13.5235648116844,0,7465,0,2,7324,27.3074822501365
19514,5,5134,81,"Tasa de exámenes médico legales por presunto delito sexual contra niños, niñas y adolescentes",2015,2,1,917,109.051254089422,1,472,211.864406779661,0,445,0
19515,5,5134,81,"Tasa de exámenes médico legales por presunto delito sexual contra niños, niñas y adolescentes",2015,3,1,1049,95.3288846520496,0,548,0,1,501,199.600798403194
19516,5,5138,81,"Tasa de exámenes médico legales por presunto delito sexual contra niños, niñas y adolescentes",2015,2,1,1906,52.4658971668416,0,966,0,1,940,106.382978723404
19517,5,5138,81,"Tasa de exámenes médico legales por presunto delito sexual contra niños, niñas y adolescentes",2015,3,2,2091,95.6480153036825,1,1056,94.6969696969697,1,1035,96.6183574879227
19518,5,5138,81,"Tasa de exámenes médico legales por presunto delito sexual contra niños, niñas y adolescentes",2015,4,3,2013,149.03129657228,0,1014,0,3,999,300.3003003003
19519,5,5147,81,"Tasa de exámenes médico legales por presunto delito sexual contra niños, niñas y adolescentes",2015,3,2,7367,27.1480928464775,0,3712,0,2,3655,54.7195622435021
19520,5,5147,81,"Tasa de exámenes médico legales por presunto delito sexual contra niños, niñas y adolescentes",2015,4,1,7121,14.0429714927679,0,3539,0,1,3582,27.9173646007817
19521,5,5148,81,"Tasa de exámenes médico legales por presunto delito sexual contra niños, niñas y adolescentes",2015,2,4,4767,83.9102160688064,1,2448,40.8496732026144,3,2319,129.366106080207
19522,5,5148,81,"Tasa de exámenes médico legales por presunto delito sexual contra niños, niñas y adolescentes",2015,3,9,5522,162.984425932633,0,2841,0,9,2681,335.695635956733
19523,5,5148,81,"Tasa de exámenes médico legales por presunto delito sexual contra niños, niñas y adolescentes",2015,4,9,5396,166.790214974055,0,2784,0,9,2612,344.563552833078
19524,5,5148,121,Tasa de exámenes médico legales por presunto delito sexual cuando la víctima está entre 18 y 28 años,2015,5,2,10136,19.7316495659037,0,5188,0,2,4948,40.4203718674212
19525,5,5148,81,"Tasa de exámenes médico legales por presunto delito sexual contra niños, niñas y adolescentes",2015,1,1,986,101.419878296146,0,506,0,1,480,208.333333333333
19526,5,5154,81,"Tasa de exámenes médico legales por presunto delito sexual contra niños, niñas y adolescentes",2015,2,7,12079,57.9518172034109,2,6164,32.4464633354964,5,5915,84.530853761623
19527,5,5154,81,"Tasa de exámenes médico legales por presunto delito sexual contra niños, niñas y adolescentes",2015,3,13,13684,95.0014615609471,1,6925,14.4404332129964,12,6759,177.541056369285
19528,5,5154,81,"Tasa de exámenes médico legales por presunto delito sexual contra niños, niñas y adolescentes",2015,4,11,13900,79.136690647482,2,6942,28.8101411696917,9,6958,129.347513653349
19529,5,5154,121,Tasa de exámenes médico legales por presunto delito sexual cuando la víctima está entre 18 y 28 años,2015,5,2,23965,8.34550385979554,0,11483,0,2,12482,16.0230732254446
19530,5,5172,81,"Tasa de exámenes médico legales por presunto delito sexual contra niños, niñas y adolescentes",2015,2,4,9139,43.7684648210964,1,4659,21.4638334406525,3,4480,66.9642857142857
19531,5,5172,81,"Tasa de exámenes médico legales por presunto delito sexual contra niños, niñas y adolescentes",2015,3,9,10087,89.2237533458908,2,5067,39.4710874284587,7,5020,139.442231075697
19532,5,5172,81,"Tasa de exámenes médico legales por presunto delito sexual contra niños, niñas y adolescentes",2015,4,16,9760,163.934426229508,2,4834,41.3736036408771,14,4926,284.206252537556
19533,5,5172,121,Tasa de exámenes médico legales por presunto delito sexual cuando la víctima está entre 18 y 28 años,2015,5,3,16489,18.1939474801383,0,8058,0,3,8431,35.5829676194995
19534,5,5172,81,"Tasa de exámenes médico legales por presunto delito sexual contra niños, niñas y adolescentes",2015,1,1,1964,50.9164969450102,1,1008,99.2063492063492,0,956,0
19535,5,5190,81,"Tasa de exámenes médico legales por presunto delito sexual contra niños, niñas y adolescentes",2015,2,2,762,262.46719160105,1,389,257.06940874036,1,373,268.096514745308
19536,5,5190,81,"Tasa de exámenes médico legales por presunto delito sexual contra niños, niñas y adolescentes",2015,3,3,915,327.868852459016,2,473,422.832980972516,1,442,226.244343891403
19537,5,5190,81,"Tasa de exámenes médico legales por presunto delito sexual contra niños, niñas y adolescentes",2015,4,1,901,110.987791342952,0,471,0,1,430,232.558139534884
19538,5,5197,81,"Tasa de exámenes médico legales por presunto delito sexual contra niños, niñas y adolescentes",2015,4,2,1451,137.835975189524,0,731,0,2,720,277.777777777778
19539,5,5197,121,Tasa de exámenes médico legales por presunto delito sexual cuando la víctima está entre 18 y 28 años,2015,5,1,2513,39.7930760047752,0,1240,0,1,1273,78.5545954438335
19540,5,5206,121,Tasa de exámenes médico legales por presunto delito sexual cuando la víctima está entre 18 y 28 años,2015,5,1,585,170.940170940171,0,311,0,1,274,364.963503649635
19541,5,5209,81,"Tasa de exámenes médico legales por presunto delito sexual contra niños, niñas y adolescentes",2015,2,1,2162,46.2534690101758,1,1116,89.6057347670251,0,1046,0
19542,5,5209,81,"Tasa de exámenes médico legales por presunto delito sexual contra niños, niñas y adolescentes",2015,3,8,2544,314.465408805031,0,1324,0,8,1220,655.737704918033
19543,5,5209,81,"Tasa de exámenes médico legales por presunto delito sexual contra niños, niñas y adolescentes",2015,4,8,2397,333.75052148519,2,1248,160.25641025641,6,1149,522.193211488251
19544,5,5209,121,Tasa de exámenes médico legales por presunto delito sexual cuando la víctima está entre 18 y 28 años,2015,5,1,4302,23.2450023245002,0,2243,0,1,2059,48.5672656629432
19545,5,5212,81,"Tasa de exámenes médico legales por presunto delito sexual contra niños, niñas y adolescentes",2015,2,5,4796,104.253544620517,2,2438,82.0344544708778,3,2358,127.226463104326
19546,5,5212,81,"Tasa de exámenes médico legales por presunto delito sexual contra niños, niñas y adolescentes",2015,3,8,6026,132.758048456688,3,3116,96.2772785622593,5,2910,171.821305841924
19547,5,5212,81,"Tasa de exámenes médico legales por presunto delito sexual contra niños, niñas y adolescentes",2015,4,15,6854,218.850306390429,2,3521,56.8020448736155,13,3333,390.03900390039
19548,5,5212,121,Tasa de exámenes médico legales por presunto delito sexual cuando la víctima está entre 18 y 28 años,2015,5,3,13124,22.8588844864371,0,6607,0,3,6517,46.0334509743747
19549,5,5234,81,"Tasa de exámenes médico legales por presunto delito sexual contra niños, niñas y adolescentes",2015,2,4,2692,148.588410104012,0,1374,0,4,1318,303.490136570561
19550,5,5234,81,"Tasa de exámenes médico legales por presunto delito sexual contra niños, niñas y adolescentes",2015,3,5,2870,174.216027874564,0,1501,0,5,1369,365.230094959825
19551,5,5234,81,"Tasa de exámenes médico legales por presunto delito sexual contra niños, niñas y adolescentes",2015,4,5,3000,166.666666666667,0,1604,0,5,1396,358.166189111748
19552,5,5234,121,Tasa de exámenes médico legales por presunto delito sexual cuando la víctima está entre 18 y 28 años,2015,5,1,4499,22.2271615914648,0,2403,0,1,2096,47.7099236641221
19553,5,5237,81,"Tasa de exámenes médico legales por presunto delito sexual contra niños, niñas y adolescentes",2015,2,2,2128,93.984962406015,1,1095,91.324200913242,1,1033,96.8054211035818
19554,5,5237,81,"Tasa de exámenes médico legales por presunto delito sexual contra niños, niñas y adolescentes",2015,3,12,2586,464.037122969838,5,1328,376.506024096386,7,1258,556.438791732909
19555,5,5237,81,"Tasa de exámenes médico legales por presunto delito sexual contra niños, niñas y adolescentes",2015,4,1,2591,38.5951370127364,0,1311,0,1,1280,78125
19556,5,5237,121,Tasa de exámenes médico legales por presunto delito sexual cuando la víctima está entre 18 y 28 años,2015,5,2,4809,41.5886878768975,0,2350,0,2,2459,81.3338755591704
19557,5,5240,81,"Tasa de exámenes médico legales por presunto delito sexual contra niños, niñas y adolescentes",2015,2,1,1192,83.8926174496644,1,607,164.744645799012,0,585,0
19558,5,5240,81,"Tasa de exámenes médico legales por presunto delito sexual contra niños, niñas y adolescentes",2015,3,3,1361,220.426157237325,1,696,143.67816091954,2,665,300.751879699248
19559,5,5240,81,"Tasa de exámenes médico legales por presunto delito sexual contra niños, niñas y adolescentes",2015,4,2,1351,148.038490007402,0,693,0,2,658,303.951367781155
19560,5,5250,81,"Tasa de exámenes médico legales por presunto delito sexual contra niños, niñas y adolescentes",2015,2,7,5553,126.05798667387,1,2851,35.0754121360926,6,2702,222.057735011103
19561,5,5250,81,"Tasa de exámenes médico legales por presunto delito sexual contra niños, niñas y adolescentes",2015,3,4,6278,63.7145587766805,0,3228,0,4,3050,131.147540983607
19562,5,5250,81,"Tasa de exámenes médico legales por presunto delito sexual contra niños, niñas y adolescentes",2015,4,18,6180,291.26213592233,0,3198,0,18,2982,603.621730382294
19563,5,5250,121,Tasa de exámenes médico legales por presunto delito sexual cuando la víctima está entre 18 y 28 años,2015,5,2,10889,18.3671595187804,0,5711,0,2,5178,38.6249517188104
19564,5,5266,81,"Tasa de exámenes médico legales por presunto delito sexual contra niños, niñas y adolescentes",2015,2,8,15808,50.6072874493927,1,8081,12.3747061007301,7,7727,90.591432638799
19565,5,5266,81,"Tasa de exámenes médico legales por presunto delito sexual contra niños, niñas y adolescentes",2015,3,11,19715,55.7950798884098,1,10116,9.88533017002768,10,9599,104.17751849151
19566,5,5266,81,"Tasa de exámenes médico legales por presunto delito sexual contra niños, niñas y adolescentes",2015,4,9,21117,42.6196902969172,1,10814,9.24727205474385,8,10303,77.6472871979035
19567,5,5266,121,Tasa de exámenes médico legales por presunto delito sexual cuando la víctima está entre 18 y 28 años,2015,5,7,41307,16.946280291476,0,20992,0,7,20315,34.4572975633768
19568,5,5282,81,"Tasa de exámenes médico legales por presunto delito sexual contra niños, niñas y adolescentes",2015,3,1,2242,44.6030330062444,0,1146,0,1,1096,91.2408759124088
19569,5,5282,81,"Tasa de exámenes médico legales por presunto delito sexual contra niños, niñas y adolescentes",2015,4,1,2254,44.3655723158829,0,1151,0,1,1103,90.6618313689937
19570,5,5282,121,Tasa de exámenes médico legales por presunto delito sexual cuando la víctima está entre 18 y 28 años,2015,5,1,4360,22.9357798165138,0,2243,0,1,2117,47.2366556447803
19571,5,5284,81,"Tasa de exámenes médico legales por presunto delito sexual contra niños, niñas y adolescentes",2015,2,3,1860,161.290322580645,1,950,105.263157894737,2,910,219.78021978022
19572,5,5284,81,"Tasa de exámenes médico legales por presunto delito sexual contra niños, niñas y adolescentes",2015,3,5,2085,239.808153477218,0,1077,0,5,1008,496.031746031746
19573,5,5284,81,"Tasa de exámenes médico legales por presunto delito sexual contra niños, niñas y adolescentes",2015,4,11,2026,542.94175715696,1,1062,94.1619585687382,10,964,1037.34439834025
19574,5,5284,121,Tasa de exámenes médico legales por presunto delito sexual cuando la víctima está entre 18 y 28 años,2015,5,1,3486,28.6861732644865,0,1842,0,1,1644,60.8272506082725
19575,5,5308,81,"Tasa de exámenes médico legales por presunto delito sexual contra niños, niñas y adolescentes",2015,2,3,4643,64.6133965108766,1,2364,42.3011844331641,2,2279,87.7577885037297
19576,5,5308,81,"Tasa de exámenes médico legales por presunto delito sexual contra niños, niñas y adolescentes",2015,3,5,5658,88.3704489218805,1,2853,35.0508236943568,4,2805,142.602495543672
19577,5,5308,81,"Tasa de exámenes médico legales por presunto delito sexual contra niños, niñas y adolescentes",2015,4,4,5857,68.2943486426498,1,2970,33.6700336700337,3,2887,103.914097679252
19578,5,5308,121,Tasa de exámenes médico legales por presunto delito sexual cuando la víctima está entre 18 y 28 años,2015,5,5,11154,44.826967903891,0,5602,0,5,5552,90.0576368876081
19579,5,5310,81,"Tasa de exámenes médico legales por presunto delito sexual contra niños, niñas y adolescentes",2015,2,1,1117,89.5255147717099,0,561,0,1,556,179.856115107914
19580,5,5310,81,"Tasa de exámenes médico legales por presunto delito sexual contra niños, niñas y adolescentes",2015,3,2,1271,157.3564122738,0,649,0,2,622,321.543408360129
19581,5,5310,81,"Tasa de exámenes médico legales por presunto delito sexual contra niños, niñas y adolescentes",2015,4,2,1310,152.671755725191,0,678,0,2,632,316.455696202532
19582,5,5310,121,Tasa de exámenes médico legales por presunto delito sexual cuando la víctima está entre 18 y 28 años,2015,5,1,2346,42.6257459505541,0,1244,0,1,1102,90.7441016333938
19583,5,5313,81,"Tasa de exámenes médico legales por presunto delito sexual contra niños, niñas y adolescentes",2015,3,2,1014,197.23865877712,1,520,192.307692307692,1,494,202.429149797571
19584,5,5318,81,"Tasa de exámenes médico legales por presunto delito sexual contra niños, niñas y adolescentes",2015,2,3,4530,66.2251655629139,0,2316,0,3,2214,135.50135501355
19585,5,5318,81,"Tasa de exámenes médico legales por presunto delito sexual contra niños, niñas y adolescentes",2015,3,5,5322,93.9496429913566,0,2724,0,5,2598,192.455735180908
19586,5,5318,81,"Tasa de exámenes médico legales por presunto delito sexual contra niños, niñas y adolescentes",2015,4,12,5200,230.769230769231,0,2685,0,12,2515,477.13717693837
19587,5,5318,121,Tasa de exámenes médico legales por presunto delito sexual cuando la víctima está entre 18 y 28 años,2015,5,2,9639,20.7490403568835,0,4912,0,2,4727,42.3101332769198
19588,5,5321,81,"Tasa de exámenes médico legales por presunto delito sexual contra niños, niñas y adolescentes",2015,2,2,436,458.715596330275,0,220,0,2,216,925.925925925926
19589,5,5321,121,Tasa de exámenes médico legales por presunto delito sexual cuando la víctima está entre 18 y 28 años,2015,5,1,986,101.419878296146,1,505,198.019801980198,0,481,0
19590,5,5360,81,"Tasa de exámenes médico legales por presunto delito sexual contra niños, niñas y adolescentes",2015,2,18,20446,88.0367798102318,5,10510,47.5737392959087,13,9936,130.837359098229
19591,5,5360,81,"Tasa de exámenes médico legales por presunto delito sexual contra niños, niñas y adolescentes",2015,3,19,24823,76.5419167707368,3,12589,23.830328064183,16,12234,130.783063593265
19592,5,5360,81,"Tasa de exámenes médico legales por presunto delito sexual contra niños, niñas y adolescentes",2015,4,25,26804,93.2696612445904,4,13487,29.6581893675391,21,13317,157.693174138319
19593,5,5360,121,Tasa de exámenes médico legales por presunto delito sexual cuando la víctima está entre 18 y 28 años,2015,5,10,52747,18.9584241757825,1,26671,3.74939072400735,9,26076,34.5144960883571
19594,5,5368,81,"Tasa de exámenes médico legales por presunto delito sexual contra niños, niñas y adolescentes",2015,2,2,1057,189.214758751183,0,539,0,2,518,386.100386100386
19595,5,5368,81,"Tasa de exámenes médico legales por presunto delito sexual contra niños, niñas y adolescentes",2015,3,6,1254,478.468899521531,1,636,157.232704402516,5,618,809.061488673139
19596,5,5368,81,"Tasa de exámenes médico legales por presunto delito sexual contra niños, niñas y adolescentes",2015,4,3,1260,238.095238095238,0,635,0,3,625,480
19597,5,5368,121,Tasa de exámenes médico legales por presunto delito sexual cuando la víctima está entre 18 y 28 años,2015,5,1,2521,39.6667988893296,0,1243,0,1,1278,78.2472613458529
19598,5,5376,81,"Tasa de exámenes médico legales por presunto delito sexual contra niños, niñas y adolescentes",2015,2,5,4530,110.37527593819,2,2311,86.5426222414539,3,2219,135.196034249662
19599,5,5376,81,"Tasa de exámenes médico legales por presunto delito sexual contra niños, niñas y adolescentes",2015,3,7,5491,127.481333090512,2,2809,71.1997152011392,5,2682,186.428038777032
19600,5,5376,81,"Tasa de exámenes médico legales por presunto delito sexual contra niños, niñas y adolescentes",2015,4,13,5652,230.007077140835,1,2840,35.2112676056338,12,2812,426.74253200569
19601,5,5376,121,Tasa de exámenes médico legales por presunto delito sexual cuando la víctima está entre 18 y 28 años,2015,5,1,11047,9.05223137503395,0,5582,0,1,5465,18.2982616651418
19602,5,5380,81,"Tasa de exámenes médico legales por presunto delito sexual contra niños, niñas y adolescentes",2015,2,2,5074,39.4166338194718,0,2616,0,2,2458,81.366965012205
19603,5,5380,81,"Tasa de exámenes médico legales por presunto delito sexual contra niños, niñas y adolescentes",2015,3,4,6164,64.8929266709929,0,3144,0,4,3020,132.450331125828
19604,5,5380,81,"Tasa de exámenes médico legales por presunto delito sexual contra niños, niñas y adolescentes",2015,4,8,6427,124.474871635289,0,3246,0,8,3181,251.493241119145
19605,5,5380,121,Tasa de exámenes médico legales por presunto delito sexual cuando la víctima está entre 18 y 28 años,2015,5,1,12631,7.91702953052015,0,6348,0,1,6283,15.9159637116027
19606,5,5400,81,"Tasa de exámenes médico legales por presunto delito sexual contra niños, niñas y adolescentes",2015,2,2,1820,109.89010989011,0,933,0,2,887,225.479143179256
19607,5,5400,81,"Tasa de exámenes médico legales por presunto delito sexual contra niños, niñas y adolescentes",2015,3,2,2158,92.678405931418,0,1115,0,2,1043,191.754554170662
19608,5,5400,81,"Tasa de exámenes médico legales por presunto delito sexual contra niños, niñas y adolescentes",2015,4,6,2131,281.557954012201,2,1103,181.323662737987,4,1028,389.105058365759
19609,5,5400,121,Tasa de exámenes médico legales por presunto delito sexual cuando la víctima está entre 18 y 28 años,2015,5,1,3917,25.5297421496043,0,2039,0,1,1878,53.248136315229
19610,5,5411,81,"Tasa de exámenes médico legales por presunto delito sexual contra niños, niñas y adolescentes",2015,2,1,798,125.31328320802,0,414,0,1,384,260.416666666667
19611,5,5411,81,"Tasa de exámenes médico legales por presunto delito sexual contra niños, niñas y adolescentes",2015,3,5,908,550.660792951542,1,482,207.46887966805,4,426,938.967136150235
19612,5,5411,81,"Tasa de exámenes médico legales por presunto delito sexual contra niños, niñas y adolescentes",2015,4,1,1062,94.1619585687382,0,571,0,1,491,203.665987780041
19613,5,5425,81,"Tasa de exámenes médico legales por presunto delito sexual contra niños, niñas y adolescentes",2015,3,1,682,146.627565982405,0,348,0,1,334,299.40119760479
19614,5,5440,81,"Tasa de exámenes médico legales por presunto delito sexual contra niños, niñas y adolescentes",2015,2,2,5309,37.6718779431155,1,2684,37.25782414307,1,2625,38.0952380952381
19615,5,5440,81,"Tasa de exámenes médico legales por presunto delito sexual contra niños, niñas y adolescentes",2015,3,7,6362,110.028292989626,1,3255,30.7219662058372,6,3107,193.11232700354
19616,5,5440,81,"Tasa de exámenes médico legales por presunto delito sexual contra niños, niñas y adolescentes",2015,4,8,6091,131.341323263832,3,3151,95.2078705172961,5,2940,170.068027210884
19617,5,5440,121,Tasa de exámenes médico legales por presunto delito sexual cuando la víctima está entre 18 y 28 años,2015,5,2,11418,17.5162024873008,0,5852,0,2,5566,35.9324469996407
19618,5,5467,81,"Tasa de exámenes médico legales por presunto delito sexual contra niños, niñas y adolescentes",2015,3,2,674,296.73590504451,0,354,0,2,320,625
19619,5,5467,81,"Tasa de exámenes médico legales por presunto delito sexual contra niños, niñas y adolescentes",2015,4,2,660,303.030303030303,0,348,0,2,312,641.025641025641
19620,5,5475,81,"Tasa de exámenes médico legales por presunto delito sexual contra niños, niñas y adolescentes",2015,4,2,518,386.100386100386,0,264,0,2,254,787.40157480315
19621,5,5480,81,"Tasa de exámenes médico legales por presunto delito sexual contra niños, niñas y adolescentes",2015,3,6,2530,237.154150197628,0,1297,0,6,1233,486.61800486618
19622,5,5480,81,"Tasa de exámenes médico legales por presunto delito sexual contra niños, niñas y adolescentes",2015,4,1,2538,39.4011032308905,0,1306,0,1,1232,81.1688311688312
19623,5,5480,121,Tasa de exámenes médico legales por presunto delito sexual cuando la víctima está entre 18 y 28 años,2015,5,1,4558,21.9394471259324,0,2334,0,1,2224,44.9640287769784
19624,5,5483,81,"Tasa de exámenes médico legales por presunto delito sexual contra niños, niñas y adolescentes",2015,2,3,1805,166.204986149584,1,933,107.181136120043,2,872,229.357798165138
19625,5,5483,81,"Tasa de exámenes médico legales por presunto delito sexual contra niños, niñas y adolescentes",2015,3,3,2024,148.221343873518,1,1049,95.3288846520496,2,975,205.128205128205
19626,5,5483,81,"Tasa de exámenes médico legales por presunto delito sexual contra niños, niñas y adolescentes",2015,4,1,2014,49.6524329692155,0,1056,0,1,958,104.384133611691
19627,5,5490,81,"Tasa de exámenes médico legales por presunto delito sexual contra niños, niñas y adolescentes",2015,3,3,8295,36.1663652802893,0,4228,0,3,4067,73.764445537251
19628,5,5490,81,"Tasa de exámenes médico legales por presunto delito sexual contra niños, niñas y adolescentes",2015,4,6,8224,72.9571984435798,1,4181,23.9177230327673,5,4043,123.670541676973
19629,5,5490,121,Tasa de exámenes médico legales por presunto delito sexual cuando la víctima está entre 18 y 28 años,2015,5,2,13776,14.5180023228804,1,6918,14.4550448106389,1,6858,14.5815106445028
19630,5,5495,81,"Tasa de exámenes médico legales por presunto delito sexual contra niños, niñas y adolescentes",2015,4,1,3294,30.3582270795386,0,1648,0,1,1646,60.7533414337788
19631,5,5501,81,"Tasa de exámenes médico legales por presunto delito sexual contra niños, niñas y adolescentes",2015,2,1,328,304.878048780488,0,170,0,1,158,632.911392405063
19632,5,5501,81,"Tasa de exámenes médico legales por presunto delito sexual contra niños, niñas y adolescentes",2015,3,2,377,530.503978779841,0,199,0,2,178,1123.59550561798
19633,5,5501,81,"Tasa de exámenes médico legales por presunto delito sexual contra niños, niñas y adolescentes",2015,4,1,386,259.067357512953,1,207,483.091787439613,0,179,0
19634,5,5541,81,"Tasa de exámenes médico legales por presunto delito sexual contra niños, niñas y adolescentes",2015,3,2,1756,113.895216400911,0,893,0,2,863,231.749710312862
19635,5,5541,81,"Tasa de exámenes médico legales por presunto delito sexual contra niños, niñas y adolescentes",2015,4,7,1792,390625,0,912,0,7,880,795.454545454545
19636,5,5541,121,Tasa de exámenes médico legales por presunto delito sexual cuando la víctima está entre 18 y 28 años,2015,5,1,3145,31.7965023847377,0,1582,0,1,1563,63.9795265515035
19637,5,5543,81,"Tasa de exámenes médico legales por presunto delito sexual contra niños, niñas y adolescentes",2015,2,1,1124,88.9679715302491,0,590,0,1,534,187.265917602996
19638,5,5543,81,"Tasa de exámenes médico legales por presunto delito sexual contra niños, niñas y adolescentes",2015,3,1,1275,78.4313725490196,0,679,0,1,596,167.785234899329
19639,5,5543,81,"Tasa de exámenes médico legales por presunto delito sexual contra niños, niñas y adolescentes",2015,4,2,1254,159.489633173844,0,678,0,2,576,347.222222222222
19640,5,5543,121,Tasa de exámenes médico legales por presunto delito sexual cuando la víctima está entre 18 y 28 años,2015,5,1,2163,46.2320850670365,0,1184,0,1,979,102.145045965271
19641,5,5576,81,"Tasa de exámenes médico legales por presunto delito sexual contra niños, niñas y adolescentes",2015,3,2,818,244.498777506112,0,417,0,2,401,498.753117206983
19642,5,5576,81,"Tasa de exámenes médico legales por presunto delito sexual contra niños, niñas y adolescentes",2015,4,1,790,126.582278481013,0,403,0,1,387,258.397932816537
19643,5,5579,81,"Tasa de exámenes médico legales por presunto delito sexual contra niños, niñas y adolescentes",2015,2,6,4228,141.911069063387,2,2163,92.464170134073,4,2065,193.704600484262
19644,5,5579,81,"Tasa de exámenes médico legales por presunto delito sexual contra niños, niñas y adolescentes",2015,3,9,5044,178.429817605075,3,2565,116.959064327485,6,2479,242.033077853973
19645,5,5579,81,"Tasa de exámenes médico legales por presunto delito sexual contra niños, niñas y adolescentes",2015,4,5,5100,98.0392156862745,0,2579,0,5,2521,198.333994446648
19646,5,5579,121,Tasa de exámenes médico legales por presunto delito sexual cuando la víctima está entre 18 y 28 años,2015,5,1,9698,10.3114044132811,1,4783,20.9073803052478,0,4915,0
19647,5,5585,81,"Tasa de exámenes médico legales por presunto delito sexual contra niños, niñas y adolescentes",2015,3,1,2045,48.8997555012225,1,1087,91.9963201471941,0,958,0
19648,5,5591,81,"Tasa de exámenes médico legales por presunto delito sexual contra niños, niñas y adolescentes",2015,2,4,2079,192.400192400192,3,1071,280.112044817927,1,1008,99.2063492063492
19649,5,5591,81,"Tasa de exámenes médico legales por presunto delito sexual contra niños, niñas y adolescentes",2015,3,6,2311,259.627866724362,3,1217,246.507806080526,3,1094,274.223034734918
19650,5,5591,81,"Tasa de exámenes médico legales por presunto delito sexual contra niños, niñas y adolescentes",2015,4,7,2334,299.914310197087,0,1249,0,7,1085,645.161290322581
19651,5,5607,81,"Tasa de exámenes médico legales por presunto delito sexual contra niños, niñas y adolescentes",2015,2,1,1646,60.7533414337788,0,843,0,1,803,124.53300124533
19652,5,5607,81,"Tasa de exámenes médico legales por presunto delito sexual contra niños, niñas y adolescentes",2015,4,2,1986,100.704934541793,2,1030,194.174757281553,0,956,0
19653,5,5615,81,"Tasa de exámenes médico legales por presunto delito sexual contra niños, niñas y adolescentes",2015,2,10,9950,100.502512562814,3,5128,58.5023400936037,7,4822,145.167980091248
19654,5,5615,81,"Tasa de exámenes médico legales por presunto delito sexual contra niños, niñas y adolescentes",2015,3,22,12124,181.458264599142,8,6206,128.907508862391,14,5918,236.566407570125
19655,5,5615,81,"Tasa de exámenes médico legales por presunto delito sexual contra niños, niñas y adolescentes",2015,4,19,12398,153.250524278109,3,6333,47.3709142586452,16,6065,263.808738664468
19656,5,5615,121,Tasa de exámenes médico legales por presunto delito sexual cuando la víctima está entre 18 y 28 años,2015,5,4,24009,16.6604190095381,1,12280,8.14332247557003,3,11729,25.5776281012874
19657,5,5631,81,"Tasa de exámenes médico legales por presunto delito sexual contra niños, niñas y adolescentes",2015,2,3,2829,106.044538706257,1,1437,69.589422407794,2,1392,143.67816091954
19658,5,5631,81,"Tasa de exámenes médico legales por presunto delito sexual contra niños, niñas y adolescentes",2015,3,3,3495,85.8369098712446,1,1763,56.7214974475326,2,1732,115.473441108545
19659,5,5631,81,"Tasa de exámenes médico legales por presunto delito sexual contra niños, niñas y adolescentes",2015,4,9,4384,205.29197080292,2,2202,90.8265213442325,7,2182,320.806599450046
19660,5,5631,121,Tasa de exámenes médico legales por presunto delito sexual cuando la víctima está entre 18 y 28 años,2015,5,5,10179,49.1207387759112,0,5013,0,5,5166,96.7866821525358
19661,5,5649,81,"Tasa de exámenes médico legales por presunto delito sexual contra niños, niñas y adolescentes",2015,2,1,1501,66.6222518321119,1,772,129.533678756477,0,729,0
19662,5,5649,81,"Tasa de exámenes médico legales por presunto delito sexual contra niños, niñas y adolescentes",2015,3,2,1770,112.994350282486,1,920,108.695652173913,1,850,117.647058823529
19663,5,5649,81,"Tasa de exámenes médico legales por presunto delito sexual contra niños, niñas y adolescentes",2015,4,1,1607,62.2277535780958,0,842,0,1,765,130.718954248366
19664,5,5656,81,"Tasa de exámenes médico legales por presunto delito sexual contra niños, niñas y adolescentes",2015,2,2,1193,167.644593461861,0,608,0,2,585,341.880341880342
19665,5,5656,81,"Tasa de exámenes médico legales por presunto delito sexual contra niños, niñas y adolescentes",2015,3,2,1395,143.36917562724,0,716,0,2,679,294.550810014728
19666,5,5656,81,"Tasa de exámenes médico legales por presunto delito sexual contra niños, niñas y adolescentes",2015,4,1,1390,71.9424460431655,0,714,0,1,676,147.92899408284
19667,5,5656,121,Tasa de exámenes médico legales por presunto delito sexual cuando la víctima está entre 18 y 28 años,2015,5,3,2502,119.904076738609,0,1301,0,3,1201,249.791840133222
19668,5,5658,81,"Tasa de exámenes médico legales por presunto delito sexual contra niños, niñas y adolescentes",2015,4,1,427,234.192037470726,0,218,0,1,209,478.468899521531
19669,5,5659,81,"Tasa de exámenes médico legales por presunto delito sexual contra niños, niñas y adolescentes",2015,3,7,3683,190.062449090415,0,1890,0,7,1793,390.407138873397
19670,5,5659,81,"Tasa de exámenes médico legales por presunto delito sexual contra niños, niñas y adolescentes",2015,4,12,3202,374.765771392879,0,1652,0,12,1550,774.193548387097
19671,5,5660,81,"Tasa de exámenes médico legales por presunto delito sexual contra niños, niñas y adolescentes",2015,3,1,1245,80.3212851405623,0,664,0,1,581,172.117039586919
19672,5,5660,81,"Tasa de exámenes médico legales por presunto delito sexual contra niños, niñas y adolescentes",2015,4,1,1180,84.7457627118644,0,646,0,1,534,187.265917602996
19673,5,5660,121,Tasa de exámenes médico legales por presunto delito sexual cuando la víctima está entre 18 y 28 años,2015,5,2,2071,96.5717044905843,0,1148,0,2,923,216.684723726977
19674,5,5664,81,"Tasa de exámenes médico legales por presunto delito sexual contra niños, niñas y adolescentes",2015,3,2,3121,64.0820249919897,1,1583,63.1711939355654,1,1538,65.0195058517555
19675,5,5664,81,"Tasa de exámenes médico legales por presunto delito sexual contra niños, niñas y adolescentes",2015,4,4,3022,132.362673726009,1,1564,63.9386189258312,3,1458,205.761316872428
19676,5,5665,81,"Tasa de exámenes médico legales por presunto delito sexual contra niños, niñas y adolescentes",2015,3,2,4264,46.9043151969981,1,2193,45.5996352029184,1,2071,48.2858522452921
19677,5,5667,81,"Tasa de exámenes médico legales por presunto delito sexual contra niños, niñas y adolescentes",2015,3,1,1206,82.9187396351576,1,637,156.985871271586,0,569,0
19678,5,5670,81,"Tasa de exámenes médico legales por presunto delito sexual contra niños, niñas y adolescentes",2015,4,1,1857,53.850296176629,0,947,0,1,910,109.89010989011
19679,5,5674,81,"Tasa de exámenes médico legales por presunto delito sexual contra niños, niñas y adolescentes",2015,3,1,1709,58.5137507314219,0,881,0,1,828,120.772946859903
19680,5,5674,81,"Tasa de exámenes médico legales por presunto delito sexual contra niños, niñas y adolescentes",2015,4,1,1746,57.2737686139748,1,897,111.482720178372,0,849,0
19681,5,5679,81,"Tasa de exámenes médico legales por presunto delito sexual contra niños, niñas y adolescentes",2015,4,1,2354,42.4808836023789,0,1196,0,1,1158,86.3557858376511
19682,5,5686,81,"Tasa de exámenes médico legales por presunto delito sexual contra niños, niñas y adolescentes",2015,3,2,3917,51.0594842992086,0,2003,0,2,1914,104.493207941484
19683,5,5686,81,"Tasa de exámenes médico legales por presunto delito sexual contra niños, niñas y adolescentes",2015,4,14,4063,344.572975633768,3,2132,140.712945590994,11,1931,569.653029518384
19684,5,5686,121,Tasa de exámenes médico legales por presunto delito sexual cuando la víctima está entre 18 y 28 años,2015,5,3,7572,39.6196513470681,1,3979,25.1319426991706,2,3593,55.663790704147
19685,5,5697,81,"Tasa de exámenes médico legales por presunto delito sexual contra niños, niñas y adolescentes",2015,2,1,2237,44.7027268663388,0,1136,0,1,1101,90.8265213442325
19686,5,5697,81,"Tasa de exámenes médico legales por presunto delito sexual contra niños, niñas y adolescentes",2015,3,8,2649,302.000755001888,1,1367,73.1528895391368,7,1282,546.021840873635
19687,5,5697,81,"Tasa de exámenes médico legales por presunto delito sexual contra niños, niñas y adolescentes",2015,4,7,2734,256.035113386979,3,1424,210.674157303371,4,1310,305.343511450382
19688,5,5697,121,Tasa de exámenes médico legales por presunto delito sexual cuando la víctima está entre 18 y 28 años,2015,5,3,5202,57.6701268742791,0,2665,0,3,2537,118.249901458415
19689,5,5736,81,"Tasa de exámenes médico legales por presunto delito sexual contra niños, niñas y adolescentes",2015,2,8,4224,189.393939393939,3,2172,138.121546961326,5,2052,243.664717348928
19690,5,5736,81,"Tasa de exámenes médico legales por presunto delito sexual contra niños, niñas y adolescentes",2015,3,5,4846,103.177878662815,1,2503,39.9520575309628,4,2343,170.721297481861
19691,5,5736,81,"Tasa de exámenes médico legales por presunto delito sexual contra niños, niñas y adolescentes",2015,4,7,4875,143.589743589744,2,2528,79.1139240506329,5,2347,213.037920749893
19692,5,5736,121,Tasa de exámenes médico legales por presunto delito sexual cuando la víctima está entre 18 y 28 años,2015,5,2,8680,23.0414746543779,0,4505,0,2,4175,47.9041916167665
19693,5,5756,81,"Tasa de exámenes médico legales por presunto delito sexual contra niños, niñas y adolescentes",2015,3,5,3847,129.971406290616,2,1970,101.522842639594,3,1877,159.829515183804
19694,5,5756,81,"Tasa de exámenes médico legales por presunto delito sexual contra niños, niñas y adolescentes",2015,4,5,3815,131.061598951507,0,1955,0,5,1860,268.817204301075
19695,5,5756,121,Tasa de exámenes médico legales por presunto delito sexual cuando la víctima está entre 18 y 28 años,2015,5,2,7543,26.5146493437624,0,3810,0,2,3733,53.5762121618002
19696,5,5761,81,"Tasa de exámenes médico legales por presunto delito sexual contra niños, niñas y adolescentes",2015,4,2,1592,125.628140703518,0,852,0,2,740,270.27027027027
19697,5,5789,81,"Tasa de exámenes médico legales por presunto delito sexual contra niños, niñas y adolescentes",2015,3,1,1428,70.0280112044818,1,729,137.174211248285,0,699,0
19698,5,5789,81,"Tasa de exámenes médico legales por presunto delito sexual contra niños, niñas y adolescentes",2015,4,6,1446,414.9377593361,1,743,134.589502018843,5,703,711.237553342817
19699,5,5789,121,Tasa de exámenes médico legales por presunto delito sexual cuando la víctima está entre 18 y 28 años,2015,5,1,2474,40.4203718674212,0,1298,0,1,1176,85.0340136054422
19700,5,5790,81,"Tasa de exámenes médico legales por presunto delito sexual contra niños, niñas y adolescentes",2015,2,4,5568,71.8390804597701,0,2843,0,4,2725,146.788990825688
19701,5,5790,81,"Tasa de exámenes médico legales por presunto delito sexual contra niños, niñas y adolescentes",2015,3,3,6201,48.3792936623125,0,3182,0,3,3019,99.3706525339516
19702,5,5790,81,"Tasa de exámenes médico legales por presunto delito sexual contra niños, niñas y adolescentes",2015,4,3,5692,52.7055516514406,0,2932,0,3,2760,108.695652173913
19703,5,5790,121,Tasa de exámenes médico legales por presunto delito sexual cuando la víctima está entre 18 y 28 años,2015,5,1,8648,11.5633672525439,0,4339,0,1,4309,23.2072406590856
19704,5,5792,81,"Tasa de exámenes médico legales por presunto delito sexual contra niños, niñas y adolescentes",2015,3,3,908,330.396475770925,0,474,0,3,434,691.244239631336
19705,5,5792,81,"Tasa de exámenes médico legales por presunto delito sexual contra niños, niñas y adolescentes",2015,4,4,880,454.545454545455,0,460,0,4,420,952.380952380953
19706,5,5809,81,"Tasa de exámenes médico legales por presunto delito sexual contra niños, niñas y adolescentes",2015,2,1,1130,88.4955752212389,0,581,0,1,549,182.149362477231
19707,5,5809,81,"Tasa de exámenes médico legales por presunto delito sexual contra niños, niñas y adolescentes",2015,4,2,1361,146.95077149155,0,710,0,2,651,307.219662058372
19708,5,5819,81,"Tasa de exámenes médico legales por presunto delito sexual contra niños, niñas y adolescentes",2015,3,1,803,124.53300124533,0,411,0,1,392,255.102040816327
19709,5,5837,81,"Tasa de exámenes médico legales por presunto delito sexual contra niños, niñas y adolescentes",2015,2,6,19302,31.0848616723656,2,9944,20.1126307320998,4,9358,42.7441761060056
19710,5,5837,81,"Tasa de exámenes médico legales por presunto delito sexual contra niños, niñas y adolescentes",2015,3,22,21551,102.083430003248,2,11112,17.9985601151908,20,10439,191.589232685123
19711,5,5837,81,"Tasa de exámenes médico legales por presunto delito sexual contra niños, niñas y adolescentes",2015,4,28,21351,131.141398529343,0,10544,0,28,10807,259.091329693717
19712,5,5837,121,Tasa de exámenes médico legales por presunto delito sexual cuando la víctima está entre 18 y 28 años,2015,5,6,35361,16.9678459319589,1,17895,5.58815311539536,5,17466,28.6270468338486
19713,5,5842,81,"Tasa de exámenes médico legales por presunto delito sexual contra niños, niñas y adolescentes",2015,3,2,958,208.768267223382,0,510,0,2,448,446.428571428571
19714,5,5842,81,"Tasa de exámenes médico legales por presunto delito sexual contra niños, niñas y adolescentes",2015,4,1,946,105.708245243129,0,511,0,1,435,229.885057471264
19715,5,5847,81,"Tasa de exámenes médico legales por presunto delito sexual contra niños, niñas y adolescentes",2015,2,7,4604,152.041702867072,0,2362,0,7,2242,312.221231043711
19716,5,5847,81,"Tasa de exámenes médico legales por presunto delito sexual contra niños, niñas y adolescentes",2015,3,4,5331,75.032826861752,0,2790,0,4,2541,157.418339236521
19717,5,5847,81,"Tasa de exámenes médico legales por presunto delito sexual contra niños, niñas y adolescentes",2015,4,13,5101,254.85198980592,2,2747,72.8066982162359,11,2354,467.289719626168
19718,5,5847,121,Tasa de exámenes médico legales por presunto delito sexual cuando la víctima está entre 18 y 28 años,2015,5,2,8212,24.3546030199708,0,4351,0,2,3861,51.8000518000518
19719,5,5856,81,"Tasa de exámenes médico legales por presunto delito sexual contra niños, niñas y adolescentes",2015,2,1,586,170.648464163823,0,303,0,1,283,353.356890459364
19720,5,5858,81,"Tasa de exámenes médico legales por presunto delito sexual contra niños, niñas y adolescentes",2015,3,1,1229,81.366965012205,0,628,0,1,601,166.389351081531
19721,5,5858,81,"Tasa de exámenes médico legales por presunto delito sexual contra niños, niñas y adolescentes",2015,4,4,1131,353.669319186561,0,576,0,4,555,720.720720720721
19722,5,5873,81,"Tasa de exámenes médico legales por presunto delito sexual contra niños, niñas y adolescentes",2015,4,1,618,161.812297734628,0,317,0,1,301,332.225913621262
19723,5,5885,81,"Tasa de exámenes médico legales por presunto delito sexual contra niños, niñas y adolescentes",2015,3,1,1078,92.7643784786642,0,560,0,1,518,193.050193050193
19724,5,5887,81,"Tasa de exámenes médico legales por presunto delito sexual contra niños, niñas y adolescentes",2015,2,6,4932,121.654501216545,0,2526,0,6,2406,249.376558603491
19725,5,5887,81,"Tasa de exámenes médico legales por presunto delito sexual contra niños, niñas y adolescentes",2015,3,2,5768,34.6740638002774,0,2947,0,2,2821,70.8968450903935
19726,5,5887,81,"Tasa de exámenes médico legales por presunto delito sexual contra niños, niñas y adolescentes",2015,4,8,5525,144.796380090498,0,2815,0,8,2710,295.20295202952
19727,5,5887,121,Tasa de exámenes médico legales por presunto delito sexual cuando la víctima está entre 18 y 28 años,2015,5,2,9763,20.4855065041483,0,4911,0,2,4852,41.2201154163232
19728,5,5893,81,"Tasa de exámenes médico legales por presunto delito sexual contra niños, niñas y adolescentes",2015,3,5,2129,234.852043212776,1,1092,91.5750915750916,4,1037,385.72806171649
19729,5,5893,81,"Tasa de exámenes médico legales por presunto delito sexual contra niños, niñas y adolescentes",2015,1,1,387,258.397932816537,0,197,0,1,190,526.315789473684
19730,5,5895,81,"Tasa de exámenes médico legales por presunto delito sexual contra niños, niñas y adolescentes",2015,4,3,3830,78.3289817232376,0,1982,0,3,1848,162.337662337662
19731,50,50001,81,"Tasa de exámenes médico legales por presunto delito sexual contra niños, niñas y adolescentes",2015,2,92,42669,215.613208652652,20,21782,91.8189330639978,72,20887,344.712021831761
19732,50,50001,81,"Tasa de exámenes médico legales por presunto delito sexual contra niños, niñas y adolescentes",2015,3,161,51868,310.403331533894,27,26308,102.630378592063,134,25560,524.256651017214
19733,50,50001,81,"Tasa de exámenes médico legales por presunto delito sexual contra niños, niñas y adolescentes",2015,4,148,52010,284.560661411267,20,26149,76.484760411488,128,25861,494.953791423379
19734,50,50001,121,Tasa de exámenes médico legales por presunto delito sexual cuando la víctima está entre 18 y 28 años,2015,5,24,95322,25.1778183420407,1,46048,2.17164697706741,23,49274,46.6777610910419
19735,50,50001,81,"Tasa de exámenes médico legales por presunto delito sexual contra niños, niñas y adolescentes",2015,1,2,8403,23.8010234440081,0,4306,0,2,4097,48.8162069807176
19736,50,50006,81,"Tasa de exámenes médico legales por presunto delito sexual contra niños, niñas y adolescentes",2015,2,3,6347,47.2664250827162,1,3214,31.1138767890479,2,3133,63.8365783593999
19737,50,50006,81,"Tasa de exámenes médico legales por presunto delito sexual contra niños, niñas y adolescentes",2015,3,14,7400,189.189189189189,2,3691,54.1858574911948,12,3709,323.53734160151
19738,50,50006,81,"Tasa de exámenes médico legales por presunto delito sexual contra niños, niñas y adolescentes",2015,4,19,7232,262.721238938053,2,3581,55.8503211393465,17,3651,465.625855929882
19739,50,50006,121,Tasa de exámenes médico legales por presunto delito sexual cuando la víctima está entre 18 y 28 años,2015,5,5,13180,37.9362670713202,1,6429,15.5545185876497,4,6751,59.2504814101615
19740,50,50110,81,"Tasa de exámenes médico legales por presunto delito sexual contra niños, niñas y adolescentes",2015,4,1,504,198.412698412698,0,252,0,1,252,396.825396825397
19741,50,50124,81,"Tasa de exámenes médico legales por presunto delito sexual contra niños, niñas y adolescentes",2015,3,2,487,410.677618069815,0,257,0,2,230,869.565217391304
19742,50,50124,81,"Tasa de exámenes médico legales por presunto delito sexual contra niños, niñas y adolescentes",2015,4,2,469,426.439232409382,0,251,0,2,218,917.431192660551
19743,50,50150,81,"Tasa de exámenes médico legales por presunto delito sexual contra niños, niñas y adolescentes",2015,3,1,1082,92.4214417744917,0,550,0,1,532,187.96992481203
19744,50,50150,81,"Tasa de exámenes médico legales por presunto delito sexual contra niños, niñas y adolescentes",2015,4,3,1074,279.329608938547,1,538,185.873605947955,2,536,373.134328358209
19745,50,50223,81,"Tasa de exámenes médico legales por presunto delito sexual contra niños, niñas y adolescentes",2015,2,1,608,164.473684210526,0,312,0,1,296,337.837837837838
19746,50,50226,81,"Tasa de exámenes médico legales por presunto delito sexual contra niños, niñas y adolescentes",2015,2,6,1896,316.455696202532,2,978,204.498977505112,4,918,435.729847494553
19747,50,50226,81,"Tasa de exámenes médico legales por presunto delito sexual contra niños, niñas y adolescentes",2015,3,7,2282,306.748466257669,0,1157,0,7,1125,622.222222222222
19748,50,50226,81,"Tasa de exámenes médico legales por presunto delito sexual contra niños, niñas y adolescentes",2015,4,17,2053,828.056502679006,1,1021,97.9431929480901,16,1032,1550.38759689922
19749,50,50251,81,"Tasa de exámenes médico legales por presunto delito sexual contra niños, niñas y adolescentes",2015,2,1,673,148.588410104012,0,347,0,1,326,306.748466257669
19750,50,50251,81,"Tasa de exámenes médico legales por presunto delito sexual contra niños, niñas y adolescentes",2015,3,1,751,133.155792276964,0,389,0,1,362,276.243093922652
19751,50,50251,81,"Tasa de exámenes médico legales por presunto delito sexual contra niños, niñas y adolescentes",2015,4,2,686,291.545189504373,0,357,0,2,329,607.90273556231
19752,50,50270,81,"Tasa de exámenes médico legales por presunto delito sexual contra niños, niñas y adolescentes",2015,3,1,464,215.51724137931,0,246,0,1,218,458.715596330275
19753,50,50270,81,"Tasa de exámenes médico legales por presunto delito sexual contra niños, niñas y adolescentes",2015,4,1,430,232.558139534884,0,235,0,1,195,512.820512820513
19754,50,50270,121,Tasa de exámenes médico legales por presunto delito sexual cuando la víctima está entre 18 y 28 años,2015,5,1,660,151.515151515152,0,362,0,1,298,335.570469798658
19755,50,50287,81,"Tasa de exámenes médico legales por presunto delito sexual contra niños, niñas y adolescentes",2015,3,2,1637,122.174709835064,0,832,0,2,805,248.447204968944
19756,50,50313,81,"Tasa de exámenes médico legales por presunto delito sexual contra niños, niñas y adolescentes",2015,2,8,6514,122.812404052809,1,3316,30.1568154402895,7,3198,218.886804252658
19757,50,50313,81,"Tasa de exámenes médico legales por presunto delito sexual contra niños, niñas y adolescentes",2015,3,15,7230,207.46887966805,4,3678,108.754758020663,11,3552,309.684684684685
19758,50,50313,81,"Tasa de exámenes médico legales por presunto delito sexual contra niños, niñas y adolescentes",2015,4,17,6759,251.516496523154,1,3414,29.2911540714704,16,3345,478.325859491779
19759,50,50318,81,"Tasa de exámenes médico legales por presunto delito sexual contra niños, niñas y adolescentes",2015,2,1,839,119.189511323004,0,434,0,1,405,246.913580246914
19760,50,50318,81,"Tasa de exámenes médico legales por presunto delito sexual contra niños, niñas y adolescentes",2015,3,1,984,101.626016260163,0,507,0,1,477,209.643605870021
19761,50,50318,81,"Tasa de exámenes médico legales por presunto delito sexual contra niños, niñas y adolescentes",2015,4,1,942,106.157112526539,1,476,210.084033613445,0,466,0
19762,50,50325,81,"Tasa de exámenes médico legales por presunto delito sexual contra niños, niñas y adolescentes",2015,4,2,1852,107.991360691145,0,927,0,2,925,216.216216216216
19763,50,50330,81,"Tasa de exámenes médico legales por presunto delito sexual contra niños, niñas y adolescentes",2015,4,7,1388,504.322766570605,1,704,142.045454545455,6,684,877.19298245614
19764,50,50350,81,"Tasa de exámenes médico legales por presunto delito sexual contra niños, niñas y adolescentes",2015,3,3,4346,69.0289921767142,0,2236,0,3,2110,142.18009478673
19765,50,50350,81,"Tasa de exámenes médico legales por presunto delito sexual contra niños, niñas y adolescentes",2015,4,6,3991,150.338261087447,1,2067,48.3792936623125,5,1924,259.87525987526
19766,50,50350,121,Tasa de exámenes médico legales por presunto delito sexual cuando la víctima está entre 18 y 28 años,2015,5,3,6135,48.8997555012225,0,3096,0,3,3039,98.7166831194472
19767,50,50370,81,"Tasa de exámenes médico legales por presunto delito sexual contra niños, niñas y adolescentes",2015,4,1,1837,54.4365813826892,0,952,0,1,885,112.994350282486
19768,50,50400,81,"Tasa de exámenes médico legales por presunto delito sexual contra niños, niñas y adolescentes",2015,2,2,996,200.803212851406,0,519,0,2,477,419.287211740042
19769,50,50400,81,"Tasa de exámenes médico legales por presunto delito sexual contra niños, niñas y adolescentes",2015,3,4,1145,349.344978165939,0,615,0,4,530,754.716981132075
19770,50,50400,81,"Tasa de exámenes médico legales por presunto delito sexual contra niños, niñas y adolescentes",2015,4,2,1109,180.34265103697,1,609,164.203612479475,1,500,200
19771,50,50400,121,Tasa de exámenes médico legales por presunto delito sexual cuando la víctima está entre 18 y 28 años,2015,5,1,1911,52.3286237571952,0,1018,0,1,893,111.982082866741
19772,50,50450,81,"Tasa de exámenes médico legales por presunto delito sexual contra niños, niñas y adolescentes",2015,2,1,2232,44.8028673835125,0,1147,0,1,1085,92.1658986175115
19773,50,50450,81,"Tasa de exámenes médico legales por presunto delito sexual contra niños, niñas y adolescentes",2015,3,2,2524,79.2393026941363,0,1311,0,2,1213,164.880461665293
19774,50,50450,81,"Tasa de exámenes médico legales por presunto delito sexual contra niños, niñas y adolescentes",2015,4,2,2447,81.732733959951,0,1292,0,2,1155,173.160173160173
19775,50,50450,121,Tasa de exámenes médico legales por presunto delito sexual cuando la víctima está entre 18 y 28 años,2015,5,1,4098,24.4021473889702,0,2025,0,1,2073,48.2392667631452
19776,50,50568,81,"Tasa de exámenes médico legales por presunto delito sexual contra niños, niñas y adolescentes",2015,2,2,2612,76.5696784073507,1,1350,74.0740740740741,1,1262,79.2393026941363
19777,50,50568,81,"Tasa de exámenes médico legales por presunto delito sexual contra niños, niñas y adolescentes",2015,3,5,2860,174.825174825175,1,1477,67.7048070412999,4,1383,289.226319595083
19778,50,50568,81,"Tasa de exámenes médico legales por presunto delito sexual contra niños, niñas y adolescentes",2015,4,3,2491,120.433560818948,0,1267,0,3,1224,245.098039215686
19779,50,50573,81,"Tasa de exámenes médico legales por presunto delito sexual contra niños, niñas y adolescentes",2015,2,5,3421,146.156094709149,2,1765,113.314447592068,3,1656,181.159420289855
19780,50,50573,81,"Tasa de exámenes médico legales por presunto delito sexual contra niños, niñas y adolescentes",2015,3,17,4122,412.421154779233,3,2164,138.632162661738,14,1958,715.015321756895
19781,50,50573,81,"Tasa de exámenes médico legales por presunto delito sexual contra niños, niñas y adolescentes",2015,4,6,3890,154.241645244216,1,2100,47.6190476190476,5,1790,279.329608938547
19782,50,50573,121,Tasa de exámenes médico legales por presunto delito sexual cuando la víctima está entre 18 y 28 años,2015,5,2,6584,30.3766707168894,0,3483,0,2,3101,64.4953240890035
19783,50,50577,81,"Tasa de exámenes médico legales por presunto delito sexual contra niños, niñas y adolescentes",2015,2,2,1071,186.741363211951,1,554,180.505415162455,1,517,193.423597678917
19784,50,50577,81,"Tasa de exámenes médico legales por presunto delito sexual contra niños, niñas y adolescentes",2015,3,4,1268,315.457413249211,1,662,151.057401812689,3,606,495.049504950495
19785,50,50577,81,"Tasa de exámenes médico legales por presunto delito sexual contra niños, niñas y adolescentes",2015,4,3,1150,260.869565217391,0,614,0,3,536,559.701492537313
19786,50,50590,81,"Tasa de exámenes médico legales por presunto delito sexual contra niños, niñas y adolescentes",2015,3,1,2499,40.016006402561,0,1364,0,1,1135,88.1057268722467
19787,50,50590,81,"Tasa de exámenes médico legales por presunto delito sexual contra niños, niñas y adolescentes",2015,4,2,2285,87.527352297593,0,1302,0,2,983,203.458799593082
19788,50,50606,81,"Tasa de exámenes médico legales por presunto delito sexual contra niños, niñas y adolescentes",2015,2,4,1024,390625,1,525,190.47619047619,3,499,601.202404809619
19789,50,50606,81,"Tasa de exámenes médico legales por presunto delito sexual contra niños, niñas y adolescentes",2015,3,5,1203,415.627597672485,2,615,325.20325203252,3,588,510.204081632653
19790,50,50606,81,"Tasa de exámenes médico legales por presunto delito sexual contra niños, niñas y adolescentes",2015,4,2,1139,175.592625109745,0,570,0,2,569,351.493848857645
19791,50,50680,81,"Tasa de exámenes médico legales por presunto delito sexual contra niños, niñas y adolescentes",2015,3,2,1246,160.513643659711,0,641,0,2,605,330.578512396694
19792,50,50680,81,"Tasa de exámenes médico legales por presunto delito sexual contra niños, niñas y adolescentes",2015,4,1,1149,87.0322019147084,0,592,0,1,557,179.533213644524
19793,50,50683,81,"Tasa de exámenes médico legales por presunto delito sexual contra niños, niñas y adolescentes",2015,3,9,1247,721.732157177225,3,646,464.396284829721,6,601,998.336106489185
19794,50,50686,121,Tasa de exámenes médico legales por presunto delito sexual cuando la víctima está entre 18 y 28 años,2015,5,1,413,242.130750605327,0,216,0,1,197,507.614213197969
19795,50,50689,81,"Tasa de exámenes médico legales por presunto delito sexual contra niños, niñas y adolescentes",2015,2,3,2431,123.406005758947,1,1242,80.5152979066023,2,1189,168.20857863751
19796,50,50689,81,"Tasa de exámenes médico legales por presunto delito sexual contra niños, niñas y adolescentes",2015,3,7,2886,242.550242550243,1,1483,67.4308833445718,6,1403,427.655024946543
19797,50,50689,81,"Tasa de exámenes médico legales por presunto delito sexual contra niños, niñas y adolescentes",2015,4,4,2577,155.219247186651,0,1303,0,4,1274,313.971742543171
19798,50,50689,121,Tasa de exámenes médico legales por presunto delito sexual cuando la víctima está entre 18 y 28 años,2015,5,2,4345,46.029919447641,0,2094,0,2,2251,88.8494002665482
19799,50,50711,81,"Tasa de exámenes médico legales por presunto delito sexual contra niños, niñas y adolescentes",2015,2,1,2908,34.3878954607978,1,1487,67.2494956287828,0,1421,0
19800,50,50711,81,"Tasa de exámenes médico legales por presunto delito sexual contra niños, niñas y adolescentes",2015,3,2,3262,61.3120784794605,0,1675,0,2,1587,126.023944549464
19801,50,50711,81,"Tasa de exámenes médico legales por presunto delito sexual contra niños, niñas y adolescentes",2015,4,4,3004,133.155792276964,0,1550,0,4,1454,275.103163686382
19802,52,52001,81,"Tasa de exámenes médico legales por presunto delito sexual contra niños, niñas y adolescentes",2015,2,15,31478,47.6523286104581,2,16114,12.4115675809855,13,15364,84.6133819317886
19803,52,52001,81,"Tasa de exámenes médico legales por presunto delito sexual contra niños, niñas y adolescentes",2015,3,28,40504,69.1289749160577,10,20469,48.854365137525,18,20035,89.8427751434989
19804,52,52001,81,"Tasa de exámenes médico legales por presunto delito sexual contra niños, niñas y adolescentes",2015,4,52,44828,115.998929240653,1,22305,4.48329970858552,51,22523,226.435199573769
19805,52,52001,121,Tasa de exámenes médico legales por presunto delito sexual cuando la víctima está entre 18 y 28 años,2015,5,33,83490,39.5256916996047,0,42462,0,33,41028,80.4328751096812
19806,52,52001,81,"Tasa de exámenes médico legales por presunto delito sexual contra niños, niñas y adolescentes",2015,1,2,6137,32.5892129705068,1,3135,31.8979266347687,1,3002,33.311125916056
19807,52,52022,81,"Tasa de exámenes médico legales por presunto delito sexual contra niños, niñas y adolescentes",2015,4,2,588,340.136054421769,0,293,0,2,295,677.966101694915
19808,52,52036,81,"Tasa de exámenes médico legales por presunto delito sexual contra niños, niñas y adolescentes",2015,3,1,681,146.842878120411,0,350,0,1,331,302.114803625378
19809,52,52079,81,"Tasa de exámenes médico legales por presunto delito sexual contra niños, niñas y adolescentes",2015,4,1,5569,17.9565451607111,0,2831,0,1,2738,36.5230094959825
19810,52,52083,81,"Tasa de exámenes médico legales por presunto delito sexual contra niños, niñas y adolescentes",2015,3,1,645,155.038759689922,0,326,0,1,319,313.479623824451
19811,52,52110,81,"Tasa de exámenes médico legales por presunto delito sexual contra niños, niñas y adolescentes",2015,3,2,2633,75.9589821496392,0,1319,0,2,1314,152.20700152207
19812,52,52110,81,"Tasa de exámenes médico legales por presunto delito sexual contra niños, niñas y adolescentes",2015,4,2,2679,74.6547219111609,0,1340,0,2,1339,149.365197908887
19813,52,52207,81,"Tasa de exámenes médico legales por presunto delito sexual contra niños, niñas y adolescentes",2015,4,1,978,102.249488752556,1,500,200,0,478,0
19814,52,52210,121,Tasa de exámenes médico legales por presunto delito sexual cuando la víctima está entre 18 y 28 años,2015,5,1,1289,77.5795190069822,0,680,0,1,609,164.203612479475
19815,52,52227,81,"Tasa de exámenes médico legales por presunto delito sexual contra niños, niñas y adolescentes",2015,3,1,4136,24.1779497098646,0,2075,0,1,2061,48.5201358563804
19816,52,52233,81,"Tasa de exámenes médico legales por presunto delito sexual contra niños, niñas y adolescentes",2015,4,2,1894,105.596620908131,0,979,0,2,915,218.579234972678
19817,52,52240,81,"Tasa de exámenes médico legales por presunto delito sexual contra niños, niñas y adolescentes",2015,3,1,1465,68.259385665529,0,724,0,1,741,134.952766531714
19818,52,52240,81,"Tasa de exámenes médico legales por presunto delito sexual contra niños, niñas y adolescentes",2015,4,2,1587,126.023944549464,0,791,0,2,796,251.256281407035
19819,52,52250,81,"Tasa de exámenes médico legales por presunto delito sexual contra niños, niñas y adolescentes",2015,3,1,5465,18.2982616651418,1,2737,36.5363536719035,0,2728,0
19820,52,52250,81,"Tasa de exámenes médico legales por presunto delito sexual contra niños, niñas y adolescentes",2015,4,1,5301,18.8643652141105,0,2674,0,1,2627,38.0662352493338
19821,52,52258,81,"Tasa de exámenes médico legales por presunto delito sexual contra niños, niñas y adolescentes",2015,3,1,1427,70.0770847932726,0,730,0,1,697,143.472022955524
19822,52,52258,81,"Tasa de exámenes médico legales por presunto delito sexual contra niños, niñas y adolescentes",2015,4,1,1609,62.1504039776258,0,828,0,1,781,128.040973111396
19823,52,52260,81,"Tasa de exámenes médico legales por presunto delito sexual contra niños, niñas y adolescentes",2015,2,1,1024,97.65625,0,520,0,1,504,198.412698412698
19824,52,52260,81,"Tasa de exámenes médico legales por presunto delito sexual contra niños, niñas y adolescentes",2015,3,2,1261,158.604282315623,0,643,0,2,618,323.624595469256
19825,52,52260,81,"Tasa de exámenes médico legales por presunto delito sexual contra niños, niñas y adolescentes",2015,4,2,1339,149.365197908887,0,681,0,2,658,303.951367781155
19826,52,52287,81,"Tasa de exámenes médico legales por presunto delito sexual contra niños, niñas y adolescentes",2015,2,1,558,179.21146953405,0,284,0,1,274,364.963503649635
19827,52,52317,81,"Tasa de exámenes médico legales por presunto delito sexual contra niños, niñas y adolescentes",2015,2,1,1063,94.0733772342427,0,541,0,1,522,191.570881226054
19828,52,52320,81,"Tasa de exámenes médico legales por presunto delito sexual contra niños, niñas y adolescentes",2015,4,3,1272,235.849056603774,0,660,0,3,612,490.196078431373
19829,52,52323,121,Tasa de exámenes médico legales por presunto delito sexual cuando la víctima está entre 18 y 28 años,2015,5,1,1026,97.4658869395711,0,504,0,1,522,191.570881226054
19830,52,52354,81,"Tasa de exámenes médico legales por presunto delito sexual contra niños, niñas y adolescentes",2015,2,1,526,190.114068441065,1,259,386.100386100386,0,267,0
19831,52,52356,81,"Tasa de exámenes médico legales por presunto delito sexual contra niños, niñas y adolescentes",2015,2,2,12053,16.5933792416826,0,6188,0,2,5865,34.1005967604433
19832,52,52356,81,"Tasa de exámenes médico legales por presunto delito sexual contra niños, niñas y adolescentes",2015,3,13,15286,85.0451393431898,3,7793,38.4960862312332,10,7493,133.457894034432
19833,52,52356,81,"Tasa de exámenes médico legales por presunto delito sexual contra niños, niñas y adolescentes",2015,4,24,15497,154.86868426147,0,7698,0,24,7799,307.731760482113
19834,52,52356,121,Tasa de exámenes médico legales por presunto delito sexual cuando la víctima está entre 18 y 28 años,2015,5,5,24946,20.0432935139902,0,12766,0,5,12180,41.0509031198686
19835,52,52385,81,"Tasa de exámenes médico legales por presunto delito sexual contra niños, niñas y adolescentes",2015,3,1,712,140.449438202247,0,357,0,1,355,281.69014084507
19836,52,52390,121,Tasa de exámenes médico legales por presunto delito sexual cuando la víctima está entre 18 y 28 años,2015,5,1,2638,37.9075056861259,0,1385,0,1,1253,79.8084596967279
19837,52,52399,81,"Tasa de exámenes médico legales por presunto delito sexual contra niños, niñas y adolescentes",2015,3,1,2574,38.8500388500388,0,1300,0,1,1274,78.4929356357928
19838,52,52399,81,"Tasa de exámenes médico legales por presunto delito sexual contra niños, niñas y adolescentes",2015,4,2,2758,72.5163161711385,1,1393,71.7875089734386,1,1365,73.2600732600733
19839,52,52405,81,"Tasa de exámenes médico legales por presunto delito sexual contra niños, niñas y adolescentes",2015,3,2,1988,100.603621730382,1,1012,98.8142292490118,1,976,102.459016393443
19840,52,52435,81,"Tasa de exámenes médico legales por presunto delito sexual contra niños, niñas y adolescentes",2015,3,1,1042,95.9692898272553,0,537,0,1,505,198.019801980198
19841,52,52435,81,"Tasa de exámenes médico legales por presunto delito sexual contra niños, niñas y adolescentes",2015,4,1,1020,98.0392156862745,0,534,0,1,486,205.761316872428
19842,52,52480,81,"Tasa de exámenes médico legales por presunto delito sexual contra niños, niñas y adolescentes",2015,4,1,502,199.203187250996,0,260,0,1,242,413.223140495868
19843,52,52540,81,"Tasa de exámenes médico legales por presunto delito sexual contra niños, niñas y adolescentes",2015,4,1,1979,50.5305709954523,0,1057,0,1,922,108.459869848156
19844,52,52573,81,"Tasa de exámenes médico legales por presunto delito sexual contra niños, niñas y adolescentes",2015,2,1,676,147.92899408284,0,343,0,1,333,300.3003003003
19845,52,52573,81,"Tasa de exámenes médico legales por presunto delito sexual contra niños, niñas y adolescentes",2015,4,3,826,363.19612590799,0,412,0,3,414,724.63768115942
19846,52,52612,81,"Tasa de exámenes médico legales por presunto delito sexual contra niños, niñas y adolescentes",2015,4,1,2600,38.4615384615385,0,1360,0,1,1240,80.6451612903226
19847,52,52678,81,"Tasa de exámenes médico legales por presunto delito sexual contra niños, niñas y adolescentes",2015,3,1,5400,18.5185185185185,0,2738,0,1,2662,37.5657400450789
19848,52,52687,81,"Tasa de exámenes médico legales por presunto delito sexual contra niños, niñas y adolescentes",2015,3,1,2081,48.0538202787122,1,1062,94.1619585687382,0,1019,0
19849,52,52693,81,"Tasa de exámenes médico legales por presunto delito sexual contra niños, niñas y adolescentes",2015,3,1,1710,58.4795321637427,1,903,110.741971207087,0,807,0
19850,52,52699,81,"Tasa de exámenes médico legales por presunto delito sexual contra niños, niñas y adolescentes",2015,3,2,3495,57.2246065808298,0,1776,0,2,1719,116.346713205352
19851,52,52699,121,Tasa de exámenes médico legales por presunto delito sexual cuando la víctima está entre 18 y 28 años,2015,5,1,5253,19.0367409099562,0,2755,0,1,2498,40.0320256204964
19852,52,52786,81,"Tasa de exámenes médico legales por presunto delito sexual contra niños, niñas y adolescentes",2015,3,2,1926,103.842159916926,0,985,0,2,941,212.539851222104
19853,52,52786,121,Tasa de exámenes médico legales por presunto delito sexual cuando la víctima está entre 18 y 28 años,2015,5,1,3999,25.0062515628907,0,2077,0,1,1922,52.0291363163372
19854,52,52788,81,"Tasa de exámenes médico legales por presunto delito sexual contra niños, niñas y adolescentes",2015,4,1,1046,95.6022944550669,0,532,0,1,514,194.552529182879
19855,52,52835,81,"Tasa de exámenes médico legales por presunto delito sexual contra niños, niñas y adolescentes",2015,2,1,24769,4.03730469538536,0,12670,0,1,12099,8.26514587982478
19856,52,52835,81,"Tasa de exámenes médico legales por presunto delito sexual contra niños, niñas y adolescentes",2015,3,5,28140,17.7683013503909,0,14311,0,5,13829,36.1559042591655
19857,52,52835,81,"Tasa de exámenes médico legales por presunto delito sexual contra niños, niñas y adolescentes",2015,4,6,25964,23.1089200431367,0,13103,0,6,12861,46.652670865407
19858,52,52835,121,Tasa de exámenes médico legales por presunto delito sexual cuando la víctima está entre 18 y 28 años,2015,5,7,39666,17.6473554177381,4,20097,19.9034681793302,3,19569,15.330369461904
19859,52,52838,81,"Tasa de exámenes médico legales por presunto delito sexual contra niños, niñas y adolescentes",2015,3,5,4132,121.006776379477,1,2109,47.4158368895211,4,2023,197.726149283243
19860,52,52838,81,"Tasa de exámenes médico legales por presunto delito sexual contra niños, niñas y adolescentes",2015,4,8,4381,182.606710796622,0,2243,0,8,2138,374.181478016838
19861,52,52838,121,Tasa de exámenes médico legales por presunto delito sexual cuando la víctima está entre 18 y 28 años,2015,5,1,7710,12.970168612192,0,3999,0,1,3711,26.9469145782808
19862,54,54001,81,"Tasa de exámenes médico legales por presunto delito sexual contra niños, niñas y adolescentes",2015,2,45,55931,80.4562764835243,16,28490,56.1600561600562,29,27441,105.681279836741
19863,54,54001,81,"Tasa de exámenes médico legales por presunto delito sexual contra niños, niñas y adolescentes",2015,3,68,69103,98.4038319609858,27,34947,77.2598506309555,41,34156,120.037475114182
19864,54,54001,81,"Tasa de exámenes médico legales por presunto delito sexual contra niños, niñas y adolescentes",2015,4,80,75265,106.29110476317,5,37928,13.1828728116431,75,37337,200.873128532019
19865,54,54001,121,Tasa de exámenes médico legales por presunto delito sexual cuando la víctima está entre 18 y 28 años,2015,5,14,129097,10.8445587426509,4,64972,6.15649818383304,10,64125,15.5945419103314
19866,54,54003,81,"Tasa de exámenes médico legales por presunto delito sexual contra niños, niñas y adolescentes",2015,4,1,4641,21.5470803706098,0,2325,0,1,2316,43.1778929188256
19867,54,54003,121,Tasa de exámenes médico legales por presunto delito sexual cuando la víctima está entre 18 y 28 años,2015,5,1,6539,15.2928582352042,0,3312,0,1,3227,30.9885342423303
19868,54,54051,81,"Tasa de exámenes médico legales por presunto delito sexual contra niños, niñas y adolescentes",2015,3,1,1011,98.9119683481701,0,531,0,1,480,208.333333333333
19869,54,54051,81,"Tasa de exámenes médico legales por presunto delito sexual contra niños, niñas y adolescentes",2015,4,2,1087,183.992640294388,0,584,0,2,503,397.614314115308
19870,54,54099,81,"Tasa de exámenes médico legales por presunto delito sexual contra niños, niñas y adolescentes",2015,4,1,831,120.336943441637,0,442,0,1,389,257.06940874036
19871,54,54109,81,"Tasa de exámenes médico legales por presunto delito sexual contra niños, niñas y adolescentes",2015,4,3,575,521.739130434783,0,300,0,3,275,1090.90909090909
19872,54,54125,81,"Tasa de exámenes médico legales por presunto delito sexual contra niños, niñas y adolescentes",2015,4,2,215,930.232558139535,0,109,0,2,106,1886.79245283019
19873,54,54128,81,"Tasa de exámenes médico legales por presunto delito sexual contra niños, niñas y adolescentes",2015,4,1,1351,74.019245003701,0,712,0,1,639,156.494522691706
19874,54,54172,81,"Tasa de exámenes médico legales por presunto delito sexual contra niños, niñas y adolescentes",2015,3,3,1814,165.380374862183,1,916,109.170305676856,2,898,222.71714922049
19875,54,54172,81,"Tasa de exámenes médico legales por presunto delito sexual contra niños, niñas y adolescentes",2015,4,11,1847,595.560368164591,1,940,106.382978723404,10,907,1102.53583241455
19876,54,54172,121,Tasa de exámenes médico legales por presunto delito sexual cuando la víctima está entre 18 y 28 años,2015,5,2,2976,67.2043010752688,0,1565,0,2,1411,141.743444365698
19877,54,54174,81,"Tasa de exámenes médico legales por presunto delito sexual contra niños, niñas y adolescentes",2015,4,1,1314,76.103500761035,0,690,0,1,624,160.25641025641
19878,54,54223,81,"Tasa de exámenes médico legales por presunto delito sexual contra niños, niñas y adolescentes",2015,3,1,1022,97.8473581213307,1,538,185.873605947955,0,484,0
19879,54,54223,81,"Tasa de exámenes médico legales por presunto delito sexual contra niños, niñas y adolescentes",2015,4,1,980,102.040816326531,0,520,0,1,460,217.391304347826
19880,54,54239,81,"Tasa de exámenes médico legales por presunto delito sexual contra niños, niñas y adolescentes",2015,4,1,404,247.524752475248,0,217,0,1,187,534.75935828877
19881,54,54245,81,"Tasa de exámenes médico legales por presunto delito sexual contra niños, niñas y adolescentes",2015,4,2,1824,109.649122807018,0,957,0,2,867,230.680507497117
19882,54,54250,81,"Tasa de exámenes médico legales por presunto delito sexual contra niños, niñas y adolescentes",2015,4,3,1595,188.087774294671,0,832,0,3,763,393.184796854522
19883,54,54261,81,"Tasa de exámenes médico legales por presunto delito sexual contra niños, niñas y adolescentes",2015,2,2,2425,82.4742268041237,0,1239,0,2,1186,168.634064080944
19884,54,54261,81,"Tasa de exámenes médico legales por presunto delito sexual contra niños, niñas y adolescentes",2015,3,2,2793,71.6075904045829,1,1440,69.4444444444444,1,1353,73.909830007391
19885,54,54261,81,"Tasa de exámenes médico legales por presunto delito sexual contra niños, niñas y adolescentes",2015,4,2,2862,69.8812019566736,0,1497,0,2,1365,146.520146520147
19886,54,54261,121,Tasa de exámenes médico legales por presunto delito sexual cuando la víctima está entre 18 y 28 años,2015,5,1,4675,21.3903743315508,0,2426,0,1,2249,44.4642063139173
19887,54,54377,81,"Tasa de exámenes médico legales por presunto delito sexual contra niños, niñas y adolescentes",2015,3,1,700,142.857142857143,0,370,0,1,330,303.030303030303
19888,54,54377,81,"Tasa de exámenes médico legales por presunto delito sexual contra niños, niñas y adolescentes",2015,4,3,758,395.778364116095,0,410,0,3,348,862.068965517241
19889,54,54385,81,"Tasa de exámenes médico legales por presunto delito sexual contra niños, niñas y adolescentes",2015,3,3,1731,173.310225303293,0,890,0,3,841,356.718192627824
19890,54,54385,81,"Tasa de exámenes médico legales por presunto delito sexual contra niños, niñas y adolescentes",2015,4,5,1693,295.333727111636,0,879,0,5,814,614.250614250614
19891,54,54398,81,"Tasa de exámenes médico legales por presunto delito sexual contra niños, niñas y adolescentes",2015,3,2,948,210.970464135021,0,473,0,2,475,421.052631578947
19892,54,54405,81,"Tasa de exámenes médico legales por presunto delito sexual contra niños, niñas y adolescentes",2015,2,3,6311,47.5360481698621,0,3213,0,3,3098,96.8366688185926
19893,54,54405,81,"Tasa de exámenes médico legales por presunto delito sexual contra niños, niñas y adolescentes",2015,3,10,7812,128.008192524322,3,3914,76.6479305058763,7,3898,179.579271421242
19894,54,54405,81,"Tasa de exámenes médico legales por presunto delito sexual contra niños, niñas y adolescentes",2015,4,4,8437,47.4102169017423,0,4249,0,4,4188,95.5109837631328
19895,54,54405,121,Tasa de exámenes médico legales por presunto delito sexual cuando la víctima está entre 18 y 28 años,2015,5,2,14799,13.5144266504494,0,7409,0,2,7390,27.063599458728
19896,54,54498,81,"Tasa de exámenes médico legales por presunto delito sexual contra niños, niñas y adolescentes",2015,2,4,8813,45.3874957449223,0,4455,0,4,4358,91.7852225791648
19897,54,54498,81,"Tasa de exámenes médico legales por presunto delito sexual contra niños, niñas y adolescentes",2015,3,7,11261,62.1614421454578,2,5731,34.8979235735474,5,5530,90.4159132007233
19898,54,54498,81,"Tasa de exámenes médico legales por presunto delito sexual contra niños, niñas y adolescentes",2015,4,16,11031,145.045780074336,1,5758,17.3671413685307,15,5273,284.468044756306
19899,54,54498,121,Tasa de exámenes médico legales por presunto delito sexual cuando la víctima está entre 18 y 28 años,2015,5,2,15990,12.5078173858662,1,8180,12.2249388753056,1,7810,12.8040973111396
19900,54,54518,81,"Tasa de exámenes médico legales por presunto delito sexual contra niños, niñas y adolescentes",2015,2,1,4101,24.3842965130456,0,2079,0,1,2022,49.4559841740851
19901,54,54518,81,"Tasa de exámenes médico legales por presunto delito sexual contra niños, niñas y adolescentes",2015,3,5,5324,93.9143501126972,0,2698,0,5,2626,190.40365575019
19902,54,54518,81,"Tasa de exámenes médico legales por presunto delito sexual contra niños, niñas y adolescentes",2015,4,6,7559,79.3755787802619,0,3761,0,6,3798,157.977883096366
19903,54,54518,121,Tasa de exámenes médico legales por presunto delito sexual cuando la víctima está entre 18 y 28 años,2015,5,1,14512,6.89084895259096,0,7443,0,1,7069,14.1462724572075
19904,54,54553,81,"Tasa de exámenes médico legales por presunto delito sexual contra niños, niñas y adolescentes",2015,2,1,947,105.596620908131,1,486,205.761316872428,0,461,0
19905,54,54553,81,"Tasa de exámenes médico legales por presunto delito sexual contra niños, niñas y adolescentes",2015,3,1,1181,84.6740050804403,0,608,0,1,573,174.520069808028
19906,54,54660,81,"Tasa de exámenes médico legales por presunto delito sexual contra niños, niñas y adolescentes",2015,2,1,921,108.5776330076,0,470,0,1,451,221.729490022173
19907,54,54660,81,"Tasa de exámenes médico legales por presunto delito sexual contra niños, niñas y adolescentes",2015,4,2,1138,175.746924428822,0,591,0,2,547,365.63071297989
19908,54,54670,81,"Tasa de exámenes médico legales por presunto delito sexual contra niños, niñas y adolescentes",2015,4,1,1900,52.6315789473684,1,1005,99.502487562189,0,895,0
19909,54,54673,81,"Tasa de exámenes médico legales por presunto delito sexual contra niños, niñas y adolescentes",2015,3,1,660,151.515151515152,0,336,0,1,324,308.641975308642
19910,54,54673,81,"Tasa de exámenes médico legales por presunto delito sexual contra niños, niñas y adolescentes",2015,4,1,638,156.739811912226,0,324,0,1,314,318.471337579618
19911,54,54673,121,Tasa de exámenes médico legales por presunto delito sexual cuando la víctima está entre 18 y 28 años,2015,5,1,996,100.401606425703,0,488,0,1,508,196.850393700787
19912,54,54720,81,"Tasa de exámenes médico legales por presunto delito sexual contra niños, niñas y adolescentes",2015,2,2,2751,72.7008360596147,0,1420,0,2,1331,150.262960180316
19913,54,54720,81,"Tasa de exámenes médico legales por presunto delito sexual contra niños, niñas y adolescentes",2015,3,1,3081,32.4569944823109,0,1621,0,1,1460,68.4931506849315
19914,54,54743,81,"Tasa de exámenes médico legales por presunto delito sexual contra niños, niñas y adolescentes",2015,4,1,561,178.25311942959,0,295,0,1,266,375.93984962406
19915,54,54800,81,"Tasa de exámenes médico legales por presunto delito sexual contra niños, niñas y adolescentes",2015,2,1,2850,35.0877192982456,0,1450,0,1,1400,71.4285714285714
19916,54,54810,81,"Tasa de exámenes médico legales por presunto delito sexual contra niños, niñas y adolescentes",2015,2,6,4646,129.14334911752,1,2387,41.8935902806871,5,2259,221.336874723329
19917,54,54810,81,"Tasa de exámenes médico legales por presunto delito sexual contra niños, niñas y adolescentes",2015,3,14,5188,269.853508095605,4,2708,147.710487444609,10,2480,403.225806451613
19918,54,54810,81,"Tasa de exámenes médico legales por presunto delito sexual contra niños, niñas y adolescentes",2015,4,15,4976,301.446945337621,2,2634,75.9301442672741,13,2342,555.081127241674
19919,54,54810,121,Tasa de exámenes médico legales por presunto delito sexual cuando la víctima está entre 18 y 28 años,2015,5,1,7097,14.0904607580668,0,3743,0,1,3354,29.8151460942159
19920,54,54820,81,"Tasa de exámenes médico legales por presunto delito sexual contra niños, niñas y adolescentes",2015,3,3,1966,152.594099694812,0,995,0,3,971,308.959835221421
19921,54,54820,81,"Tasa de exámenes médico legales por presunto delito sexual contra niños, niñas y adolescentes",2015,4,2,2032,98.4251968503937,1,1033,96.8054211035818,1,999,100.1001001001
19922,54,54871,81,"Tasa de exámenes médico legales por presunto delito sexual contra niños, niñas y adolescentes",2015,3,1,713,140.252454417952,0,360,0,1,353,283.28611898017
19923,54,54871,81,"Tasa de exámenes médico legales por presunto delito sexual contra niños, niñas y adolescentes",2015,4,1,693,144.300144300144,0,359,0,1,334,299.40119760479
19924,54,54874,81,"Tasa de exámenes médico legales por presunto delito sexual contra niños, niñas y adolescentes",2015,2,2,7973,25.0846607299636,0,4094,0,2,3879,51.559680329982
19925,54,54874,81,"Tasa de exámenes médico legales por presunto delito sexual contra niños, niñas y adolescentes",2015,3,3,9708,30.902348578492,0,4959,0,3,4749,63.1711939355654
19926,54,54874,81,"Tasa de exámenes médico legales por presunto delito sexual contra niños, niñas y adolescentes",2015,4,9,10408,86.4719446579554,1,5320,18.796992481203,8,5088,157.232704402516
19927,54,54874,121,Tasa de exámenes médico legales por presunto delito sexual cuando la víctima está entre 18 y 28 años,2015,5,2,17723,11.2847712012639,0,9105,0,2,8618,23.2072406590856
19928,63,63001,81,"Tasa de exámenes médico legales por presunto delito sexual contra niños, niñas y adolescentes",2015,2,53,22759,232.874906630344,15,11617,129.121115606439,38,11142,341.051875785317
19929,63,63001,81,"Tasa de exámenes médico legales por presunto delito sexual contra niños, niñas y adolescentes",2015,3,57,27292,208.85241096292,13,13849,93.8695934724529,44,13443,327.307892583501
19930,63,63001,81,"Tasa de exámenes médico legales por presunto delito sexual contra niños, niñas y adolescentes",2015,4,81,28078,288.482085618634,12,14245,84.2400842400842,69,13833,498.807200173498
19931,63,63001,121,Tasa de exámenes médico legales por presunto delito sexual cuando la víctima está entre 18 y 28 años,2015,5,19,53905,35.2471941378351,2,27171,7.36078907658901,17,26734,63.5894366724022
19932,63,63001,81,"Tasa de exámenes médico legales por presunto delito sexual contra niños, niñas y adolescentes",2015,1,1,4606,21.7108119843682,0,2365,0,1,2241,44.6229361892012
19933,63,63111,81,"Tasa de exámenes médico legales por presunto delito sexual contra niños, niñas y adolescentes",2015,4,1,281,355.871886120996,0,145,0,1,136,735.294117647059
19934,63,63130,81,"Tasa de exámenes médico legales por presunto delito sexual contra niños, niñas y adolescentes",2015,2,6,6454,92.965602726991,2,3329,60.0781015319916,4,3125,128
19935,63,63130,81,"Tasa de exámenes médico legales por presunto delito sexual contra niños, niñas y adolescentes",2015,3,17,7657,222.019067519916,3,3955,75.8533501896334,14,3702,378.17396002161
19936,63,63130,81,"Tasa de exámenes médico legales por presunto delito sexual contra niños, niñas y adolescentes",2015,4,20,7680,260.416666666667,2,3963,50.4668180671209,18,3717,484.261501210654
19937,63,63130,121,Tasa de exámenes médico legales por presunto delito sexual cuando la víctima está entre 18 y 28 años,2015,5,5,14253,35.0803339647793,0,7331,0,5,6922,72.2334585379948
19938,63,63190,81,"Tasa de exámenes médico legales por presunto delito sexual contra niños, niñas y adolescentes",2015,2,2,2378,84.1042893187552,2,1215,164.609053497942,0,1163,0
19939,63,63190,81,"Tasa de exámenes médico legales por presunto delito sexual contra niños, niñas y adolescentes",2015,3,7,2785,251.346499102334,1,1393,71.7875089734386,6,1392,431.034482758621
19940,63,63190,81,"Tasa de exámenes médico legales por presunto delito sexual contra niños, niñas y adolescentes",2015,4,5,2845,175.746924428822,0,1414,0,5,1431,349.406009783368
19941,63,63190,121,Tasa de exámenes médico legales por presunto delito sexual cuando la víctima está entre 18 y 28 años,2015,5,4,5396,74.1289844329133,0,2733,0,4,2663,150.206533984228
19942,63,63212,81,"Tasa de exámenes médico legales por presunto delito sexual contra niños, niñas y adolescentes",2015,4,1,525,190.47619047619,0,269,0,1,256,390625
19943,63,63212,121,Tasa de exámenes médico legales por presunto delito sexual cuando la víctima está entre 18 y 28 años,2015,5,3,979,306.435137895812,0,499,0,3,480,625
19944,63,63272,81,"Tasa de exámenes médico legales por presunto delito sexual contra niños, niñas y adolescentes",2015,2,4,1176,340.136054421769,2,601,332.778702163062,2,575,347.826086956522
19945,63,63272,81,"Tasa de exámenes médico legales por presunto delito sexual contra niños, niñas y adolescentes",2015,3,3,1328,225.903614457831,1,681,146.842878120411,2,647,309.119010819165
19946,63,63272,81,"Tasa de exámenes médico legales por presunto delito sexual contra niños, niñas y adolescentes",2015,4,6,1412,424.929178470255,0,727,0,6,685,875.912408759124
19947,63,63302,81,"Tasa de exámenes médico legales por presunto delito sexual contra niños, niñas y adolescentes",2015,3,2,774,258.397932816537,1,397,251.889168765743,1,377,265.25198938992
19948,63,63302,81,"Tasa de exámenes médico legales por presunto delito sexual contra niños, niñas y adolescentes",2015,4,2,784,255.102040816327,1,402,248.756218905473,1,382,261.780104712042
19949,63,63302,121,Tasa de exámenes médico legales por presunto delito sexual cuando la víctima está entre 18 y 28 años,2015,5,1,1462,68.3994528043776,0,744,0,1,718,139.275766016713
19950,63,63401,81,"Tasa de exámenes médico legales por presunto delito sexual contra niños, niñas y adolescentes",2015,2,5,4029,124.100273020601,2,2074,96.4320154291225,3,1955,153.452685421995
19951,63,63401,81,"Tasa de exámenes médico legales por presunto delito sexual contra niños, niñas y adolescentes",2015,3,6,4693,127.849989345834,0,2440,0,6,2253,266.311584553928
19952,63,63401,81,"Tasa de exámenes médico legales por presunto delito sexual contra niños, niñas y adolescentes",2015,4,11,4804,228.975853455454,0,2460,0,11,2344,469.283276450512
19953,63,63401,121,Tasa de exámenes médico legales por presunto delito sexual cuando la víctima está entre 18 y 28 años,2015,5,1,7942,12.591286829514,0,3940,0,1,4002,24.9875062468766
19954,63,63470,81,"Tasa de exámenes médico legales por presunto delito sexual contra niños, niñas y adolescentes",2015,2,13,3575,363.636363636364,3,1834,163.576881134133,10,1741,574.382538770821
19955,63,63470,81,"Tasa de exámenes médico legales por presunto delito sexual contra niños, niñas y adolescentes",2015,3,9,4200,214.285714285714,4,2172,184.162062615101,5,2028,246.5483234714
19956,63,63470,81,"Tasa de exámenes médico legales por presunto delito sexual contra niños, niñas y adolescentes",2015,4,11,4287,256.589689759739,2,2257,88.6132033673017,9,2030,443.349753694581
19957,63,63470,121,Tasa de exámenes médico legales por presunto delito sexual cuando la víctima está entre 18 y 28 años,2015,5,3,7928,37.8405650857719,0,4190,0,3,3738,80.2568218298555
19958,63,63548,81,"Tasa de exámenes médico legales por presunto delito sexual contra niños, niñas y adolescentes",2015,2,2,511,391.389432485323,1,262,381.679389312977,1,249,401.606425702811
19959,63,63548,81,"Tasa de exámenes médico legales por presunto delito sexual contra niños, niñas y adolescentes",2015,4,3,605,495.867768595041,1,311,321.543408360129,2,294,680.272108843537
19960,63,63594,81,"Tasa de exámenes médico legales por presunto delito sexual contra niños, niñas y adolescentes",2015,2,3,2919,102.774922918808,0,1500,0,3,1419,211.416490486258
19961,63,63594,81,"Tasa de exámenes médico legales por presunto delito sexual contra niños, niñas y adolescentes",2015,4,14,3438,407.213496218732,2,1782,112.233445566779,12,1656,724.63768115942
19962,63,63594,121,Tasa de exámenes médico legales por presunto delito sexual cuando la víctima está entre 18 y 28 años,2015,5,1,6646,15.0466445982546,0,3393,0,1,3253,30.7408545957578
19963,63,63690,81,"Tasa de exámenes médico legales por presunto delito sexual contra niños, niñas y adolescentes",2015,3,2,741,269.905533063428,0,386,0,2,355,563.380281690141
19964,63,63690,81,"Tasa de exámenes médico legales por presunto delito sexual contra niños, niñas y adolescentes",2015,4,1,720,138.888888888889,0,373,0,1,347,288.184438040346
19965,63,63690,121,Tasa de exámenes médico legales por presunto delito sexual cuando la víctima está entre 18 y 28 años,2015,5,3,1265,237.154150197628,0,655,0,3,610,491.803278688525
19966,66,66001,81,"Tasa de exámenes médico legales por presunto delito sexual contra niños, niñas y adolescentes",2015,2,59,34124,172.898839526433,12,17476,68.6655985351339,47,16648,282.316194137434
19967,66,66001,81,"Tasa de exámenes médico legales por presunto delito sexual contra niños, niñas y adolescentes",2015,3,74,41405,178.722376524574,13,21191,61.346798169034,61,20214,301.771049767488
19968,66,66001,81,"Tasa de exámenes médico legales por presunto delito sexual contra niños, niñas y adolescentes",2015,4,109,43647,249.730794785438,11,22271,49.3915854698936,98,21376,458.458083832335
19969,66,66001,121,Tasa de exámenes médico legales por presunto delito sexual cuando la víctima está entre 18 y 28 años,2015,5,19,84998,22.3534671404033,2,43159,4.63402766514516,17,41839,40.6319462702263
19970,66,66045,81,"Tasa de exámenes médico legales por presunto delito sexual contra niños, niñas y adolescentes",2015,2,1,1826,54.7645125958379,0,935,0,1,891,112.233445566779
19971,66,66045,81,"Tasa de exámenes médico legales por presunto delito sexual contra niños, niñas y adolescentes",2015,3,2,2168,92.2509225092251,1,1117,89.5255147717099,1,1051,95.1474785918173
19972,66,66045,81,"Tasa de exámenes médico legales por presunto delito sexual contra niños, niñas y adolescentes",2015,4,4,2026,197.433366238894,0,1055,0,4,971,411.946446961895
19973,66,66045,121,Tasa de exámenes médico legales por presunto delito sexual cuando la víctima está entre 18 y 28 años,2015,5,1,3376,29.6208530805687,0,1744,0,1,1632,61.2745098039216
19974,66,66075,81,"Tasa de exámenes médico legales por presunto delito sexual contra niños, niñas y adolescentes",2015,3,1,666,150.15015015015,0,342,0,1,324,308.641975308642
19975,66,66075,81,"Tasa de exámenes médico legales por presunto delito sexual contra niños, niñas y adolescentes",2015,4,2,654,305.810397553517,0,337,0,2,317,630.914826498423
19976,66,66088,81,"Tasa de exámenes médico legales por presunto delito sexual contra niños, niñas y adolescentes",2015,2,3,2575,116.504854368932,0,1326,0,3,1249,240.192153722978
19977,66,66088,81,"Tasa de exámenes médico legales por presunto delito sexual contra niños, niñas y adolescentes",2015,3,7,3034,230.71852340145,1,1548,64.5994832041344,6,1486,403.768506056528
19978,66,66088,81,"Tasa de exámenes médico legales por presunto delito sexual contra niños, niñas y adolescentes",2015,4,6,3031,197.954470471791,2,1558,128.369704749679,4,1473,271.554650373388
19979,66,66088,121,Tasa de exámenes médico legales por presunto delito sexual cuando la víctima está entre 18 y 28 años,2015,5,1,5066,19.739439399921,0,2661,0,1,2405,41.5800415800416
19980,66,66170,81,"Tasa de exámenes médico legales por presunto delito sexual contra niños, niñas y adolescentes",2015,2,22,15160,145.118733509235,5,7782,64.2508352608584,17,7378,230.414746543779
19981,66,66170,81,"Tasa de exámenes médico legales por presunto delito sexual contra niños, niñas y adolescentes",2015,3,20,18497,108.125641995999,2,9458,21.1461196870374,18,9039,199.137072685032
19982,66,66170,81,"Tasa de exámenes médico legales por presunto delito sexual contra niños, niñas y adolescentes",2015,4,26,19737,131.732279475098,1,10017,9.98302885095338,25,9720,257.201646090535
19983,66,66170,121,Tasa de exámenes médico legales por presunto delito sexual cuando la víctima está entre 18 y 28 años,2015,5,8,38077,21.0100585655383,0,19365,0,8,18712,42.7533133817871
19984,66,66318,81,"Tasa de exámenes médico legales por presunto delito sexual contra niños, niñas y adolescentes",2015,3,1,1561,64.0614990390775,0,778,0,1,783,127.713920817369
19985,66,66318,81,"Tasa de exámenes médico legales por presunto delito sexual contra niños, niñas y adolescentes",2015,4,1,1531,65.3167864141084,0,760,0,1,771,129.70168612192
19986,66,66318,121,Tasa de exámenes médico legales por presunto delito sexual cuando la víctima está entre 18 y 28 años,2015,5,1,2545,39.2927308447937,0,1292,0,1,1253,79.8084596967279
19987,66,66383,81,"Tasa de exámenes médico legales por presunto delito sexual contra niños, niñas y adolescentes",2015,2,1,791,126.422250316056,0,406,0,1,385,259.74025974026
19988,66,66383,81,"Tasa de exámenes médico legales por presunto delito sexual contra niños, niñas y adolescentes",2015,4,2,915,218.579234972678,0,478,0,2,437,457.66590389016
19989,66,66400,81,"Tasa de exámenes médico legales por presunto delito sexual contra niños, niñas y adolescentes",2015,2,10,2781,359.582883854728,1,1410,70.9219858156028,9,1371,656.455142231947
19990,66,66400,81,"Tasa de exámenes médico legales por presunto delito sexual contra niños, niñas y adolescentes",2015,3,10,3270,305.810397553517,1,1654,60.459492140266,9,1616,556.930693069307
19991,66,66400,81,"Tasa de exámenes médico legales por presunto delito sexual contra niños, niñas y adolescentes",2015,4,13,3259,398.895366676895,1,1595,62.6959247648903,12,1664,721.153846153846
19992,66,66440,81,"Tasa de exámenes médico legales por presunto delito sexual contra niños, niñas y adolescentes",2015,2,2,1878,106.496272630458,1,963,103.842159916926,1,915,109.289617486339
19993,66,66440,81,"Tasa de exámenes médico legales por presunto delito sexual contra niños, niñas y adolescentes",2015,3,1,2303,43.4216239687364,1,1177,84.9617672047579,0,1126,0
19994,66,66440,81,"Tasa de exámenes médico legales por presunto delito sexual contra niños, niñas y adolescentes",2015,4,6,2403,249.687890137328,0,1224,0,6,1179,508.905852417303
19995,66,66456,81,"Tasa de exámenes médico legales por presunto delito sexual contra niños, niñas y adolescentes",2015,2,1,2168,46.1254612546125,1,1103,90.6618313689937,0,1065,0
19996,66,66456,81,"Tasa de exámenes médico legales por presunto delito sexual contra niños, niñas y adolescentes",2015,3,1,2340,42.7350427350427,0,1169,0,1,1171,85.397096498719
19997,66,66456,81,"Tasa de exámenes médico legales por presunto delito sexual contra niños, niñas y adolescentes",2015,4,5,2136,234.082397003745,0,1094,0,5,1042,479.846449136276
19998,66,66456,121,Tasa de exámenes médico legales por presunto delito sexual cuando la víctima está entre 18 y 28 años,2015,5,1,3147,31.7762948840165,1,1681,59.4883997620464,0,1466,0
19999,66,66572,81,"Tasa de exámenes médico legales por presunto delito sexual contra niños, niñas y adolescentes",2015,4,2,1754,114.025085518814,0,898,0,2,856,233.644859813084
20000,66,66594,81,"Tasa de exámenes médico legales por presunto delito sexual contra niños, niñas y adolescentes",2015,4,4,3730,107.238605898123,1,1884,53.0785562632696,3,1846,162.513542795233
20001,66,66594,121,Tasa de exámenes médico legales por presunto delito sexual cuando la víctima está entre 18 y 28 años,2015,5,1,6057,16.5098233448902,0,3098,0,1,2959,33.7952010814464
20002,66,66682,81,"Tasa de exámenes médico legales por presunto delito sexual contra niños, niñas y adolescentes",2015,2,1,5856,17.0765027322404,0,3006,0,1,2850,35.0877192982456
20003,66,66682,81,"Tasa de exámenes médico legales por presunto delito sexual contra niños, niñas y adolescentes",2015,3,8,7191,111.250173828397,2,3683,54.3035568829758,6,3508,171.037628278221
20004,66,66682,81,"Tasa de exámenes médico legales por presunto delito sexual contra niños, niñas y adolescentes",2015,4,7,7456,93.8841201716738,0,3796,0,7,3660,191.256830601093
20005,66,66682,121,Tasa de exámenes médico legales por presunto delito sexual cuando la víctima está entre 18 y 28 años,2015,5,2,13399,14.9264870512725,0,6904,0,2,6495,30.7929176289453
20006,66,66687,81,"Tasa de exámenes médico legales por presunto delito sexual contra niños, niñas y adolescentes",2015,2,2,1449,138.026224982747,0,737,0,2,712,280.898876404494
20007,66,66687,81,"Tasa de exámenes médico legales por presunto delito sexual contra niños, niñas y adolescentes",2015,3,5,1673,298.864315600717,2,858,233.100233100233,3,815,368.098159509202
20008,66,66687,81,"Tasa de exámenes médico legales por presunto delito sexual contra niños, niñas y adolescentes",2015,4,4,1653,241.984271022384,0,855,0,4,798,501.25313283208
20009,66,66687,121,Tasa de exámenes médico legales por presunto delito sexual cuando la víctima está entre 18 y 28 años,2015,5,1,2781,35.9582883854728,0,1442,0,1,1339,74.6825989544436
20010,68,68001,81,"Tasa de exámenes médico legales por presunto delito sexual contra niños, niñas y adolescentes",2015,2,72,35384,203.481799683473,16,18079,88.5004701587477,56,17305,323.605894250217
20011,68,68001,81,"Tasa de exámenes médico legales por presunto delito sexual contra niños, niñas y adolescentes",2015,3,109,46013,236.889574685415,15,23514,63.79178361827,94,22499,417.796346504289
20012,68,68001,81,"Tasa de exámenes médico legales por presunto delito sexual contra niños, niñas y adolescentes",2015,4,147,50921,288.682468922448,22,25967,84.7229175491971,125,24954,500.921695920494
20013,68,68001,121,Tasa de exámenes médico legales por presunto delito sexual cuando la víctima está entre 18 y 28 años,2015,5,40,98581,40.5757701788377,4,50239,7.96194191763371,36,48342,74.4694054859129
20014,68,68001,81,"Tasa de exámenes médico legales por presunto delito sexual contra niños, niñas y adolescentes",2015,1,1,6804,14.6972369194591,0,3498,0,1,3306,30.2480338777979
20015,68,68020,81,"Tasa de exámenes médico legales por presunto delito sexual contra niños, niñas y adolescentes",2015,4,1,608,164.473684210526,0,324,0,1,284,352.112676056338
20016,68,68051,81,"Tasa de exámenes médico legales por presunto delito sexual contra niños, niñas y adolescentes",2015,4,2,890,224.719101123596,0,499,0,2,391,511.50895140665
20017,68,68077,81,"Tasa de exámenes médico legales por presunto delito sexual contra niños, niñas y adolescentes",2015,2,4,2505,159.680638722555,1,1295,77.2200772200772,3,1210,247.933884297521
20018,68,68077,81,"Tasa de exámenes médico legales por presunto delito sexual contra niños, niñas y adolescentes",2015,3,7,2975,235.294117647059,1,1543,64.8088139987038,6,1432,418.994413407821
20019,68,68077,81,"Tasa de exámenes médico legales por presunto delito sexual contra niños, niñas y adolescentes",2015,4,10,2963,337.495781302734,1,1552,64.4329896907217,9,1411,637.845499645641
20020,68,68077,121,Tasa de exámenes médico legales por presunto delito sexual cuando la víctima está entre 18 y 28 años,2015,5,1,5273,18.964536317087,0,2668,0,1,2605,38.3877159309021
20021,68,68079,81,"Tasa de exámenes médico legales por presunto delito sexual contra niños, niñas y adolescentes",2015,3,4,756,529.100529100529,1,385,259.74025974026,3,371,808.625336927224
20022,68,68081,81,"Tasa de exámenes médico legales por presunto delito sexual contra niños, niñas y adolescentes",2015,2,45,15699,286.642461303268,13,8055,161.39044072005,32,7644,418.628990057562
20023,68,68081,81,"Tasa de exámenes médico legales por presunto delito sexual contra niños, niñas y adolescentes",2015,3,56,19141,292.565696672065,10,9848,101.543460601137,46,9293,494.996233724309
20024,68,68081,81,"Tasa de exámenes médico legales por presunto delito sexual contra niños, niñas y adolescentes",2015,4,87,19983,435.370064554872,8,10284,77.7907429015947,79,9699,814.516960511393
20025,68,68081,121,Tasa de exámenes médico legales por presunto delito sexual cuando la víctima está entre 18 y 28 años,2015,5,7,36837,19.0026332220322,0,19149,0,7,17688,39.5748530076888
20026,68,68092,81,"Tasa de exámenes médico legales por presunto delito sexual contra niños, niñas y adolescentes",2015,3,1,605,165.289256198347,0,310,0,1,295,338.983050847458
20027,68,68101,81,"Tasa de exámenes médico legales por presunto delito sexual contra niños, niñas y adolescentes",2015,4,2,1370,145.985401459854,0,684,0,2,686,291.545189504373
20028,68,68147,81,"Tasa de exámenes médico legales por presunto delito sexual contra niños, niñas y adolescentes",2015,2,1,476,210.084033613445,0,243,0,1,233,429.184549356223
20029,68,68147,81,"Tasa de exámenes médico legales por presunto delito sexual contra niños, niñas y adolescentes",2015,4,1,548,182.481751824818,0,275,0,1,273,366.300366300366
20030,68,68147,121,Tasa de exámenes médico legales por presunto delito sexual cuando la víctima está entre 18 y 28 años,2015,5,2,1031,193.986420950533,0,526,0,2,505,396.039603960396
20031,68,68152,81,"Tasa de exámenes médico legales por presunto delito sexual contra niños, niñas y adolescentes",2015,3,1,475,210.526315789474,0,244,0,1,231,432.900432900433
20032,68,68152,81,"Tasa de exámenes médico legales por presunto delito sexual contra niños, niñas y adolescentes",2015,4,4,484,826.446280991736,0,242,0,4,242,1652.89256198347
20033,68,68162,81,"Tasa de exámenes médico legales por presunto delito sexual contra niños, niñas y adolescentes",2015,2,1,530,188.679245283019,0,270,0,1,260,384.615384615385
20034,68,68162,81,"Tasa de exámenes médico legales por presunto delito sexual contra niños, niñas y adolescentes",2015,3,3,632,474.683544303797,1,318,314.465408805031,2,314,636.942675159236
20035,68,68162,81,"Tasa de exámenes médico legales por presunto delito sexual contra niños, niñas y adolescentes",2015,4,1,644,155.27950310559,0,326,0,1,318,314.465408805031
20036,68,68167,81,"Tasa de exámenes médico legales por presunto delito sexual contra niños, niñas y adolescentes",2015,2,1,940,106.382978723404,1,483,207.03933747412,0,457,0
20037,68,68167,81,"Tasa de exámenes médico legales por presunto delito sexual contra niños, niñas y adolescentes",2015,3,2,1132,176.678445229682,1,582,171.821305841924,1,550,181.818181818182
20038,68,68167,81,"Tasa de exámenes médico legales por presunto delito sexual contra niños, niñas y adolescentes",2015,4,2,1129,177.147918511957,0,582,0,2,547,365.63071297989
20039,68,68169,81,"Tasa de exámenes médico legales por presunto delito sexual contra niños, niñas y adolescentes",2015,3,1,253,395.256916996047,1,128,781.25,0,125,0
20040,68,68169,81,"Tasa de exámenes médico legales por presunto delito sexual contra niños, niñas y adolescentes",2015,4,8,240,3333.33333333333,8,119,6722.68907563025,0,121,0
20041,68,68176,81,"Tasa de exámenes médico legales por presunto delito sexual contra niños, niñas y adolescentes",2015,2,1,237,421.940928270042,0,121,0,1,116,862.068965517241
20042,68,68176,81,"Tasa de exámenes médico legales por presunto delito sexual contra niños, niñas y adolescentes",2015,3,2,253,790.513833992095,2,127,1574.8031496063,0,126,0
20043,68,68176,81,"Tasa de exámenes médico legales por presunto delito sexual contra niños, niñas y adolescentes",2015,4,2,272,735.294117647059,1,131,763.358778625954,1,141,709.219858156028
20044,68,68179,81,"Tasa de exámenes médico legales por presunto delito sexual contra niños, niñas y adolescentes",2015,2,1,446,224.215246636771,0,230,0,1,216,462.962962962963
20045,68,68179,81,"Tasa de exámenes médico legales por presunto delito sexual contra niños, niñas y adolescentes",2015,3,1,495,202.020202020202,1,260,384.615384615385,0,235,0
20046,68,68190,81,"Tasa de exámenes médico legales por presunto delito sexual contra niños, niñas y adolescentes",2015,2,3,4828,62.1375310687655,1,2493,40.1123144805455,2,2335,85.6531049250535
20047,68,68190,81,"Tasa de exámenes médico legales por presunto delito sexual contra niños, niñas y adolescentes",2015,3,3,5486,54.6846518410499,0,2831,0,3,2655,112.994350282486
20048,68,68190,81,"Tasa de exámenes médico legales por presunto delito sexual contra niños, niñas y adolescentes",2015,4,8,5328,150.15015015015,3,2736,109.649122807018,5,2592,192.901234567901
20049,68,68190,121,Tasa de exámenes médico legales por presunto delito sexual cuando la víctima está entre 18 y 28 años,2015,5,2,8556,23.3754090696587,1,4321,23.1427910205971,1,4235,23.6127508854782
20050,68,68190,81,"Tasa de exámenes médico legales por presunto delito sexual contra niños, niñas y adolescentes",2015,1,1,1006,99.403578528827,0,520,0,1,486,205.761316872428
20051,68,68209,81,"Tasa de exámenes médico legales por presunto delito sexual contra niños, niñas y adolescentes",2015,4,1,268,373.134328358209,0,132,0,1,136,735.294117647059
20052,68,68211,81,"Tasa de exámenes médico legales por presunto delito sexual contra niños, niñas y adolescentes",2015,3,1,426,234.741784037559,0,220,0,1,206,485.436893203883
20053,68,68211,81,"Tasa de exámenes médico legales por presunto delito sexual contra niños, niñas y adolescentes",2015,4,2,444,450.45045045045,0,227,0,2,217,921.658986175115
20054,68,68217,81,"Tasa de exámenes médico legales por presunto delito sexual contra niños, niñas y adolescentes",2015,4,1,825,121.212121212121,0,424,0,1,401,249.376558603491
20055,68,68229,81,"Tasa de exámenes médico legales por presunto delito sexual contra niños, niñas y adolescentes",2015,4,5,1214,411.861614497529,0,609,0,5,605,826.446280991736
20056,68,68235,81,"Tasa de exámenes médico legales por presunto delito sexual contra niños, niñas y adolescentes",2015,2,2,1867,107.123727905731,0,959,0,2,908,220.264317180617
20057,68,68235,81,"Tasa de exámenes médico legales por presunto delito sexual contra niños, niñas y adolescentes",2015,3,4,2105,190.023752969121,0,1085,0,4,1020,392.156862745098
20058,68,68235,81,"Tasa de exámenes médico legales por presunto delito sexual contra niños, niñas y adolescentes",2015,4,5,2161,231.3743637205,0,1125,0,5,1036,482.625482625483
20059,68,68250,81,"Tasa de exámenes médico legales por presunto delito sexual contra niños, niñas y adolescentes",2015,3,2,655,305.343511450382,0,335,0,2,320,625
20060,68,68250,81,"Tasa de exámenes médico legales por presunto delito sexual contra niños, niñas y adolescentes",2015,4,2,687,291.120815138282,0,358,0,2,329,607.90273556231
20061,68,68255,81,"Tasa de exámenes médico legales por presunto delito sexual contra niños, niñas y adolescentes",2015,2,3,1235,242.914979757085,0,645,0,3,590,508.474576271186
20062,68,68255,81,"Tasa de exámenes médico legales por presunto delito sexual contra niños, niñas y adolescentes",2015,3,4,1383,289.226319595083,2,744,268.817204301075,2,639,312.989045383412
20063,68,68255,81,"Tasa de exámenes médico legales por presunto delito sexual contra niños, niñas y adolescentes",2015,4,5,1328,376.506024096386,0,728,0,5,600,833.333333333333
20064,68,68264,81,"Tasa de exámenes médico legales por presunto delito sexual contra niños, niñas y adolescentes",2015,4,1,225,444.444444444444,0,122,0,1,103,970.873786407767
20065,68,68266,81,"Tasa de exámenes médico legales por presunto delito sexual contra niños, niñas y adolescentes",2015,3,1,322,310.55900621118,0,164,0,1,158,632.911392405063
20066,68,68271,81,"Tasa de exámenes médico legales por presunto delito sexual contra niños, niñas y adolescentes",2015,3,1,730,136.986301369863,0,379,0,1,351,284.900284900285
20067,68,68271,81,"Tasa de exámenes médico legales por presunto delito sexual contra niños, niñas y adolescentes",2015,4,1,751,133.155792276964,0,401,0,1,350,285.714285714286
20068,68,68276,81,"Tasa de exámenes médico legales por presunto delito sexual contra niños, niñas y adolescentes",2015,2,19,18122,104.844939852113,8,9294,86.0770389498601,11,8828,124.603534209334
20069,68,68276,81,"Tasa de exámenes médico legales por presunto delito sexual contra niños, niñas y adolescentes",2015,3,43,23078,186.324638183551,9,11895,75.6620428751576,34,11183,304.03290709112
20070,68,68276,81,"Tasa de exámenes médico legales por presunto delito sexual contra niños, niñas y adolescentes",2015,4,32,25290,126.532226176354,5,13002,38.4556222119674,27,12288,219.7265625
20071,68,68276,121,Tasa de exámenes médico legales por presunto delito sexual cuando la víctima está entre 18 y 28 años,2015,5,13,48625,26.7352185089974,2,24546,8.14796708221299,11,24079,45.6829602558246
20072,68,68296,81,"Tasa de exámenes médico legales por presunto delito sexual contra niños, niñas y adolescentes",2015,4,1,222,450.45045045045,0,120,0,1,102,980.392156862745
20073,68,68298,81,"Tasa de exámenes médico legales por presunto delito sexual contra niños, niñas y adolescentes",2015,4,1,539,185.528756957328,0,274,0,1,265,377.358490566038
20074,68,68307,81,"Tasa de exámenes médico legales por presunto delito sexual contra niños, niñas y adolescentes",2015,2,19,14766,128.673980766626,5,7541,66.3042036865137,14,7225,193.771626297578
20075,68,68307,81,"Tasa de exámenes médico legales por presunto delito sexual contra niños, niñas y adolescentes",2015,3,38,17859,212.777871101405,10,9055,110.436223081171,28,8804,318.037255792821
20076,68,68307,81,"Tasa de exámenes médico legales por presunto delito sexual contra niños, niñas y adolescentes",2015,4,31,18867,164.308051094504,2,9587,20.8615833941796,29,9280,312.5
20077,68,68307,121,Tasa de exámenes médico legales por presunto delito sexual cuando la víctima está entre 18 y 28 años,2015,5,6,34511,17.3857610616905,0,17613,0,6,16898,35.5071606107232
20078,68,68318,81,"Tasa de exámenes médico legales por presunto delito sexual contra niños, niñas y adolescentes",2015,4,2,619,323.101777059774,1,289,346.020761245675,1,330,303.030303030303
20079,68,68318,121,Tasa de exámenes médico legales por presunto delito sexual cuando la víctima está entre 18 y 28 años,2015,5,1,1150,86.9565217391304,0,518,0,1,632,158.227848101266
20080,68,68320,81,"Tasa de exámenes médico legales por presunto delito sexual contra niños, niñas y adolescentes",2015,4,1,545,183.48623853211,0,275,0,1,270,370.37037037037
20081,68,68327,81,"Tasa de exámenes médico legales por presunto delito sexual contra niños, niñas y adolescentes",2015,3,3,370,810.810810810811,0,189,0,3,181,1657.45856353591
20082,68,68327,81,"Tasa de exámenes médico legales por presunto delito sexual contra niños, niñas y adolescentes",2015,4,2,394,507.614213197969,0,200,0,2,194,1030.92783505155
20083,68,68344,81,"Tasa de exámenes médico legales por presunto delito sexual contra niños, niñas y adolescentes",2015,2,1,193,518.134715025907,0,98,0,1,95,1052.63157894737
20084,68,68368,81,"Tasa de exámenes médico legales por presunto delito sexual contra niños, niñas y adolescentes",2015,4,2,355,563.380281690141,0,187,0,2,168,1190.47619047619
20085,68,68377,81,"Tasa de exámenes médico legales por presunto delito sexual contra niños, niñas y adolescentes",2015,4,1,970,103.092783505155,0,511,0,1,459,217.864923747277
20086,68,68385,81,"Tasa de exámenes médico legales por presunto delito sexual contra niños, niñas y adolescentes",2015,4,2,1755,113.960113960114,0,925,0,2,830,240.963855421687
20087,68,68397,81,"Tasa de exámenes médico legales por presunto delito sexual contra niños, niñas y adolescentes",2015,4,1,512,195.3125,0,268,0,1,244,409.83606557377
20088,68,68406,81,"Tasa de exámenes médico legales por presunto delito sexual contra niños, niñas y adolescentes",2015,2,2,3633,55.0509221029452,1,1868,53.5331905781585,1,1765,56.657223796034
20089,68,68406,81,"Tasa de exámenes médico legales por presunto delito sexual contra niños, niñas y adolescentes",2015,3,2,4189,47.744091668656,1,2179,45.8926112895824,1,2010,49.7512437810945
20090,68,68406,81,"Tasa de exámenes médico legales por presunto delito sexual contra niños, niñas y adolescentes",2015,4,8,4283,186.784963810413,1,2224,44.9640287769784,7,2059,339.970859640602
20091,68,68406,121,Tasa de exámenes médico legales por presunto delito sexual cuando la víctima está entre 18 y 28 años,2015,5,1,7243,13.8064337981499,0,3730,0,1,3513,28.4656988329063
20092,68,68418,81,"Tasa de exámenes médico legales por presunto delito sexual contra niños, niñas y adolescentes",2015,2,2,1116,179.21146953405,1,575,173.913043478261,1,541,184.842883548983
20093,68,68418,81,"Tasa de exámenes médico legales por presunto delito sexual contra niños, niñas y adolescentes",2015,3,3,1279,234.558248631744,1,664,150.602409638554,2,615,325.20325203252
20094,68,68418,81,"Tasa de exámenes médico legales por presunto delito sexual contra niños, niñas y adolescentes",2015,4,4,1316,303.951367781155,0,690,0,4,626,638.977635782748
20095,68,68432,81,"Tasa de exámenes médico legales por presunto delito sexual contra niños, niñas y adolescentes",2015,3,1,1732,57.7367205542725,0,876,0,1,856,116.822429906542
20096,68,68432,81,"Tasa de exámenes médico legales por presunto delito sexual contra niños, niñas y adolescentes",2015,4,1,1884,53.0785562632696,0,947,0,1,937,106.723585912487
20097,68,68432,121,Tasa de exámenes médico legales por presunto delito sexual cuando la víctima está entre 18 y 28 años,2015,5,1,3698,27.0416441319632,0,1819,0,1,1879,53.2197977647685
20098,68,68444,81,"Tasa de exámenes médico legales por presunto delito sexual contra niños, niñas y adolescentes",2015,4,1,541,184.842883548983,0,275,0,1,266,375.93984962406
20099,68,68464,81,"Tasa de exámenes médico legales por presunto delito sexual contra niños, niñas y adolescentes",2015,2,1,1163,85.9845227858985,0,600,0,1,563,177.619893428064
20100,68,68464,81,"Tasa de exámenes médico legales por presunto delito sexual contra niños, niñas y adolescentes",2015,3,4,1240,322.58064516129,0,643,0,4,597,670.01675041876
20101,68,68464,81,"Tasa de exámenes médico legales por presunto delito sexual contra niños, niñas y adolescentes",2015,4,2,1170,170.940170940171,0,604,0,2,566,353.356890459364
20102,68,68464,121,Tasa de exámenes médico legales por presunto delito sexual cuando la víctima está entre 18 y 28 años,2015,5,1,2162,46.2534690101758,0,1135,0,1,1027,97.3709834469328
20103,68,68498,81,"Tasa de exámenes médico legales por presunto delito sexual contra niños, niñas y adolescentes",2015,3,2,503,397.614314115308,0,262,0,2,241,829.875518672199
20104,68,68498,81,"Tasa de exámenes médico legales por presunto delito sexual contra niños, niñas y adolescentes",2015,4,2,486,411.522633744856,0,255,0,2,231,865.800865800866
20105,68,68500,81,"Tasa de exámenes médico legales por presunto delito sexual contra niños, niñas y adolescentes",2015,3,3,1405,213.523131672598,0,722,0,3,683,439.238653001464
20106,68,68500,81,"Tasa de exámenes médico legales por presunto delito sexual contra niños, niñas y adolescentes",2015,4,2,1299,153.964588144727,0,667,0,2,632,316.455696202532
20107,68,68502,81,"Tasa de exámenes médico legales por presunto delito sexual contra niños, niñas y adolescentes",2015,2,1,530,188.679245283019,0,270,0,1,260,384.615384615385
20108,68,68502,81,"Tasa de exámenes médico legales por presunto delito sexual contra niños, niñas y adolescentes",2015,4,2,561,356.50623885918,0,283,0,2,278,719.424460431655
20109,68,68533,81,"Tasa de exámenes médico legales por presunto delito sexual contra niños, niñas y adolescentes",2015,3,1,524,190.839694656489,0,268,0,1,256,390625
20110,68,68533,81,"Tasa de exámenes médico legales por presunto delito sexual contra niños, niñas y adolescentes",2015,4,1,473,211.416490486258,0,247,0,1,226,442.477876106195
20111,68,68547,81,"Tasa de exámenes médico legales por presunto delito sexual contra niños, niñas y adolescentes",2015,2,16,12011,133.211223045542,3,6123,48.9955903968643,13,5888,220.788043478261
20112,68,68547,81,"Tasa de exámenes médico legales por presunto delito sexual contra niños, niñas y adolescentes",2015,3,39,14491,269.13256504037,10,7344,136.165577342048,29,7147,405.76465649923
20113,68,68547,81,"Tasa de exámenes médico legales por presunto delito sexual contra niños, niñas y adolescentes",2015,4,38,15268,248.886560125753,9,7819,115.104233277913,29,7449,389.314001879447
20114,68,68547,121,Tasa de exámenes médico legales por presunto delito sexual cuando la víctima está entre 18 y 28 años,2015,5,6,28531,21.0297571063054,2,14231,14.0538261541705,4,14300,27.972027972028
20115,68,68572,121,Tasa de exámenes médico legales por presunto delito sexual cuando la víctima está entre 18 y 28 años,2015,5,1,2121,47.1475719000471,0,1015,0,1,1106,90.4159132007233
20116,68,68573,81,"Tasa de exámenes médico legales por presunto delito sexual contra niños, niñas y adolescentes",2015,4,1,1011,98.9119683481701,0,532,0,1,479,208.768267223382
20117,68,68575,81,"Tasa de exámenes médico legales por presunto delito sexual contra niños, niñas y adolescentes",2015,2,2,3456,57.8703703703704,0,1759,0,2,1697,117.855038302887
20118,68,68575,81,"Tasa de exámenes médico legales por presunto delito sexual contra niños, niñas y adolescentes",2015,3,5,3802,131.509731720147,2,1901,105.207785376118,3,1901,157.811678064177
20119,68,68575,81,"Tasa de exámenes médico legales por presunto delito sexual contra niños, niñas y adolescentes",2015,4,7,3668,190.839694656489,1,1817,55.0357732526142,6,1851,324.149108589951
20120,68,68575,121,Tasa de exámenes médico legales por presunto delito sexual cuando la víctima está entre 18 y 28 años,2015,5,3,6273,47.8240076518412,0,3149,0,3,3124,96.0307298335467
20121,68,68615,81,"Tasa de exámenes médico legales por presunto delito sexual contra niños, niñas y adolescentes",2015,2,2,2633,75.9589821496392,2,1352,147.92899408284,0,1281,0
20122,68,68615,81,"Tasa de exámenes médico legales por presunto delito sexual contra niños, niñas y adolescentes",2015,3,4,2989,133.824021411843,0,1548,0,4,1441,277.585010409438
20123,68,68615,81,"Tasa de exámenes médico legales por presunto delito sexual contra niños, niñas y adolescentes",2015,4,8,3051,262.209111766634,0,1588,0,8,1463,546.821599453178
20124,68,68615,121,Tasa de exámenes médico legales por presunto delito sexual cuando la víctima está entre 18 y 28 años,2015,5,1,5242,19.0766882869134,1,2754,36.3108206245461,0,2488,0
20125,68,68655,81,"Tasa de exámenes médico legales por presunto delito sexual contra niños, niñas y adolescentes",2015,2,6,1748,343.24942791762,1,896,111.607142857143,5,852,586.854460093897
20126,68,68655,81,"Tasa de exámenes médico legales por presunto delito sexual contra niños, niñas y adolescentes",2015,3,17,1980,858.585858585859,1,1018,98.2318271119843,16,962,1663.20166320166
20127,68,68655,81,"Tasa de exámenes médico legales por presunto delito sexual contra niños, niñas y adolescentes",2015,4,13,2002,649.350649350649,0,1034,0,13,968,1342.97520661157
20128,68,68669,81,"Tasa de exámenes médico legales por presunto delito sexual contra niños, niñas y adolescentes",2015,4,7,796,879.396984924623,0,420,0,7,376,1861.70212765957
20129,68,68679,81,"Tasa de exámenes médico legales por presunto delito sexual contra niños, niñas y adolescentes",2015,2,10,3241,308.546744831842,1,1659,60.2772754671489,9,1582,568.90012642225
20130,68,68679,81,"Tasa de exámenes médico legales por presunto delito sexual contra niños, niñas y adolescentes",2015,3,13,4004,324.675324675325,6,2004,299.40119760479,7,2000,350
20131,68,68679,81,"Tasa de exámenes médico legales por presunto delito sexual contra niños, niñas y adolescentes",2015,4,8,4122,194.080543425522,0,2013,0,8,2109,379.326695116169
20132,68,68679,121,Tasa de exámenes médico legales por presunto delito sexual cuando la víctima está entre 18 y 28 años,2015,5,1,8040,12.4378109452736,0,4031,0,1,4009,24.9438762783737
20133,68,68684,81,"Tasa de exámenes médico legales por presunto delito sexual contra niños, niñas y adolescentes",2015,3,1,458,218.340611353712,0,233,0,1,225,444.444444444444
20134,68,68684,81,"Tasa de exámenes médico legales por presunto delito sexual contra niños, niñas y adolescentes",2015,4,2,460,434.782608695652,0,231,0,2,229,873.362445414847
20135,68,68689,81,"Tasa de exámenes médico legales por presunto delito sexual contra niños, niñas y adolescentes",2015,2,2,3331,60.0420294205944,0,1702,0,2,1629,122.774708410068
20136,68,68689,81,"Tasa de exámenes médico legales por presunto delito sexual contra niños, niñas y adolescentes",2015,3,8,3887,205.814252636995,0,1975,0,8,1912,418.410041841004
20137,68,68689,81,"Tasa de exámenes médico legales por presunto delito sexual contra niños, niñas y adolescentes",2015,4,9,3815,235.910878112713,0,1934,0,9,1881,478.468899521531
20138,68,68689,121,Tasa de exámenes médico legales por presunto delito sexual cuando la víctima está entre 18 y 28 años,2015,5,2,6632,30.1568154402895,0,3395,0,2,3237,61.7856039542787
20139,68,68705,81,"Tasa de exámenes médico legales por presunto delito sexual contra niños, niñas y adolescentes",2015,4,2,223,896.860986547085,0,118,0,2,105,1904.76190476191
20140,68,68720,81,"Tasa de exámenes médico legales por presunto delito sexual contra niños, niñas y adolescentes",2015,2,1,490,204.081632653061,0,251,0,1,239,418.410041841004
20141,68,68720,81,"Tasa de exámenes médico legales por presunto delito sexual contra niños, niñas y adolescentes",2015,3,3,523,573.613766730402,0,270,0,3,253,1185.77075098814
20142,68,68720,81,"Tasa de exámenes médico legales por presunto delito sexual contra niños, niñas y adolescentes",2015,4,2,549,364.298724954463,0,281,0,2,268,746.268656716418
20143,68,68745,81,"Tasa de exámenes médico legales por presunto delito sexual contra niños, niñas y adolescentes",2015,3,5,870,574.712643678161,1,452,221.238938053097,4,418,956.937799043062
20144,68,68745,81,"Tasa de exámenes médico legales por presunto delito sexual contra niños, niñas y adolescentes",2015,4,2,864,231.481481481481,0,456,0,2,408,490.196078431373
20145,68,68755,81,"Tasa de exámenes médico legales por presunto delito sexual contra niños, niñas y adolescentes",2015,2,1,2379,42.0344682639765,0,1222,0,1,1157,86.4304235090752
20146,68,68755,81,"Tasa de exámenes médico legales por presunto delito sexual contra niños, niñas y adolescentes",2015,3,1,2818,35.486160397445,1,1410,70.9219858156028,0,1408,0
20147,68,68755,81,"Tasa de exámenes médico legales por presunto delito sexual contra niños, niñas y adolescentes",2015,4,4,3307,120.955548835803,0,1824,0,4,1483,269.723533378287
20148,68,68755,121,Tasa de exámenes médico legales por presunto delito sexual cuando la víctima está entre 18 y 28 años,2015,5,1,6705,14.9142431021626,0,4009,0,1,2696,37.0919881305638
20149,68,68770,81,"Tasa de exámenes médico legales por presunto delito sexual contra niños, niñas y adolescentes",2015,2,1,899,111.234705228031,1,464,215.51724137931,0,435,0
20150,68,68770,81,"Tasa de exámenes médico legales por presunto delito sexual contra niños, niñas y adolescentes",2015,3,5,1003,498.504486540379,0,525,0,5,478,1046.02510460251
20151,68,68770,81,"Tasa de exámenes médico legales por presunto delito sexual contra niños, niñas y adolescentes",2015,4,4,1003,398.803589232303,0,526,0,4,477,838.574423480084
20152,68,68773,81,"Tasa de exámenes médico legales por presunto delito sexual contra niños, niñas y adolescentes",2015,4,1,933,107.181136120043,0,490,0,1,443,225.733634311512
20153,68,68780,81,"Tasa de exámenes médico legales por presunto delito sexual contra niños, niñas y adolescentes",2015,3,1,315,317.460317460317,0,160,0,1,155,645.161290322581
20154,68,68780,81,"Tasa de exámenes médico legales por presunto delito sexual contra niños, niñas y adolescentes",2015,4,1,325,307.692307692308,1,163,613.496932515337,0,162,0
20155,68,68820,81,"Tasa de exámenes médico legales por presunto delito sexual contra niños, niñas y adolescentes",2015,2,1,630,158.730158730159,0,324,0,1,306,326.797385620915
20156,68,68820,81,"Tasa de exámenes médico legales por presunto delito sexual contra niños, niñas y adolescentes",2015,3,1,742,134.770889487871,0,382,0,1,360,277.777777777778
20157,68,68820,81,"Tasa de exámenes médico legales por presunto delito sexual contra niños, niñas y adolescentes",2015,4,2,762,262.46719160105,0,400,0,2,362,552.486187845304
20158,68,68820,121,Tasa de exámenes médico legales por presunto delito sexual cuando la víctima está entre 18 y 28 años,2015,5,1,1282,78.003120124805,1,695,143.884892086331,0,587,0
20159,68,68855,81,"Tasa de exámenes médico legales por presunto delito sexual contra niños, niñas y adolescentes",2015,3,1,445,224.719101123596,0,230,0,1,215,465.116279069767
20160,68,68855,81,"Tasa de exámenes médico legales por presunto delito sexual contra niños, niñas y adolescentes",2015,4,2,508,393.700787401575,0,265,0,2,243,823.045267489712
20161,68,68861,81,"Tasa de exámenes médico legales por presunto delito sexual contra niños, niñas y adolescentes",2015,4,8,2223,359.87404408457,0,1156,0,8,1067,749.765698219307
20162,68,68861,121,Tasa de exámenes médico legales por presunto delito sexual cuando la víctima está entre 18 y 28 años,2015,5,1,3987,25.0815149235014,0,2242,0,1,1745,57.3065902578797
20163,68,68867,81,"Tasa de exámenes médico legales por presunto delito sexual contra niños, niñas y adolescentes",2015,4,1,291,343.642611683849,0,155,0,1,136,735.294117647059
20164,68,68872,81,"Tasa de exámenes médico legales por presunto delito sexual contra niños, niñas y adolescentes",2015,2,1,428,233.644859813084,1,221,452.488687782805,0,207,0
20165,68,68872,81,"Tasa de exámenes médico legales por presunto delito sexual contra niños, niñas y adolescentes",2015,4,1,543,184.162062615101,0,271,0,1,272,367.647058823529
20166,70,70001,81,"Tasa de exámenes médico legales por presunto delito sexual contra niños, niñas y adolescentes",2015,2,25,23712,105.431848852901,4,12117,33.0114714863415,21,11595,181.11254851229
20167,70,70001,81,"Tasa de exámenes médico legales por presunto delito sexual contra niños, niñas y adolescentes",2015,3,60,29774,201.518103042923,16,15169,105.478278067111,44,14605,301.266689489901
20168,70,70001,81,"Tasa de exámenes médico legales por presunto delito sexual contra niños, niñas y adolescentes",2015,4,87,31283,278.106319726369,4,15808,25.3036437246964,83,15475,536.348949919225
20169,70,70001,121,Tasa de exámenes médico legales por presunto delito sexual cuando la víctima está entre 18 y 28 años,2015,5,19,55186,34.4290218533686,2,27881,7.17334385423765,17,27305,62.2596594030397
20170,70,70001,81,"Tasa de exámenes médico legales por presunto delito sexual contra niños, niñas y adolescentes",2015,1,1,4661,21.4546234713581,0,2376,0,1,2285,43.7636761487965
20171,70,70110,81,"Tasa de exámenes médico legales por presunto delito sexual contra niños, niñas y adolescentes",2015,2,2,988,202.429149797571,0,501,0,2,487,410.677618069815
20172,70,70110,81,"Tasa de exámenes médico legales por presunto delito sexual contra niños, niñas y adolescentes",2015,3,2,1168,171.232876712329,0,584,0,2,584,342.465753424658
20173,70,70110,81,"Tasa de exámenes médico legales por presunto delito sexual contra niños, niñas y adolescentes",2015,4,3,1127,266.193433895297,0,563,0,3,564,531.914893617021
20174,70,70124,81,"Tasa de exámenes médico legales por presunto delito sexual contra niños, niñas y adolescentes",2015,4,1,1462,68.3994528043776,0,756,0,1,706,141.643059490085
20175,70,70204,81,"Tasa de exámenes médico legales por presunto delito sexual contra niños, niñas y adolescentes",2015,4,5,680,735.294117647059,1,349,286.532951289398,4,331,1208.45921450151
20176,70,70204,121,Tasa de exámenes médico legales por presunto delito sexual cuando la víctima está entre 18 y 28 años,2015,5,1,1189,84.1042893187552,0,622,0,1,567,176.36684303351
20177,70,70215,81,"Tasa de exámenes médico legales por presunto delito sexual contra niños, niñas y adolescentes",2015,2,7,5268,132.87775246773,0,2690,0,7,2578,271.528316524438
20178,70,70215,81,"Tasa de exámenes médico legales por presunto delito sexual contra niños, niñas y adolescentes",2015,3,14,6619,211.512313038223,1,3360,29.7619047619048,13,3259,398.895366676895
20179,70,70215,81,"Tasa de exámenes médico legales por presunto delito sexual contra niños, niñas y adolescentes",2015,4,28,6975,401.433691756272,3,3557,84.3407365757661,25,3418,731.421884142774
20180,70,70215,121,Tasa de exámenes médico legales por presunto delito sexual cuando la víctima está entre 18 y 28 años,2015,5,5,13590,36.7917586460633,0,7560,0,5,6030,82.9187396351576
20181,70,70221,81,"Tasa de exámenes médico legales por presunto delito sexual contra niños, niñas y adolescentes",2015,2,1,1478,67.65899864682,1,762,131.233595800525,0,716,0
20182,70,70221,81,"Tasa de exámenes médico legales por presunto delito sexual contra niños, niñas y adolescentes",2015,3,3,1724,174.013921113689,0,878,0,3,846,354.609929078014
20183,70,70221,81,"Tasa de exámenes médico legales por presunto delito sexual contra niños, niñas y adolescentes",2015,4,7,1698,412.249705535925,2,848,235.849056603774,5,850,588.235294117647
20184,70,70230,81,"Tasa de exámenes médico legales por presunto delito sexual contra niños, niñas y adolescentes",2015,3,2,547,365.63071297989,0,283,0,2,264,757.575757575758
20185,70,70230,81,"Tasa de exámenes médico legales por presunto delito sexual contra niños, niñas y adolescentes",2015,4,2,528,378.787878787879,0,277,0,2,251,796.812749003984
20186,70,70233,81,"Tasa de exámenes médico legales por presunto delito sexual contra niños, niñas y adolescentes",2015,2,1,1109,90.1713255184851,1,565,176.991150442478,0,544,0
20187,70,70233,81,"Tasa de exámenes médico legales por presunto delito sexual contra niños, niñas y adolescentes",2015,3,1,1296,77.1604938271605,0,664,0,1,632,158.227848101266
20188,70,70233,81,"Tasa de exámenes médico legales por presunto delito sexual contra niños, niñas y adolescentes",2015,4,2,1276,156.739811912226,0,665,0,2,611,327.332242225859
20189,70,70235,81,"Tasa de exámenes médico legales por presunto delito sexual contra niños, niñas y adolescentes",2015,2,1,2172,46.0405156537753,0,1105,0,1,1067,93.7207122774133
20190,70,70235,81,"Tasa de exámenes médico legales por presunto delito sexual contra niños, niñas y adolescentes",2015,3,5,2534,197.316495659037,1,1289,77.5795190069822,4,1245,321.285140562249
20191,70,70235,81,"Tasa de exámenes médico legales por presunto delito sexual contra niños, niñas y adolescentes",2015,4,3,2499,120.048019207683,1,1268,78.8643533123028,2,1231,162.46953696182
20192,70,70400,81,"Tasa de exámenes médico legales por presunto delito sexual contra niños, niñas y adolescentes",2015,4,1,1333,75.0187546886722,0,693,0,1,640,156.25
20193,70,70418,81,"Tasa de exámenes médico legales por presunto delito sexual contra niños, niñas y adolescentes",2015,2,1,1755,56.980056980057,0,897,0,1,858,116.550116550117
20194,70,70418,81,"Tasa de exámenes médico legales por presunto delito sexual contra niños, niñas y adolescentes",2015,3,2,2068,96.7117988394584,0,1057,0,2,1011,197.82393669634
20195,70,70418,81,"Tasa de exámenes médico legales por presunto delito sexual contra niños, niñas y adolescentes",2015,4,7,2104,332.699619771863,1,1075,93.0232558139535,6,1029,583.090379008746
20196,70,70429,81,"Tasa de exámenes médico legales por presunto delito sexual contra niños, niñas y adolescentes",2015,4,1,4081,24.5037980887037,0,2100,0,1,1981,50.4795557799091
20197,70,70473,81,"Tasa de exámenes médico legales por presunto delito sexual contra niños, niñas y adolescentes",2015,4,5,1690,295.85798816568,0,881,0,5,809,618.046971569839
20198,70,70473,121,Tasa de exámenes médico legales por presunto delito sexual cuando la víctima está entre 18 y 28 años,2015,5,1,2968,33.6927223719677,0,1560,0,1,1408,71.0227272727273
20199,70,70508,81,"Tasa de exámenes médico legales por presunto delito sexual contra niños, niñas y adolescentes",2015,2,1,2235,44.7427293064877,0,1147,0,1,1088,91.9117647058823
20200,70,70508,81,"Tasa de exámenes médico legales por presunto delito sexual contra niños, niñas y adolescentes",2015,3,1,2585,38.6847195357834,0,1337,0,1,1248,80.1282051282051
20201,70,70508,81,"Tasa de exámenes médico legales por presunto delito sexual contra niños, niñas y adolescentes",2015,4,5,2515,198.807157057654,0,1306,0,5,1209,413.564929693962
20202,70,70508,121,Tasa de exámenes médico legales por presunto delito sexual cuando la víctima está entre 18 y 28 años,2015,5,2,4355,45.9242250287026,0,2231,0,2,2124,94.1619585687382
20203,70,70523,81,"Tasa de exámenes médico legales por presunto delito sexual contra niños, niñas y adolescentes",2015,4,2,1881,106.326422115896,0,995,0,2,886,225.733634311512
20204,70,70670,81,"Tasa de exámenes médico legales por presunto delito sexual contra niños, niñas y adolescentes",2015,2,1,3989,25.0689395838556,0,2033,0,1,1956,51.1247443762781
20205,70,70670,81,"Tasa de exámenes médico legales por presunto delito sexual contra niños, niñas y adolescentes",2015,3,7,4668,149.957155098543,1,2395,41.7536534446764,6,2273,263.968323801144
20206,70,70670,81,"Tasa de exámenes médico legales por presunto delito sexual contra niños, niñas y adolescentes",2015,4,14,4603,304.149467738431,0,2400,0,14,2203,635.497049477985
20207,70,70678,81,"Tasa de exámenes médico legales por presunto delito sexual contra niños, niñas y adolescentes",2015,4,1,3198,31.2695434646654,0,1651,0,1,1547,64.6412411118293
20208,70,70702,81,"Tasa de exámenes médico legales por presunto delito sexual contra niños, niñas y adolescentes",2015,2,1,1070,93.4579439252336,0,545,0,1,525,190.47619047619
20209,70,70702,81,"Tasa de exámenes médico legales por presunto delito sexual contra niños, niñas y adolescentes",2015,3,4,1298,308.166409861325,3,664,451.807228915663,1,634,157.728706624606
20210,70,70702,81,"Tasa de exámenes médico legales por presunto delito sexual contra niños, niñas y adolescentes",2015,4,1,1360,73.5294117647059,0,695,0,1,665,150.375939849624
20211,70,70708,81,"Tasa de exámenes médico legales por presunto delito sexual contra niños, niñas y adolescentes",2015,2,2,6165,32.441200324412,0,3136,0,2,3029,66.0283922086497
20212,70,70708,81,"Tasa de exámenes médico legales por presunto delito sexual contra niños, niñas y adolescentes",2015,3,4,7044,56.785917092561,1,3515,28.4495021337127,3,3529,85.0099178237461
20213,70,70708,81,"Tasa de exámenes médico legales por presunto delito sexual contra niños, niñas y adolescentes",2015,4,12,7002,171.379605826907,2,3466,57.7034045008655,10,3536,282.805429864253
20214,70,70708,121,Tasa de exámenes médico legales por presunto delito sexual cuando la víctima está entre 18 y 28 años,2015,5,1,11533,8.67077083152692,0,5843,0,1,5690,17.5746924428823
20215,70,70713,81,"Tasa de exámenes médico legales por presunto delito sexual contra niños, niñas y adolescentes",2015,2,3,6175,48.582995951417,0,3157,0,3,3018,99.403578528827
20216,70,70713,81,"Tasa de exámenes médico legales por presunto delito sexual contra niños, niñas y adolescentes",2015,3,4,6848,58.411214953271,2,3515,56.8990042674253,2,3333,60.00600060006
20217,70,70713,81,"Tasa de exámenes médico legales por presunto delito sexual contra niños, niñas y adolescentes",2015,4,6,6599,90.9228671010759,0,3428,0,6,3171,189.214758751183
20218,70,70713,121,Tasa de exámenes médico legales por presunto delito sexual cuando la víctima está entre 18 y 28 años,2015,5,3,10291,29.1516859391702,0,5493,0,3,4798,62.5260525218841
20219,70,70717,81,"Tasa de exámenes médico legales por presunto delito sexual contra niños, niñas y adolescentes",2015,2,1,1457,68.6341798215511,0,747,0,1,710,140.845070422535
20220,70,70717,81,"Tasa de exámenes médico legales por presunto delito sexual contra niños, niñas y adolescentes",2015,3,1,1729,57.8368999421631,0,900,0,1,829,120.627261761158
20221,70,70717,81,"Tasa de exámenes médico legales por presunto delito sexual contra niños, niñas y adolescentes",2015,4,4,1743,229.489386115892,0,918,0,4,825,484.848484848485
20222,70,70717,121,Tasa de exámenes médico legales por presunto delito sexual cuando la víctima está entre 18 y 28 años,2015,5,1,3200,31.25,0,1689,0,1,1511,66.1813368630046
20223,70,70742,81,"Tasa de exámenes médico legales por presunto delito sexual contra niños, niñas y adolescentes",2015,2,2,3195,62.5978090766823,0,1651,0,2,1544,129.533678756477
20224,70,70742,81,"Tasa de exámenes médico legales por presunto delito sexual contra niños, niñas y adolescentes",2015,3,5,3897,128.303823453939,0,2027,0,5,1870,267.379679144385
20225,70,70742,81,"Tasa de exámenes médico legales por presunto delito sexual contra niños, niñas y adolescentes",2015,4,7,3907,179.165600204761,0,2034,0,7,1873,373.731980779498
20226,70,70742,121,Tasa de exámenes médico legales por presunto delito sexual cuando la víctima está entre 18 y 28 años,2015,5,1,6195,16.1420500403551,0,3140,0,1,3055,32.7332242225859
20227,70,70771,81,"Tasa de exámenes médico legales por presunto delito sexual contra niños, niñas y adolescentes",2015,3,1,2458,40.6834825061025,0,1260,0,1,1198,83.4724540901503
20228,70,70820,81,"Tasa de exámenes médico legales por presunto delito sexual contra niños, niñas y adolescentes",2015,2,1,3492,28.6368843069874,0,1789,0,1,1703,58.7199060481503
20229,70,70820,81,"Tasa de exámenes médico legales por presunto delito sexual contra niños, niñas y adolescentes",2015,3,3,4103,73.117231294175,0,2103,0,3,2000,150
20230,70,70820,81,"Tasa de exámenes médico legales por presunto delito sexual contra niños, niñas y adolescentes",2015,4,20,4129,484.378784209252,0,2106,0,20,2023,988.630746416214
20231,70,70820,121,Tasa de exámenes médico legales por presunto delito sexual cuando la víctima está entre 18 y 28 años,2015,5,1,6514,15.3515505066012,0,3251,0,1,3263,30.6466441924609
20232,70,70820,81,"Tasa de exámenes médico legales por presunto delito sexual contra niños, niñas y adolescentes",2015,1,1,731,136.798905608755,1,376,265.957446808511,0,355,0
20233,70,70823,81,"Tasa de exámenes médico legales por presunto delito sexual contra niños, niñas y adolescentes",2015,2,2,1903,105.097214923805,1,984,101.626016260163,1,919,108.813928182807
20234,70,70823,81,"Tasa de exámenes médico legales por presunto delito sexual contra niños, niñas y adolescentes",2015,4,3,2198,136.487716105551,0,1155,0,3,1043,287.631831255992
20235,70,70823,121,Tasa de exámenes médico legales por presunto delito sexual cuando la víctima está entre 18 y 28 años,2015,5,2,3793,52.7287107830214,0,2029,0,2,1764,113.378684807256
20236,73,73001,81,"Tasa de exámenes médico legales por presunto delito sexual contra niños, niñas y adolescentes",2015,2,37,43973,84.1425420144179,5,22494,22.2281497288166,32,21479,148.982727315052
20237,73,73001,81,"Tasa de exámenes médico legales por presunto delito sexual contra niños, niñas y adolescentes",2015,3,95,55977,169.712560515926,18,28504,63.149031714847,77,27473,280.275179266917
20238,73,73001,81,"Tasa de exámenes médico legales por presunto delito sexual contra niños, niñas y adolescentes",2015,4,138,59934,230.253278606467,16,30680,52.1512385919166,122,29254,417.036986395023
20239,73,73001,121,Tasa de exámenes médico legales por presunto delito sexual cuando la víctima está entre 18 y 28 años,2015,5,27,105941,25.4858836522215,2,54742,3.65350188155347,25,51199,48.8290786929432
20240,73,73001,81,"Tasa de exámenes médico legales por presunto delito sexual contra niños, niñas y adolescentes",2015,1,2,8562,23.3590282644242,1,4409,22.6808800181447,1,4153,24.0789790512882
20241,73,73026,81,"Tasa de exámenes médico legales por presunto delito sexual contra niños, niñas y adolescentes",2015,3,2,1012,197.628458498024,0,533,0,2,479,417.536534446764
20242,73,73026,81,"Tasa de exámenes médico legales por presunto delito sexual contra niños, niñas y adolescentes",2015,4,4,932,429.184549356223,0,490,0,4,442,904.977375565611
20243,73,73030,81,"Tasa de exámenes médico legales por presunto delito sexual contra niños, niñas y adolescentes",2015,2,1,573,174.520069808028,0,296,0,1,277,361.01083032491
20244,73,73043,81,"Tasa de exámenes médico legales por presunto delito sexual contra niños, niñas y adolescentes",2015,4,2,2391,83.6470096194061,0,1314,0,2,1077,185.701021355617
20245,73,73055,81,"Tasa de exámenes médico legales por presunto delito sexual contra niños, niñas y adolescentes",2015,3,3,1290,232.558139534884,1,663,150.829562594268,2,627,318.979266347687
20246,73,73055,81,"Tasa de exámenes médico legales por presunto delito sexual contra niños, niñas y adolescentes",2015,4,12,1273,942.655145326002,0,667,0,12,606,1980.19801980198
20247,73,73055,121,Tasa de exámenes médico legales por presunto delito sexual cuando la víctima está entre 18 y 28 años,2015,5,2,2388,83.7520938023451,0,1272,0,2,1116,179.21146953405
20248,73,73067,81,"Tasa de exámenes médico legales por presunto delito sexual contra niños, niñas y adolescentes",2015,4,3,2826,106.157112526539,0,1448,0,3,1378,217.706821480406
20249,73,73124,81,"Tasa de exámenes médico legales por presunto delito sexual contra niños, niñas y adolescentes",2015,2,1,1858,53.8213132400431,0,955,0,1,903,110.741971207087
20250,73,73124,81,"Tasa de exámenes médico legales por presunto delito sexual contra niños, niñas y adolescentes",2015,3,2,2245,89.086859688196,0,1176,0,2,1069,187.090739008419
20251,73,73148,81,"Tasa de exámenes médico legales por presunto delito sexual contra niños, niñas y adolescentes",2015,4,1,938,106.609808102345,0,474,0,1,464,215.51724137931
20252,73,73168,81,"Tasa de exámenes médico legales por presunto delito sexual contra niños, niñas y adolescentes",2015,2,8,5334,149.981252343457,3,2727,110.01100110011,5,2607,191.791331031837
20253,73,73168,81,"Tasa de exámenes médico legales por presunto delito sexual contra niños, niñas y adolescentes",2015,3,18,6089,295.615043521104,2,3118,64.143681847338,16,2971,538.539212386402
20254,73,73168,81,"Tasa de exámenes médico legales por presunto delito sexual contra niños, niñas y adolescentes",2015,4,22,5920,371.621621621622,0,3023,0,22,2897,759.406282361063
20255,73,73168,121,Tasa de exámenes médico legales por presunto delito sexual cuando la víctima está entre 18 y 28 años,2015,5,3,9273,32.3519896473633,1,4623,21.6309755569976,2,4650,43.010752688172
20256,73,73200,81,"Tasa de exámenes médico legales por presunto delito sexual contra niños, niñas y adolescentes",2015,2,1,951,105.15247108307,1,487,205.338809034908,0,464,0
20257,73,73200,81,"Tasa de exámenes médico legales por presunto delito sexual contra niños, niñas y adolescentes",2015,4,1,1096,91.2408759124088,1,580,172.413793103448,0,516,0
20258,73,73217,81,"Tasa de exámenes médico legales por presunto delito sexual contra niños, niñas y adolescentes",2015,4,1,3520,28.4090909090909,0,1875,0,1,1645,60.790273556231
20259,73,73268,81,"Tasa de exámenes médico legales por presunto delito sexual contra niños, niñas y adolescentes",2015,2,4,6604,60.5693519079346,0,3354,0,4,3250,123.076923076923
20260,73,73268,81,"Tasa de exámenes médico legales por presunto delito sexual contra niños, niñas y adolescentes",2015,3,8,8336,95.9692898272553,2,4288,46.6417910447761,6,4048,148.221343873518
20261,73,73268,81,"Tasa de exámenes médico legales por presunto delito sexual contra niños, niñas y adolescentes",2015,4,27,8378,322.272618763428,1,4309,23.2072406590856,26,4069,638.977635782748
20262,73,73268,121,Tasa de exámenes médico legales por presunto delito sexual cuando la víctima está entre 18 y 28 años,2015,5,5,14051,35.5846558963775,0,7513,0,5,6538,76.4759865402264
20263,73,73270,81,"Tasa de exámenes médico legales por presunto delito sexual contra niños, niñas y adolescentes",2015,3,1,1001,99.9000999000999,1,518,193.050193050193,0,483,0
20264,73,73270,81,"Tasa de exámenes médico legales por presunto delito sexual contra niños, niñas y adolescentes",2015,4,1,999,100.1001001001,0,520,0,1,479,208.768267223382
20265,73,73275,81,"Tasa de exámenes médico legales por presunto delito sexual contra niños, niñas y adolescentes",2015,3,3,3021,99.304865938431,1,1557,64.2260757867694,2,1464,136.612021857924
20266,73,73275,81,"Tasa de exámenes médico legales por presunto delito sexual contra niños, niñas y adolescentes",2015,4,5,3148,158.831003811944,0,1630,0,5,1518,329.380764163373
20267,73,73275,121,Tasa de exámenes médico legales por presunto delito sexual cuando la víctima está entre 18 y 28 años,2015,5,1,5429,18.4195984527537,0,2767,0,1,2662,37.5657400450789
20268,73,73319,81,"Tasa de exámenes médico legales por presunto delito sexual contra niños, niñas y adolescentes",2015,2,3,2781,107.874865156419,1,1416,70.6214689265537,2,1365,146.520146520147
20269,73,73319,81,"Tasa de exámenes médico legales por presunto delito sexual contra niños, niñas y adolescentes",2015,3,3,3416,87.8220140515222,0,1731,0,3,1685,178.041543026706
20270,73,73347,81,"Tasa de exámenes médico legales por presunto delito sexual contra niños, niñas y adolescentes",2015,4,1,870,114.942528735632,0,451,0,1,419,238.663484486874
20271,73,73349,81,"Tasa de exámenes médico legales por presunto delito sexual contra niños, niñas y adolescentes",2015,2,1,1992,50.2008032128514,0,1027,0,1,965,103.626943005181
20272,73,73349,81,"Tasa de exámenes médico legales por presunto delito sexual contra niños, niñas y adolescentes",2015,3,4,2395,167.014613778706,0,1210,0,4,1185,337.552742616034
20273,73,73349,81,"Tasa de exámenes médico legales por presunto delito sexual contra niños, niñas y adolescentes",2015,4,7,2631,266.058532877233,1,1462,68.3994528043776,6,1169,513.259195893926
20274,73,73349,121,Tasa de exámenes médico legales por presunto delito sexual cuando la víctima está entre 18 y 28 años,2015,5,1,5334,18.7476565429321,0,3176,0,1,2158,46.339202965709
20275,73,73408,81,"Tasa de exámenes médico legales por presunto delito sexual contra niños, niñas y adolescentes",2015,2,1,1466,68.212824010914,0,750,0,1,716,139.664804469274
20276,73,73408,81,"Tasa de exámenes médico legales por presunto delito sexual contra niños, niñas y adolescentes",2015,3,2,1785,112.044817927171,1,908,110.132158590308,1,877,114.025085518814
20277,73,73408,81,"Tasa de exámenes médico legales por presunto delito sexual contra niños, niñas y adolescentes",2015,4,4,1783,224.340998317443,1,912,109.649122807018,3,871,344.43168771527
20278,73,73411,81,"Tasa de exámenes médico legales por presunto delito sexual contra niños, niñas y adolescentes",2015,2,3,3696,81.1688311688312,1,1896,52.7426160337553,2,1800,111.111111111111
20279,73,73411,81,"Tasa de exámenes médico legales por presunto delito sexual contra niños, niñas y adolescentes",2015,3,6,4400,136.363636363636,2,2276,87.8734622144112,4,2124,188.323917137476
20280,73,73411,81,"Tasa de exámenes médico legales por presunto delito sexual contra niños, niñas y adolescentes",2015,4,11,4379,251.198903859329,1,2272,44.0140845070423,10,2107,474.608448030375
20281,73,73411,121,Tasa de exámenes médico legales por presunto delito sexual cuando la víctima está entre 18 y 28 años,2015,5,2,7606,26.2950302392848,0,3895,0,2,3711,53.8938291565616
20282,73,73443,81,"Tasa de exámenes médico legales por presunto delito sexual contra niños, niñas y adolescentes",2015,2,3,2843,105.522335561027,2,1460,136.986301369863,1,1383,72.3065798987708
20283,73,73443,81,"Tasa de exámenes médico legales por presunto delito sexual contra niños, niñas y adolescentes",2015,3,16,3479,459.902270767462,1,1779,56.2113546936481,15,1700,882.352941176471
20284,73,73443,81,"Tasa de exámenes médico legales por presunto delito sexual contra niños, niñas y adolescentes",2015,4,10,3422,292.226767971946,1,1743,57.372346528973,9,1679,536.03335318642
20285,73,73443,81,"Tasa de exámenes médico legales por presunto delito sexual contra niños, niñas y adolescentes",2015,1,1,563,177.619893428064,0,291,0,1,272,367.647058823529
20286,73,73449,81,"Tasa de exámenes médico legales por presunto delito sexual contra niños, niñas y adolescentes",2015,2,1,3188,31.3676286072773,0,1636,0,1,1552,64.4329896907217
20287,73,73449,81,"Tasa de exámenes médico legales por presunto delito sexual contra niños, niñas y adolescentes",2015,3,2,4020,49.7512437810945,1,2098,47.6644423260248,1,1922,52.0291363163372
20288,73,73449,81,"Tasa de exámenes médico legales por presunto delito sexual contra niños, niñas y adolescentes",2015,4,1,4149,24.1021932995903,0,2180,0,1,1969,50.7872016251904
20289,73,73449,121,Tasa de exámenes médico legales por presunto delito sexual cuando la víctima está entre 18 y 28 años,2015,5,2,6723,29.7486241261342,0,3621,0,2,3102,64.4745325596389
20290,73,73461,81,"Tasa de exámenes médico legales por presunto delito sexual contra niños, niñas y adolescentes",2015,3,1,629,158.982511923688,0,323,0,1,306,326.797385620915
20291,73,73461,81,"Tasa de exámenes médico legales por presunto delito sexual contra niños, niñas y adolescentes",2015,4,1,605,165.289256198347,0,318,0,1,287,348.432055749129
20292,73,73483,81,"Tasa de exámenes médico legales por presunto delito sexual contra niños, niñas y adolescentes",2015,2,1,1857,53.850296176629,0,956,0,1,901,110.987791342952
20293,73,73483,81,"Tasa de exámenes médico legales por presunto delito sexual contra niños, niñas y adolescentes",2015,3,1,2320,43.1034482758621,0,1197,0,1,1123,89.0471950133571
20294,73,73483,81,"Tasa de exámenes médico legales por presunto delito sexual contra niños, niñas y adolescentes",2015,4,1,2253,44.3852640923213,0,1162,0,1,1091,91.6590284142988
20295,73,73504,81,"Tasa de exámenes médico legales por presunto delito sexual contra niños, niñas y adolescentes",2015,2,1,3799,26.3227165043432,0,1930,0,1,1869,53.5045478865704
20296,73,73504,81,"Tasa de exámenes médico legales por presunto delito sexual contra niños, niñas y adolescentes",2015,4,2,3863,51.7732332384157,0,1972,0,2,1891,105.764145954521
20297,73,73520,81,"Tasa de exámenes médico legales por presunto delito sexual contra niños, niñas y adolescentes",2015,2,1,866,115.473441108545,0,445,0,1,421,237.529691211401
20298,73,73547,81,"Tasa de exámenes médico legales por presunto delito sexual contra niños, niñas y adolescentes",2015,3,2,678,294.985250737463,0,353,0,2,325,615.384615384615
20299,73,73547,81,"Tasa de exámenes médico legales por presunto delito sexual contra niños, niñas y adolescentes",2015,4,1,634,157.728706624606,0,335,0,1,299,334.448160535117
20300,73,73555,81,"Tasa de exámenes médico legales por presunto delito sexual contra niños, niñas y adolescentes",2015,3,1,4204,23.7868696479543,0,2174,0,1,2030,49.2610837438424
20301,73,73555,81,"Tasa de exámenes médico legales por presunto delito sexual contra niños, niñas y adolescentes",2015,4,1,4100,24.390243902439,0,2173,0,1,1927,51.8941359626362
20302,73,73563,81,"Tasa de exámenes médico legales por presunto delito sexual contra niños, niñas y adolescentes",2015,4,1,778,128.53470437018,0,402,0,1,376,265.957446808511
20303,73,73585,81,"Tasa de exámenes médico legales por presunto delito sexual contra niños, niñas y adolescentes",2015,2,2,2410,82.9875518672199,0,1241,0,2,1169,171.086398631309
20304,73,73585,81,"Tasa de exámenes médico legales por presunto delito sexual contra niños, niñas y adolescentes",2015,3,2,3010,66.4451827242525,1,1553,64.3915003219575,1,1457,68.6341798215511
20305,73,73585,121,Tasa de exámenes médico legales por presunto delito sexual cuando la víctima está entre 18 y 28 años,2015,5,1,4930,20.2839756592292,0,2501,0,1,2429,41.1692054343351
20306,73,73616,81,"Tasa de exámenes médico legales por presunto delito sexual contra niños, niñas y adolescentes",2015,3,4,3534,113.186191284663,0,1829,0,4,1705,234.604105571847
20307,73,73616,81,"Tasa de exámenes médico legales por presunto delito sexual contra niños, niñas y adolescentes",2015,4,4,3345,119.581464872945,0,1758,0,4,1587,252.047889098929
20308,73,73622,81,"Tasa de exámenes médico legales por presunto delito sexual contra niños, niñas y adolescentes",2015,3,1,722,138.504155124654,1,379,263.852242744063,0,343,0
20309,73,73624,81,"Tasa de exámenes médico legales por presunto delito sexual contra niños, niñas y adolescentes",2015,3,2,2604,76.8049155145929,0,1315,0,2,1289,155.159038013964
20310,73,73624,81,"Tasa de exámenes médico legales por presunto delito sexual contra niños, niñas y adolescentes",2015,4,1,2450,40.8163265306122,0,1251,0,1,1199,83.4028356964137
20311,73,73671,81,"Tasa de exámenes médico legales por presunto delito sexual contra niños, niñas y adolescentes",2015,4,1,1551,64.4745325596389,0,805,0,1,746,134.048257372654
20312,73,73675,81,"Tasa de exámenes médico legales por presunto delito sexual contra niños, niñas y adolescentes",2015,2,1,1683,59.41770647653,0,855,0,1,828,120.772946859903
20313,73,73675,81,"Tasa de exámenes médico legales por presunto delito sexual contra niños, niñas y adolescentes",2015,4,3,1708,175.644028103044,0,872,0,3,836,358.851674641148
20314,73,73675,121,Tasa de exámenes médico legales por presunto delito sexual cuando la víctima está entre 18 y 28 años,2015,5,2,2927,68.3293474547318,0,1555,0,2,1372,145.772594752187
20315,73,73678,81,"Tasa de exámenes médico legales por presunto delito sexual contra niños, niñas y adolescentes",2015,4,3,2009,149.328023892484,1,1022,97.8473581213307,2,987,202.634245187437
20316,73,73770,81,"Tasa de exámenes médico legales por presunto delito sexual contra niños, niñas y adolescentes",2015,4,2,480,416.666666666667,0,244,0,2,236,847.457627118644
20317,73,73861,81,"Tasa de exámenes médico legales por presunto delito sexual contra niños, niñas y adolescentes",2015,4,1,2068,48.3558994197292,0,1085,0,1,983,101.729399796541
20318,73,73870,81,"Tasa de exámenes médico legales por presunto delito sexual contra niños, niñas y adolescentes",2015,4,1,1214,82.3723228995058,0,645,0,1,569,175.746924428822
20319,73,73870,121,Tasa de exámenes médico legales por presunto delito sexual cuando la víctima está entre 18 y 28 años,2015,5,1,1986,50.3524672708963,0,1081,0,1,905,110.497237569061
20320,76,76001,81,"Tasa de exámenes médico legales por presunto delito sexual contra niños, niñas y adolescentes",2015,2,215,176414,121.87241375401,52,90249,57.6183669625148,163,86165,189.171937561655
20321,76,76001,81,"Tasa de exámenes médico legales por presunto delito sexual contra niños, niñas y adolescentes",2015,3,309,215068,143.675488682649,79,109145,72.380777864309,230,105923,217.138865024593
20322,76,76001,81,"Tasa de exámenes médico legales por presunto delito sexual contra niños, niñas y adolescentes",2015,4,341,230518,147.927710634311,43,116562,36.8902386712651,298,113956,261.504440310295
20323,76,76001,121,Tasa de exámenes médico legales por presunto delito sexual cuando la víctima está entre 18 y 28 años,2015,5,81,447034,18.1194271576659,6,225680,2.65863169088976,75,221354,33.8823784526144
20324,76,76001,81,"Tasa de exámenes médico legales por presunto delito sexual contra niños, niñas y adolescentes",2015,1,2,35428,5.64525234277972,0,18150,0,2,17278,11.5754138210441
20325,76,76036,81,"Tasa de exámenes médico legales por presunto delito sexual contra niños, niñas y adolescentes",2015,4,4,1679,238.237045860631,0,864,0,4,815,490.79754601227
20326,76,76041,81,"Tasa de exámenes médico legales por presunto delito sexual contra niños, niñas y adolescentes",2015,2,1,1825,54.7945205479452,0,933,0,1,892,112.107623318386
20327,76,76041,81,"Tasa de exámenes médico legales por presunto delito sexual contra niños, niñas y adolescentes",2015,3,2,2047,97.7039570102589,1,1039,96.2463907603465,1,1008,99.2063492063492
20328,76,76041,81,"Tasa de exámenes médico legales por presunto delito sexual contra niños, niñas y adolescentes",2015,4,5,2031,246.184145741014,2,1029,194.363459669582,3,1002,299.40119760479
20329,76,76100,81,"Tasa de exámenes médico legales por presunto delito sexual contra niños, niñas y adolescentes",2015,3,3,1418,211.565585331453,0,744,0,3,674,445.103857566766
20330,76,76100,81,"Tasa de exámenes médico legales por presunto delito sexual contra niños, niñas y adolescentes",2015,4,4,1341,298.284862043251,0,714,0,4,627,637.958532695375
20331,76,76109,81,"Tasa de exámenes médico legales por presunto delito sexual contra niños, niñas y adolescentes",2015,2,14,42134,33.2273223524944,3,21590,13.8953219082909,11,20544,53.5436137071651
20332,76,76109,81,"Tasa de exámenes médico legales por presunto delito sexual contra niños, niñas y adolescentes",2015,3,23,47267,48.6597414686779,2,24067,8.31013420866747,21,23200,90.5172413793103
20333,76,76109,81,"Tasa de exámenes médico legales por presunto delito sexual contra niños, niñas y adolescentes",2015,4,46,47057,97.7537879592834,3,23804,12.6029238783398,43,23253,184.922375607449
20334,76,76109,121,Tasa de exámenes médico legales por presunto delito sexual cuando la víctima está entre 18 y 28 años,2015,5,15,82852,18.1045720079177,2,41265,4.84672240397431,13,41587,31.2597686777118
20335,76,76111,81,"Tasa de exámenes médico legales por presunto delito sexual contra niños, niñas y adolescentes",2015,2,8,7939,100.768358735357,0,4087,0,8,3852,207.684319833853
20336,76,76111,81,"Tasa de exámenes médico legales por presunto delito sexual contra niños, niñas y adolescentes",2015,3,18,9531,188.857412653447,5,4926,101.502233049127,13,4605,282.301845819761
20337,76,76111,81,"Tasa de exámenes médico legales por presunto delito sexual contra niños, niñas y adolescentes",2015,4,25,10070,248.262164846077,3,5281,56.807422836584,22,4789,459.38609313009
20338,76,76111,121,Tasa de exámenes médico legales por presunto delito sexual cuando la víctima está entre 18 y 28 años,2015,5,3,20720,14.4787644787645,0,10928,0,3,9792,30.6372549019608
20339,76,76113,81,"Tasa de exámenes médico legales por presunto delito sexual contra niños, niñas y adolescentes",2015,2,1,1606,62.266500622665,0,830,0,1,776,128.865979381443
20340,76,76113,81,"Tasa de exámenes médico legales por presunto delito sexual contra niños, niñas y adolescentes",2015,3,4,1881,212.652844231792,0,984,0,4,897,445.930880713489
20341,76,76113,81,"Tasa de exámenes médico legales por presunto delito sexual contra niños, niñas y adolescentes",2015,4,1,1957,51.0986203372509,0,1044,0,1,913,109.529025191676
20342,76,76113,121,Tasa de exámenes médico legales por presunto delito sexual cuando la víctima está entre 18 y 28 años,2015,5,1,3849,25.980774227072,0,2071,0,1,1778,56.2429696287964
20343,76,76122,81,"Tasa de exámenes médico legales por presunto delito sexual contra niños, niñas y adolescentes",2015,2,3,2328,128.865979381443,0,1197,0,3,1131,265.25198938992
20344,76,76122,81,"Tasa de exámenes médico legales por presunto delito sexual contra niños, niñas y adolescentes",2015,3,2,2658,75.2445447705041,1,1374,72.7802037845706,1,1284,77.8816199376947
20345,76,76122,81,"Tasa de exámenes médico legales por presunto delito sexual contra niños, niñas y adolescentes",2015,4,3,2806,106.913756236636,0,1450,0,3,1356,221.238938053097
20346,76,76122,121,Tasa de exámenes médico legales por presunto delito sexual cuando la víctima está entre 18 y 28 años,2015,5,5,5586,89.5094880057286,1,2846,35.1370344342937,4,2740,145.985401459854
20347,76,76126,81,"Tasa de exámenes médico legales por presunto delito sexual contra niños, niñas y adolescentes",2015,2,1,1226,81.5660685154976,0,628,0,1,598,167.224080267559
20348,76,76126,81,"Tasa de exámenes médico legales por presunto delito sexual contra niños, niñas y adolescentes",2015,3,7,1380,507.246376811594,1,704,142.045454545455,6,676,887.573964497041
20349,76,76126,81,"Tasa de exámenes médico legales por presunto delito sexual contra niños, niñas y adolescentes",2015,4,11,1384,794.797687861272,0,707,0,11,677,1624.81536189069
20350,76,76126,121,Tasa de exámenes médico legales por presunto delito sexual cuando la víctima está entre 18 y 28 años,2015,5,1,2807,35.6252226576416,0,1395,0,1,1412,70.8215297450425
20351,76,76130,81,"Tasa de exámenes médico legales por presunto delito sexual contra niños, niñas y adolescentes",2015,2,8,6044,132.362673726009,1,3107,32.1853878339234,7,2937,238.338440585632
20352,76,76130,81,"Tasa de exámenes médico legales por presunto delito sexual contra niños, niñas y adolescentes",2015,3,8,6861,116.601078559977,2,3560,56.1797752808989,6,3301,181.763102090276
20353,76,76130,81,"Tasa de exámenes médico legales por presunto delito sexual contra niños, niñas y adolescentes",2015,4,26,7349,353.789631242346,1,3832,26.0960334029228,25,3517,710.833096388968
20354,76,76130,121,Tasa de exámenes médico legales por presunto delito sexual cuando la víctima está entre 18 y 28 años,2015,5,7,15460,45.2781371280724,0,7700,0,7,7760,90.2061855670103
20355,76,76147,81,"Tasa de exámenes médico legales por presunto delito sexual contra niños, niñas y adolescentes",2015,2,8,10031,79.7527664240853,3,5126,58.5251658213032,5,4905,101.936799184506
20356,76,76147,81,"Tasa de exámenes médico legales por presunto delito sexual contra niños, niñas y adolescentes",2015,3,19,12016,158.122503328895,4,6062,65.9848234905972,15,5954,251.931474638898
20357,76,76147,81,"Tasa de exámenes médico legales por presunto delito sexual contra niños, niñas y adolescentes",2015,4,22,11980,183.639398998331,3,6106,49.1320013101867,19,5874,323.459312223357
20358,76,76147,121,Tasa de exámenes médico legales por presunto delito sexual cuando la víctima está entre 18 y 28 años,2015,5,3,23605,12.7091717856386,0,12015,0,3,11590,25.8843830888697
20359,76,76233,81,"Tasa de exámenes médico legales por presunto delito sexual contra niños, niñas y adolescentes",2015,2,10,2960,337.837837837838,1,1517,65.9195781147001,9,1443,623.700623700624
20360,76,76233,81,"Tasa de exámenes médico legales por presunto delito sexual contra niños, niñas y adolescentes",2015,3,24,3258,736.648250460405,3,1665,180.18018018018,21,1593,1318.26741996234
20361,76,76233,81,"Tasa de exámenes médico legales por presunto delito sexual contra niños, niñas y adolescentes",2015,4,18,3261,551.977920883165,1,1673,59.7728631201434,17,1588,1070.52896725441
20362,76,76233,121,Tasa de exámenes médico legales por presunto delito sexual cuando la víctima está entre 18 y 28 años,2015,5,2,6520,30.6748466257669,0,3430,0,2,3090,64.7249190938511
20363,76,76243,81,"Tasa de exámenes médico legales por presunto delito sexual contra niños, niñas y adolescentes",2015,4,3,1101,272.479564032698,1,571,175.131348511384,2,530,377.358490566038
20364,76,76243,121,Tasa de exámenes médico legales por presunto delito sexual cuando la víctima está entre 18 y 28 años,2015,5,1,2014,49.6524329692155,0,1064,0,1,950,105.263157894737
20365,76,76246,121,Tasa de exámenes médico legales por presunto delito sexual cuando la víctima está entre 18 y 28 años,2015,5,1,1889,52.9380624669137,0,974,0,1,915,109.289617486339
20366,76,76248,81,"Tasa de exámenes médico legales por presunto delito sexual contra niños, niñas y adolescentes",2015,2,2,4332,46.1680517082179,0,2219,0,2,2113,94.6521533364884
20367,76,76248,81,"Tasa de exámenes médico legales por presunto delito sexual contra niños, niñas y adolescentes",2015,3,7,5056,138.449367088608,0,2582,0,7,2474,282.942603071948
20368,76,76248,81,"Tasa de exámenes médico legales por presunto delito sexual contra niños, niñas y adolescentes",2015,4,5,5207,96.024582293067,1,2627,38.0662352493338,4,2580,155.038759689922
20369,76,76248,121,Tasa de exámenes médico legales por presunto delito sexual cuando la víctima está entre 18 y 28 años,2015,5,2,10471,19.1003724572629,0,5191,0,2,5280,37.8787878787879
20370,76,76250,81,"Tasa de exámenes médico legales por presunto delito sexual contra niños, niñas y adolescentes",2015,2,1,798,125.31328320802,0,408,0,1,390,256.410256410256
20371,76,76275,81,"Tasa de exámenes médico legales por presunto delito sexual contra niños, niñas y adolescentes",2015,2,3,5105,58.7659157688541,0,2622,0,3,2483,120.821586790173
20372,76,76275,81,"Tasa de exámenes médico legales por presunto delito sexual contra niños, niñas y adolescentes",2015,3,2,5850,34.1880341880342,0,3001,0,2,2849,70.2000702000702
20373,76,76275,81,"Tasa de exámenes médico legales por presunto delito sexual contra niños, niñas y adolescentes",2015,4,2,5945,33.6417157275021,0,3047,0,2,2898,69.0131124913734
20374,76,76306,81,"Tasa de exámenes médico legales por presunto delito sexual contra niños, niñas y adolescentes",2015,2,1,1551,64.4745325596389,0,791,0,1,760,131.578947368421
20375,76,76306,81,"Tasa de exámenes médico legales por presunto delito sexual contra niños, niñas y adolescentes",2015,4,2,1729,115.673799884326,0,863,0,2,866,230.94688221709
20376,76,76318,81,"Tasa de exámenes médico legales por presunto delito sexual contra niños, niñas y adolescentes",2015,3,5,3087,161.969549724652,1,1573,63.5727908455181,4,1514,264.200792602378
20377,76,76318,81,"Tasa de exámenes médico legales por presunto delito sexual contra niños, niñas y adolescentes",2015,4,6,3201,187.441424554827,1,1641,60.9384521633151,5,1560,320.51282051282
20378,76,76364,81,"Tasa de exámenes médico legales por presunto delito sexual contra niños, niñas y adolescentes",2015,2,4,9936,40.2576489533011,0,5093,0,4,4843,82.5934338220111
20379,76,76364,81,"Tasa de exámenes médico legales por presunto delito sexual contra niños, niñas y adolescentes",2015,3,15,11660,128.644939965695,1,6012,16.6333998669328,14,5648,247.875354107649
20380,76,76364,81,"Tasa de exámenes médico legales por presunto delito sexual contra niños, niñas y adolescentes",2015,4,13,12370,105.092966855295,2,6342,31.5357931251971,11,6028,182.481751824818
20381,76,76364,121,Tasa de exámenes médico legales por presunto delito sexual cuando la víctima está entre 18 y 28 años,2015,5,8,23193,34.493166041478,0,11707,0,8,11486,69.6500087062511
20382,76,76377,81,"Tasa de exámenes médico legales por presunto delito sexual contra niños, niñas y adolescentes",2015,3,3,1013,296.150049358342,0,529,0,3,484,619.834710743802
20383,76,76377,81,"Tasa de exámenes médico legales por presunto delito sexual contra niños, niñas y adolescentes",2015,4,3,1000,300,0,527,0,3,473,634.249471458774
20384,76,76400,81,"Tasa de exámenes médico legales por presunto delito sexual contra niños, niñas y adolescentes",2015,3,2,3547,56.3856780377784,0,1840,0,2,1707,117.164616285882
20385,76,76400,81,"Tasa de exámenes médico legales por presunto delito sexual contra niños, niñas y adolescentes",2015,4,3,3548,84.554678692221,0,1809,0,3,1739,172.512938470385
20386,76,76403,81,"Tasa de exámenes médico legales por presunto delito sexual contra niños, niñas y adolescentes",2015,2,1,954,104.82180293501,1,495,202.020202020202,0,459,0
20387,76,76497,81,"Tasa de exámenes médico legales por presunto delito sexual contra niños, niñas y adolescentes",2015,3,3,1591,188.560653676933,1,823,121.506682867558,2,768,260.416666666667
20388,76,76497,81,"Tasa de exámenes médico legales por presunto delito sexual contra niños, niñas y adolescentes",2015,4,1,1588,62.9722921914358,0,820,0,1,768,130.208333333333
20389,76,76497,121,Tasa de exámenes médico legales por presunto delito sexual cuando la víctima está entre 18 y 28 años,2015,5,1,2910,34.3642611683849,0,1513,0,1,1397,71.5819613457409
20390,76,76520,81,"Tasa de exámenes médico legales por presunto delito sexual contra niños, niñas y adolescentes",2015,2,27,21017,128.467431127183,4,10729,37.2821325379812,23,10288,223.561430793157
20391,76,76520,81,"Tasa de exámenes médico legales por presunto delito sexual contra niños, niñas y adolescentes",2015,3,44,25364,173.474215423435,6,12989,46.1929324813304,38,12375,307.070707070707
20392,76,76520,81,"Tasa de exámenes médico legales por presunto delito sexual contra niños, niñas y adolescentes",2015,4,53,27541,192.440361642642,7,14174,49.3862000846621,46,13367,344.131069050647
20393,76,76520,121,Tasa de exámenes médico legales por presunto delito sexual cuando la víctima está entre 18 y 28 años,2015,5,12,56798,21.1275044895947,2,29021,6.89156128320871,10,27777,36.0010080282248
20394,76,76563,81,"Tasa de exámenes médico legales por presunto delito sexual contra niños, niñas y adolescentes",2015,2,1,5299,18.8714851858841,0,2721,0,1,2578,38.7897595034911
20395,76,76563,81,"Tasa de exámenes médico legales por presunto delito sexual contra niños, niñas y adolescentes",2015,3,11,6012,182.967398536261,4,3094,129.282482223659,7,2918,239.89033584647
20396,76,76563,81,"Tasa de exámenes médico legales por presunto delito sexual contra niños, niñas y adolescentes",2015,4,5,5950,84.0336134453782,1,3047,32.8191663931736,4,2903,137.788494660696
20397,76,76563,121,Tasa de exámenes médico legales por presunto delito sexual cuando la víctima está entre 18 y 28 años,2015,5,1,10478,9.54380606986066,0,5208,0,1,5270,18.9753320683112
20398,76,76606,81,"Tasa de exámenes médico legales por presunto delito sexual contra niños, niñas y adolescentes",2015,2,1,1370,72.992700729927,0,705,0,1,665,150.375939849624
20399,76,76606,81,"Tasa de exámenes médico legales por presunto delito sexual contra niños, niñas y adolescentes",2015,3,8,1560,512.820512820513,1,812,123.152709359606,7,748,935.828877005348
20400,76,76606,81,"Tasa de exámenes médico legales por presunto delito sexual contra niños, niñas y adolescentes",2015,4,6,1601,374.765771392879,0,838,0,6,763,786.369593709043
20401,76,76616,81,"Tasa de exámenes médico legales por presunto delito sexual contra niños, niñas y adolescentes",2015,3,3,1384,216.763005780347,0,733,0,3,651,460.829493087558
20402,76,76616,81,"Tasa de exámenes médico legales por presunto delito sexual contra niños, niñas y adolescentes",2015,4,6,1309,458.365164247517,0,694,0,6,615,975.609756097561
20403,76,76616,121,Tasa de exámenes médico legales por presunto delito sexual cuando la víctima está entre 18 y 28 años,2015,5,2,2689,74.3770918557084,0,1393,0,2,1296,154.320987654321
20404,76,76622,81,"Tasa de exámenes médico legales por presunto delito sexual contra niños, niñas y adolescentes",2015,2,6,2602,230.59185242121401,0,1332,0,6,1270,472.44094488189
20405,76,76622,81,"Tasa de exámenes médico legales por presunto delito sexual contra niños, niñas y adolescentes",2015,3,3,2979,100.704934541793,0,1535,0,3,1444,207.756232686981
20406,76,76622,81,"Tasa de exámenes médico legales por presunto delito sexual contra niños, niñas y adolescentes",2015,4,5,3073,162.707452001302,1,1590,62.8930817610063,4,1483,269.723533378287
20407,76,76622,121,Tasa de exámenes médico legales por presunto delito sexual cuando la víctima está entre 18 y 28 años,2015,5,2,5845,34.2172797262618,0,2931,0,2,2914,68.6341798215511
20408,76,76670,81,"Tasa de exámenes médico legales por presunto delito sexual contra niños, niñas y adolescentes",2015,2,1,1362,73.4214390602056,0,709,0,1,653,153.139356814701
20409,76,76670,81,"Tasa de exámenes médico legales por presunto delito sexual contra niños, niñas y adolescentes",2015,3,2,1590,125.786163522013,0,850,0,2,740,270.27027027027
20410,76,76670,81,"Tasa de exámenes médico legales por presunto delito sexual contra niños, niñas y adolescentes",2015,4,2,1765,113.314447592068,0,959,0,2,806,248.138957816377
20411,76,76736,81,"Tasa de exámenes médico legales por presunto delito sexual contra niños, niñas y adolescentes",2015,2,1,3658,27.3373428102788,0,1892,0,1,1766,56.6251415628539
20412,76,76736,81,"Tasa de exámenes médico legales por presunto delito sexual contra niños, niñas y adolescentes",2015,3,11,4343,253.281142067695,2,2338,85.5431993156544,9,2005,448.877805486284
20413,76,76736,81,"Tasa de exámenes médico legales por presunto delito sexual contra niños, niñas y adolescentes",2015,4,15,4355,344.43168771527,0,2352,0,15,2003,748.876684972541
20414,76,76736,121,Tasa de exámenes médico legales por presunto delito sexual cuando la víctima está entre 18 y 28 años,2015,5,1,8112,12.32741617357,0,4239,0,1,3873,25.8197779499096
20415,76,76823,81,"Tasa de exámenes médico legales por presunto delito sexual contra niños, niñas y adolescentes",2015,3,2,1728,115.740740740741,0,892,0,2,836,239.234449760766
20416,76,76823,81,"Tasa de exámenes médico legales por presunto delito sexual contra niños, niñas y adolescentes",2015,4,3,1720,174.418604651163,0,890,0,3,830,361.44578313253
20417,76,76823,121,Tasa de exámenes médico legales por presunto delito sexual cuando la víctima está entre 18 y 28 años,2015,5,1,3222,31.0366232153942,0,1712,0,1,1510,66.2251655629139
20418,76,76828,81,"Tasa de exámenes médico legales por presunto delito sexual contra niños, niñas y adolescentes",2015,2,2,1663,120.264582080577,1,858,116.550116550117,1,805,124.223602484472
20419,76,76828,81,"Tasa de exámenes médico legales por presunto delito sexual contra niños, niñas y adolescentes",2015,3,3,1915,156.657963446475,1,992,100.806451612903,2,923,216.684723726977
20420,76,76828,81,"Tasa de exámenes médico legales por presunto delito sexual contra niños, niñas y adolescentes",2015,4,1,1773,56.4015792442188,0,925,0,1,848,117.924528301887
20421,76,76834,81,"Tasa de exámenes médico legales por presunto delito sexual contra niños, niñas y adolescentes",2015,2,23,16154,142.379596384796,7,8306,84.2764266795088,16,7848,203.873598369011
20422,76,76834,81,"Tasa de exámenes médico legales por presunto delito sexual contra niños, niñas y adolescentes",2015,3,30,19123,156.879150760864,6,9820,61.0997963340122,24,9303,257.981296356014
20423,76,76834,81,"Tasa de exámenes médico legales por presunto delito sexual contra niños, niñas y adolescentes",2015,4,21,19912,105.464041783849,1,10251,9.7551458394303,20,9661,207.01790704896
20424,76,76834,121,Tasa de exámenes médico legales por presunto delito sexual cuando la víctima está entre 18 y 28 años,2015,5,8,40094,19.953110191051,0,20353,0,8,19741,40.5247961096196
20425,76,76863,81,"Tasa de exámenes médico legales por presunto delito sexual contra niños, niñas y adolescentes",2015,2,1,590,169.491525423729,0,300,0,1,290,344.827586206897
20426,76,76863,81,"Tasa de exámenes médico legales por presunto delito sexual contra niños, niñas y adolescentes",2015,3,4,685,583.941605839416,0,354,0,4,331,1208.45921450151
20427,76,76863,81,"Tasa de exámenes médico legales por presunto delito sexual contra niños, niñas y adolescentes",2015,4,2,676,295.85798816568,0,356,0,2,320,625
20428,76,76869,81,"Tasa de exámenes médico legales por presunto delito sexual contra niños, niñas y adolescentes",2015,2,2,859,232.828870779977,1,436,229.357798165138,1,423,236.406619385343
20429,76,76869,81,"Tasa de exámenes médico legales por presunto delito sexual contra niños, niñas y adolescentes",2015,3,3,984,304.878048780488,1,501,199.600798403194,2,483,414.07867494824
20430,76,76869,81,"Tasa de exámenes médico legales por presunto delito sexual contra niños, niñas y adolescentes",2015,4,3,913,328.587075575027,0,468,0,3,445,674.157303370787
20431,76,76890,81,"Tasa de exámenes médico legales por presunto delito sexual contra niños, niñas y adolescentes",2015,3,10,1411,708.71722182849,2,740,270.27027027027,8,671,1192.25037257824
20432,76,76890,81,"Tasa de exámenes médico legales por presunto delito sexual contra niños, niñas y adolescentes",2015,4,9,1531,587.851077726976,0,811,0,9,720,1250
20433,76,76890,121,Tasa de exámenes médico legales por presunto delito sexual cuando la víctima está entre 18 y 28 años,2015,5,1,3191,31.3381385145722,0,1668,0,1,1523,65.6598818122127
20434,76,76892,81,"Tasa de exámenes médico legales por presunto delito sexual contra niños, niñas y adolescentes",2015,2,9,9263,97.1607470581885,2,4746,42.1407501053519,7,4517,154.970112906797
20435,76,76892,81,"Tasa de exámenes médico legales por presunto delito sexual contra niños, niñas y adolescentes",2015,3,27,10900,247.706422018349,9,5573,161.492912255518,18,5327,337.901257743571
20436,76,76892,81,"Tasa de exámenes médico legales por presunto delito sexual contra niños, niñas y adolescentes",2015,4,13,11485,113.191118850675,3,5964,50.3018108651912,10,5521,181.126607498642
20437,76,76892,121,Tasa de exámenes médico legales por presunto delito sexual cuando la víctima está entre 18 y 28 años,2015,5,7,22505,31.104199066874,1,11652,8.58221764503948,6,10853,55.2842532018797
20438,76,76895,81,"Tasa de exámenes médico legales por presunto delito sexual contra niños, niñas y adolescentes",2015,2,4,3630,110.192837465565,1,1858,53.8213132400431,3,1772,169.300225733634
20439,76,76895,81,"Tasa de exámenes médico legales por presunto delito sexual contra niños, niñas y adolescentes",2015,3,3,4242,70.7213578500707,0,2168,0,3,2074,144.648023143684
20440,76,76895,81,"Tasa de exámenes médico legales por presunto delito sexual contra niños, niñas y adolescentes",2015,4,3,4327,69.3321007626531,0,2171,0,3,2156,139.146567717996
20441,76,76895,121,Tasa de exámenes médico legales por presunto delito sexual cuando la víctima está entre 18 y 28 años,2015,5,2,8276,24.1662638956017,1,4148,24.1080038572806,1,4128,24.2248062015504
20442,8,8001,81,"Tasa de exámenes médico legales por presunto delito sexual contra niños, niñas y adolescentes",2015,2,98,97556,100.455123211284,11,49888,22.0493906350224,87,47668,182.51237727616
20443,8,8001,81,"Tasa de exámenes médico legales por presunto delito sexual contra niños, niñas y adolescentes",2015,3,175,120392,145.358495581102,35,61481,56.9281566662872,140,58911,237.646619476838
20444,8,8001,81,"Tasa de exámenes médico legales por presunto delito sexual contra niños, niñas y adolescentes",2015,4,201,122789,163.695445031721,12,62503,19.1990784442347,189,60286,313.505623196099
20445,8,8001,121,Tasa de exámenes médico legales por presunto delito sexual cuando la víctima está entre 18 y 28 años,2015,5,49,224882,21.7892050052917,2,114499,1.74674014620215,47,110383,42.579020320158
20446,8,8078,81,"Tasa de exámenes médico legales por presunto delito sexual contra niños, niñas y adolescentes",2015,2,2,5169,38.6922035209905,0,2638,0,2,2531,79.0201501382853
20447,8,8078,81,"Tasa de exámenes médico legales por presunto delito sexual contra niños, niñas y adolescentes",2015,3,4,6104,65.5307994757536,0,3123,0,4,2981,134.183160013418
20448,8,8078,81,"Tasa de exámenes médico legales por presunto delito sexual contra niños, niñas y adolescentes",2015,4,6,6000,100,0,3068,0,6,2932,204.638472032742
20449,8,8137,81,"Tasa de exámenes médico legales por presunto delito sexual contra niños, niñas y adolescentes",2015,3,3,2245,133.630289532294,0,1158,0,3,1087,275.988960441582
20450,8,8137,81,"Tasa de exámenes médico legales por presunto delito sexual contra niños, niñas y adolescentes",2015,4,3,2199,136.425648021828,0,1137,0,3,1062,282.485875706215
20451,8,8141,81,"Tasa de exámenes médico legales por presunto delito sexual contra niños, niñas y adolescentes",2015,2,2,1288,155.27950310559,0,676,0,2,612,326.797385620915
20452,8,8141,81,"Tasa de exámenes médico legales por presunto delito sexual contra niños, niñas y adolescentes",2015,4,2,1595,125.391849529781,0,848,0,2,747,267.737617135207
20453,8,8296,81,"Tasa de exámenes médico legales por presunto delito sexual contra niños, niñas y adolescentes",2015,2,7,4284,163.398692810458,3,2202,136.239782016349,4,2082,192.122958693564
20454,8,8296,81,"Tasa de exámenes médico legales por presunto delito sexual contra niños, niñas y adolescentes",2015,3,3,5143,58.331713007972,1,2665,37.5234521575985,2,2478,80.7102502017756
20455,8,8296,81,"Tasa de exámenes médico legales por presunto delito sexual contra niños, niñas y adolescentes",2015,4,7,5052,138.558986539984,2,2627,76.1324704986677,5,2425,206.185567010309
20456,8,8296,121,Tasa de exámenes médico legales por presunto delito sexual cuando la víctima está entre 18 y 28 años,2015,5,2,8234,24.2895312120476,0,4252,0,2,3982,50.2260170768458
20457,8,8372,81,"Tasa de exámenes médico legales por presunto delito sexual contra niños, niñas y adolescentes",2015,3,1,1791,55.8347292015634,0,955,0,1,836,119.617224880383
20458,8,8372,81,"Tasa de exámenes médico legales por presunto delito sexual contra niños, niñas y adolescentes",2015,4,6,1840,326.086956521739,3,983,305.188199389624,3,857,350.058343057176
20459,8,8372,121,Tasa de exámenes médico legales por presunto delito sexual cuando la víctima está entre 18 y 28 años,2015,5,3,3232,92.8217821782178,0,1713,0,3,1519,197.498354180382
20460,8,8421,81,"Tasa de exámenes médico legales por presunto delito sexual contra niños, niñas y adolescentes",2015,3,1,3209,31.1623558741041,1,1640,60.9756097560976,0,1569,0
20461,8,8421,81,"Tasa de exámenes médico legales por presunto delito sexual contra niños, niñas y adolescentes",2015,4,4,2978,134.318334452653,0,1508,0,4,1470,272.108843537415
20462,8,8433,81,"Tasa de exámenes médico legales por presunto delito sexual contra niños, niñas y adolescentes",2015,2,8,11852,67.4991562605467,2,6095,32.8137817883511,6,5757,104.220948410631
20463,8,8433,81,"Tasa de exámenes médico legales por presunto delito sexual contra niños, niñas y adolescentes",2015,3,15,13878,108.084738434933,1,7111,14.0627197299958,14,6767,206.886360277819
20464,8,8433,81,"Tasa de exámenes médico legales por presunto delito sexual contra niños, niñas y adolescentes",2015,4,23,13593,169.204737732656,2,6952,28.7686996547756,21,6641,316.217437132962
20465,8,8433,121,Tasa de exámenes médico legales por presunto delito sexual cuando la víctima está entre 18 y 28 años,2015,5,5,23964,20.8646302787515,1,12632,7.91640278657378,4,11332,35.2982703847511
20466,8,8436,81,"Tasa de exámenes médico legales por presunto delito sexual contra niños, niñas y adolescentes",2015,3,2,1517,131.8391562294,1,793,126.103404791929,1,724,138.121546961326
20467,8,8520,81,"Tasa de exámenes médico legales por presunto delito sexual contra niños, niñas y adolescentes",2015,2,3,2261,132.684652808492,0,1170,0,3,1091,274.977085242896
20468,8,8520,81,"Tasa de exámenes médico legales por presunto delito sexual contra niños, niñas y adolescentes",2015,3,4,2741,145.932141554177,0,1425,0,4,1316,303.951367781155
20469,8,8520,81,"Tasa de exámenes médico legales por presunto delito sexual contra niños, niñas y adolescentes",2015,4,1,2828,35.3606789250354,0,1470,0,1,1358,73.6377025036819
20470,8,8549,81,"Tasa de exámenes médico legales por presunto delito sexual contra niños, niñas y adolescentes",2015,4,2,607,329.489291598023,0,298,0,2,309,647.249190938511
20471,8,8549,121,Tasa de exámenes médico legales por presunto delito sexual cuando la víctima está entre 18 y 28 años,2015,5,1,1046,95.6022944550669,1,529,189.035916824197,0,517,0
20472,8,8558,81,"Tasa de exámenes médico legales por presunto delito sexual contra niños, niñas y adolescentes",2015,2,1,1372,72.8862973760933,0,707,0,1,665,150.375939849624
20473,8,8558,81,"Tasa de exámenes médico legales por presunto delito sexual contra niños, niñas y adolescentes",2015,3,1,1619,61.7665225447807,1,839,119.189511323004,0,780,0
20474,8,8558,81,"Tasa de exámenes médico legales por presunto delito sexual contra niños, niñas y adolescentes",2015,4,2,1594,125.470514429109,0,823,0,2,771,259.403372243839
20475,8,8558,121,Tasa de exámenes médico legales por presunto delito sexual cuando la víctima está entre 18 y 28 años,2015,5,1,2841,35.1988736360436,0,1466,0,1,1375,72.7272727272727
20476,8,8560,81,"Tasa de exámenes médico legales por presunto delito sexual contra niños, niñas y adolescentes",2015,2,1,2366,42.2654268808115,1,1209,82.7129859387924,0,1157,0
20477,8,8560,81,"Tasa de exámenes médico legales por presunto delito sexual contra niños, niñas y adolescentes",2015,4,5,2579,193.87359441644,0,1333,0,5,1246,401.284109149278
20478,8,8573,81,"Tasa de exámenes médico legales por presunto delito sexual contra niños, niñas y adolescentes",2015,2,2,2166,92.3361034164358,0,1124,0,2,1042,191.938579654511
20479,8,8573,81,"Tasa de exámenes médico legales por presunto delito sexual contra niños, niñas y adolescentes",2015,3,2,2623,76.2485703393061,0,1386,0,2,1237,161.681487469685
20480,8,8573,81,"Tasa de exámenes médico legales por presunto delito sexual contra niños, niñas y adolescentes",2015,4,6,2774,216.294160057678,0,1491,0,6,1283,467.653936087295
20481,8,8573,121,Tasa de exámenes médico legales por presunto delito sexual cuando la víctima está entre 18 y 28 años,2015,5,4,5088,78.6163522012579,0,2693,0,4,2395,167.014613778706
20482,8,8606,81,"Tasa de exámenes médico legales por presunto delito sexual contra niños, niñas y adolescentes",2015,4,1,3046,32.8299409061064,0,1542,0,1,1504,66.4893617021277
20483,8,8634,81,"Tasa de exámenes médico legales por presunto delito sexual contra niños, niñas y adolescentes",2015,2,5,2808,178.062678062678,3,1423,210.822206605762,2,1385,144.404332129964
20484,8,8634,81,"Tasa de exámenes médico legales por presunto delito sexual contra niños, niñas y adolescentes",2015,3,6,3269,183.542367696543,3,1656,181.159420289855,3,1613,185.98884066956
20485,8,8634,81,"Tasa de exámenes médico legales por presunto delito sexual contra niños, niñas y adolescentes",2015,4,3,3411,87.9507475813544,0,1762,0,3,1649,181.928441479685
20486,8,8634,121,Tasa de exámenes médico legales por presunto delito sexual cuando la víctima está entre 18 y 28 años,2015,5,1,6198,16.134236850597,0,3305,0,1,2893,34.5661942620118
20487,8,8638,81,"Tasa de exámenes médico legales por presunto delito sexual contra niños, niñas y adolescentes",2015,2,5,9846,50.7820434694292,1,5064,19.7472353870458,4,4782,83.6470096194061
20488,8,8638,81,"Tasa de exámenes médico legales por presunto delito sexual contra niños, niñas y adolescentes",2015,3,5,11720,42.6621160409556,1,6068,16.479894528675,4,5652,70.7714083510262
20489,8,8638,81,"Tasa de exámenes médico legales por presunto delito sexual contra niños, niñas y adolescentes",2015,4,18,11015,163.413527008625,2,5700,35.0877192982456,16,5315,301.034807149577
20490,8,8638,121,Tasa de exámenes médico legales por presunto delito sexual cuando la víctima está entre 18 y 28 años,2015,5,5,18109,27.6105803743995,0,9262,0,5,8847,56.5163332203007
20491,8,8675,81,"Tasa de exámenes médico legales por presunto delito sexual contra niños, niñas y adolescentes",2015,4,2,1467,136.332651670075,0,755,0,2,712,280.898876404494
20492,8,8675,121,Tasa de exámenes médico legales por presunto delito sexual cuando la víctima está entre 18 y 28 años,2015,5,1,2330,42.9184549356223,0,1222,0,1,1108,90.2527075812274
20493,8,8685,81,"Tasa de exámenes médico legales por presunto delito sexual contra niños, niñas y adolescentes",2015,3,3,2475,121.212121212121,1,1260,79.3650793650794,2,1215,164.609053497942
20494,8,8685,81,"Tasa de exámenes médico legales por presunto delito sexual contra niños, niñas y adolescentes",2015,4,3,2641,113.59333585763,0,1340,0,3,1301,230.591852421214
20495,8,8758,81,"Tasa de exámenes médico legales por presunto delito sexual contra niños, niñas y adolescentes",2015,2,32,56794,56.3439799978871,5,29020,17.2294968986906,27,27774,97.2132209980557
20496,8,8758,81,"Tasa de exámenes médico legales por presunto delito sexual contra niños, niñas y adolescentes",2015,3,44,68413,64.3152617192639,8,34858,22.9502553215905,36,33555,107.286544479213
20497,8,8758,81,"Tasa de exámenes médico legales por presunto delito sexual contra niños, niñas y adolescentes",2015,4,70,68795,101.751580783487,3,35028,8.56457690990065,67,33767,198.418574347736
20498,8,8758,121,Tasa de exámenes médico legales por presunto delito sexual cuando la víctima está entre 18 y 28 años,2015,5,13,119954,10.8374877036197,0,61148,0,13,58806,22.1065877631534
20499,8,8758,81,"Tasa de exámenes médico legales por presunto delito sexual contra niños, niñas y adolescentes",2015,1,1,11501,8.69489609599165,0,5887,0,1,5614,17.8126113288208
20500,8,8770,81,"Tasa de exámenes médico legales por presunto delito sexual contra niños, niñas y adolescentes",2015,3,1,902,110.864745011086,0,463,0,1,439,227.790432801822
20501,8,8770,81,"Tasa de exámenes médico legales por presunto delito sexual contra niños, niñas y adolescentes",2015,4,1,973,102.774922918808,0,501,0,1,472,211.864406779661
20502,8,8832,81,"Tasa de exámenes médico legales por presunto delito sexual contra niños, niñas y adolescentes",2015,2,1,976,102.459016393443,1,500,200,0,476,0
20503,8,8832,81,"Tasa de exámenes médico legales por presunto delito sexual contra niños, niñas y adolescentes",2015,3,1,1124,88.9679715302491,1,584,171.232876712329,0,540,0
20504,8,8832,81,"Tasa de exámenes médico legales por presunto delito sexual contra niños, niñas y adolescentes",2015,4,3,1129,265.721877767936,0,590,0,3,539,556.586270871985
20505,8,8849,81,"Tasa de exámenes médico legales por presunto delito sexual contra niños, niñas y adolescentes",2015,3,1,1023,97.7517106549365,0,522,0,1,501,199.600798403194
20506,81,81001,81,"Tasa de exámenes médico legales por presunto delito sexual contra niños, niñas y adolescentes",2015,2,13,11033,117.828333182271,2,5572,35.8937544867193,11,5461,201.428309833364
20507,81,81001,81,"Tasa de exámenes médico legales por presunto delito sexual contra niños, niñas y adolescentes",2015,3,21,13605,154.355016538037,6,6862,87.4380647041679,15,6743,222.452914133175
20508,81,81001,81,"Tasa de exámenes médico legales por presunto delito sexual contra niños, niñas y adolescentes",2015,4,50,11661,428.77969299374,4,5766,69.3721817551162,46,5895,780.322307039864
20509,81,81001,121,Tasa de exámenes médico legales por presunto delito sexual cuando la víctima está entre 18 y 28 años,2015,5,4,15478,25.8431321876211,0,7308,0,4,8170,48.9596083231334
20510,81,81001,81,"Tasa de exámenes médico legales por presunto delito sexual contra niños, niñas y adolescentes",2015,1,1,2237,44.7027268663388,0,1139,0,1,1098,91.0746812386157
20511,81,81065,81,"Tasa de exámenes médico legales por presunto delito sexual contra niños, niñas y adolescentes",2015,2,1,5203,19.2196809532962,1,2638,37.9075056861259,0,2565,0
20512,81,81065,81,"Tasa de exámenes médico legales por presunto delito sexual contra niños, niñas y adolescentes",2015,3,6,6062,98.9772352358957,1,3078,32.488628979857,5,2984,167.560321715818
20513,81,81065,81,"Tasa de exámenes médico legales por presunto delito sexual contra niños, niñas y adolescentes",2015,4,4,5696,70.2247191011236,0,2908,0,4,2788,143.472022955524
20514,81,81065,121,Tasa de exámenes médico legales por presunto delito sexual cuando la víctima está entre 18 y 28 años,2015,5,2,7615,26.2639527248851,1,3774,26.4970853206147,1,3841,26.0348867482426
20515,81,81300,81,"Tasa de exámenes médico legales por presunto delito sexual contra niños, niñas y adolescentes",2015,3,4,3742,106.894708711919,2,1877,106.553010122536,2,1865,107.238605898123
20516,81,81300,81,"Tasa de exámenes médico legales por presunto delito sexual contra niños, niñas y adolescentes",2015,4,3,3498,85.7632933104631,0,1730,0,3,1768,169.683257918552
20517,81,81591,81,"Tasa de exámenes médico legales por presunto delito sexual contra niños, niñas y adolescentes",2015,2,1,477,209.643605870021,0,244,0,1,233,429.184549356223
20518,81,81591,81,"Tasa de exámenes médico legales por presunto delito sexual contra niños, niñas y adolescentes",2015,3,2,532,375.93984962406,0,266,0,2,266,751.87969924812
20519,81,81591,81,"Tasa de exámenes médico legales por presunto delito sexual contra niños, niñas y adolescentes",2015,4,1,556,179.856115107914,0,298,0,1,258,387.596899224806
20520,81,81736,81,"Tasa de exámenes médico legales por presunto delito sexual contra niños, niñas y adolescentes",2015,2,5,6029,82.9324929507381,2,3086,64.8088139987038,3,2943,101.936799184506
20521,81,81736,81,"Tasa de exámenes médico legales por presunto delito sexual contra niños, niñas y adolescentes",2015,3,16,6714,238.308013106941,3,3390,88.4955752212389,13,3324,391.095066185319
20522,81,81736,81,"Tasa de exámenes médico legales por presunto delito sexual contra niños, niñas y adolescentes",2015,4,11,6663,165.090799939967,1,3442,29.0528762347472,10,3221,310.462589257994
20523,81,81736,121,Tasa de exámenes médico legales por presunto delito sexual cuando la víctima está entre 18 y 28 años,2015,5,3,9793,30.6341264168283,0,5256,0,3,4537,66.1229887590919
20524,81,81794,81,"Tasa de exámenes médico legales por presunto delito sexual contra niños, niñas y adolescentes",2015,2,8,6537,122.38029677222,2,3376,59.2417061611374,6,3161,189.813350205631
20525,81,81794,81,"Tasa de exámenes médico legales por presunto delito sexual contra niños, niñas y adolescentes",2015,3,18,7420,242.587601078167,4,3868,103.412616339193,14,3552,394.144144144144
20526,81,81794,81,"Tasa de exámenes médico legales por presunto delito sexual contra niños, niñas y adolescentes",2015,4,20,6988,286.204922724671,3,3645,82.3045267489712,17,3343,508.525276697577
20527,81,81794,121,Tasa de exámenes médico legales por presunto delito sexual cuando la víctima está entre 18 y 28 años,2015,5,4,10348,38.6548125241593,0,5530,0,4,4818,83.02200083022
20528,85,85001,81,"Tasa de exámenes médico legales por presunto delito sexual contra niños, niñas y adolescentes",2015,2,17,13198,128.807395059858,6,6759,88.7705281846427,11,6439,170.833980431744
20529,85,85001,81,"Tasa de exámenes médico legales por presunto delito sexual contra niños, niñas y adolescentes",2015,3,48,16565,289.767582251736,10,8539,117.109731818714,38,8026,473.461250934463
20530,85,85001,81,"Tasa de exámenes médico legales por presunto delito sexual contra niños, niñas y adolescentes",2015,4,72,16682,431.602925308716,6,8467,70.8633518365419,66,8215,803.408399269629
20531,85,85001,121,Tasa de exámenes médico legales por presunto delito sexual cuando la víctima está entre 18 y 28 años,2015,5,8,28513,28.0573773366535,3,14059,21.3386442847998,5,14454,34.592500345925
20532,85,85010,81,"Tasa de exámenes médico legales por presunto delito sexual contra niños, niñas y adolescentes",2015,2,2,3809,52.5072197427146,0,1946,0,2,1863,107.353730542136
20533,85,85010,81,"Tasa de exámenes médico legales por presunto delito sexual contra niños, niñas y adolescentes",2015,3,4,4608,86.8055555555556,2,2350,85.1063829787234,2,2258,88.5739592559787
20534,85,85010,81,"Tasa de exámenes médico legales por presunto delito sexual contra niños, niñas y adolescentes",2015,4,9,4824,186.567164179104,1,2424,41.2541254125413,8,2400,333.333333333333
20535,85,85125,81,"Tasa de exámenes médico legales por presunto delito sexual contra niños, niñas y adolescentes",2015,2,1,1466,68.212824010914,0,766,0,1,700,142.857142857143
20536,85,85125,81,"Tasa de exámenes médico legales por presunto delito sexual contra niños, niñas y adolescentes",2015,4,2,1627,122.925629993854,0,849,0,2,778,257.06940874036
20537,85,85125,121,Tasa de exámenes médico legales por presunto delito sexual cuando la víctima está entre 18 y 28 años,2015,5,1,2634,37.9650721336371,0,1374,0,1,1260,79.3650793650794
20538,85,85139,81,"Tasa de exámenes médico legales por presunto delito sexual contra niños, niñas y adolescentes",2015,2,1,1108,90.2527075812274,0,568,0,1,540,185.185185185185
20539,85,85139,81,"Tasa de exámenes médico legales por presunto delito sexual contra niños, niñas y adolescentes",2015,3,1,1312,76.219512195122,0,685,0,1,627,159.489633173844
20540,85,85139,81,"Tasa de exámenes médico legales por presunto delito sexual contra niños, niñas y adolescentes",2015,4,6,1313,456.968773800457,0,699,0,6,614,977.198697068404
20541,85,85139,121,Tasa de exámenes médico legales por presunto delito sexual cuando la víctima está entre 18 y 28 años,2015,5,2,2290,87.3362445414847,0,1212,0,2,1078,185.528756957328
20542,85,85162,81,"Tasa de exámenes médico legales por presunto delito sexual contra niños, niñas y adolescentes",2015,2,2,1499,133.422281521014,0,760,0,2,739,270.63599458728
20543,85,85162,81,"Tasa de exámenes médico legales por presunto delito sexual contra niños, niñas y adolescentes",2015,3,2,1771,112.930547713156,0,883,0,2,888,225.225225225225
20544,85,85162,81,"Tasa de exámenes médico legales por presunto delito sexual contra niños, niñas y adolescentes",2015,4,1,1781,56.1482313307131,0,877,0,1,904,110.619469026549
20545,85,85225,81,"Tasa de exámenes médico legales por presunto delito sexual contra niños, niñas y adolescentes",2015,3,1,1147,87.1839581517001,0,577,0,1,570,175.438596491228
20546,85,85225,81,"Tasa de exámenes médico legales por presunto delito sexual contra niños, niñas y adolescentes",2015,4,3,1110,270.27027027027,0,543,0,3,567,529.100529100529
20547,85,85230,81,"Tasa de exámenes médico legales por presunto delito sexual contra niños, niñas y adolescentes",2015,3,2,1173,170.502983802217,0,609,0,2,564,354.609929078014
20548,85,85230,81,"Tasa de exámenes médico legales por presunto delito sexual contra niños, niñas y adolescentes",2015,4,3,1055,284.36018957346,0,548,0,3,507,591.715976331361
20549,85,85250,81,"Tasa de exámenes médico legales por presunto delito sexual contra niños, niñas y adolescentes",2015,2,7,2934,238.582140422631,2,1500,133.333333333333,5,1434,348.675034867503
20550,85,85250,81,"Tasa de exámenes médico legales por presunto delito sexual contra niños, niñas y adolescentes",2015,3,16,3512,455.580865603645,4,1829,218.698742482231,12,1683,713.01247771836
20551,85,85250,81,"Tasa de exámenes médico legales por presunto delito sexual contra niños, niñas y adolescentes",2015,4,24,3333,720.07200720072,1,1708,58.5480093676815,23,1625,1415.38461538462
20552,85,85250,121,Tasa de exámenes médico legales por presunto delito sexual cuando la víctima está entre 18 y 28 años,2015,5,4,5298,75.5001887504719,0,2619,0,4,2679,149.309443822322
20553,85,85263,81,"Tasa de exámenes médico legales por presunto delito sexual contra niños, niñas y adolescentes",2015,2,1,871,114.810562571757,0,450,0,1,421,237.529691211401
20554,85,85263,81,"Tasa de exámenes médico legales por presunto delito sexual contra niños, niñas y adolescentes",2015,3,2,972,205.761316872428,0,509,0,2,463,431.965442764579
20555,85,85263,81,"Tasa de exámenes médico legales por presunto delito sexual contra niños, niñas y adolescentes",2015,4,5,985,507.614213197969,1,514,194.552529182879,4,471,849.256900212314
20556,85,85279,81,"Tasa de exámenes médico legales por presunto delito sexual contra niños, niñas y adolescentes",2015,3,1,541,184.842883548983,0,275,0,1,266,375.93984962406
20557,85,85300,81,"Tasa de exámenes médico legales por presunto delito sexual contra niños, niñas y adolescentes",2015,3,1,359,278.551532033426,0,179,0,1,180,555.555555555556
20558,85,85300,81,"Tasa de exámenes médico legales por presunto delito sexual contra niños, niñas y adolescentes",2015,4,2,354,564.971751412429,0,174,0,2,180,1111.11111111111
20559,85,85325,81,"Tasa de exámenes médico legales por presunto delito sexual contra niños, niñas y adolescentes",2015,3,1,955,104.712041884817,0,513,0,1,442,226.244343891403
20560,85,85325,81,"Tasa de exámenes médico legales por presunto delito sexual contra niños, niñas y adolescentes",2015,4,1,900,111.111111111111,0,487,0,1,413,242.130750605327
20561,85,85400,81,"Tasa de exámenes médico legales por presunto delito sexual contra niños, niñas y adolescentes",2015,3,2,989,202.224469160768,0,506,0,2,483,414.07867494824
20562,85,85400,81,"Tasa de exámenes médico legales por presunto delito sexual contra niños, niñas y adolescentes",2015,4,1,854,117.096018735363,1,440,227.272727272727,0,414,0
20563,85,85410,81,"Tasa de exámenes médico legales por presunto delito sexual contra niños, niñas y adolescentes",2015,2,6,2193,273.59781121751,1,1112,89.9280575539568,5,1081,462.534690101758
20564,85,85410,81,"Tasa de exámenes médico legales por presunto delito sexual contra niños, niñas y adolescentes",2015,3,5,2633,189.897455374098,1,1321,75.7002271006813,4,1312,304.878048780488
20565,85,85410,81,"Tasa de exámenes médico legales por presunto delito sexual contra niños, niñas y adolescentes",2015,4,5,2501,199.920031987205,0,1365,0,5,1136,440.140845070423
20566,85,85410,121,Tasa de exámenes médico legales por presunto delito sexual cuando la víctima está entre 18 y 28 años,2015,5,2,5276,37.9075056861259,0,3061,0,2,2215,90.293453724605
20567,85,85430,81,"Tasa de exámenes médico legales por presunto delito sexual contra niños, niñas y adolescentes",2015,2,4,1704,234.741784037559,0,857,0,4,847,472.255017709563
20568,85,85430,81,"Tasa de exámenes médico legales por presunto delito sexual contra niños, niñas y adolescentes",2015,3,4,1965,203.562340966921,0,976,0,4,989,404.448938321537
20569,85,85430,81,"Tasa de exámenes médico legales por presunto delito sexual contra niños, niñas y adolescentes",2015,4,4,1940,206.185567010309,0,958,0,4,982,407.331975560081
20570,85,85440,81,"Tasa de exámenes médico legales por presunto delito sexual contra niños, niñas y adolescentes",2015,2,2,2426,82.4402308326463,0,1243,0,2,1183,169.061707523246
20571,85,85440,81,"Tasa de exámenes médico legales por presunto delito sexual contra niños, niñas y adolescentes",2015,3,3,2882,104.094378903539,1,1474,67.842605156038,2,1408,142.045454545455
20572,85,85440,81,"Tasa de exámenes médico legales por presunto delito sexual contra niños, niñas y adolescentes",2015,4,5,2964,168.690958164642,1,1510,66.2251655629139,4,1454,275.103163686382
20573,85,85440,121,Tasa de exámenes médico legales por presunto delito sexual cuando la víctima está entre 18 y 28 años,2015,5,3,4970,60.3621730382294,1,2469,40.5022276225192,2,2501,79.968012794882
20574,86,86001,81,"Tasa de exámenes médico legales por presunto delito sexual contra niños, niñas y adolescentes",2015,2,4,4303,92.9584011155008,1,2223,44.9842555105713,3,2080,144.230769230769
20575,86,86001,81,"Tasa de exámenes médico legales por presunto delito sexual contra niños, niñas y adolescentes",2015,3,12,5209,230.37051257439,3,2692,111.441307578009,9,2517,357.568533969011
20576,86,86001,81,"Tasa de exámenes médico legales por presunto delito sexual contra niños, niñas y adolescentes",2015,4,21,4934,425.618159708148,0,2524,0,21,2410,871.369294605809
20577,86,86001,121,Tasa de exámenes médico legales por presunto delito sexual cuando la víctima está entre 18 y 28 años,2015,5,3,8505,35.2733686067019,1,4131,24.2072137496974,2,4374,45.7247370827618
20578,86,86219,81,"Tasa de exámenes médico legales por presunto delito sexual contra niños, niñas y adolescentes",2015,3,1,581,172.117039586919,0,297,0,1,284,352.112676056338
20579,86,86320,81,"Tasa de exámenes médico legales por presunto delito sexual contra niños, niñas y adolescentes",2015,2,1,6785,14.7383935151069,1,3437,29.0951411114344,0,3348,0
20580,86,86320,81,"Tasa de exámenes médico legales por presunto delito sexual contra niños, niñas y adolescentes",2015,3,4,7740,51.6795865633075,2,3915,51.0855683269476,2,3825,52.2875816993464
20581,86,86320,81,"Tasa de exámenes médico legales por presunto delito sexual contra niños, niñas y adolescentes",2015,4,10,7731,129.349372655543,0,3985,0,10,3746,266.951414842499
20582,86,86320,121,Tasa de exámenes médico legales por presunto delito sexual cuando la víctima está entre 18 y 28 años,2015,5,2,10909,18.3334861123843,0,5621,0,2,5288,37.821482602118
20583,86,86568,81,"Tasa de exámenes médico legales por presunto delito sexual contra niños, niñas y adolescentes",2015,2,8,6746,118.588793359028,3,3429,87.4890638670166,5,3317,150.738619234248
20584,86,86568,81,"Tasa de exámenes médico legales por presunto delito sexual contra niños, niñas y adolescentes",2015,3,19,8036,236.436037829766,5,4079,122.579063495955,14,3957,353.803386403841
20585,86,86568,81,"Tasa de exámenes médico legales por presunto delito sexual contra niños, niñas y adolescentes",2015,4,14,7838,178.616994131156,1,3938,25.3936008125952,13,3900,333.333333333333
20586,86,86568,121,Tasa de exámenes médico legales por presunto delito sexual cuando la víctima está entre 18 y 28 años,2015,5,5,12646,39.5381938953029,1,6346,15.7579577686732,4,6300,63.4920634920635
20587,86,86569,81,"Tasa de exámenes médico legales por presunto delito sexual contra niños, niñas y adolescentes",2015,3,1,1864,53.6480686695279,0,933,0,1,931,107.411385606874
20588,86,86571,81,"Tasa de exámenes médico legales por presunto delito sexual contra niños, niñas y adolescentes",2015,3,1,3387,29.5246530853262,0,1761,0,1,1626,61.5006150061501
20589,86,86573,81,"Tasa de exámenes médico legales por presunto delito sexual contra niños, niñas y adolescentes",2015,2,1,1711,58.4453535943892,0,876,0,1,835,119.760479041916
20590,86,86573,81,"Tasa de exámenes médico legales por presunto delito sexual contra niños, niñas y adolescentes",2015,3,3,2037,147.275405007364,0,1048,0,3,989,303.336703741153
20591,86,86573,81,"Tasa de exámenes médico legales por presunto delito sexual contra niños, niñas y adolescentes",2015,4,14,1974,709.219858156028,2,1016,196.850393700787,12,958,1252.60960334029
20592,86,86573,121,Tasa de exámenes médico legales por presunto delito sexual cuando la víctima está entre 18 y 28 años,2015,5,1,3233,30.9310238168883,0,1661,0,1,1572,63.6132315521629
20593,86,86749,81,"Tasa de exámenes médico legales por presunto delito sexual contra niños, niñas y adolescentes",2015,2,1,1288,77.639751552795,1,667,149.925037481259,0,621,0
20594,86,86749,81,"Tasa de exámenes médico legales por presunto delito sexual contra niños, niñas y adolescentes",2015,3,1,1546,64.6830530401035,0,788,0,1,758,131.926121372032
20595,86,86749,121,Tasa de exámenes médico legales por presunto delito sexual cuando la víctima está entre 18 y 28 años,2015,5,1,2993,33.4112930170398,0,1509,0,1,1484,67.3854447439353
20596,86,86757,81,"Tasa de exámenes médico legales por presunto delito sexual contra niños, niñas y adolescentes",2015,2,1,3440,29.0697674418605,0,1738,0,1,1702,58.7544065804935
20597,86,86757,81,"Tasa de exámenes médico legales por presunto delito sexual contra niños, niñas y adolescentes",2015,3,3,3923,76.4720876879939,1,1978,50.5561172901921,2,1945,102.827763496144
20598,86,86757,81,"Tasa de exámenes médico legales por presunto delito sexual contra niños, niñas y adolescentes",2015,4,4,3904,102.459016393443,0,2001,0,4,1903,210.194429847609
20599,86,86757,121,Tasa de exámenes médico legales por presunto delito sexual cuando la víctima está entre 18 y 28 años,2015,5,1,5520,18.1159420289855,0,2835,0,1,2685,37.243947858473
20600,86,86760,81,"Tasa de exámenes médico legales por presunto delito sexual contra niños, niñas y adolescentes",2015,3,1,1250,80,0,631,0,1,619,161.550888529887
20601,86,86760,81,"Tasa de exámenes médico legales por presunto delito sexual contra niños, niñas y adolescentes",2015,4,1,1301,76.8639508070715,0,661,0,1,640,156.25
20602,86,86760,121,Tasa de exámenes médico legales por presunto delito sexual cuando la víctima está entre 18 y 28 años,2015,5,1,2107,47.4608448030375,0,1093,0,1,1014,98.6193293885602
20603,86,86865,81,"Tasa de exámenes médico legales por presunto delito sexual contra niños, niñas y adolescentes",2015,2,9,5630,159.857904085258,4,2876,139.082058414465,5,2754,181.554103122731
20604,86,86865,81,"Tasa de exámenes médico legales por presunto delito sexual contra niños, niñas y adolescentes",2015,3,10,6738,148.411991688928,1,3431,29.146021568056,9,3307,272.149984880556
20605,86,86865,81,"Tasa de exámenes médico legales por presunto delito sexual contra niños, niñas y adolescentes",2015,4,11,7039,156.272197755363,0,3555,0,11,3484,315.729047072331
20606,86,86865,121,Tasa de exámenes médico legales por presunto delito sexual cuando la víctima está entre 18 y 28 años,2015,5,3,10583,28.3473495228196,0,5422,0,3,5161,58.1282697151715
20607,86,86885,81,"Tasa de exámenes médico legales por presunto delito sexual contra niños, niñas y adolescentes",2015,2,6,2322,258.397932816537,2,1177,169.923534409516,4,1145,349.344978165939
20608,86,86885,81,"Tasa de exámenes médico legales por presunto delito sexual contra niños, niñas y adolescentes",2015,3,9,2703,332.963374028857,2,1353,147.819660014782,7,1350,518.518518518518
20609,86,86885,81,"Tasa de exámenes médico legales por presunto delito sexual contra niños, niñas y adolescentes",2015,4,4,2793,143.215180809166,0,1394,0,4,1399,285.918513223731
20610,88,88001,81,"Tasa de exámenes médico legales por presunto delito sexual contra niños, niñas y adolescentes",2015,2,4,5941,67.32873253661,0,3037,0,4,2904,137.741046831956
20611,88,88001,81,"Tasa de exámenes médico legales por presunto delito sexual contra niños, niñas y adolescentes",2015,3,7,7061,99.1360997025917,1,3602,27.7623542476402,6,3459,173.460537727667
20612,88,88001,81,"Tasa de exámenes médico legales por presunto delito sexual contra niños, niñas y adolescentes",2015,4,9,7281,123.609394313968,0,3709,0,9,3572,251.959686450168
20613,88,88001,121,Tasa de exámenes médico legales por presunto delito sexual cuando la víctima está entre 18 y 28 años,2015,5,2,13365,14.9644594089039,0,6841,0,2,6524,30.6560392397302
20614,91,91001,81,"Tasa de exámenes médico legales por presunto delito sexual contra niños, niñas y adolescentes",2015,2,9,4861,185.147089076322,4,2496,160.25641025641,5,2365,211.416490486258
20615,91,91001,81,"Tasa de exámenes médico legales por presunto delito sexual contra niños, niñas y adolescentes",2015,3,20,5584,358.166189111748,3,2853,105.15247108307,17,2731,622.482607103625
20616,91,91001,81,"Tasa de exámenes médico legales por presunto delito sexual contra niños, niñas y adolescentes",2015,4,34,5460,622.710622710623,1,2757,36.2713093942691,33,2703,1220.86570477248
20617,91,91001,121,Tasa de exámenes médico legales por presunto delito sexual cuando la víctima está entre 18 y 28 años,2015,5,5,9813,50.9528176908183,1,4831,20.6996481059822,4,4982,80.2890405459655
20618,91,91540,81,"Tasa de exámenes médico legales por presunto delito sexual contra niños, niñas y adolescentes",2015,2,1,1317,75.9301442672741,1,671,149.03129657228,0,646,0
20619,91,91540,81,"Tasa de exámenes médico legales por presunto delito sexual contra niños, niñas y adolescentes",2015,3,2,1342,149.03129657228,0,685,0,2,657,304.41400304414
20620,91,91540,81,"Tasa de exámenes médico legales por presunto delito sexual contra niños, niñas y adolescentes",2015,4,1,1202,83.1946755407654,0,614,0,1,588,170.068027210884
20621,91,91669,81,"Tasa de exámenes médico legales por presunto delito sexual contra niños, niñas y adolescentes",2015,4,1,374,267.379679144385,0,198,0,1,176,568.181818181818
20622,94,94001,81,"Tasa de exámenes médico legales por presunto delito sexual contra niños, niñas y adolescentes",2015,2,2,2338,85.5431993156544,0,1210,0,2,1128,177.304964539007
20623,94,94001,81,"Tasa de exámenes médico legales por presunto delito sexual contra niños, niñas y adolescentes",2015,3,9,2703,332.963374028857,1,1388,72.0461095100865,8,1315,608.365019011407
20624,94,94001,81,"Tasa de exámenes médico legales por presunto delito sexual contra niños, niñas y adolescentes",2015,4,12,2790,430.10752688172,0,1439,0,12,1351,888.230940044411
20625,94,94001,121,Tasa de exámenes médico legales por presunto delito sexual cuando la víctima está entre 18 y 28 años,2015,5,4,4707,84.9798172933928,0,2386,0,4,2321,172.3395088324
20626,94,94001,81,"Tasa de exámenes médico legales por presunto delito sexual contra niños, niñas y adolescentes",2015,1,1,457,218.818380743982,0,236,0,1,221,452.488687782805
20627,95,95001,81,"Tasa de exámenes médico legales por presunto delito sexual contra niños, niñas y adolescentes",2015,2,4,8608,46.4684014869888,0,4410,0,4,4198,95.2834683182468
20628,95,95001,81,"Tasa de exámenes médico legales por presunto delito sexual contra niños, niñas y adolescentes",2015,3,14,9719,144.047741537195,2,4941,40.4776361060514,12,4778,251.151109250733
20629,95,95001,81,"Tasa de exámenes médico legales por presunto delito sexual contra niños, niñas y adolescentes",2015,4,14,8814,158.838211935557,0,4445,0,14,4369,320.439459830625
20630,95,95001,121,Tasa de exámenes médico legales por presunto delito sexual cuando la víctima está entre 18 y 28 años,2015,5,5,14102,35.4559636930932,0,6981,0,5,7121,70.2148574638394
20631,95,95015,121,Tasa de exámenes médico legales por presunto delito sexual cuando la víctima está entre 18 y 28 años,2015,5,1,1840,54.3478260869565,0,1002,0,1,838,119.331742243437
20632,95,95025,81,"Tasa de exámenes médico legales por presunto delito sexual contra niños, niñas y adolescentes",2015,4,1,3361,29.753049687593,0,1659,0,1,1702,58.7544065804935
20633,95,95200,81,"Tasa de exámenes médico legales por presunto delito sexual contra niños, niñas y adolescentes",2015,4,1,1603,62.3830318153462,0,819,0,1,784,127.551020408163
20634,99,99001,81,"Tasa de exámenes médico legales por presunto delito sexual contra niños, niñas y adolescentes",2015,2,1,1952,51.2295081967213,0,1027,0,1,925,108.108108108108
20635,99,99001,81,"Tasa de exámenes médico legales por presunto delito sexual contra niños, niñas y adolescentes",2015,3,6,2268,264.550264550265,0,1214,0,6,1054,569.259962049336
20636,99,99001,81,"Tasa de exámenes médico legales por presunto delito sexual contra niños, niñas y adolescentes",2015,4,11,2238,491.510277033065,1,1182,84.6023688663282,10,1056,946.969696969697
20637,99,99001,121,Tasa de exámenes médico legales por presunto delito sexual cuando la víctima está entre 18 y 28 años,2015,5,2,3990,50.125313283208,0,2109,0,2,1881,106.326422115896
20638,99,99524,81,"Tasa de exámenes médico legales por presunto delito sexual contra niños, niñas y adolescentes",2015,4,1,2009,49.7760079641613,0,1027,0,1,982,101.83299389002
20639,99,99773,81,"Tasa de exámenes médico legales por presunto delito sexual contra niños, niñas y adolescentes",2015,3,1,5946,16.8180289270098,1,2990,33.4448160535117,0,2956,0
20640,99,99773,81,"Tasa de exámenes médico legales por presunto delito sexual contra niños, niñas y adolescentes",2015,4,1,5413,18.4740439682246,0,2723,0,1,2690,37.1747211895911
