id,cdep,cmun,cindica,nomind,periodo,edadR,casos,poblacion,tasa,casosh,poblacionh,tasah,casosm,poblacionm,tasam
16201,85,85001,81,"Tasa de exámenes médico legales por presunto delito sexual contra niños, niñas y adolescentes",2014,2,22,13119,167.695708514368,7,6722,104.135673906575,15,6397,234.484914803814
16202,19,19001,81,"Tasa de exámenes médico legales por presunto delito sexual contra niños, niñas y adolescentes",2014,2,17,18778,90.5314730003195,5,9574,52.2247754334656,12,9204,130.378096479791
16203,50,50006,81,"Tasa de exámenes médico legales por presunto delito sexual contra niños, niñas y adolescentes",2014,2,8,6252,127.959053103007,0,3167,0,8,3085,259.319286871961
16204,50,50226,81,"Tasa de exámenes médico legales por presunto delito sexual contra niños, niñas y adolescentes",2014,2,2,1927,103.788271925272,0,986,0,2,941,212.539851222104
16205,63,63001,81,"Tasa de exámenes médico legales por presunto delito sexual contra niños, niñas y adolescentes",2014,2,55,22838,240.826692354847,17,11656,145.847632120796,38,11182,339.831872652477
16206,5,5001,81,"Tasa de exámenes médico legales por presunto delito sexual contra niños, niñas y adolescentes",2014,2,188,146476,128.348671454709,50,74886,66.7681542611436,138,71590,192.764352563207
16207,68,68001,81,"Tasa de exámenes médico legales por presunto delito sexual contra niños, niñas y adolescentes",2014,2,45,35849,125.526513989233,13,18321,70.9568255007915,32,17528,182.565038795071
16208,8,8001,81,"Tasa de exámenes médico legales por presunto delito sexual contra niños, niñas y adolescentes",2014,2,86,98524,87.2883764361983,14,50392,27.7821876488331,72,48132,149.588631264024
16209,8,8758,81,"Tasa de exámenes médico legales por presunto delito sexual contra niños, niñas y adolescentes",2014,2,22,55984,39.2969419834238,9,28594,31.4751346436315,13,27390,47.4625775830595
16210,47,47001,81,"Tasa de exámenes médico legales por presunto delito sexual contra niños, niñas y adolescentes",2014,2,31,46886,66.1178176854498,12,23960,50.0834724540901,19,22926,82.875338044142
16211,76,76001,81,"Tasa de exámenes médico legales por presunto delito sexual contra niños, niñas y adolescentes",2014,2,193,176146,109.568199107558,48,90121,53.2617259018431,145,86025,168.55565242662
16212,11,11001,81,"Tasa de exámenes médico legales por presunto delito sexual contra niños, niñas y adolescentes",2014,2,683,599879,113.856294352694,179,307453,58.2202808234104,504,292426,172.35129571242
16213,76,76111,81,"Tasa de exámenes médico legales por presunto delito sexual contra niños, niñas y adolescentes",2014,2,12,8026,149.514079242462,5,4125,121.212121212121,7,3901,179.441168931043
16214,13,13001,81,"Tasa de exámenes médico legales por presunto delito sexual contra niños, niñas y adolescentes",2014,2,70,83668,83.6640053544963,11,42686,25.7695731621609,59,40982,143.965643453223
16215,15,15001,81,"Tasa de exámenes médico legales por presunto delito sexual contra niños, niñas y adolescentes",2014,2,13,14729,88.261253309797,2,7541,26.5216814746055,11,7188,153.032832498609
16216,20,20001,81,"Tasa de exámenes médico legales por presunto delito sexual contra niños, niñas y adolescentes",2014,2,47,43963,106.908081796056,11,22378,49.155420502279,36,21585,166.782487838777
16217,27,27001,81,"Tasa de exámenes médico legales por presunto delito sexual contra niños, niñas y adolescentes",2014,2,18,15049,119.609276363878,2,7661,26.1062524474612,16,7388,216.567406605306
16218,50,50001,81,"Tasa de exámenes médico legales por presunto delito sexual contra niños, niñas y adolescentes",2014,2,108,42144,256.26423690205,29,21509,134.82728160305,79,20635,382.84468136661
16219,54,54810,81,"Tasa de exámenes médico legales por presunto delito sexual contra niños, niñas y adolescentes",2014,2,2,4651,43.0015050526768,0,2388,0,2,2263,88.3782589482987
16220,54,54001,81,"Tasa de exámenes médico legales por presunto delito sexual contra niños, niñas y adolescentes",2014,2,31,55987,55.3699966063551,10,28543,35.034859685387,21,27444,76.5194578049847
16221,70,70001,81,"Tasa de exámenes médico legales por presunto delito sexual contra niños, niñas y adolescentes",2014,2,29,23742,122.14640721085,11,12139,90.6170195238487,18,11603,155.132293372404
16222,41,41001,81,"Tasa de exámenes médico legales por presunto delito sexual contra niños, niñas y adolescentes",2014,2,38,26624,142.728365384615,13,13542,95.9976369812435,25,13082,191.102277939153
16223,76,76497,81,"Tasa de exámenes médico legales por presunto delito sexual contra niños, niñas y adolescentes",2014,2,1,1434,69.7350069735007,1,737,135.685210312076,0,697,0
16224,76,76892,81,"Tasa de exámenes médico legales por presunto delito sexual contra niños, niñas y adolescentes",2014,2,14,9107,153.727901614143,5,4658,107.342206955775,9,4449,202.292650033715
16225,5,5631,81,"Tasa de exámenes médico legales por presunto delito sexual contra niños, niñas y adolescentes",2014,2,6,2757,217.627856365615,2,1401,142.755174875089,4,1356,294.985250737463
16226,27,27361,81,"Tasa de exámenes médico legales por presunto delito sexual contra niños, niñas y adolescentes",2014,2,4,3155,126.782884310618,0,1576,0,4,1579,253.324889170361
16227,54,54498,81,"Tasa de exámenes médico legales por presunto delito sexual contra niños, niñas y adolescentes",2014,2,7,8821,79.356082076862,2,4471,44.7327219861329,5,4350,114.942528735632
16228,76,76520,81,"Tasa de exámenes médico legales por presunto delito sexual contra niños, niñas y adolescentes",2014,2,18,21007,85.6857238063503,3,10736,27.9433681073025,15,10271,146.042254892416
16229,15,15572,81,"Tasa de exámenes médico legales por presunto delito sexual contra niños, niñas y adolescentes",2014,2,3,5153,58.218513487289,0,2633,0,3,2520,119.047619047619
16230,76,76622,81,"Tasa de exámenes médico legales por presunto delito sexual contra niños, niñas y adolescentes",2014,2,4,2625,152.380952380952,2,1345,148.698884758364,2,1280,156.25
16231,25,25740,81,"Tasa de exámenes médico legales por presunto delito sexual contra niños, niñas y adolescentes",2014,2,5,3254,153.657037492317,1,1658,60.313630880579,4,1596,250.62656641604
16232,25,25754,81,"Tasa de exámenes médico legales por presunto delito sexual contra niños, niñas y adolescentes",2014,2,59,46936,125.703085051986,16,24066,66.483836117344,43,22870,188.019239177962
16233,68,68077,81,"Tasa de exámenes médico legales por presunto delito sexual contra niños, niñas y adolescentes",2014,2,3,2510,119.521912350598,1,1291,77.4593338497289,2,1219,164.068908941756
16234,25,25875,81,"Tasa de exámenes médico legales por presunto delito sexual contra niños, niñas y adolescentes",2014,2,11,2164,508.317929759704,7,1103,634.632819582956,4,1061,377.002827521206
16235,17,17001,81,"Tasa de exámenes médico legales por presunto delito sexual contra niños, niñas y adolescentes",2014,2,42,25858,162.425554953979,12,13210,90.8402725208176,30,12648,237.19165085389
16236,68,68655,81,"Tasa de exámenes médico legales por presunto delito sexual contra niños, niñas y adolescentes",2014,2,2,1773,112.803158488438,0,908,0,2,865,231.21387283237
16237,25,25438,81,"Tasa de exámenes médico legales por presunto delito sexual contra niños, niñas y adolescentes",2014,2,2,1128,177.304964539007,0,583,0,2,545,366.97247706422
16238,86,86885,81,"Tasa de exámenes médico legales por presunto delito sexual contra niños, niñas y adolescentes",2014,2,3,2325,129.032258064516,0,1179,0,3,1146,261.780104712042
16239,63,63594,81,"Tasa de exámenes médico legales por presunto delito sexual contra niños, niñas y adolescentes",2014,2,5,2927,170.82336863683,1,1503,66.5335994677312,4,1424,280.898876404494
16240,68,68307,81,"Tasa de exámenes médico legales por presunto delito sexual contra niños, niñas y adolescentes",2014,2,21,14547,144.359661785935,6,7427,80.7863201831157,15,7120,210.674157303371
16241,66,66001,81,"Tasa de exámenes médico legales por presunto delito sexual contra niños, niñas y adolescentes",2014,2,65,34255,189.753320683112,17,17546,96.8881796420837,48,16709,287.270333353283
16242,66,66170,81,"Tasa de exámenes médico legales por presunto delito sexual contra niños, niñas y adolescentes",2014,2,18,15133,118.94535121919,3,7766,38.6299253154777,15,7367,203.610696348582
16243,17,17042,81,"Tasa de exámenes médico legales por presunto delito sexual contra niños, niñas y adolescentes",2014,2,6,2850,210.526315789474,0,1444,0,6,1406,426.74253200569
16244,20,20710,81,"Tasa de exámenes médico legales por presunto delito sexual contra niños, niñas y adolescentes",2014,2,2,2501,79.968012794882,1,1272,78.6163522012579,1,1229,81.366965012205
16245,73,73268,81,"Tasa de exámenes médico legales por presunto delito sexual contra niños, niñas y adolescentes",2014,2,3,6728,44.589774078478,1,3444,29.0360046457607,2,3284,60.9013398294762
16246,25,25269,81,"Tasa de exámenes médico legales por presunto delito sexual contra niños, niñas y adolescentes",2014,2,13,12001,108.324306307808,3,6151,48.7725573077548,10,5850,170.940170940171
16247,41,41319,81,"Tasa de exámenes médico legales por presunto delito sexual contra niños, niñas y adolescentes",2014,2,1,2450,40.8163265306122,0,1250,0,1,1200,83.3333333333333
16248,66,66682,81,"Tasa de exámenes médico legales por presunto delito sexual contra niños, niñas y adolescentes",2014,2,5,5868,85.2079072937969,3,3014,99.535500995355,2,2854,70.0770847932726
16249,76,76834,81,"Tasa de exámenes médico legales por presunto delito sexual contra niños, niñas y adolescentes",2014,2,14,16096,86.9781312127237,3,8264,36.3020329138432,11,7832,140.449438202247
16250,25,25843,81,"Tasa de exámenes médico legales por presunto delito sexual contra niños, niñas y adolescentes",2014,2,7,3794,184.50184501845,2,1926,103.842159916926,5,1868,267.665952890792
16251,5,5088,81,"Tasa de exámenes médico legales por presunto delito sexual contra niños, niñas y adolescentes",2014,2,29,37087,78.1945155984577,6,18942,31.675641431739,23,18145,126.75668228162
16252,15,15500,81,"Tasa de exámenes médico legales por presunto delito sexual contra niños, niñas y adolescentes",2014,2,1,289,346.020761245675,0,149,0,1,140,714.285714285714
16253,19,19807,81,"Tasa de exámenes médico legales por presunto delito sexual contra niños, niñas y adolescentes",2014,2,3,2677,112.065745237206,1,1379,72.5163161711385,2,1298,154.083204930663
16254,23,23686,81,"Tasa de exámenes médico legales por presunto delito sexual contra niños, niñas y adolescentes",2014,2,1,3999,25.0062515628907,1,2050,48.780487804878,0,1949,0
16255,54,54405,81,"Tasa de exámenes médico legales por presunto delito sexual contra niños, niñas y adolescentes",2014,2,3,6331,47.3858790080556,2,3213,62.2471210706505,1,3118,32.071840923669
16256,68,68276,81,"Tasa de exámenes médico legales por presunto delito sexual contra niños, niñas y adolescentes",2014,2,22,18357,119.84529062483,7,9422,74.2942050520059,15,8935,167.879127028539
16257,8,8421,81,"Tasa de exámenes médico legales por presunto delito sexual contra niños, niñas y adolescentes",2014,2,1,2823,35.4233085370174,1,1448,69.060773480663,0,1375,0
16258,8,8638,81,"Tasa de exámenes médico legales por presunto delito sexual contra niños, niñas y adolescentes",2014,2,3,9899,30.3060915243964,0,5091,0,3,4808,62.396006655574
16259,68,68573,81,"Tasa de exámenes médico legales por presunto delito sexual contra niños, niñas y adolescentes",2014,2,2,896,223.214285714286,0,461,0,2,435,459.770114942529
16260,76,76109,81,"Tasa de exámenes médico legales por presunto delito sexual contra niños, niñas y adolescentes",2014,2,16,41481,38.5718762807068,8,21242,37.6612371716411,8,20239,39.5276446464746
16261,25,25594,81,"Tasa de exámenes médico legales por presunto delito sexual contra niños, niñas y adolescentes",2014,2,1,592,168.918918918919,0,308,0,1,284,352.112676056338
16262,13,13244,81,"Tasa de exámenes médico legales por presunto delito sexual contra niños, niñas y adolescentes",2014,2,6,9055,66.2617338487024,1,4648,21.5146299483649,5,4407,113.455865668255
16263,25,25286,81,"Tasa de exámenes médico legales por presunto delito sexual contra niños, niñas y adolescentes",2014,2,5,6562,76.1962816214569,1,3320,30.1204819277108,4,3242,123.380629241209
16264,17,17380,81,"Tasa de exámenes médico legales por presunto delito sexual contra niños, niñas y adolescentes",2014,2,7,7137,98.0804259492784,0,3684,0,7,3453,202.722270489429
16265,54,54518,81,"Tasa de exámenes médico legales por presunto delito sexual contra niños, niñas y adolescentes",2014,2,5,4138,120.831319478009,0,2097,0,5,2041,244.977951984321
16266,44,44650,81,"Tasa de exámenes médico legales por presunto delito sexual contra niños, niñas y adolescentes",2014,2,2,4124,48.4966052376334,1,2134,46.8603561387067,1,1990,50.251256281407
16267,50,50606,81,"Tasa de exámenes médico legales por presunto delito sexual contra niños, niñas y adolescentes",2014,2,1,1028,97.2762645914397,0,526,0,1,502,199.203187250996
16268,52,52001,81,"Tasa de exámenes médico legales por presunto delito sexual contra niños, niñas y adolescentes",2014,2,18,31593,56.9746462824043,5,16168,30.9252845126175,13,15425,84.2787682333874
16269,73,73001,81,"Tasa de exámenes médico legales por presunto delito sexual contra niños, niñas y adolescentes",2014,2,30,43895,68.3449139993166,10,22434,44.5751983596327,20,21461,93.1923023158287
16270,68,68235,81,"Tasa de exámenes médico legales por presunto delito sexual contra niños, niñas y adolescentes",2014,2,2,1863,107.353730542136,0,957,0,2,906,220.75055187638
16271,66,66400,81,"Tasa de exámenes médico legales por presunto delito sexual contra niños, niñas y adolescentes",2014,2,6,2795,214.669051878354,1,1425,70.1754385964912,5,1370,364.963503649635
16272,68,68081,81,"Tasa de exámenes médico legales por presunto delito sexual contra niños, niñas y adolescentes",2014,2,21,15913,131.967573681895,4,8176,48.9236790606654,17,7737,219.723407005299
16273,63,63130,81,"Tasa de exámenes médico legales por presunto delito sexual contra niños, niñas y adolescentes",2014,2,16,6466,247.448190535107,2,3337,59.9340725202278,14,3129,447.427293064877
16274,76,76147,81,"Tasa de exámenes médico legales por presunto delito sexual contra niños, niñas y adolescentes",2014,2,11,10127,108.620519403575,3,5157,58.173356602676,8,4970,160.965794768612
16275,25,25290,81,"Tasa de exámenes médico legales por presunto delito sexual contra niños, niñas y adolescentes",2014,2,13,10433,124.604619955909,5,5302,94.3040362127499,8,5131,155.915026310661
16276,52,52356,81,"Tasa de exámenes médico legales por presunto delito sexual contra niños, niñas y adolescentes",2014,2,4,12091,33.0824580266314,0,6212,0,4,5879,68.0387821058003
16277,44,44035,81,"Tasa de exámenes médico legales por presunto delito sexual contra niños, niñas y adolescentes",2014,2,2,3368,59.3824228028504,0,1730,0,2,1638,122.100122100122
16278,15,15469,81,"Tasa de exámenes médico legales por presunto delito sexual contra niños, niñas y adolescentes",2014,2,3,1862,161.117078410312,0,958,0,3,904,331.858407079646
16279,86,86320,81,"Tasa de exámenes médico legales por presunto delito sexual contra niños, niñas y adolescentes",2014,2,2,6647,30.08876184745,1,3361,29.753049687593,1,3286,30.4321363359708
16280,23,23001,81,"Tasa de exámenes médico legales por presunto delito sexual contra niños, niñas y adolescentes",2014,2,20,40728,49.1062659595364,4,20735,19.2910537738124,16,19993,80.0280098034312
16281,44,44090,81,"Tasa de exámenes médico legales por presunto delito sexual contra niños, niñas y adolescentes",2014,2,5,4315,115.874855156431,1,2211,45.2284034373587,4,2104,190.114068441065
16282,5,5360,81,"Tasa de exámenes médico legales por presunto delito sexual contra niños, niñas y adolescentes",2014,2,13,20459,63.5417175815045,0,10501,0,13,9958,130.548302872063
16283,25,25307,81,"Tasa de exámenes médico legales por presunto delito sexual contra niños, niñas y adolescentes",2014,2,13,7815,166.346769033909,7,3914,178.845171180378,6,3901,153.806716226609
16284,50,50313,81,"Tasa de exámenes médico legales por presunto delito sexual contra niños, niñas y adolescentes",2014,2,9,6451,139.513253759107,3,3288,91.2408759124088,6,3163,189.693329117926
16285,5,5380,81,"Tasa de exámenes médico legales por presunto delito sexual contra niños, niñas y adolescentes",2014,2,4,5064,78.9889415481832,1,2603,38.4172109104879,3,2461,121.901665989435
16286,44,44847,81,"Tasa de exámenes médico legales por presunto delito sexual contra niños, niñas y adolescentes",2014,2,4,23789,16.8144940939089,0,12077,0,4,11712,34.1530054644809
16287,68,68861,81,"Tasa de exámenes médico legales por presunto delito sexual contra niños, niñas y adolescentes",2014,2,2,2012,99.403578528827,1,1041,96.0614793467819,1,971,102.986611740474
16288,13,13222,81,"Tasa de exámenes médico legales por presunto delito sexual contra niños, niñas y adolescentes",2014,2,3,1445,207.612456747405,2,749,267.022696929239,1,696,143.67816091954
16289,13,13873,81,"Tasa de exámenes médico legales por presunto delito sexual contra niños, niñas y adolescentes",2014,2,3,2030,147.783251231527,0,1039,0,3,991,302.724520686176
16290,18,18001,81,"Tasa de exámenes médico legales por presunto delito sexual contra niños, niñas y adolescentes",2014,2,9,16579,54.2855419506605,1,8382,11.9303268909568,8,8197,97.5966817128218
16291,19,19130,81,"Tasa de exámenes médico legales por presunto delito sexual contra niños, niñas y adolescentes",2014,2,1,4017,24.8941996514812,0,2056,0,1,1961,50.9943906170321
16292,20,20400,81,"Tasa de exámenes médico legales por presunto delito sexual contra niños, niñas y adolescentes",2014,2,2,2575,77.6699029126214,0,1328,0,2,1247,160.384923817161
16293,44,44001,81,"Tasa de exámenes médico legales por presunto delito sexual contra niños, niñas y adolescentes",2014,2,7,33872,20.6660368445914,1,17351,5.76335657887153,6,16521,36.3174142001089
16294,50,50568,81,"Tasa de exámenes médico legales por presunto delito sexual contra niños, niñas y adolescentes",2014,2,6,2630,228.136882129278,0,1358,0,6,1272,471.698113207547
16295,41,41524,81,"Tasa de exámenes médico legales por presunto delito sexual contra niños, niñas y adolescentes",2014,2,2,3133,63.8365783593999,0,1599,0,2,1534,130.378096479791
16296,50,50573,81,"Tasa de exámenes médico legales por presunto delito sexual contra niños, niñas y adolescentes",2014,2,7,3455,202.60492040521,2,1783,112.170499158721,5,1672,299.043062200957
16297,20,20011,81,"Tasa de exámenes médico legales por presunto delito sexual contra niños, niñas y adolescentes",2014,2,5,9627,51.9372597901735,1,4915,20.3458799593082,4,4712,84.8896434634974
16298,5,5266,81,"Tasa de exámenes médico legales por presunto delito sexual contra niños, niñas y adolescentes",2014,2,19,15483,122.715236065362,4,7915,50.5369551484523,15,7568,198.202959830867
16299,17,17524,81,"Tasa de exámenes médico legales por presunto delito sexual contra niños, niñas y adolescentes",2014,2,2,1726,115.874855156431,0,887,0,2,839,238.379022646007
16300,68,68190,81,"Tasa de exámenes médico legales por presunto delito sexual contra niños, niñas y adolescentes",2014,2,7,4741,147.648175490403,3,2450,122.448979591837,4,2291,174.596246180707
16301,27,27135,81,"Tasa de exámenes médico legales por presunto delito sexual contra niños, niñas y adolescentes",2014,2,2,1003,199.401794616152,0,508,0,2,495,404.040404040404
16302,13,13268,81,"Tasa de exámenes médico legales por presunto delito sexual contra niños, niñas y adolescentes",2014,2,1,1168,85.6164383561644,0,601,0,1,567,176.36684303351
16303,25,25430,81,"Tasa de exámenes médico legales por presunto delito sexual contra niños, niñas y adolescentes",2014,2,13,7108,182.892515475521,2,3610,55.4016620498615,11,3498,314.465408805031
16304,44,44430,81,"Tasa de exámenes médico legales por presunto delito sexual contra niños, niñas y adolescentes",2014,2,7,19890,35.1935646053293,1,10152,9.85027580772262,6,9738,61.6142945163278
16305,73,73055,81,"Tasa de exámenes médico legales por presunto delito sexual contra niños, niñas y adolescentes",2014,2,2,1089,183.654729109275,2,558,358.4229390681,0,531,0
16306,15,15542,81,"Tasa de exámenes médico legales por presunto delito sexual contra niños, niñas y adolescentes",2014,2,1,691,144.717800289436,0,357,0,1,334,299.40119760479
16307,25,25718,81,"Tasa de exámenes médico legales por presunto delito sexual contra niños, niñas y adolescentes",2014,2,1,860,116.279069767442,0,442,0,1,418,239.234449760766
16308,25,25899,81,"Tasa de exámenes médico legales por presunto delito sexual contra niños, niñas y adolescentes",2014,2,5,10608,47.1342383107089,1,5456,18.3284457478006,4,5152,77.639751552795
16309,13,13052,81,"Tasa de exámenes médico legales por presunto delito sexual contra niños, niñas y adolescentes",2014,2,3,7339,40.8775037471045,0,3743,0,3,3596,83.4260289210234
16310,23,23162,81,"Tasa de exámenes médico legales por presunto delito sexual contra niños, niñas y adolescentes",2014,2,5,8226,60.7828835399951,0,4189,0,5,4037,123.85434728759
16311,70,70473,81,"Tasa de exámenes médico legales por presunto delito sexual contra niños, niñas y adolescentes",2014,2,2,1407,142.146410803127,0,729,0,2,678,294.985250737463
16312,19,19548,81,"Tasa de exámenes médico legales por presunto delito sexual contra niños, niñas y adolescentes",2014,2,1,3967,25.2079657171666,0,2024,0,1,1943,51.4668039114771
16313,5,5172,81,"Tasa de exámenes médico legales por presunto delito sexual contra niños, niñas y adolescentes",2014,2,5,8967,55.7600089216014,1,4566,21.9010074463425,4,4401,90.8884344467167
16314,15,15176,81,"Tasa de exámenes médico legales por presunto delito sexual contra niños, niñas y adolescentes",2014,2,5,5659,88.3548330093656,2,2909,68.7521485046408,3,2750,109.090909090909
16315,25,25426,81,"Tasa de exámenes médico legales por presunto delito sexual contra niños, niñas y adolescentes",2014,2,1,578,173.010380622837,0,292,0,1,286,349.65034965035
16316,15,15299,81,"Tasa de exámenes médico legales por presunto delito sexual contra niños, niñas y adolescentes",2014,2,3,1517,197.7587343441,0,773,0,3,744,403.225806451613
16317,5,5679,81,"Tasa de exámenes médico legales por presunto delito sexual contra niños, niñas y adolescentes",2014,2,1,2079,48.1000481000481,0,1061,0,1,1018,98.2318271119843
16318,54,54223,81,"Tasa de exámenes médico legales por presunto delito sexual contra niños, niñas y adolescentes",2014,2,1,897,111.482720178372,0,465,0,1,432,231.481481481481
16319,25,25200,81,"Tasa de exámenes médico legales por presunto delito sexual contra niños, niñas y adolescentes",2014,2,1,1996,50.1002004008016,0,1003,0,1,993,100.704934541793
16320,13,13683,81,"Tasa de exámenes médico legales por presunto delito sexual contra niños, niñas y adolescentes",2014,2,1,2499,40.016006402561,1,1279,78.1860828772479,0,1220,0
16321,63,63470,81,"Tasa de exámenes médico legales por presunto delito sexual contra niños, niñas y adolescentes",2014,2,11,3565,308.55539971949503,0,1828,0,11,1737,633.275762809442
16322,63,63190,81,"Tasa de exámenes médico legales por presunto delito sexual contra niños, niñas y adolescentes",2014,2,3,2369,126.635711270578,1,1206,82.9187396351576,2,1163,171.969045571797
16323,5,5212,81,"Tasa de exámenes médico legales por presunto delito sexual contra niños, niñas y adolescentes",2014,2,8,4730,169.133192389006,1,2419,41.3393964448119,7,2311,302.899177845089
16324,66,66687,81,"Tasa de exámenes médico legales por presunto delito sexual contra niños, niñas y adolescentes",2014,2,2,1449,138.026224982747,1,739,135.31799729364,1,710,140.845070422535
16325,66,66045,81,"Tasa de exámenes médico legales por presunto delito sexual contra niños, niñas y adolescentes",2014,2,2,1832,109.170305676856,1,940,106.382978723404,1,892,112.107623318386
16326,66,66088,81,"Tasa de exámenes médico legales por presunto delito sexual contra niños, niñas y adolescentes",2014,2,5,2585,193.423597678917,3,1325,226.415094339623,2,1260,158.730158730159
16327,5,5190,81,"Tasa de exámenes médico legales por presunto delito sexual contra niños, niñas y adolescentes",2014,2,2,770,259.74025974026,0,395,0,2,375,533.333333333333
16328,25,25001,81,"Tasa de exámenes médico legales por presunto delito sexual contra niños, niñas y adolescentes",2014,2,1,912,109.649122807018,0,472,0,1,440,227.272727272727
16329,73,73870,81,"Tasa de exámenes médico legales por presunto delito sexual contra niños, niñas y adolescentes",2014,2,1,1087,91.9963201471941,0,559,0,1,528,189.393939393939
16330,13,13458,81,"Tasa de exámenes médico legales por presunto delito sexual contra niños, niñas y adolescentes",2014,2,1,2455,40.7331975560082,0,1258,0,1,1197,83.5421888053467
16331,86,86568,81,"Tasa de exámenes médico legales por presunto delito sexual contra niños, niñas y adolescentes",2014,2,3,6848,43.8084112149533,0,3490,0,3,3358,89.3388921977367
16332,68,68051,81,"Tasa de exámenes médico legales por presunto delito sexual contra niños, niñas y adolescentes",2014,2,1,745,134.228187919463,0,390,0,1,355,281.69014084507
16333,76,76364,81,"Tasa de exámenes médico legales por presunto delito sexual contra niños, niñas y adolescentes",2014,2,5,9773,51.1613629387087,1,5023,19.9084212621939,4,4750,84.2105263157895
16334,5,5045,81,"Tasa de exámenes médico legales por presunto delito sexual contra niños, niñas y adolescentes",2014,2,13,20828,62.4159784904936,2,10662,18.758206715438,11,10166,108.203816643714
16335,25,25736,81,"Tasa de exámenes médico legales por presunto delito sexual contra niños, niñas y adolescentes",2014,2,1,1318,75.8725341426404,0,674,0,1,644,155.27950310559
16336,47,47189,81,"Tasa de exámenes médico legales por presunto delito sexual contra niños, niñas y adolescentes",2014,2,1,11182,8.94294401717045,0,5745,0,1,5437,18.3924958616884
16337,5,5129,81,"Tasa de exámenes médico legales por presunto delito sexual contra niños, niñas y adolescentes",2014,2,7,5739,121.972469071267,3,2931,102.354145342886,4,2808,142.450142450142
16338,5,5615,81,"Tasa de exámenes médico legales por presunto delito sexual contra niños, niñas y adolescentes",2014,2,9,9950,90.4522613065327,2,5100,39.2156862745098,7,4850,144.329896907216
16339,81,81001,81,"Tasa de exámenes médico legales por presunto delito sexual contra niños, niñas y adolescentes",2014,2,20,11235,178.015131286159,6,5678,105.671010919338,14,5557,251.934497030772
16340,73,73547,81,"Tasa de exámenes médico legales por presunto delito sexual contra niños, niñas y adolescentes",2014,2,1,554,180.505415162455,0,283,0,1,271,369.0036900369
16341,8,8296,81,"Tasa de exámenes médico legales por presunto delito sexual contra niños, niñas y adolescentes",2014,2,2,4223,47.3596968979399,0,2172,0,2,2051,97.5134080936129
16342,41,41206,81,"Tasa de exámenes médico legales por presunto delito sexual contra niños, niñas y adolescentes",2014,2,3,1243,241.351568785197,0,639,0,3,604,496.688741721854
16343,5,5034,81,"Tasa de exámenes médico legales por presunto delito sexual contra niños, niñas y adolescentes",2014,2,3,4364,68.7442713107241,2,2228,89.7666068222621,1,2136,46.8164794007491
16344,5,5837,81,"Tasa de exámenes médico legales por presunto delito sexual contra niños, niñas y adolescentes",2014,2,6,18724,32.0444349497971,1,9702,10.307153164296,5,9022,55.420084238528
16345,5,5440,81,"Tasa de exámenes médico legales por presunto delito sexual contra niños, niñas y adolescentes",2014,2,5,5347,93.5103796521414,0,2713,0,5,2634,189.825360668185
16346,5,5376,81,"Tasa de exámenes médico legales por presunto delito sexual contra niños, niñas y adolescentes",2014,2,5,4535,110.253583241455,4,2321,172.3395088324,1,2214,45.16711833785
16347,47,47245,81,"Tasa de exámenes médico legales por presunto delito sexual contra niños, niñas y adolescentes",2014,2,5,6767,73.8879858135067,1,3461,28.8933834151979,4,3306,120.992135511192
16348,23,23672,81,"Tasa de exámenes médico legales por presunto delito sexual contra niños, niñas y adolescentes",2014,2,2,3200,62.5,0,1629,0,2,1571,127.307447485678
16349,13,13430,81,"Tasa de exámenes médico legales por presunto delito sexual contra niños, niñas y adolescentes",2014,2,6,12959,46.2998688170384,3,6640,45.1807228915663,3,6319,47.4758664345624
16350,76,76130,81,"Tasa de exámenes médico legales por presunto delito sexual contra niños, niñas y adolescentes",2014,2,2,5983,33.4280461307037,0,3080,0,2,2903,68.8942473303479
16351,54,54520,81,"Tasa de exámenes médico legales por presunto delito sexual contra niños, niñas y adolescentes",2014,2,1,477,209.643605870021,0,243,0,1,234,427.350427350427
16352,54,54172,81,"Tasa de exámenes médico legales por presunto delito sexual contra niños, niñas y adolescentes",2014,2,1,1563,63.9795265515035,0,796,0,1,767,130.378096479791
16353,76,76122,81,"Tasa de exámenes médico legales por presunto delito sexual contra niños, niñas y adolescentes",2014,2,2,2336,85.6164383561644,1,1202,83.1946755407654,1,1134,88.1834215167548
16354,70,70215,81,"Tasa de exámenes médico legales por presunto delito sexual contra niños, niñas y adolescentes",2014,2,3,5307,56.5291124929339,0,2713,0,3,2594,115.651503469545
16355,8,8433,81,"Tasa de exámenes médico legales por presunto delito sexual contra niños, niñas y adolescentes",2014,2,8,11806,67.7621548365238,0,6065,0,8,5741,139.348545549556
16356,66,66456,81,"Tasa de exámenes médico legales por presunto delito sexual contra niños, niñas y adolescentes",2014,2,2,2154,92.8505106778087,0,1092,0,2,1062,188.323917137476
16357,68,68755,81,"Tasa de exámenes médico legales por presunto delito sexual contra niños, niñas y adolescentes",2014,2,1,2400,41.6666666666667,0,1233,0,1,1167,85.6898029134533
16358,15,15814,81,"Tasa de exámenes médico legales por presunto delito sexual contra niños, niñas y adolescentes",2014,2,2,987,202.634245187437,1,508,196.850393700787,1,479,208.768267223382
16359,13,13300,81,"Tasa de exámenes médico legales por presunto delito sexual contra niños, niñas y adolescentes",2014,2,1,1593,62.7746390458255,0,818,0,1,775,129.032258064516
16360,73,73411,81,"Tasa de exámenes médico legales por presunto delito sexual contra niños, niñas y adolescentes",2014,2,4,3732,107.181136120043,0,1916,0,4,1816,220.264317180617
16361,76,76895,81,"Tasa de exámenes médico legales por presunto delito sexual contra niños, niñas y adolescentes",2014,2,1,3627,27.5709953129308,0,1860,0,1,1767,56.5930956423316
16362,76,76736,81,"Tasa de exámenes médico legales por presunto delito sexual contra niños, niñas y adolescentes",2014,2,2,3722,53.7345513164965,1,1940,51.5463917525773,1,1782,56.1167227833895
16363,19,19455,81,"Tasa de exámenes médico legales por presunto delito sexual contra niños, niñas y adolescentes",2014,2,1,4196,23.8322211630124,0,2123,0,1,2073,48.2392667631452
16364,63,63401,81,"Tasa de exámenes médico legales por presunto delito sexual contra niños, niñas y adolescentes",2014,2,6,3922,152.983171851096,1,2018,49.5540138751239,5,1904,262.605042016807
16365,50,50689,81,"Tasa de exámenes médico legales por presunto delito sexual contra niños, niñas y adolescentes",2014,2,1,2462,40.6173842404549,0,1259,0,1,1203,83.1255195344971
16366,41,41807,81,"Tasa de exámenes médico legales por presunto delito sexual contra niños, niñas y adolescentes",2014,2,1,2135,46.8384074941452,0,1090,0,1,1045,95.6937799043062
16367,17,17614,81,"Tasa de exámenes médico legales por presunto delito sexual contra niños, niñas y adolescentes",2014,2,4,5163,77.4743366259926,1,2654,37.6789751318764,3,2509,119.569549621363
16368,68,68547,81,"Tasa de exámenes médico legales por presunto delito sexual contra niños, niñas y adolescentes",2014,2,19,11865,160.134850400337,6,6038,99.3706525339516,13,5827,223.099365024884
16369,13,13140,81,"Tasa de exámenes médico legales por presunto delito sexual contra niños, niñas y adolescentes",2014,2,2,2540,78.740157480315,2,1332,150.15015015015,0,1208,0
16370,25,25743,81,"Tasa de exámenes médico legales por presunto delito sexual contra niños, niñas y adolescentes",2014,2,4,1841,217.273221075502,1,943,106.044538706257,3,898,334.075723830735
16371,68,68167,81,"Tasa de exámenes médico legales por presunto delito sexual contra niños, niñas y adolescentes",2014,2,2,965,207.253886010363,1,495,202.020202020202,1,470,212.765957446809
16372,50,50450,81,"Tasa de exámenes médico legales por presunto delito sexual contra niños, niñas y adolescentes",2014,2,1,2181,45.8505272810637,0,1120,0,1,1061,94.2507068803016
16373,54,54874,81,"Tasa de exámenes médico legales por presunto delito sexual contra niños, niñas y adolescentes",2014,2,1,7885,12.6823081800888,1,4048,24.703557312253,0,3837,0
16374,15,15238,81,"Tasa de exámenes médico legales por presunto delito sexual contra niños, niñas y adolescentes",2014,2,5,9166,54.5494217761292,1,4677,21.381227282446,4,4489,89.1067052795723
16375,17,17486,81,"Tasa de exámenes médico legales por presunto delito sexual contra niños, niñas y adolescentes",2014,2,3,3181,94.3099654196793,2,1639,122.02562538133,1,1542,64.8508430609598
16376,44,44855,81,"Tasa de exámenes médico legales por presunto delito sexual contra niños, niñas y adolescentes",2014,2,1,1861,53.7345513164965,0,951,0,1,910,109.89010989011
16377,70,70670,81,"Tasa de exámenes médico legales por presunto delito sexual contra niños, niñas y adolescentes",2014,2,4,4030,99.2555831265509,1,2056,48.6381322957198,3,1974,151.975683890577
16378,70,70418,81,"Tasa de exámenes médico legales por presunto delito sexual contra niños, niñas y adolescentes",2014,2,3,1777,168.823860438942,1,909,110.01100110011,2,868,230.414746543779
16379,23,23182,81,"Tasa de exámenes médico legales por presunto delito sexual contra niños, niñas y adolescentes",2014,2,2,4378,45.6829602558246,1,2212,45.2079566003617,1,2166,46.1680517082179
16380,86,86001,81,"Tasa de exámenes médico legales por presunto delito sexual contra niños, niñas y adolescentes",2014,2,4,4371,91.5122397620682,0,2263,0,4,2108,189.753320683112
16381,76,76233,81,"Tasa de exámenes médico legales por presunto delito sexual contra niños, niñas y adolescentes",2014,2,7,2973,235.452404978137,3,1523,196.979645436638,4,1450,275.862068965517
16382,91,91001,81,"Tasa de exámenes médico legales por presunto delito sexual contra niños, niñas y adolescentes",2014,2,5,4828,103.562551781276,0,2480,0,5,2348,212.947189097104
16383,66,66594,81,"Tasa de exámenes médico legales por presunto delito sexual contra niños, niñas y adolescentes",2014,2,1,3543,28.2246683601468,1,1797,55.6483027267668,0,1746,0
16384,47,47980,81,"Tasa de exámenes médico legales por presunto delito sexual contra niños, niñas y adolescentes",2014,2,1,7972,12.5439036628199,0,4092,0,1,3880,25.7731958762887
16385,41,41396,81,"Tasa de exámenes médico legales por presunto delito sexual contra niños, niñas y adolescentes",2014,2,2,6962,28.7273771904625,2,3567,56.0695262125035,0,3395,0
16386,41,41530,81,"Tasa de exámenes médico legales por presunto delito sexual contra niños, niñas y adolescentes",2014,2,1,1255,79.6812749003984,1,656,152.439024390244,0,599,0
16387,15,15835,81,"Tasa de exámenes médico legales por presunto delito sexual contra niños, niñas y adolescentes",2014,2,1,540,185.185185185185,1,278,359.712230215827,0,262,0
16388,8,8685,81,"Tasa de exámenes médico legales por presunto delito sexual contra niños, niñas y adolescentes",2014,2,1,2076,48.1695568400771,0,1058,0,1,1018,98.2318271119843
16389,25,25649,81,"Tasa de exámenes médico legales por presunto delito sexual contra niños, niñas y adolescentes",2014,2,3,965,310.880829015544,0,495,0,3,470,638.297872340425
16390,85,85250,81,"Tasa de exámenes médico legales por presunto delito sexual contra niños, niñas y adolescentes",2014,2,9,2978,302.216252518469,0,1528,0,9,1450,620.689655172414
16391,5,5147,81,"Tasa de exámenes médico legales por presunto delito sexual contra niños, niñas y adolescentes",2014,2,2,6557,30.5017538508464,1,3344,29.9043062200957,1,3213,31.1235605353252
16392,17,17442,81,"Tasa de exámenes médico legales por presunto delito sexual contra niños, niñas y adolescentes",2014,2,1,955,104.712041884817,0,488,0,1,467,214.132762312634
16393,68,68820,81,"Tasa de exámenes médico legales por presunto delito sexual contra niños, niñas y adolescentes",2014,2,1,634,157.728706624606,0,325,0,1,309,323.624595469256
16394,8,8078,81,"Tasa de exámenes médico legales por presunto delito sexual contra niños, niñas y adolescentes",2014,2,2,5179,38.6174937246573,0,2646,0,2,2533,78.9577575996842
16395,5,5736,81,"Tasa de exámenes médico legales por presunto delito sexual contra niños, niñas y adolescentes",2014,2,5,4206,118.87779362815,0,2162,0,5,2044,244.618395303327
16396,20,20178,81,"Tasa de exámenes médico legales por presunto delito sexual contra niños, niñas y adolescentes",2014,2,2,2374,84.24599831508,0,1215,0,2,1159,172.562553925798
16397,52,52678,81,"Tasa de exámenes médico legales por presunto delito sexual contra niños, niñas y adolescentes",2014,2,1,4454,22.4517287831163,1,2273,43.994720633524,0,2181,0
16398,23,23189,81,"Tasa de exámenes médico legales por presunto delito sexual contra niños, niñas y adolescentes",2014,2,3,6385,46.9851213782302,1,3284,30.4506699147381,2,3101,64.4953240890035
16399,25,25214,81,"Tasa de exámenes médico legales por presunto delito sexual contra niños, niñas y adolescentes",2014,2,2,2110,94.7867298578199,0,1079,0,2,1031,193.986420950533
16400,15,15516,81,"Tasa de exámenes médico legales por presunto delito sexual contra niños, niñas y adolescentes",2014,2,1,2623,38.1242851696531,0,1341,0,1,1282,78.003120124805
16401,20,20621,81,"Tasa de exámenes médico legales por presunto delito sexual contra niños, niñas y adolescentes",2014,2,1,2616,38.2262996941896,0,1341,0,1,1275,78.4313725490196
16402,20,20443,81,"Tasa de exámenes médico legales por presunto delito sexual contra niños, niñas y adolescentes",2014,2,1,1633,61.2369871402327,1,839,119.189511323004,0,794,0
16403,41,41132,81,"Tasa de exámenes médico legales por presunto delito sexual contra niños, niñas y adolescentes",2014,2,1,3215,31.104199066874,0,1643,0,1,1572,63.6132315521629
16404,47,47053,81,"Tasa de exámenes médico legales por presunto delito sexual contra niños, niñas y adolescentes",2014,2,1,4954,20.185708518369,0,2535,0,1,2419,41.3393964448119
16405,44,44560,81,"Tasa de exámenes médico legales por presunto delito sexual contra niños, niñas y adolescentes",2014,2,2,14305,13.9811254806012,0,7268,0,2,7037,28.4212022168538
16406,20,20614,81,"Tasa de exámenes médico legales por presunto delito sexual contra niños, niñas y adolescentes",2014,2,3,1309,229.182582123759,1,669,149.476831091181,2,640,312.5
16407,17,17653,81,"Tasa de exámenes médico legales por presunto delito sexual contra niños, niñas y adolescentes",2014,2,1,1643,60.8642726719416,0,842,0,1,801,124.843945068664
16408,25,25175,81,"Tasa de exámenes médico legales por presunto delito sexual contra niños, niñas y adolescentes",2014,2,13,10163,127.914985732559,2,5205,38.4245917387128,11,4958,221.863654699476
16409,5,5541,81,"Tasa de exámenes médico legales por presunto delito sexual contra niños, niñas y adolescentes",2014,2,3,1553,193.174500965873,0,790,0,3,763,393.184796854522
16410,15,15693,81,"Tasa de exámenes médico legales por presunto delito sexual contra niños, niñas y adolescentes",2014,2,1,959,104.275286757039,0,494,0,1,465,215.05376344086
16411,47,47460,81,"Tasa de exámenes médico legales por presunto delito sexual contra niños, niñas y adolescentes",2014,2,1,2178,45.9136822773186,0,1120,0,1,1058,94.5179584120983
16412,68,68406,81,"Tasa de exámenes médico legales por presunto delito sexual contra niños, niñas y adolescentes",2014,2,1,3567,28.0347631062518,0,1835,0,1,1732,57.7367205542725
16413,41,41615,81,"Tasa de exámenes médico legales por presunto delito sexual contra niños, niñas y adolescentes",2014,2,1,1787,55.9597090095132,1,913,109.529025191676,0,874,0
16414,68,68679,81,"Tasa de exámenes médico legales por presunto delito sexual contra niños, niñas y adolescentes",2014,2,4,3285,121.765601217656,2,1681,118.976799524093,2,1604,124.688279301746
16415,76,76113,81,"Tasa de exámenes médico legales por presunto delito sexual contra niños, niñas y adolescentes",2014,2,1,1623,61.6142945163278,0,838,0,1,785,127.388535031847
16416,25,25402,81,"Tasa de exámenes médico legales por presunto delito sexual contra niños, niñas y adolescentes",2014,2,2,1174,170.357751277683,0,602,0,2,572,349.65034965035
16417,5,5079,81,"Tasa de exámenes médico legales por presunto delito sexual contra niños, niñas y adolescentes",2014,2,1,4687,21.3356091316407,0,2398,0,1,2289,43.6871996505024
16418,66,66440,81,"Tasa de exámenes médico legales por presunto delito sexual contra niños, niñas y adolescentes",2014,2,2,1869,107.009095773141,0,958,0,2,911,219.53896816685
16419,25,25797,81,"Tasa de exámenes médico legales por presunto delito sexual contra niños, niñas y adolescentes",2014,2,2,970,206.185567010309,0,488,0,2,482,414.9377593361
16420,5,5030,81,"Tasa de exámenes médico legales por presunto delito sexual contra niños, niñas y adolescentes",2014,2,4,2835,141.093474426808,2,1466,136.425648021828,2,1369,146.09203798393
16421,20,20750,81,"Tasa de exámenes médico legales por presunto delito sexual contra niños, niñas y adolescentes",2014,2,1,1507,66.35700066357,1,777,128.700128700129,0,730,0
16422,86,86573,81,"Tasa de exámenes médico legales por presunto delito sexual contra niños, niñas y adolescentes",2014,2,3,1761,170.357751277683,1,902,110.864745011086,2,859,232.828870779977
16423,23,23417,81,"Tasa de exámenes médico legales por presunto delito sexual contra niños, niñas y adolescentes",2014,2,2,12195,16.40016400164,1,6255,15.9872102318145,1,5940,16.8350168350168
16424,41,41551,81,"Tasa de exámenes médico legales por presunto delito sexual contra niños, niñas y adolescentes",2014,2,4,12681,31.5432536866178,2,6455,30.9837335398916,2,6226,32.123353678124
16425,13,13433,81,"Tasa de exámenes médico legales por presunto delito sexual contra niños, niñas y adolescentes",2014,2,2,2618,76.3941940412529,0,1341,0,2,1277,156.617071260767
16426,13,13836,81,"Tasa de exámenes médico legales por presunto delito sexual contra niños, niñas y adolescentes",2014,2,1,6153,16.2522346822688,0,3140,0,1,3013,33.1895121141719
16427,52,52560,81,"Tasa de exámenes médico legales por presunto delito sexual contra niños, niñas y adolescentes",2014,2,1,904,110.619469026549,0,463,0,1,441,226.757369614512
16428,5,5649,81,"Tasa de exámenes médico legales por presunto delito sexual contra niños, niñas y adolescentes",2014,2,1,1538,65.0195058517555,0,791,0,1,747,133.868808567604
16429,68,68615,81,"Tasa de exámenes médico legales por presunto delito sexual contra niños, niñas y adolescentes",2014,2,2,2658,75.2445447705041,1,1368,73.0994152046784,1,1290,77.5193798449612
16430,8,8573,81,"Tasa de exámenes médico legales por presunto delito sexual contra niños, niñas y adolescentes",2014,2,3,2187,137.174211248285,2,1136,176.056338028169,1,1051,95.1474785918173
16431,8,8832,81,"Tasa de exámenes médico legales por presunto delito sexual contra niños, niñas y adolescentes",2014,2,2,981,203.873598369011,1,504,198.412698412698,1,477,209.643605870021
16432,66,66572,81,"Tasa de exámenes médico legales por presunto delito sexual contra niños, niñas y adolescentes",2014,2,1,1762,56.7536889897843,0,894,0,1,868,115.207373271889
16433,76,76243,81,"Tasa de exámenes médico legales por presunto delito sexual contra niños, niñas y adolescentes",2014,2,1,989,101.112234580384,0,509,0,1,480,208.333333333333
16434,25,25535,81,"Tasa de exámenes médico legales por presunto delito sexual contra niños, niñas y adolescentes",2014,2,1,1242,80.5152979066023,1,630,158.730158730159,0,612,0
16435,5,5042,81,"Tasa de exámenes médico legales por presunto delito sexual contra niños, niñas y adolescentes",2014,2,1,2560,39.0625,0,1319,0,1,1241,80.58017727639
16436,76,76126,81,"Tasa de exámenes médico legales por presunto delito sexual contra niños, niñas y adolescentes",2014,2,1,1238,80.7754442649435,1,634,157.728706624606,0,604,0
16437,13,13760,81,"Tasa de exámenes médico legales por presunto delito sexual contra niños, niñas y adolescentes",2014,2,1,724,138.121546961326,1,370,270.27027027027,0,354,0
16438,52,52233,81,"Tasa de exámenes médico legales por presunto delito sexual contra niños, niñas y adolescentes",2014,2,1,1565,63.8977635782748,0,802,0,1,763,131.061598951507
16439,5,5656,81,"Tasa de exámenes médico legales por presunto delito sexual contra niños, niñas y adolescentes",2014,2,2,1196,167.224080267559,0,610,0,2,586,341.296928327645
16440,20,20770,81,"Tasa de exámenes médico legales por presunto delito sexual contra niños, niñas y adolescentes",2014,2,2,2045,97.799511002445,1,1052,95.0570342205323,1,993,100.704934541793
16441,20,20175,81,"Tasa de exámenes médico legales por presunto delito sexual contra niños, niñas y adolescentes",2014,2,1,4036,24.7770069375619,0,2080,0,1,1956,51.1247443762781
16442,25,25099,81,"Tasa de exámenes médico legales por presunto delito sexual contra niños, niñas y adolescentes",2014,2,2,1275,156.862745098039,1,648,154.320987654321,1,627,159.489633173844
16443,52,52287,81,"Tasa de exámenes médico legales por presunto delito sexual contra niños, niñas y adolescentes",2014,2,1,562,177.935943060498,0,286,0,1,276,362.31884057971
16444,19,19573,81,"Tasa de exámenes médico legales por presunto delito sexual contra niños, niñas y adolescentes",2014,2,4,3994,100.150225338007,1,2039,49.0436488474743,3,1955,153.452685421995
16445,70,70820,81,"Tasa de exámenes médico legales por presunto delito sexual contra niños, niñas y adolescentes",2014,2,1,3462,28.8850375505488,0,1775,0,1,1687,59.2768227622999
16446,76,76318,81,"Tasa de exámenes médico legales por presunto delito sexual contra niños, niñas y adolescentes",2014,2,3,2670,112.359550561798,2,1362,146.842878120411,1,1308,76.4525993883792
16447,85,85230,81,"Tasa de exámenes médico legales por presunto delito sexual contra niños, niñas y adolescentes",2014,2,1,1014,98.6193293885602,0,519,0,1,495,202.020202020202
16448,23,23678,81,"Tasa de exámenes médico legales por presunto delito sexual contra niños, niñas y adolescentes",2014,2,1,2948,33.921302578019,0,1504,0,1,1444,69.2520775623269
16449,95,95001,81,"Tasa de exámenes médico legales por presunto delito sexual contra niños, niñas y adolescentes",2014,2,3,8558,35.0549193736854,2,4383,45.6308464522017,1,4175,23.9520958083832
16450,18,18247,81,"Tasa de exámenes médico legales por presunto delito sexual contra niños, niñas y adolescentes",2014,2,4,2339,171.013253527148,2,1193,167.644593461861,2,1146,174.520069808028
16451,52,52258,81,"Tasa de exámenes médico legales por presunto delito sexual contra niños, niñas y adolescentes",2014,2,2,1179,169.635284139101,0,600,0,2,579,345.423143350604
16452,17,17873,81,"Tasa de exámenes médico legales por presunto delito sexual contra niños, niñas y adolescentes",2014,2,4,4437,90.1510029299076,1,2287,43.7254044599913,3,2150,139.53488372093
16453,50,50686,81,"Tasa de exámenes médico legales por presunto delito sexual contra niños, niñas y adolescentes",2014,2,1,246,406.50406504065,0,128,0,1,118,847.457627118644
16454,50,50577,81,"Tasa de exámenes médico legales por presunto delito sexual contra niños, niñas y adolescentes",2014,2,2,1114,179.533213644524,2,575,347.826086956522,0,539,0
16455,27,27495,81,"Tasa de exámenes médico legales por presunto delito sexual contra niños, niñas y adolescentes",2014,2,1,1164,85.9106529209622,0,583,0,1,581,172.117039586919
16456,23,23574,81,"Tasa de exámenes médico legales por presunto delito sexual contra niños, niñas y adolescentes",2014,2,1,3568,28.0269058295964,0,1840,0,1,1728,57.8703703703704
16457,23,23580,81,"Tasa de exámenes médico legales por presunto delito sexual contra niños, niñas y adolescentes",2014,2,1,5820,17.1821305841924,0,2991,0,1,2829,35.3481795687522
16458,5,5607,81,"Tasa de exámenes médico legales por presunto delito sexual contra niños, niñas y adolescentes",2014,2,2,1668,119.904076738609,1,855,116.959064327485,1,813,123.0012300123
16459,25,25878,81,"Tasa de exámenes médico legales por presunto delito sexual contra niños, niñas y adolescentes",2014,2,1,1106,90.4159132007233,0,567,0,1,539,185.528756957328
16460,76,76400,81,"Tasa de exámenes médico legales por presunto delito sexual contra niños, niñas y adolescentes",2014,2,2,3042,65.7462195923734,2,1566,127.713920817369,0,1476,0
16461,23,23807,81,"Tasa de exámenes médico legales por presunto delito sexual contra niños, niñas y adolescentes",2014,2,1,12430,8.0450522928399,1,6350,15.748031496063,0,6080,0
16462,44,44078,81,"Tasa de exámenes médico legales por presunto delito sexual contra niños, niñas y adolescentes",2014,2,1,4400,22.7272727272727,1,2229,44.8631673396142,0,2171,0
16463,13,13670,81,"Tasa de exámenes médico legales por presunto delito sexual contra niños, niñas y adolescentes",2014,2,1,3653,27.3747604708459,0,1836,0,1,1817,55.0357732526142
16464,73,73443,81,"Tasa de exámenes médico legales por presunto delito sexual contra niños, niñas y adolescentes",2014,2,1,2895,34.5423143350604,0,1486,0,1,1409,70.97232079489
16465,27,27787,81,"Tasa de exámenes médico legales por presunto delito sexual contra niños, niñas y adolescentes",2014,2,1,2596,38.5208012326656,1,1309,76.3941940412529,0,1287,0
16466,8,8560,81,"Tasa de exámenes médico legales por presunto delito sexual contra niños, niñas y adolescentes",2014,2,1,2361,42.3549343498518,0,1207,0,1,1154,86.6551126516464
16467,17,17877,81,"Tasa de exámenes médico legales por presunto delito sexual contra niños, niñas y adolescentes",2014,2,1,1174,85.1788756388416,1,604,165.562913907285,0,570,0
16468,76,76275,81,"Tasa de exámenes médico legales por presunto delito sexual contra niños, niñas y adolescentes",2014,2,2,5112,39.1236306729264,0,2627,0,2,2485,80.4828973843058
16469,25,25407,81,"Tasa de exámenes médico legales por presunto delito sexual contra niños, niñas y adolescentes",2014,2,1,1021,97.9431929480901,0,528,0,1,493,202.839756592292
16470,47,47288,81,"Tasa de exámenes médico legales por presunto delito sexual contra niños, niñas y adolescentes",2014,2,1,6933,14.4237703735757,0,3528,0,1,3405,29.3685756240822
16471,19,19050,81,"Tasa de exámenes médico legales por presunto delito sexual contra niños, niñas y adolescentes",2014,2,1,2781,35.9582883854728,0,1403,0,1,1378,72.5689404934688
16472,44,44279,81,"Tasa de exámenes médico legales por presunto delito sexual contra niños, niñas y adolescentes",2014,2,2,3801,52.6177321757432,0,1931,0,2,1870,106.951871657754
16473,41,41357,81,"Tasa de exámenes médico legales por presunto delito sexual contra niños, niñas y adolescentes",2014,2,1,1230,81.3008130081301,0,636,0,1,594,168.350168350168
16474,17,17174,81,"Tasa de exámenes médico legales por presunto delito sexual contra niños, niñas y adolescentes",2014,2,3,4491,66.8002672010688,0,2296,0,3,2195,136.674259681093
16475,27,27205,81,"Tasa de exámenes médico legales por presunto delito sexual contra niños, niñas y adolescentes",2014,2,1,1736,57.6036866359447,0,875,0,1,861,116.144018583043
16476,70,70221,81,"Tasa de exámenes médico legales por presunto delito sexual contra niños, niñas y adolescentes",2014,2,1,1471,67.9809653297077,0,758,0,1,713,140.252454417952
16477,15,15759,81,"Tasa de exámenes médico legales por presunto delito sexual contra niños, niñas y adolescentes",2014,2,1,8695,11.5008625646924,1,4370,22.883295194508,0,4325,0
16478,52,52390,81,"Tasa de exámenes médico legales por presunto delito sexual contra niños, niñas y adolescentes",2014,2,1,1793,55.7724484104852,0,911,0,1,882,113.378684807256
16479,27,27600,81,"Tasa de exámenes médico legales por presunto delito sexual contra niños, niñas y adolescentes",2014,2,1,1172,85.3242320819113,0,594,0,1,578,173.010380622837
16480,63,63111,81,"Tasa de exámenes médico legales por presunto delito sexual contra niños, niñas y adolescentes",2014,2,1,239,418.410041841004,0,124,0,1,115,869.565217391304
16481,5,5642,81,"Tasa de exámenes médico legales por presunto delito sexual contra niños, niñas y adolescentes",2014,2,1,1888,52.9661016949153,0,971,0,1,917,109.051254089422
16482,85,85410,81,"Tasa de exámenes médico legales por presunto delito sexual contra niños, niñas y adolescentes",2014,2,1,2154,46.4252553389044,0,1090,0,1,1064,93.984962406015
16483,70,70523,81,"Tasa de exámenes médico legales por presunto delito sexual contra niños, niñas y adolescentes",2014,2,1,1741,57.4382538770821,1,897,111.482720178372,0,844,0
16484,25,25386,81,"Tasa de exámenes médico legales por presunto delito sexual contra niños, niñas y adolescentes",2014,2,1,2476,40.3877221324717,0,1260,0,1,1216,82.2368421052632
16485,73,73349,81,"Tasa de exámenes médico legales por presunto delito sexual contra niños, niñas y adolescentes",2014,2,1,2052,48.7329434697856,0,1060,0,1,992,100.806451612903
16486,19,19513,81,"Tasa de exámenes médico legales por presunto delito sexual contra niños, niñas y adolescentes",2014,2,1,758,131.926121372032,1,386,259.067357512953,0,372,0
16487,23,23570,81,"Tasa de exámenes médico legales por presunto delito sexual contra niños, niñas y adolescentes",2014,2,1,4403,22.7117874176698,0,2261,0,1,2142,46.6853408029879
16488,41,41885,81,"Tasa de exámenes médico legales por presunto delito sexual contra niños, niñas y adolescentes",2014,2,2,754,265.25198938992,0,385,0,2,369,542.0054200542
16489,27,27160,81,"Tasa de exámenes médico legales por presunto delito sexual contra niños, niñas y adolescentes",2014,2,1,986,101.419878296146,0,499,0,1,487,205.338809034908
16490,19,19256,81,"Tasa de exámenes médico legales por presunto delito sexual contra niños, niñas y adolescentes",2014,2,1,4657,21.4730513205927,0,2392,0,1,2265,44.1501103752759
16491,19,19532,81,"Tasa de exámenes médico legales por presunto delito sexual contra niños, niñas y adolescentes",2014,2,1,3532,28.312570781427,0,1815,0,1,1717,58.24111822947
16492,76,76563,81,"Tasa de exámenes médico legales por presunto delito sexual contra niños, niñas y adolescentes",2014,2,5,5260,95.0570342205323,0,2703,0,5,2557,195.541650371529
16493,5,5887,81,"Tasa de exámenes médico legales por presunto delito sexual contra niños, niñas y adolescentes",2014,2,2,4945,40.4448938321537,0,2531,0,2,2414,82.8500414250207
16494,63,63302,81,"Tasa de exámenes médico legales por presunto delito sexual contra niños, niñas y adolescentes",2014,2,1,675,148.148148148148,0,347,0,1,328,304.878048780488
16495,70,70717,81,"Tasa de exámenes médico legales por presunto delito sexual contra niños, niñas y adolescentes",2014,2,2,1478,135.31799729364,0,759,0,2,719,278.164116828929
16496,70,70110,81,"Tasa de exámenes médico legales por presunto delito sexual contra niños, niñas y adolescentes",2014,2,1,1000,100,0,507,0,1,493,202.839756592292
16497,68,68418,81,"Tasa de exámenes médico legales por presunto delito sexual contra niños, niñas y adolescentes",2014,2,1,1105,90.4977375565611,0,570,0,1,535,186.915887850467
16498,20,20550,81,"Tasa de exámenes médico legales por presunto delito sexual contra niños, niñas y adolescentes",2014,2,3,2081,144.161460836136,1,1063,94.0733772342427,2,1018,196.463654223969
16499,8,8634,81,"Tasa de exámenes médico legales por presunto delito sexual contra niños, niñas y adolescentes",2014,2,2,2743,72.9128691213999,2,1390,143.884892086331,0,1353,0
16500,25,25312,81,"Tasa de exámenes médico legales por presunto delito sexual contra niños, niñas y adolescentes",2014,2,1,873,114.54753722795,1,444,225.225225225225,0,429,0
16501,25,25777,81,"Tasa de exámenes médico legales por presunto delito sexual contra niños, niñas y adolescentes",2014,2,1,557,179.533213644524,0,281,0,1,276,362.31884057971
16502,20,20228,81,"Tasa de exámenes médico legales por presunto delito sexual contra niños, niñas y adolescentes",2014,2,4,2881,138.840680319334,1,1474,67.842605156038,3,1407,213.219616204691
16503,23,23555,81,"Tasa de exámenes médico legales por presunto delito sexual contra niños, niñas y adolescentes",2014,2,1,6926,14.4383482529599,0,3539,0,1,3387,29.5246530853262
16504,68,68575,81,"Tasa de exámenes médico legales por presunto delito sexual contra niños, niñas y adolescentes",2014,2,3,3479,86.2316757688991,0,1772,0,3,1707,175.746924428822
16505,13,13657,81,"Tasa de exámenes médico legales por presunto delito sexual contra niños, niñas y adolescentes",2014,2,1,3241,30.8546744831842,0,1670,0,1,1571,63.6537237428389
16506,73,73873,81,"Tasa de exámenes médico legales por presunto delito sexual contra niños, niñas y adolescentes",2014,2,1,489,204.498977505112,0,250,0,1,239,418.410041841004
16507,25,25473,81,"Tasa de exámenes médico legales por presunto delito sexual contra niños, niñas y adolescentes",2014,2,1,7366,13.575889220744,0,3788,0,1,3578,27.9485746226942
16508,76,76606,81,"Tasa de exámenes médico legales por presunto delito sexual contra niños, niñas y adolescentes",2014,2,1,1365,73.2600732600733,0,703,0,1,662,151.057401812689
16509,76,76041,81,"Tasa de exámenes médico legales por presunto delito sexual contra niños, niñas y adolescentes",2014,2,2,1845,108.40108401084,1,942,106.157112526539,1,903,110.741971207087
16510,25,25260,81,"Tasa de exámenes médico legales por presunto delito sexual contra niños, niñas y adolescentes",2014,2,2,1741,114.876507754164,0,887,0,2,854,234.192037470726
16511,41,41359,81,"Tasa de exámenes médico legales por presunto delito sexual contra niños, niñas y adolescentes",2014,2,1,2851,35.0754121360926,1,1449,69.0131124913734,0,1402,0
16512,81,81736,81,"Tasa de exámenes médico legales por presunto delito sexual contra niños, niñas y adolescentes",2014,2,4,5943,67.3060743732122,0,3039,0,4,2904,137.741046831956
16513,41,41020,81,"Tasa de exámenes médico legales por presunto delito sexual contra niños, niñas y adolescentes",2014,2,1,2622,38.13882532418,0,1349,0,1,1273,78.5545954438335
16514,76,76890,81,"Tasa de exámenes médico legales por presunto delito sexual contra niños, niñas y adolescentes",2014,2,2,1225,163.265306122449,1,635,157.48031496063,1,590,169.491525423729
16515,5,5697,81,"Tasa de exámenes médico legales por presunto delito sexual contra niños, niñas y adolescentes",2014,2,6,2235,268.456375838926,3,1140,263.157894736842,3,1095,273.972602739726
16516,68,68385,81,"Tasa de exámenes médico legales por presunto delito sexual contra niños, niñas y adolescentes",2014,2,1,1627,61.4628149969269,0,835,0,1,792,126.262626262626
16517,76,76250,81,"Tasa de exámenes médico legales por presunto delito sexual contra niños, niñas y adolescentes",2014,2,1,817,122.399020807834,0,417,0,1,400,250
16518,76,76823,81,"Tasa de exámenes médico legales por presunto delito sexual contra niños, niñas y adolescentes",2014,2,1,1484,67.3854447439353,0,765,0,1,719,139.082058414465
16519,18,18479,81,"Tasa de exámenes médico legales por presunto delito sexual contra niños, niñas y adolescentes",2014,2,1,458,218.340611353712,1,233,429.184549356223,0,225,0
16520,15,15778,81,"Tasa de exámenes médico legales por presunto delito sexual contra niños, niñas y adolescentes",2014,2,1,299,334.448160535117,0,151,0,1,148,675.675675675676
16521,17,17777,81,"Tasa de exámenes médico legales por presunto delito sexual contra niños, niñas y adolescentes",2014,2,1,2404,41.5973377703827,0,1228,0,1,1176,85.0340136054422
16522,76,76248,81,"Tasa de exámenes médico legales por presunto delito sexual contra niños, niñas y adolescentes",2014,2,1,4347,23.0043708304578,0,2227,0,1,2120,47.1698113207547
16523,5,5237,81,"Tasa de exámenes médico legales por presunto delito sexual contra niños, niñas y adolescentes",2014,2,2,2117,94.4733112895607,2,1087,183.992640294388,0,1030,0
16524,25,25183,81,"Tasa de exámenes médico legales por presunto delito sexual contra niños, niñas y adolescentes",2014,2,1,2289,43.6871996505024,1,1169,85.5431993156544,0,1120,0
16525,19,19450,81,"Tasa de exámenes médico legales por presunto delito sexual contra niños, niñas y adolescentes",2014,2,1,1710,58.4795321637427,0,871,0,1,839,119.189511323004
16526,50,50590,81,"Tasa de exámenes médico legales por presunto delito sexual contra niños, niñas y adolescentes",2014,2,1,2220,45.045045045045,0,1163,0,1,1057,94.6073793755913
16527,73,73168,81,"Tasa de exámenes médico legales por presunto delito sexual contra niños, niñas y adolescentes",2014,2,1,5308,18.8394875659382,1,2712,36.8731563421829,0,2596,0
16528,5,5347,81,"Tasa de exámenes médico legales por presunto delito sexual contra niños, niñas y adolescentes",2014,2,2,596,335.570469798658,0,309,0,2,287,696.864111498258
16529,68,68673,81,"Tasa de exámenes médico legales por presunto delito sexual contra niños, niñas y adolescentes",2014,2,1,391,255.754475703325,0,201,0,1,190,526.315789473684
16530,13,13442,81,"Tasa de exámenes médico legales por presunto delito sexual contra niños, niñas y adolescentes",2014,2,1,5710,17.5131348511384,0,2936,0,1,2774,36.0490266762797
16531,99,99001,81,"Tasa de exámenes médico legales por presunto delito sexual contra niños, niñas y adolescentes",2014,2,2,1909,104.766893661603,0,1005,0,2,904,221.238938053097
16532,5,5579,81,"Tasa de exámenes médico legales por presunto delito sexual contra niños, niñas y adolescentes",2014,2,5,4188,119.388729703916,1,2140,46.7289719626168,4,2048,195.3125
16533,19,19698,81,"Tasa de exámenes médico legales por presunto delito sexual contra niños, niñas y adolescentes",2014,2,3,7951,37.7311030059112,1,4010,24.9376558603491,2,3941,50.7485409794468
16534,76,76020,81,"Tasa de exámenes médico legales por presunto delito sexual contra niños, niñas y adolescentes",2014,2,1,1846,54.1711809317443,1,943,106.044538706257,0,903,0
16535,76,76100,81,"Tasa de exámenes médico legales por presunto delito sexual contra niños, niñas y adolescentes",2014,2,1,1308,76.4525993883792,0,670,0,1,638,156.739811912226
16536,88,88001,81,"Tasa de exámenes médico legales por presunto delito sexual contra niños, niñas y adolescentes",2014,2,2,5922,33.7723741979061,0,3029,0,2,2893,69.1323885240235
16537,70,70823,81,"Tasa de exámenes médico legales por presunto delito sexual contra niños, niñas y adolescentes",2014,2,1,1932,51.75983436853,0,998,0,1,934,107.066381156317
16538,5,5893,81,"Tasa de exámenes médico legales por presunto delito sexual contra niños, niñas y adolescentes",2014,2,1,1826,54.7645125958379,0,934,0,1,892,112.107623318386
16539,5,5093,81,"Tasa de exámenes médico legales por presunto delito sexual contra niños, niñas y adolescentes",2014,2,2,1849,108.166576527853,1,933,107.181136120043,1,916,109.170305676856
16540,17,17013,81,"Tasa de exámenes médico legales por presunto delito sexual contra niños, niñas y adolescentes",2014,2,1,1964,50.9164969450102,0,1005,0,1,959,104.275286757039
16541,17,17433,81,"Tasa de exámenes médico legales por presunto delito sexual contra niños, niñas y adolescentes",2014,2,3,2156,139.146567717996,0,1105,0,3,1051,285.442435775452
16542,5,5761,81,"Tasa de exámenes médico legales por presunto delito sexual contra niños, niñas y adolescentes",2014,2,1,1327,75.3579502637528,0,681,0,1,646,154.798761609907
16543,85,85139,81,"Tasa de exámenes médico legales por presunto delito sexual contra niños, niñas y adolescentes",2014,2,2,1117,179.05102954342,0,573,0,2,544,367.647058823529
16544,85,85125,81,"Tasa de exámenes médico legales por presunto delito sexual contra niños, niñas y adolescentes",2014,2,1,1445,69.2041522491349,0,755,0,1,690,144.927536231884
16545,23,23466,81,"Tasa de exámenes médico legales por presunto delito sexual contra niños, niñas y adolescentes",2014,2,5,9001,55.5493834018442,0,4584,0,5,4417,113.199003848766
16546,41,41378,81,"Tasa de exámenes médico legales por presunto delito sexual contra niños, niñas y adolescentes",2014,2,3,1635,183.48623853211,1,833,120.048019207683,2,802,249.376558603491
16547,85,85162,81,"Tasa de exámenes médico legales por presunto delito sexual contra niños, niñas y adolescentes",2014,2,4,1491,268.276324614353,1,756,132.275132275132,3,735,408.163265306122
16548,68,68179,81,"Tasa de exámenes médico legales por presunto delito sexual contra niños, niñas y adolescentes",2014,2,1,444,225.225225225225,0,229,0,1,215,465.116279069767
16549,25,25295,81,"Tasa de exámenes médico legales por presunto delito sexual contra niños, niñas y adolescentes",2014,2,1,1617,61.8429189857761,0,827,0,1,790,126.582278481013
16550,5,5002,81,"Tasa de exámenes médico legales por presunto delito sexual contra niños, niñas y adolescentes",2014,2,4,1711,233.781414377557,0,880,0,4,831,481.347773766546
16551,5,5250,81,"Tasa de exámenes médico legales por presunto delito sexual contra niños, niñas y adolescentes",2014,2,4,5607,71.3393971820938,1,2877,34.7584289190129,3,2730,109.89010989011
16552,5,5040,81,"Tasa de exámenes médico legales por presunto delito sexual contra niños, niñas y adolescentes",2014,2,1,1697,58.9275191514437,0,872,0,1,825,121.212121212121
16553,5,5044,81,"Tasa de exámenes médico legales por presunto delito sexual contra niños, niñas y adolescentes",2014,2,3,773,388.098318240621,1,405,246.913580246914,2,368,543.478260869565
16554,25,25053,81,"Tasa de exámenes médico legales por presunto delito sexual contra niños, niñas y adolescentes",2014,2,2,1274,156.985871271586,1,654,152.905198776758,1,620,161.290322580645
16555,50,50251,81,"Tasa de exámenes médico legales por presunto delito sexual contra niños, niñas y adolescentes",2014,2,1,689,145.137880986938,0,355,0,1,334,299.40119760479
16556,5,5138,81,"Tasa de exámenes médico legales por presunto delito sexual contra niños, niñas y adolescentes",2014,2,1,1879,53.2197977647685,0,953,0,1,926,107.991360691145
16557,5,5101,81,"Tasa de exámenes médico legales por presunto delito sexual contra niños, niñas y adolescentes",2014,2,5,2668,187.406296851574,1,1364,73.3137829912023,4,1304,306.748466257669
16558,25,25436,81,"Tasa de exámenes médico legales por presunto delito sexual contra niños, niñas y adolescentes",2014,2,2,431,464.037122969838,1,219,456.62100456621,1,212,471.698113207547
16559,25,25758,81,"Tasa de exámenes médico legales por presunto delito sexual contra niños, niñas y adolescentes",2014,2,1,2346,42.6257459505541,0,1200,0,1,1146,87.260034904014
16560,5,5847,81,"Tasa de exámenes médico legales por presunto delito sexual contra niños, niñas y adolescentes",2014,2,2,4583,43.6395374209033,1,2355,42.4628450106157,1,2228,44.8833034111311
16561,19,19212,81,"Tasa de exámenes médico legales por presunto delito sexual contra niños, niñas y adolescentes",2014,2,1,3049,32.797638570023,0,1552,0,1,1497,66.8002672010688
16562,5,5318,81,"Tasa de exámenes médico legales por presunto delito sexual contra niños, niñas y adolescentes",2014,2,4,4531,88.2807327300817,1,2308,43.3275563258232,3,2223,134.952766531714
16563,25,25506,81,"Tasa de exámenes médico legales por presunto delito sexual contra niños, niñas y adolescentes",2014,2,1,258,387.596899224806,0,133,0,1,125,800
16564,68,68498,81,"Tasa de exámenes médico legales por presunto delito sexual contra niños, niñas y adolescentes",2014,2,3,462,649.350649350649,1,239,418.410041841004,2,223,896.860986547085
16565,50,50270,81,"Tasa de exámenes médico legales por presunto delito sexual contra niños, niñas y adolescentes",2014,2,1,398,251.256281407035,0,206,0,1,192,520.833333333333
16566,5,5209,81,"Tasa de exámenes médico legales por presunto delito sexual contra niños, niñas y adolescentes",2014,2,2,2221,90.049527239982,1,1146,87.260034904014,1,1075,93.0232558139535
16567,5,5113,81,"Tasa de exámenes médico legales por presunto delito sexual contra niños, niñas y adolescentes",2014,2,4,682,586.510263929619,0,357,0,4,325,1230.76923076923
16568,41,41483,81,"Tasa de exámenes médico legales por presunto delito sexual contra niños, niñas y adolescentes",2014,2,1,717,139.470013947001,1,370,270.27027027027,0,347,0
16569,5,5234,81,"Tasa de exámenes médico legales por presunto delito sexual contra niños, niñas y adolescentes",2014,2,2,2659,75.2162467092892,0,1355,0,2,1304,153.374233128834
16570,25,25486,81,"Tasa de exámenes médico legales por presunto delito sexual contra niños, niñas y adolescentes",2014,2,2,1381,144.822592324403,0,701,0,2,680,294.117647058824
16571,5,5483,81,"Tasa de exámenes médico legales por presunto delito sexual contra niños, niñas y adolescentes",2014,2,2,1776,112.612612612613,0,917,0,2,859,232.828870779977
16572,25,25491,81,"Tasa de exámenes médico legales por presunto delito sexual contra niños, niñas y adolescentes",2014,2,1,490,204.081632653061,0,252,0,1,238,420.168067226891
16573,5,5890,81,"Tasa de exámenes médico legales por presunto delito sexual contra niños, niñas y adolescentes",2014,2,1,2366,42.2654268808115,0,1208,0,1,1158,86.3557858376511
16574,70,70742,81,"Tasa de exámenes médico legales por presunto delito sexual contra niños, niñas y adolescentes",2014,2,1,3208,31.1720698254364,1,1659,60.2772754671489,0,1549,0
16575,5,5036,81,"Tasa de exámenes médico legales por presunto delito sexual contra niños, niñas y adolescentes",2014,2,3,700,428.571428571429,1,360,277.777777777778,2,340,588.235294117647
16576,68,68327,81,"Tasa de exámenes médico legales por presunto delito sexual contra niños, niñas y adolescentes",2014,2,1,321,311.526479750779,0,163,0,1,158,632.911392405063
16577,5,5490,81,"Tasa de exámenes médico legales por presunto delito sexual contra niños, niñas y adolescentes",2014,2,1,7304,13.6911281489595,0,3735,0,1,3569,28.0190529560101
16578,20,20013,81,"Tasa de exámenes médico legales por presunto delito sexual contra niños, niñas y adolescentes",2014,2,1,5913,16.9118890580078,0,3021,0,1,2892,34.5781466113416
16579,5,5154,81,"Tasa de exámenes médico legales por presunto delito sexual contra niños, niñas y adolescentes",2014,2,2,11792,16.9606512890095,0,6016,0,2,5776,34.6260387811634
16580,86,86571,81,"Tasa de exámenes médico legales por presunto delito sexual contra niños, niñas y adolescentes",2014,2,1,3010,33.2225913621262,0,1549,0,1,1461,68.4462696783025
16581,13,13468,81,"Tasa de exámenes médico legales por presunto delito sexual contra niños, niñas y adolescentes",2014,2,1,4959,20.165355918532,1,2530,39.5256916996047,0,2429,0
16582,25,25769,81,"Tasa de exámenes médico legales por presunto delito sexual contra niños, niñas y adolescentes",2014,2,1,1335,74.9063670411985,1,680,147.058823529412,0,655,0
16583,5,5670,81,"Tasa de exámenes médico legales por presunto delito sexual contra niños, niñas y adolescentes",2014,2,2,1742,114.810562571757,1,892,112.107623318386,1,850,117.647058823529
16584,5,5858,81,"Tasa de exámenes médico legales por presunto delito sexual contra niños, niñas y adolescentes",2014,2,2,1085,184.331797235023,1,555,180.18018018018,1,530,188.679245283019
16585,25,25035,81,"Tasa de exámenes médico legales por presunto delito sexual contra niños, niñas y adolescentes",2014,2,3,1026,292.397660818713,0,524,0,3,502,597.609561752988
16586,15,15599,81,"Tasa de exámenes médico legales por presunto delito sexual contra niños, niñas y adolescentes",2014,2,1,977,102.354145342886,0,497,0,1,480,208.333333333333
16587,5,5658,81,"Tasa de exámenes médico legales por presunto delito sexual contra niños, niñas y adolescentes",2014,2,1,397,251.889168765743,0,203,0,1,194,515.463917525773
16588,15,15097,81,"Tasa de exámenes médico legales por presunto delito sexual contra niños, niñas y adolescentes",2014,2,1,548,182.481751824818,1,280,357.142857142857,0,268,0
16589,50,50110,81,"Tasa de exámenes médico legales por presunto delito sexual contra niños, niñas y adolescentes",2014,2,3,462,649.350649350649,0,236,0,3,226,1327.43362831858
16590,5,5310,81,"Tasa de exámenes médico legales por presunto delito sexual contra niños, niñas y adolescentes",2014,2,2,1105,180.995475113122,0,556,0,2,549,364.298724954463
16591,5,5284,81,"Tasa de exámenes médico legales por presunto delito sexual contra niños, niñas y adolescentes",2014,2,1,1898,52.6870389884089,0,970,0,1,928,107.758620689655
16592,25,25320,81,"Tasa de exámenes médico legales por presunto delito sexual contra niños, niñas y adolescentes",2014,2,2,3636,55.005500550055,0,1862,0,2,1774,112.739571589628
16593,85,85010,81,"Tasa de exámenes médico legales por presunto delito sexual contra niños, niñas y adolescentes",2014,2,2,3714,53.850296176629,1,1900,52.6315789473684,1,1814,55.1267916207277
16594,5,5664,81,"Tasa de exámenes médico legales por presunto delito sexual contra niños, niñas y adolescentes",2014,2,1,2601,38.4467512495194,1,1320,75.7575757575758,0,1281,0
16595,25,25513,81,"Tasa de exámenes médico legales por presunto delito sexual contra niños, niñas y adolescentes",2014,2,2,2453,81.5328169588259,0,1233,0,2,1220,163.934426229508
16596,20,20250,81,"Tasa de exámenes médico legales por presunto delito sexual contra niños, niñas y adolescentes",2014,2,1,2860,34.965034965035,0,1465,0,1,1395,71.6845878136201
16597,18,18860,81,"Tasa de exámenes médico legales por presunto delito sexual contra niños, niñas y adolescentes",2014,2,1,1388,72.0461095100865,0,710,0,1,678,147.492625368732
16598,85,85263,81,"Tasa de exámenes médico legales por presunto delito sexual contra niños, niñas y adolescentes",2014,2,3,867,346.020761245675,1,447,223.713646532438,2,420,476.190476190476
16599,5,5790,81,"Tasa de exámenes médico legales por presunto delito sexual contra niños, niñas y adolescentes",2014,2,1,5480,18.2481751824818,0,2799,0,1,2681,37.2995151063036
16600,54,54239,81,"Tasa de exámenes médico legales por presunto delito sexual contra niños, niñas y adolescentes",2014,2,1,348,287.35632183908,1,177,564.971751412429,0,171,0
16601,50,50711,81,"Tasa de exámenes médico legales por presunto delito sexual contra niños, niñas y adolescentes",2014,2,1,2893,34.5661942620118,0,1480,0,1,1413,70.7714083510262
16602,25,25398,81,"Tasa de exámenes médico legales por presunto delito sexual contra niños, niñas y adolescentes",2014,2,1,580,172.413793103448,0,297,0,1,283,353.356890459364
16603,68,68895,81,"Tasa de exámenes médico legales por presunto delito sexual contra niños, niñas y adolescentes",2014,2,1,758,131.926121372032,0,387,0,1,371,269.541778975741
16604,68,68770,81,"Tasa de exámenes médico legales por presunto delito sexual contra niños, niñas y adolescentes",2014,2,2,905,220.994475138122,1,466,214.592274678112,1,439,227.790432801822
16605,25,25785,81,"Tasa de exámenes médico legales por presunto delito sexual contra niños, niñas y adolescentes",2014,2,1,2281,43.8404208680403,1,1167,85.6898029134533,0,1114,0
16606,5,5543,81,"Tasa de exámenes médico legales por presunto delito sexual contra niños, niñas y adolescentes",2014,2,2,1108,180.505415162455,1,582,171.821305841924,1,526,190.114068441065
16607,18,18753,81,"Tasa de exámenes médico legales por presunto delito sexual contra niños, niñas y adolescentes",2014,2,2,8024,24.9252243270189,0,4101,0,2,3923,50.9813917919959
16608,85,85440,81,"Tasa de exámenes médico legales por presunto delito sexual contra niños, niñas y adolescentes",2014,2,2,2419,82.6787928896238,0,1239,0,2,1180,169.491525423729
16609,5,5756,81,"Tasa de exámenes médico legales por presunto delito sexual contra niños, niñas y adolescentes",2014,2,2,3198,62.5390869293308,0,1633,0,2,1565,127.79552715655
16610,50,50330,81,"Tasa de exámenes médico legales por presunto delito sexual contra niños, niñas y adolescentes",2014,2,2,1365,146.520146520147,0,704,0,2,661,302.571860816944
16611,25,25772,81,"Tasa de exámenes médico legales por presunto delito sexual contra niños, niñas y adolescentes",2014,2,2,1974,101.317122593718,1,999,100.1001001001,1,975,102.564102564103
16612,25,25645,81,"Tasa de exámenes médico legales por presunto delito sexual contra niños, niñas y adolescentes",2014,2,1,1044,95.7854406130268,0,531,0,1,513,194.931773879142
16613,5,5400,81,"Tasa de exámenes médico legales por presunto delito sexual contra niños, niñas y adolescentes",2014,2,1,1846,54.1711809317443,0,945,0,1,901,110.987791342952
16614,25,25662,81,"Tasa de exámenes médico legales por presunto delito sexual contra niños, niñas y adolescentes",2014,2,1,869,115.074798619102,1,438,228.310502283105,0,431,0
16615,5,5809,81,"Tasa de exámenes médico legales por presunto delito sexual contra niños, niñas y adolescentes",2014,2,1,1135,88.1057268722467,0,584,0,1,551,181.488203266788
16616,25,25126,81,"Tasa de exámenes médico legales por presunto delito sexual contra niños, niñas y adolescentes",2014,2,4,4857,82.355363393041,2,2501,79.968012794882,2,2356,84.8896434634974
16617,20,20238,81,"Tasa de exámenes médico legales por presunto delito sexual contra niños, niñas y adolescentes",2014,2,2,3169,63.1113916061849,0,1616,0,2,1553,128.783000643915
16618,23,23660,81,"Tasa de exámenes médico legales por presunto delito sexual contra niños, niñas y adolescentes",2014,2,2,8590,23.2828870779977,0,4386,0,2,4204,47.5737392959087
16619,86,86865,81,"Tasa de exámenes médico legales por presunto delito sexual contra niños, niñas y adolescentes",2014,2,1,5596,17.8699070764832,0,2864,0,1,2732,36.6032210834553
16620,25,25799,81,"Tasa de exámenes médico legales por presunto delito sexual contra niños, niñas y adolescentes",2014,2,1,1855,53.9083557951483,0,950,0,1,905,110.497237569061
16621,5,5792,81,"Tasa de exámenes médico legales por presunto delito sexual contra niños, niñas y adolescentes",2014,2,1,788,126.903553299492,0,409,0,1,379,263.852242744063
16622,68,68318,81,"Tasa de exámenes médico legales por presunto delito sexual contra niños, niñas y adolescentes",2014,2,1,558,179.21146953405,0,280,0,1,278,359.712230215827
16623,5,5660,81,"Tasa de exámenes médico legales por presunto delito sexual contra niños, niñas y adolescentes",2014,2,2,1083,184.672206832872,0,561,0,2,522,383.141762452107
16624,41,41668,81,"Tasa de exámenes médico legales por presunto delito sexual contra niños, niñas y adolescentes",2014,2,1,3163,31.6155548529877,0,1607,0,1,1556,64.26735218509
16625,73,73675,81,"Tasa de exámenes médico legales por presunto delito sexual contra niños, niñas y adolescentes",2014,2,1,1692,59.1016548463357,0,859,0,1,833,120.048019207683
16626,25,25898,81,"Tasa de exámenes médico legales por presunto delito sexual contra niños, niñas y adolescentes",2014,2,1,579,172.711571675302,1,293,341.296928327645,0,286,0
16627,5,5059,81,"Tasa de exámenes médico legales por presunto delito sexual contra niños, niñas y adolescentes",2014,2,3,423,709.219858156028,0,220,0,3,203,1477.83251231527
16628,50,50124,81,"Tasa de exámenes médico legales por presunto delito sexual contra niños, niñas y adolescentes",2014,2,1,436,229.357798165138,0,226,0,1,210,476.190476190476
16629,41,41006,81,"Tasa de exámenes médico legales por presunto delito sexual contra niños, niñas y adolescentes",2014,2,1,3985,25.0941028858218,0,2040,0,1,1945,51.413881748072
16630,41,41770,81,"Tasa de exámenes médico legales por presunto delito sexual contra niños, niñas y adolescentes",2014,2,1,2147,46.5766185374942,0,1097,0,1,1050,95.2380952380952
16631,5,5148,81,"Tasa de exámenes médico legales por presunto delito sexual contra niños, niñas y adolescentes",2014,2,2,4772,41.9111483654652,0,2450,0,2,2322,86.1326442721791
16632,70,70708,81,"Tasa de exámenes médico legales por presunto delito sexual contra niños, niñas y adolescentes",2014,2,1,6087,16.4284540824708,1,3075,32.520325203252,0,3012,0
16633,13,13673,81,"Tasa de exámenes médico legales por presunto delito sexual contra niños, niñas y adolescentes",2014,3,1,1710,58.4795321637427,0,872,0,1,838,119.331742243437
16634,13,13001,81,"Tasa de exámenes médico legales por presunto delito sexual contra niños, niñas y adolescentes",2014,3,150,105341,142.394699120001,28,53253,52.579197416108,122,52088,234.219013976348
16635,85,85001,81,"Tasa de exámenes médico legales por presunto delito sexual contra niños, niñas y adolescentes",2014,3,54,16397,329.328535707751,12,8442,142.146410803127,42,7955,527.969830295412
16636,20,20013,81,"Tasa de exámenes médico legales por presunto delito sexual contra niños, niñas y adolescentes",2014,3,11,7042,156.205623402442,1,3582,27.9173646007817,10,3460,289.017341040462
16637,20,20001,81,"Tasa de exámenes médico legales por presunto delito sexual contra niños, niñas y adolescentes",2014,3,103,54153,190.201835540044,26,27436,94.7660008747631,77,26717,288.206011153947
16638,54,54874,81,"Tasa de exámenes médico legales por presunto delito sexual contra niños, niñas y adolescentes",2014,3,13,9694,134.103569218073,4,4948,80.8407437348424,9,4746,189.633375474083
16639,86,86001,81,"Tasa de exámenes médico legales por presunto delito sexual contra niños, niñas y adolescentes",2014,3,14,5210,268.714011516315,2,2690,74.3494423791822,12,2520,476.190476190476
16640,73,73001,81,"Tasa de exámenes médico legales por presunto delito sexual contra niños, niñas y adolescentes",2014,3,79,56359,140.172820667507,16,28717,55.7161263363165,63,27642,227.914043846321
16641,68,68001,81,"Tasa de exámenes médico legales por presunto delito sexual contra niños, niñas y adolescentes",2014,3,86,46676,184.248864512812,23,23849,96.4401023103694,63,22827,275.988960441582
16642,68,68547,81,"Tasa de exámenes médico legales por presunto delito sexual contra niños, niñas y adolescentes",2014,3,40,14388,278.009452321379,9,7301,123.270784823997,31,7087,437.420629321292
16643,76,76147,81,"Tasa de exámenes médico legales por presunto delito sexual contra niños, niñas y adolescentes",2014,3,18,12087,148.920327624721,5,6091,82.0883270398949,13,5996,216.811207471648
16644,41,41001,81,"Tasa de exámenes médico legales por presunto delito sexual contra niños, niñas y adolescentes",2014,3,62,33972,182.503237960674,16,17248,92.7643784786642,46,16724,275.053814876824
16645,76,76001,81,"Tasa de exámenes médico legales por presunto delito sexual contra niños, niñas y adolescentes",2014,3,307,215473,142.477247729414,71,109218,65.0075994799392,236,106255,222.107194955531
16646,13,13160,81,"Tasa de exámenes médico legales por presunto delito sexual contra niños, niñas y adolescentes",2014,3,1,1104,90.5797101449275,0,566,0,1,538,185.873605947955
16647,76,76109,81,"Tasa de exámenes médico legales por presunto delito sexual contra niños, niñas y adolescentes",2014,3,39,46879,83.1929008724589,5,23828,20.9837166358905,34,23051,147.499023903518
16648,66,66001,81,"Tasa de exámenes médico legales por presunto delito sexual contra niños, niñas y adolescentes",2014,3,107,41695,256.625494663629,21,21315,98.5221674876847,86,20380,421.98233562316
16649,25,25175,81,"Tasa de exámenes médico legales por presunto delito sexual contra niños, niñas y adolescentes",2014,3,21,12561,167.184141390017,4,6434,62.1697233447311,17,6127,277.460421086992
16650,5,5172,81,"Tasa de exámenes médico legales por presunto delito sexual contra niños, niñas y adolescentes",2014,3,14,9967,140.463529647838,3,5000,60,11,4967,221.461646869338
16651,5,5045,81,"Tasa de exámenes médico legales por presunto delito sexual contra niños, niñas y adolescentes",2014,3,30,23480,127.768313458262,3,11969,25.0647506057315,27,11511,234.558248631744
16652,11,11001,81,"Tasa de exámenes médico legales por presunto delito sexual contra niños, niñas y adolescentes",2014,3,1148,717903,159.910182852001,253,367850,68.7780345249422,895,350053,255.675569128103
16653,25,25245,81,"Tasa de exámenes médico legales por presunto delito sexual contra niños, niñas y adolescentes",2014,3,4,2157,185.442744552619,2,1091,183.318056828598,2,1066,187.617260787993
16654,47,47245,81,"Tasa de exámenes médico legales por presunto delito sexual contra niños, niñas y adolescentes",2014,3,11,7691,143.024314133403,4,3937,101.600203200406,7,3754,186.467767714438
16655,18,18753,81,"Tasa de exámenes médico legales por presunto delito sexual contra niños, niñas y adolescentes",2014,3,7,9280,75.4310344827586,0,4710,0,7,4570,153.172866520788
16656,44,44430,81,"Tasa de exámenes médico legales por presunto delito sexual contra niños, niñas y adolescentes",2014,3,21,22484,93.3997509339975,6,11468,52.3194977328218,15,11016,136.165577342048
16657,66,66682,81,"Tasa de exámenes médico legales por presunto delito sexual contra niños, niñas y adolescentes",2014,3,10,7232,138.274336283186,5,3694,135.354629128316,5,3538,141.322781232335
16658,5,5001,81,"Tasa de exámenes médico legales por presunto delito sexual contra niños, niñas y adolescentes",2014,3,339,180923,187.372528644783,59,92545,63.7527689232265,280,88378,316.82092828532
16659,25,25286,81,"Tasa de exámenes médico legales por presunto delito sexual contra niños, niñas y adolescentes",2014,3,16,7916,202.122283981809,2,3937,50.8001016002032,14,3979,351.847197788389
16660,68,68077,81,"Tasa de exámenes médico legales por presunto delito sexual contra niños, niñas y adolescentes",2014,3,10,2989,334.560053529609,1,1550,64.5161290322581,9,1439,625.434329395414
16661,25,25875,81,"Tasa de exámenes médico legales por presunto delito sexual contra niños, niñas y adolescentes",2014,3,17,2600,653.846153846154,4,1320,303.030303030303,13,1280,1015625
16662,25,25899,81,"Tasa de exámenes médico legales por presunto delito sexual contra niños, niñas y adolescentes",2014,3,10,13012,76.8521364893944,1,6687,14.9543891132047,9,6325,142.292490118577
16663,13,13836,81,"Tasa de exámenes médico legales por presunto delito sexual contra niños, niñas y adolescentes",2014,3,9,7655,117.570215545395,1,3882,25.7599175682638,8,3773,212.03286509409
16664,13,13442,81,"Tasa de exámenes médico legales por presunto delito sexual contra niños, niñas y adolescentes",2014,3,2,6320,31.6455696202532,1,3291,30.3859009419629,1,3029,33.0141961043249
16665,17,17001,81,"Tasa de exámenes médico legales por presunto delito sexual contra niños, niñas y adolescentes",2014,3,74,32787,225.699210052765,23,16660,138.055222088836,51,16127,316.239846220624
16666,18,18001,81,"Tasa de exámenes médico legales por presunto delito sexual contra niños, niñas y adolescentes",2014,3,23,20126,114.28003577462,6,10150,59.1133004926108,17,9976,170.408981555734
16667,44,44874,81,"Tasa de exámenes médico legales por presunto delito sexual contra niños, niñas y adolescentes",2014,3,1,3019,33.1235508446505,0,1552,0,1,1467,68.1663258350375
16668,27,27001,81,"Tasa de exámenes médico legales por presunto delito sexual contra niños, niñas y adolescentes",2014,3,31,17477,177.375979859244,3,8902,33.7002920691979,28,8575,326.530612244898
16669,50,50001,81,"Tasa de exámenes médico legales por presunto delito sexual contra niños, niñas y adolescentes",2014,3,175,51198,341.810226961991,43,25953,165.684121296189,132,25245,522.875816993464
16670,52,52001,81,"Tasa de exámenes médico legales por presunto delito sexual contra niños, niñas y adolescentes",2014,3,37,40935,90.3871992182729,7,20612,33.9607995342519,30,20323,147.616001574571
16671,54,54810,81,"Tasa de exámenes médico legales por presunto delito sexual contra niños, niñas y adolescentes",2014,3,6,5254,114.198705748002,1,2745,36.4298724954463,5,2509,199.282582702272
16672,63,63001,81,"Tasa de exámenes médico legales por presunto delito sexual contra niños, niñas y adolescentes",2014,3,73,27420,266.229029905179,10,13915,71.8648939992813,63,13505,466.493891151425
16673,63,63594,81,"Tasa de exámenes médico legales por presunto delito sexual contra niños, niñas y adolescentes",2014,3,7,3413,205.098154116613,0,1765,0,7,1648,424.757281553398
16674,5,5360,81,"Tasa de exámenes médico legales por presunto delito sexual contra niños, niñas y adolescentes",2014,3,21,24956,84.1481006571566,1,12644,7.9088895919013,20,12312,162.443144899285
16675,5,5088,81,"Tasa de exámenes médico legales por presunto delito sexual contra niños, niñas y adolescentes",2014,3,41,44891,91.3323383306231,5,22726,22.0012320689959,36,22165,162.418226934356
16676,68,68276,81,"Tasa de exámenes médico legales por presunto delito sexual contra niños, niñas y adolescentes",2014,3,45,23464,191.783157176952,6,12092,49.6195831955012,39,11372,342.947590573338
16677,8,8001,81,"Tasa de exámenes médico legales por presunto delito sexual contra niños, niñas y adolescentes",2014,3,159,121676,130.674907130412,31,62134,49.8921685389642,128,59542,214.974303852743
16678,8,8758,81,"Tasa de exámenes médico legales por presunto delito sexual contra niños, niñas y adolescentes",2014,3,65,67768,95.9154763310117,11,34530,31.8563567911961,54,33238,162.464648895842
16679,8,8573,81,"Tasa de exámenes médico legales por presunto delito sexual contra niños, niñas y adolescentes",2014,3,10,2677,373.552484124019,3,1416,211.864406779661,7,1261,555.114988104679
16680,76,76364,81,"Tasa de exámenes médico legales por presunto delito sexual contra niños, niñas y adolescentes",2014,3,23,11571,198.772794054101,2,5969,33.5064499916234,21,5602,374.866119243127
16681,76,76306,81,"Tasa de exámenes médico legales por presunto delito sexual contra niños, niñas y adolescentes",2014,3,3,1719,174.520069808028,0,868,0,3,851,352.526439482961
16682,68,68081,81,"Tasa de exámenes médico legales por presunto delito sexual contra niños, niñas y adolescentes",2014,3,47,19421,242.006075897225,12,9985,120.180270405608,35,9436,370.919881305638
16683,66,66170,81,"Tasa de exámenes médico legales por presunto delito sexual contra niños, niñas y adolescentes",2014,3,28,18539,151.032957548951,5,9466,52.820621170505,23,9073,253.499393805797
16684,17,17174,81,"Tasa de exámenes médico legales por presunto delito sexual contra niños, niñas y adolescentes",2014,3,10,5490,182.149362477231,4,2784,143.67816091954,6,2706,221.729490022173
16685,15,15131,81,"Tasa de exámenes médico legales por presunto delito sexual contra niños, niñas y adolescentes",2014,3,1,371,269.541778975741,0,191,0,1,180,555.555555555556
16686,15,15248,81,"Tasa de exámenes médico legales por presunto delito sexual contra niños, niñas y adolescentes",2014,3,1,269,371.747211895911,0,128,0,1,141,709.219858156028
16687,25,25743,81,"Tasa de exámenes médico legales por presunto delito sexual contra niños, niñas y adolescentes",2014,3,11,2247,489.541611036938,2,1159,172.562553925798,9,1088,827.205882352941
16688,50,50313,81,"Tasa de exámenes médico legales por presunto delito sexual contra niños, niñas y adolescentes",2014,3,29,7155,405.310971348707,4,3652,109.529025191676,25,3503,713.673993719669
16689,27,27787,81,"Tasa de exámenes médico legales por presunto delito sexual contra niños, niñas y adolescentes",2014,3,4,2895,138.169257340242,1,1445,69.2041522491349,3,1450,206.896551724138
16690,44,44035,81,"Tasa de exámenes médico legales por presunto delito sexual contra niños, niñas y adolescentes",2014,3,6,3557,168.681473151532,3,1846,162.513542795233,3,1711,175.336060783168
16691,76,76520,81,"Tasa de exámenes médico legales por presunto delito sexual contra niños, niñas y adolescentes",2014,3,31,25483,121.64972726916,3,13057,22.9761813586582,28,12426,225.333977144697
16692,76,76275,81,"Tasa de exámenes médico legales por presunto delito sexual contra niños, niñas y adolescentes",2014,3,8,5893,135.754284744612,2,3025,66.1157024793389,6,2868,209.205020920502
16693,76,76622,81,"Tasa de exámenes médico legales por presunto delito sexual contra niños, niñas y adolescentes",2014,3,5,3035,164.744645799012,2,1566,127.713920817369,3,1469,204.220558202859
16694,95,95001,81,"Tasa de exámenes médico legales por presunto delito sexual contra niños, niñas y adolescentes",2014,3,14,9566,146.351662136734,3,4852,61.8301731244847,11,4714,233.347475604582
16695,19,19780,81,"Tasa de exámenes médico legales por presunto delito sexual contra niños, niñas y adolescentes",2014,3,2,2417,82.7472072817542,0,1243,0,2,1174,170.357751277683
16696,25,25843,81,"Tasa de exámenes médico legales por presunto delito sexual contra niños, niñas y adolescentes",2014,3,10,4421,226.193168966297,2,2213,90.3750564844103,8,2208,362.31884057971
16697,13,13873,81,"Tasa de exámenes médico legales por presunto delito sexual contra niños, niñas y adolescentes",2014,3,2,2397,83.4376303712975,0,1218,0,2,1179,169.635284139101
16698,15,15476,81,"Tasa de exámenes médico legales por presunto delito sexual contra niños, niñas y adolescentes",2014,3,1,927,107.874865156419,0,489,0,1,438,228.310502283105
16699,18,18410,81,"Tasa de exámenes médico legales por presunto delito sexual contra niños, niñas y adolescentes",2014,3,1,3377,29.6120817293456,0,1734,0,1,1643,60.8642726719416
16700,19,19473,81,"Tasa de exámenes médico legales por presunto delito sexual contra niños, niñas y adolescentes",2014,3,2,3133,63.8365783593999,1,1611,62.0732464307883,1,1522,65.7030223390276
16701,23,23001,81,"Tasa de exámenes médico legales por presunto delito sexual contra niños, niñas y adolescentes",2014,3,51,49206,103.645896841849,11,24803,44.3494738539693,40,24403,163.914272835307
16702,23,23189,81,"Tasa de exámenes médico legales por presunto delito sexual contra niños, niñas y adolescentes",2014,3,6,7527,79.7130330809087,3,3884,77.2399588053553,3,3643,82.3497117760088
16703,47,47001,81,"Tasa de exámenes médico legales por presunto delito sexual contra niños, niñas y adolescentes",2014,3,74,59496,124.378109452736,7,30005,23.3294450924846,67,29491,227.187955647486
16704,54,54001,81,"Tasa de exámenes médico legales por presunto delito sexual contra niños, niñas y adolescentes",2014,3,54,69841,77.3184805486748,21,35333,59.4345229671978,33,34508,95.6299988408485
16705,86,86571,81,"Tasa de exámenes médico legales por presunto delito sexual contra niños, niñas y adolescentes",2014,3,3,3433,87.3871249635887,0,1785,0,3,1648,182.038834951456
16706,63,63401,81,"Tasa de exámenes médico legales por presunto delito sexual contra niños, niñas y adolescentes",2014,3,11,4637,237.222342031486,1,2407,41.5454923140839,10,2230,448.430493273543
16707,70,70001,81,"Tasa de exámenes médico legales por presunto delito sexual contra niños, niñas y adolescentes",2014,3,51,29853,170.837101798814,10,15201,65.7851457140978,41,14652,279.82527982528
16708,70,70204,81,"Tasa de exámenes médico legales por presunto delito sexual contra niños, niñas y adolescentes",2014,3,1,686,145.772594752187,0,350,0,1,336,297.619047619048
16709,8,8638,81,"Tasa de exámenes médico legales por presunto delito sexual contra niños, niñas y adolescentes",2014,3,10,11768,84.9762066621346,1,6086,16.4311534669734,9,5682,158.394931362196
16710,8,8558,81,"Tasa de exámenes médico legales por presunto delito sexual contra niños, niñas y adolescentes",2014,3,3,1628,184.275184275184,0,843,0,3,785,382.165605095541
16711,17,17042,81,"Tasa de exámenes médico legales por presunto delito sexual contra niños, niñas y adolescentes",2014,3,10,3487,286.779466590192,2,1736,115.207373271889,8,1751,456.881781838949
16712,5,5819,81,"Tasa de exámenes médico legales por presunto delito sexual contra niños, niñas y adolescentes",2014,3,4,803,498.13200498132,1,411,243.30900243309,3,392,765.30612244898
16713,15,15176,81,"Tasa de exámenes médico legales por presunto delito sexual contra niños, niñas y adolescentes",2014,3,13,7691,169.02873488493,3,4020,74.6268656716418,10,3671,272.405339144647
16714,25,25754,81,"Tasa de exámenes médico legales por presunto delito sexual contra niños, niñas y adolescentes",2014,3,120,55776,215.146299483649,27,28564,94.5245763898614,93,27212,341.7609877995
16715,20,20710,81,"Tasa de exámenes médico legales por presunto delito sexual contra niños, niñas y adolescentes",2014,3,4,2884,138.69625520111,0,1459,0,4,1425,280.701754385965
16716,19,19532,81,"Tasa de exámenes médico legales por presunto delito sexual contra niños, niñas y adolescentes",2014,3,4,4251,94.0955069395436,1,2201,45.4338936846888,3,2050,146.341463414634
16717,25,25269,81,"Tasa de exámenes médico legales por presunto delito sexual contra niños, niñas y adolescentes",2014,3,25,14615,171.05713308245,7,7484,93.5328701229289,18,7131,252.419015565839
16718,73,73624,81,"Tasa de exámenes médico legales por presunto delito sexual contra niños, niñas y adolescentes",2014,3,3,2634,113.895216400911,0,1331,0,3,1303,230.237912509593
16719,25,25290,81,"Tasa de exámenes médico legales por presunto delito sexual contra niños, niñas y adolescentes",2014,3,23,12691,181.230793475691,4,6626,60.3682463024449,19,6065,313.272877164056
16720,50,50689,81,"Tasa de exámenes médico legales por presunto delito sexual contra niños, niñas y adolescentes",2014,3,5,2875,173.913043478261,1,1476,67.7506775067751,4,1399,285.918513223731
16721,54,54498,81,"Tasa de exámenes médico legales por presunto delito sexual contra niños, niñas y adolescentes",2014,3,12,11411,105.161686092367,4,5829,68.6224052153028,8,5582,143.317807237549
16722,76,76863,81,"Tasa de exámenes médico legales por presunto delito sexual contra niños, niñas y adolescentes",2014,3,2,700,285.714285714286,0,362,0,2,338,591.715976331361
16723,76,76834,81,"Tasa de exámenes médico legales por presunto delito sexual contra niños, niñas y adolescentes",2014,3,26,19085,136.232643437254,7,9790,71.5015321756895,19,9295,204.410973641743
16724,5,5837,81,"Tasa de exámenes médico legales por presunto delito sexual contra niños, niñas y adolescentes",2014,3,22,21282,103.37374306926,5,10954,45.6454263282819,17,10328,164.601084430674
16725,76,76111,81,"Tasa de exámenes médico legales por presunto delito sexual contra niños, niñas y adolescentes",2014,3,15,9654,155.376009944065,3,4978,60.265166733628,12,4676,256.629597946963
16726,68,68720,81,"Tasa de exámenes médico legales por presunto delito sexual contra niños, niñas y adolescentes",2014,3,1,530,188.679245283019,0,274,0,1,256,390625
16727,25,25658,81,"Tasa de exámenes médico legales por presunto delito sexual contra niños, niñas y adolescentes",2014,3,3,1103,271.985494106981,0,577,0,3,526,570.342205323194
16728,5,5887,81,"Tasa de exámenes médico legales por presunto delito sexual contra niños, niñas y adolescentes",2014,3,6,5743,104.475013059377,1,2934,34.0831629175187,5,2809,177.999288002848
16729,25,25200,81,"Tasa de exámenes médico legales por presunto delito sexual contra niños, niñas y adolescentes",2014,3,4,2416,165.562913907285,2,1199,166.805671392827,2,1217,164.338537387017
16730,13,13042,81,"Tasa de exámenes médico legales por presunto delito sexual contra niños, niñas y adolescentes",2014,3,1,2587,38.6548125241593,0,1355,0,1,1232,81.1688311688312
16731,13,13838,81,"Tasa de exámenes médico legales por presunto delito sexual contra niños, niñas y adolescentes",2014,3,2,2063,96.9461948618517,0,1060,0,2,1003,199.401794616152
16732,15,15001,81,"Tasa de exámenes médico legales por presunto delito sexual contra niños, niñas y adolescentes",2014,3,35,19726,177.430801987225,8,9951,80.3939302582655,27,9775,276.214833759591
16733,15,15500,81,"Tasa de exámenes médico legales por presunto delito sexual contra niños, niñas y adolescentes",2014,3,1,355,281.69014084507,0,186,0,1,169,591.715976331361
16734,19,19001,81,"Tasa de exámenes médico legales por presunto delito sexual contra niños, niñas y adolescentes",2014,3,46,24228,189.862968466237,3,12309,24.3724104313917,43,11919,360.768520849064
16735,23,23686,81,"Tasa de exámenes médico legales por presunto delito sexual contra niños, niñas y adolescentes",2014,3,3,4720,63.5593220338983,1,2409,41.51100041511,2,2311,86.5426222414539
16736,50,50226,81,"Tasa de exámenes médico legales por presunto delito sexual contra niños, niñas y adolescentes",2014,3,3,2266,132.391879964696,0,1140,0,3,1126,266.429840142096
16737,99,99524,81,"Tasa de exámenes médico legales por presunto delito sexual contra niños, niñas y adolescentes",2014,3,1,2190,45.662100456621,0,1126,0,1,1064,93.984962406015
16738,63,63130,81,"Tasa de exámenes médico legales por presunto delito sexual contra niños, niñas y adolescentes",2014,3,20,7672,260.688216892596,5,3958,126.326427488631,15,3714,403.877221324717
16739,73,73268,81,"Tasa de exámenes médico legales por presunto delito sexual contra niños, niñas y adolescentes",2014,3,9,8485,106.069534472599,4,4374,91.4494741655235,5,4111,121.624908781318
16740,5,5615,81,"Tasa de exámenes médico legales por presunto delito sexual contra niños, niñas y adolescentes",2014,3,10,12097,82.6651235843598,3,6179,48.5515455575336,7,5918,118.283203785063
16741,66,66572,81,"Tasa de exámenes médico legales por presunto delito sexual contra niños, niñas y adolescentes",2014,3,3,1907,157.315154693235,2,951,210.304942166141,1,956,104.602510460251
16742,73,73168,81,"Tasa de exámenes médico legales por presunto delito sexual contra niños, niñas y adolescentes",2014,3,13,6133,211.968041741399,4,3139,127.429117553361,9,2994,300.60120240481
16743,23,23586,81,"Tasa de exámenes médico legales por presunto delito sexual contra niños, niñas y adolescentes",2014,3,2,1886,106.044538706257,0,985,0,2,901,221.975582685905
16744,15,15861,81,"Tasa de exámenes médico legales por presunto delito sexual contra niños, niñas y adolescentes",2014,3,3,1938,154.798761609907,0,979,0,3,959,312.825860271116
16745,19,19785,81,"Tasa de exámenes médico legales por presunto delito sexual contra niños, niñas y adolescentes",2014,3,1,930,107.52688172043,0,479,0,1,451,221.729490022173
16746,41,41396,81,"Tasa de exámenes médico legales por presunto delito sexual contra niños, niñas y adolescentes",2014,3,8,8107,98.6801529542371,0,4151,0,8,3956,202.224469160768
16747,23,23417,81,"Tasa de exámenes médico legales por presunto delito sexual contra niños, niñas y adolescentes",2014,3,13,14212,91.4719954967633,4,7299,54.802027675024,9,6913,130.189498047158
16748,76,76248,81,"Tasa de exámenes médico legales por presunto delito sexual contra niños, niñas y adolescentes",2014,3,4,5086,78.6472670074715,0,2596,0,4,2490,160.642570281125
16749,41,41551,81,"Tasa de exámenes médico legales por presunto delito sexual contra niños, niñas y adolescentes",2014,3,25,15143,165.092782143565,2,7642,26.1711593823606,23,7501,306.625783228903
16750,76,76895,81,"Tasa de exámenes médico legales por presunto delito sexual contra niños, niñas y adolescentes",2014,3,8,4248,188.323917137476,2,2170,92.1658986175115,6,2078,288.739172281039
16751,70,70221,81,"Tasa de exámenes médico legales por presunto delito sexual contra niños, niñas y adolescentes",2014,3,4,1724,232.018561484919,1,873,114.54753722795,3,851,352.526439482961
16752,5,5134,81,"Tasa de exámenes médico legales por presunto delito sexual contra niños, niñas y adolescentes",2014,3,1,1056,94.6969696969697,0,552,0,1,504,198.412698412698
16753,81,81591,81,"Tasa de exámenes médico legales por presunto delito sexual contra niños, niñas y adolescentes",2014,3,1,537,186.219739292365,0,268,0,1,269,371.747211895911
16754,15,15204,81,"Tasa de exámenes médico legales por presunto delito sexual contra niños, niñas y adolescentes",2014,3,3,1158,259.067357512953,0,598,0,3,560,535.714285714286
16755,73,73347,81,"Tasa de exámenes médico legales por presunto delito sexual contra niños, niñas y adolescentes",2014,3,2,921,217.155266015201,0,478,0,2,443,451.467268623025
16756,17,17486,81,"Tasa de exámenes médico legales por presunto delito sexual contra niños, niñas y adolescentes",2014,3,6,3792,158.227848101266,1,1953,51.2032770097286,5,1839,271.886895051659
16757,18,18247,81,"Tasa de exámenes médico legales por presunto delito sexual contra niños, niñas y adolescentes",2014,3,1,2771,36.0880548538434,0,1421,0,1,1350,74.0740740740741
16758,20,20060,81,"Tasa de exámenes médico legales por presunto delito sexual contra niños, niñas y adolescentes",2014,3,2,5389,37.1126368528484,0,2780,0,2,2609,76.657723265619
16759,54,54250,81,"Tasa de exámenes médico legales por presunto delito sexual contra niños, niñas y adolescentes",2014,3,2,1579,126.66244458518,1,813,123.0012300123,1,766,130.548302872063
16760,63,63212,81,"Tasa de exámenes médico legales por presunto delito sexual contra niños, niñas y adolescentes",2014,3,2,525,380.952380952381,0,269,0,2,256,781.25
16761,70,70473,81,"Tasa de exámenes médico legales por presunto delito sexual contra niños, niñas y adolescentes",2014,3,6,1665,360.36036036036,0,865,0,6,800,750
16762,70,70215,81,"Tasa de exámenes médico legales por presunto delito sexual contra niños, niñas y adolescentes",2014,3,12,6677,179.72143178074,2,3390,58.9970501474926,10,3287,304.228780042592
16763,68,68271,81,"Tasa de exámenes médico legales por presunto delito sexual contra niños, niñas y adolescentes",2014,3,2,735,272.108843537415,0,384,0,2,351,569.80056980057
16764,68,68255,81,"Tasa de exámenes médico legales por presunto delito sexual contra niños, niñas y adolescentes",2014,3,4,1419,281.888653981677,1,764,130.890052356021,3,655,458.015267175573
16765,68,68406,81,"Tasa de exámenes médico legales por presunto delito sexual contra niños, niñas y adolescentes",2014,3,6,4157,144.334856867934,3,2165,138.568129330254,3,1992,150.602409638554
16766,68,68307,81,"Tasa de exámenes médico legales por presunto delito sexual contra niños, niñas y adolescentes",2014,3,28,17665,158.505519388622,6,8954,67.0091579182488,22,8711,252.554241763288
16767,66,66088,81,"Tasa de exámenes médico legales por presunto delito sexual contra niños, niñas y adolescentes",2014,3,8,3064,261.096605744125,1,1559,64.143681847338,7,1505,465.116279069767
16768,76,76122,81,"Tasa de exámenes médico legales por presunto delito sexual contra niños, niñas y adolescentes",2014,3,6,2692,222.882615156018,2,1392,143.67816091954,4,1300,307.692307692308
16769,25,25438,81,"Tasa de exámenes médico legales por presunto delito sexual contra niños, niñas y adolescentes",2014,3,3,1239,242.130750605327,0,653,0,3,586,511.945392491468
16770,52,52356,81,"Tasa de exámenes médico legales por presunto delito sexual contra niños, niñas y adolescentes",2014,3,11,15308,71.8578521034753,2,7770,25.7400257400257,9,7538,119.39506500398
16771,15,15469,81,"Tasa de exámenes médico legales por presunto delito sexual contra niños, niñas y adolescentes",2014,3,1,2272,44.0140845070423,1,1166,85.7632933104631,0,1106,0
16772,86,86568,81,"Tasa de exámenes médico legales por presunto delito sexual contra niños, niñas y adolescentes",2014,3,25,8105,308.451573103023,3,4119,72.8332119446468,22,3986,551.931761164074
16773,68,68051,81,"Tasa de exámenes médico legales por presunto delito sexual contra niños, niñas y adolescentes",2014,3,1,882,113.378684807256,0,477,0,1,405,246.913580246914
16774,19,19698,81,"Tasa de exámenes médico legales por presunto delito sexual contra niños, niñas y adolescentes",2014,3,7,9815,71.3194090677534,2,4968,40.2576489533011,5,4847,103.15659170621
16775,76,76318,81,"Tasa de exámenes médico legales por presunto delito sexual contra niños, niñas y adolescentes",2014,3,4,3103,128.907508862391,0,1586,0,4,1517,263.6783124588
16776,85,85410,81,"Tasa de exámenes médico legales por presunto delito sexual contra niños, niñas y adolescentes",2014,3,4,2586,154.679040989946,0,1297,0,4,1289,310.318076027929
16777,19,19355,81,"Tasa de exámenes médico legales por presunto delito sexual contra niños, niñas y adolescentes",2014,3,4,4215,94.8991696322657,0,2138,0,4,2077,192.585459797785
16778,27,27245,81,"Tasa de exámenes médico legales por presunto delito sexual contra niños, niñas y adolescentes",2014,3,1,2170,46.0829493087558,0,1093,0,1,1077,92.8505106778087
16779,50,50606,81,"Tasa de exámenes médico legales por presunto delito sexual contra niños, niñas y adolescentes",2014,3,3,1208,248.344370860927,2,618,323.624595469256,1,590,169.491525423729
16780,70,70702,81,"Tasa de exámenes médico legales por presunto delito sexual contra niños, niñas y adolescentes",2014,3,4,1320,303.030303030303,1,675,148.148148148148,3,645,465.116279069767
16781,73,73678,81,"Tasa de exámenes médico legales por presunto delito sexual contra niños, niñas y adolescentes",2014,3,1,2046,48.8758553274682,0,1037,0,1,1009,99.1080277502478
16782,5,5440,81,"Tasa de exámenes médico legales por presunto delito sexual contra niños, niñas y adolescentes",2014,3,10,6328,158.02781289507,0,3254,0,10,3074,325.309043591412
16783,47,47980,81,"Tasa de exámenes médico legales por presunto delito sexual contra niños, niñas y adolescentes",2014,3,8,9428,84.8536274925753,0,4880,0,8,4548,175.901495162709
16784,8,8078,81,"Tasa de exámenes médico legales por presunto delito sexual contra niños, niñas y adolescentes",2014,3,3,6133,48.9157019403228,1,3140,31.8471337579618,2,2993,66.8225860340795
16785,13,13580,81,"Tasa de exámenes médico legales por presunto delito sexual contra niños, niñas y adolescentes",2014,3,3,1516,197.889182058048,1,771,129.70168612192,2,745,268.456375838926
16786,66,66687,81,"Tasa de exámenes médico legales por presunto delito sexual contra niños, niñas y adolescentes",2014,3,3,1685,178.041543026706,1,866,115.473441108545,2,819,244.200244200244
16787,13,13894,81,"Tasa de exámenes médico legales por presunto delito sexual contra niños, niñas y adolescentes",2014,3,3,1417,211.714890613973,0,743,0,3,674,445.103857566766
16788,25,25181,81,"Tasa de exámenes médico legales por presunto delito sexual contra niños, niñas y adolescentes",2014,3,1,1236,80.9061488673139,0,630,0,1,606,165.016501650165
16789,25,25307,81,"Tasa de exámenes médico legales por presunto delito sexual contra niños, niñas y adolescentes",2014,3,26,9562,271.90964233424,5,4717,105.999576001696,21,4845,433.43653250774
16790,54,54518,81,"Tasa de exámenes médico legales por presunto delito sexual contra niños, niñas y adolescentes",2014,3,8,5388,148.478099480327,2,2732,73.2064421669107,6,2656,225.903614457831
16791,41,41770,81,"Tasa de exámenes médico legales por presunto delito sexual contra niños, niñas y adolescentes",2014,3,2,2426,82.4402308326463,1,1244,80.3858520900322,1,1182,84.6023688663282
16792,52,52835,81,"Tasa de exámenes médico legales por presunto delito sexual contra niños, niñas y adolescentes",2014,3,9,28046,32.0901376310347,3,14221,21.0955628999367,6,13825,43.3996383363472
16793,76,76377,81,"Tasa de exámenes médico legales por presunto delito sexual contra niños, niñas y adolescentes",2014,3,7,1015,689.655172413793,2,526,380.228136882129,5,489,1022.49488752556
16794,76,76892,81,"Tasa de exámenes médico legales por presunto delito sexual contra niños, niñas y adolescentes",2014,3,20,10785,185.442744552619,3,5512,54.4267053701016,17,5273,322.39711739048
16795,25,25817,81,"Tasa de exámenes médico legales por presunto delito sexual contra niños, niñas y adolescentes",2014,3,5,3969,125.976316452507,1,2038,49.0677134445535,4,1931,207.146556188503
16796,15,15837,81,"Tasa de exámenes médico legales por presunto delito sexual contra niños, niñas y adolescentes",2014,3,1,1124,88.9679715302491,0,579,0,1,545,183.48623853211
16797,19,19807,81,"Tasa de exámenes médico legales por presunto delito sexual contra niños, niñas y adolescentes",2014,3,6,3257,184.218606079214,0,1701,0,6,1556,385.60411311054
16798,44,44001,81,"Tasa de exámenes médico legales por presunto delito sexual contra niños, niñas y adolescentes",2014,3,30,36515,82.1580172531836,5,18657,26.7995926461918,25,17858,139.993280322545
16799,86,86885,81,"Tasa de exámenes médico legales por presunto delito sexual contra niños, niñas y adolescentes",2014,3,6,2739,219.058050383352,0,1370,0,6,1369,438.27611395179
16800,63,63470,81,"Tasa de exámenes médico legales por presunto delito sexual contra niños, niñas y adolescentes",2014,3,11,4215,260.972716488731,1,2179,45.8926112895824,10,2036,491.159135559921
16801,81,81001,81,"Tasa de exámenes médico legales por presunto delito sexual contra niños, niñas y adolescentes",2014,3,30,13650,219.78021978022,8,6892,116.076610562972,22,6758,325.540100621486
16802,91,91001,81,"Tasa de exámenes médico legales por presunto delito sexual contra niños, niñas y adolescentes",2014,3,17,5569,305.261267732088,4,2842,140.745953553835,13,2727,476.714338100477
16803,50,50006,81,"Tasa de exámenes médico legales por presunto delito sexual contra niños, niñas y adolescentes",2014,3,18,7295,246.744345442084,2,3639,54.9601538884309,16,3656,437.636761487965
16804,5,5034,81,"Tasa de exámenes médico legales por presunto delito sexual contra niños, niñas y adolescentes",2014,3,7,5120,136.71875,4,2644,151.285930408472,3,2476,121.163166397415
16805,13,13244,81,"Tasa de exámenes médico legales por presunto delito sexual contra niños, niñas y adolescentes",2014,3,8,10011,79.912096693637,2,5220,38.3141762452107,6,4791,125.234815278647
16806,20,20228,81,"Tasa de exámenes médico legales por presunto delito sexual contra niños, niñas y adolescentes",2014,3,8,3292,243.013365735115,2,1682,118.906064209275,6,1610,372.670807453416
16807,25,25183,81,"Tasa de exámenes médico legales por presunto delito sexual contra niños, niñas y adolescentes",2014,3,7,2636,265.553869499241,3,1337,224.382946896036,4,1299,307.929176289453
16808,15,15238,81,"Tasa de exámenes médico legales por presunto delito sexual contra niños, niñas y adolescentes",2014,3,10,12221,81.8263644546273,1,6095,16.4068908941756,9,6126,146.914789422135
16809,41,41791,81,"Tasa de exámenes médico legales por presunto delito sexual contra niños, niñas y adolescentes",2014,3,1,2399,41.6840350145894,0,1230,0,1,1169,85.5431993156544
16810,76,76130,81,"Tasa de exámenes médico legales por presunto delito sexual contra niños, niñas y adolescentes",2014,3,8,6868,116.48223645894,3,3571,84.0100812097452,5,3297,151.653017895056
16811,17,17653,81,"Tasa de exámenes médico legales por presunto delito sexual contra niños, niñas y adolescentes",2014,3,8,1997,400.600901352028,0,1031,0,8,966,828.15734989648
16812,68,68855,81,"Tasa de exámenes médico legales por presunto delito sexual contra niños, niñas y adolescentes",2014,3,1,457,218.818380743982,0,237,0,1,220,454.545454545455
16813,76,76828,81,"Tasa de exámenes médico legales por presunto delito sexual contra niños, niñas y adolescentes",2014,3,2,1945,102.827763496144,0,1007,0,2,938,213.219616204691
16814,68,68861,81,"Tasa de exámenes médico legales por presunto delito sexual contra niños, niñas y adolescentes",2014,3,2,2290,87.3362445414847,0,1179,0,2,1111,180.01800180018
16815,19,19256,81,"Tasa de exámenes médico legales por presunto delito sexual contra niños, niñas y adolescentes",2014,3,2,5365,37.2786579683131,0,2768,0,2,2597,77.0119368502118
16816,44,44279,81,"Tasa de exámenes médico legales por presunto delito sexual contra niños, niñas y adolescentes",2014,3,6,4046,148.294611962432,0,2046,0,6,2000,300
16817,50,50568,81,"Tasa de exámenes médico legales por presunto delito sexual contra niños, niñas y adolescentes",2014,3,10,2857,350.017500875044,4,1469,272.294077603812,6,1388,432.276657060519
16818,70,70820,81,"Tasa de exámenes médico legales por presunto delito sexual contra niños, niñas y adolescentes",2014,3,14,4106,340.964442279591,2,2105,95.0118764845606,12,2001,599.700149925037
16819,70,70823,81,"Tasa de exámenes médico legales por presunto delito sexual contra niños, niñas y adolescentes",2014,3,4,2274,175.901495162709,0,1189,0,4,1085,368.663594470046
16820,73,73124,81,"Tasa de exámenes médico legales por presunto delito sexual contra niños, niñas y adolescentes",2014,3,4,2279,175.515577007459,1,1194,83.7520938023451,3,1085,276.497695852535
16821,8,8433,81,"Tasa de exámenes médico legales por presunto delito sexual contra niños, niñas y adolescentes",2014,3,19,13893,136.759519182322,4,7098,56.3539025077487,15,6795,220.75055187638
16822,54,54385,81,"Tasa de exámenes médico legales por presunto delito sexual contra niños, niñas y adolescentes",2014,3,2,1747,114.481969089868,0,898,0,2,849,235.571260306243
16823,20,20011,81,"Tasa de exámenes médico legales por presunto delito sexual contra niños, niñas y adolescentes",2014,3,17,11538,147.339226902409,1,5876,17.0183798502383,16,5662,282.585658777817
16824,17,17665,81,"Tasa de exámenes médico legales por presunto delito sexual contra niños, niñas y adolescentes",2014,3,4,832,480.769230769231,0,424,0,4,408,980.392156862745
16825,27,27075,81,"Tasa de exámenes médico legales por presunto delito sexual contra niños, niñas y adolescentes",2014,3,1,1368,73.0994152046784,0,690,0,1,678,147.492625368732
16826,5,5321,81,"Tasa de exámenes médico legales por presunto delito sexual contra niños, niñas y adolescentes",2014,3,2,534,374.531835205993,1,275,363.636363636364,1,259,386.100386100386
16827,47,47189,81,"Tasa de exámenes médico legales por presunto delito sexual contra niños, niñas y adolescentes",2014,3,11,13549,81.1868034541294,3,7014,42.7715996578272,8,6535,122.417750573833
16828,5,5607,81,"Tasa de exámenes médico legales por presunto delito sexual contra niños, niñas y adolescentes",2014,3,4,1995,200.501253132832,1,1027,97.3709834469328,3,968,309.917355371901
16829,5,5266,81,"Tasa de exámenes médico legales por presunto delito sexual contra niños, niñas y adolescentes",2014,3,6,19413,30.9071240921032,1,9961,10.0391526955125,5,9452,52.8988573846805
16830,41,41306,81,"Tasa de exámenes médico legales por presunto delito sexual contra niños, niñas y adolescentes",2014,3,4,4135,96.7351874244256,1,2120,47.1698113207547,3,2015,148.883374689826
16831,50,50251,81,"Tasa de exámenes médico legales por presunto delito sexual contra niños, niñas y adolescentes",2014,3,4,761,525.624178712221,0,392,0,4,369,1084.0108401084
16832,5,5129,81,"Tasa de exámenes médico legales por presunto delito sexual contra niños, niñas y adolescentes",2014,3,12,7112,168.728908886389,4,3631,110.162489672267,8,3481,229.8190175237
16833,23,23300,81,"Tasa de exámenes médico legales por presunto delito sexual contra niños, niñas y adolescentes",2014,3,2,1553,128.783000643915,1,797,125.470514429109,1,756,132.275132275132
16834,47,47170,81,"Tasa de exámenes médico legales por presunto delito sexual contra niños, niñas y adolescentes",2014,3,3,2469,121.506682867558,1,1268,78.8643533123028,2,1201,166.527893422148
16835,25,25740,81,"Tasa de exámenes médico legales por presunto delito sexual contra niños, niñas y adolescentes",2014,3,7,4009,174.607133948616,1,2044,48.9236790606654,6,1965,305.343511450382
16836,68,68397,81,"Tasa de exámenes médico legales por presunto delito sexual contra niños, niñas y adolescentes",2014,3,4,515,776.699029126214,1,269,371.747211895911,3,246,1219.51219512195
16837,25,25862,81,"Tasa de exámenes médico legales por presunto delito sexual contra niños, niñas y adolescentes",2014,3,1,790,126.582278481013,0,393,0,1,397,251.889168765743
16838,19,19392,81,"Tasa de exámenes médico legales por presunto delito sexual contra niños, niñas y adolescentes",2014,3,1,987,101.317122593718,1,514,194.552529182879,0,473,0
16839,20,20570,81,"Tasa de exámenes médico legales por presunto delito sexual contra niños, niñas y adolescentes",2014,3,7,3331,210.14710297208,1,1751,57.1102227298686,6,1580,379.746835443038
16840,52,52786,81,"Tasa de exámenes médico legales por presunto delito sexual contra niños, niñas y adolescentes",2014,3,5,1923,260.010400416017,0,985,0,5,938,533.049040511727
16841,54,54261,81,"Tasa de exámenes médico legales por presunto delito sexual contra niños, niñas y adolescentes",2014,3,2,2817,70.997515086972,0,1458,0,2,1359,147.167034584253
16842,54,54405,81,"Tasa de exámenes médico legales por presunto delito sexual contra niños, niñas y adolescentes",2014,3,6,7893,76.0167236792094,2,3952,50.6072874493927,4,3941,101.497081958894
16843,73,73686,81,"Tasa de exámenes médico legales por presunto delito sexual contra niños, niñas y adolescentes",2014,3,1,812,123.152709359606,0,420,0,1,392,255.102040816327
16844,63,63690,81,"Tasa de exámenes médico legales por presunto delito sexual contra niños, niñas y adolescentes",2014,3,5,749,667.556742323098,2,388,515.463917525773,3,361,831.024930747922
16845,70,70717,81,"Tasa de exámenes médico legales por presunto delito sexual contra niños, niñas y adolescentes",2014,3,3,1753,171.135196805476,0,915,0,3,838,357.99522673031
16846,5,5079,81,"Tasa de exámenes médico legales por presunto delito sexual contra niños, niñas y adolescentes",2014,3,2,5536,36.1271676300578,0,2835,0,2,2701,74.0466493891151
16847,8,8520,81,"Tasa de exámenes médico legales por presunto delito sexual contra niños, niñas y adolescentes",2014,3,2,2767,72.2804481387785,0,1433,0,2,1334,149.925037481259
16848,47,47745,81,"Tasa de exámenes médico legales por presunto delito sexual contra niños, niñas y adolescentes",2014,3,6,4284,140.056022408964,0,2201,0,6,2083,288.04608737398
16849,66,66400,81,"Tasa de exámenes médico legales por presunto delito sexual contra niños, niñas y adolescentes",2014,3,16,3288,486.61800486618,5,1666,300.120048019208,11,1622,678.175092478422
16850,50,50573,81,"Tasa de exámenes médico legales por presunto delito sexual contra niños, niñas y adolescentes",2014,3,14,4120,339.805825242718,1,2161,46.2748727441,13,1959,663.603879530373
16851,5,5234,81,"Tasa de exámenes médico legales por presunto delito sexual contra niños, niñas y adolescentes",2014,3,3,2950,101.694915254237,0,1543,0,3,1407,213.219616204691
16852,76,76243,81,"Tasa de exámenes médico legales por presunto delito sexual contra niños, niñas y adolescentes",2014,3,3,1116,268.817204301075,0,575,0,3,541,554.52865064695
16853,25,25430,81,"Tasa de exámenes médico legales por presunto delito sexual contra niños, niñas y adolescentes",2014,3,24,8695,276.020701552616,4,4397,90.9711166704571,20,4298,465.332712889716
16854,15,15693,81,"Tasa de exámenes médico legales por presunto delito sexual contra niños, niñas y adolescentes",2014,3,1,1043,95.8772770853308,0,489,0,1,554,180.505415162455
16855,25,25123,81,"Tasa de exámenes médico legales por presunto delito sexual contra niños, niñas y adolescentes",2014,3,3,1272,235.849056603774,0,644,0,3,628,477.707006369427
16856,15,15425,81,"Tasa de exámenes médico legales por presunto delito sexual contra niños, niñas y adolescentes",2014,3,1,490,204.081632653061,0,247,0,1,243,411.522633744856
16857,54,54670,81,"Tasa de exámenes médico legales por presunto delito sexual contra niños, niñas y adolescentes",2014,3,2,1960,102.040816326531,0,989,0,2,971,205.973223480947
16858,68,68679,81,"Tasa de exámenes médico legales por presunto delito sexual contra niños, niñas y adolescentes",2014,3,9,4052,222.112537018756,1,2022,49.4559841740851,8,2030,394.088669950739
16859,15,15051,81,"Tasa de exámenes médico legales por presunto delito sexual contra niños, niñas y adolescentes",2014,3,1,607,164.744645799012,0,320,0,1,287,348.432055749129
16860,19,19100,81,"Tasa de exámenes médico legales por presunto delito sexual contra niños, niñas y adolescentes",2014,3,1,4681,21.362956633198,1,2405,41.5800415800416,0,2276,0
16861,44,44560,81,"Tasa de exámenes médico legales por presunto delito sexual contra niños, niñas y adolescentes",2014,3,3,14749,20.3403620584446,1,7422,13.4734572891404,2,7327,27.2963013511669
16862,44,44650,81,"Tasa de exámenes médico legales por presunto delito sexual contra niños, niñas y adolescentes",2014,3,4,4403,90.8471496706791,1,2298,43.5161009573542,3,2105,142.517814726841
16863,73,73675,81,"Tasa de exámenes médico legales por presunto delito sexual contra niños, niñas y adolescentes",2014,3,4,1838,217.627856365615,0,929,0,4,909,440.04400440044
16864,68,68190,81,"Tasa de exámenes médico legales por presunto delito sexual contra niños, niñas y adolescentes",2014,3,12,5420,221.40221402214,5,2797,178.762960314623,7,2623,266.869996187571
16865,15,15572,81,"Tasa de exámenes médico legales por presunto delito sexual contra niños, niñas y adolescentes",2014,3,19,6687,284.13339315089,3,3387,88.5739592559787,16,3300,484.848484848485
16866,25,25312,81,"Tasa de exámenes médico legales por presunto delito sexual contra niños, niñas y adolescentes",2014,3,5,1014,493.096646942801,1,506,197.628458498024,4,508,787.40157480315
16867,13,13760,81,"Tasa de exámenes médico legales por presunto delito sexual contra niños, niñas y adolescentes",2014,3,2,905,220.994475138122,0,459,0,2,446,448.430493273543
16868,54,54553,81,"Tasa de exámenes médico legales por presunto delito sexual contra niños, niñas y adolescentes",2014,3,1,1184,84.4594594594595,1,610,163.934426229508,0,574,0
16869,50,50150,81,"Tasa de exámenes médico legales por presunto delito sexual contra niños, niñas y adolescentes",2014,3,8,1063,752.587017873942,3,538,557.620817843866,5,525,952.380952380953
16870,5,5579,81,"Tasa de exámenes médico legales por presunto delito sexual contra niños, niñas y adolescentes",2014,3,6,5007,119.83223487118,1,2548,39.2464678178964,5,2459,203.334688897926
16871,25,25473,81,"Tasa de exámenes médico legales por presunto delito sexual contra niños, niñas y adolescentes",2014,3,9,8973,100.300902708124,0,4625,0,9,4348,206.991720331187
16872,41,41298,81,"Tasa de exámenes médico legales por presunto delito sexual contra niños, niñas y adolescentes",2014,3,10,11087,90.1957247226482,0,5668,0,10,5419,184.535892231039
16873,85,85250,81,"Tasa de exámenes médico legales por presunto delito sexual contra niños, niñas y adolescentes",2014,3,11,3545,310.296191819464,1,1848,54.1125541125541,10,1697,589.275191514437
16874,47,47798,81,"Tasa de exámenes médico legales por presunto delito sexual contra niños, niñas y adolescentes",2014,3,3,1713,175.131348511384,0,878,0,3,835,359.281437125748
16875,68,68229,81,"Tasa de exámenes médico legales por presunto delito sexual contra niños, niñas y adolescentes",2014,3,2,1200,166.666666666667,1,604,165.562913907285,1,596,167.785234899329
16876,52,52678,81,"Tasa de exámenes médico legales por presunto delito sexual contra niños, niñas y adolescentes",2014,3,1,5534,18.0701120346946,0,2804,0,1,2730,36.6300366300366
16877,27,27025,81,"Tasa de exámenes médico legales por presunto delito sexual contra niños, niñas y adolescentes",2014,3,1,5664,17.6553672316384,0,2940,0,1,2724,36.7107195301028
16878,8,8296,81,"Tasa de exámenes médico legales por presunto delito sexual contra niños, niñas y adolescentes",2014,3,6,5090,117.878192534381,0,2641,0,6,2449,244.997958350347
16879,18,18592,81,"Tasa de exámenes médico legales por presunto delito sexual contra niños, niñas y adolescentes",2014,3,2,4678,42.7533133817871,1,2408,41.5282392026578,1,2270,44.0528634361234
16880,76,76233,81,"Tasa de exámenes médico legales por presunto delito sexual contra niños, niñas y adolescentes",2014,3,19,3287,578.034682080925,2,1677,119.260584376863,17,1610,1055.90062111801
16881,17,17380,81,"Tasa de exámenes médico legales por presunto delito sexual contra niños, niñas y adolescentes",2014,3,12,8314,144.334856867934,2,4214,47.4608448030375,10,4100,243.90243902439
16882,13,13430,81,"Tasa de exámenes médico legales por presunto delito sexual contra niños, niñas y adolescentes",2014,3,19,15000,126.666666666667,5,7685,65.0618087182824,14,7315,191.387559808612
16883,5,5148,81,"Tasa de exámenes médico legales por presunto delito sexual contra niños, niñas y adolescentes",2014,3,9,5516,163.161711385062,2,2840,70.4225352112676,7,2676,261.584454409567
16884,13,13433,81,"Tasa de exámenes médico legales por presunto delito sexual contra niños, niñas y adolescentes",2014,3,2,3007,66.511473229132,0,1536,0,2,1471,135.961930659415
16885,17,17873,81,"Tasa de exámenes médico legales por presunto delito sexual contra niños, niñas y adolescentes",2014,3,8,5319,150.404211317917,0,2729,0,8,2590,308.880308880309
16886,19,19622,81,"Tasa de exámenes médico legales por presunto delito sexual contra niños, niñas y adolescentes",2014,3,2,1306,153.139356814701,2,672,297.619047619048,0,634,0
16887,27,27495,81,"Tasa de exámenes médico legales por presunto delito sexual contra niños, niñas y adolescentes",2014,3,2,1349,148.257968865827,0,672,0,2,677,295.420974889217
16888,27,27600,81,"Tasa de exámenes médico legales por presunto delito sexual contra niños, niñas y adolescentes",2014,3,2,1323,151.171579743008,0,671,0,2,652,306.748466257669
16889,23,23555,81,"Tasa de exámenes médico legales por presunto delito sexual contra niños, niñas y adolescentes",2014,3,2,8092,24.7157686604053,0,4115,0,2,3977,50.2891626854413
16890,73,73408,81,"Tasa de exámenes médico legales por presunto delito sexual contra niños, niñas y adolescentes",2014,3,7,1826,383.351588170865,0,929,0,7,897,780.379041248607
16891,8,8634,81,"Tasa de exámenes médico legales por presunto delito sexual contra niños, niñas y adolescentes",2014,3,3,3254,92.1942224953903,1,1651,60.5693519079346,2,1603,124.766063630692
16892,52,52287,81,"Tasa de exámenes médico legales por presunto delito sexual contra niños, niñas y adolescentes",2014,3,1,683,146.412884333821,0,346,0,1,337,296.73590504451
16893,20,20383,81,"Tasa de exámenes médico legales por presunto delito sexual contra niños, niñas y adolescentes",2014,3,3,1775,169.014084507042,1,931,107.411385606874,2,844,236.96682464455
16894,27,27660,81,"Tasa de exámenes médico legales por presunto delito sexual contra niños, niñas y adolescentes",2014,3,1,770,129.87012987013,0,373,0,1,397,251.889168765743
16895,20,20238,81,"Tasa de exámenes médico legales por presunto delito sexual contra niños, niñas y adolescentes",2014,3,4,3645,109.739368998628,0,1849,0,4,1796,222.71714922049
16896,50,50450,81,"Tasa de exámenes médico legales por presunto delito sexual contra niños, niñas y adolescentes",2014,3,3,2480,120.967741935484,0,1291,0,3,1189,252.312867956266
16897,25,25572,81,"Tasa de exámenes médico legales por presunto delito sexual contra niños, niñas y adolescentes",2014,3,3,2160,138.888888888889,0,1111,0,3,1049,285.986653956149
16898,66,66440,81,"Tasa de exámenes médico legales por presunto delito sexual contra niños, niñas y adolescentes",2014,3,7,2305,303.687635574837,0,1174,0,7,1131,618.921308576481
16899,68,68211,81,"Tasa de exámenes médico legales por presunto delito sexual contra niños, niñas y adolescentes",2014,3,1,436,229.357798165138,0,225,0,1,211,473.9336492891
16900,15,15759,81,"Tasa de exámenes médico legales por presunto delito sexual contra niños, niñas y adolescentes",2014,3,5,11842,42.2225975342003,1,5944,16.8236877523553,4,5898,67.8195998643608
16901,19,19760,81,"Tasa de exámenes médico legales por presunto delito sexual contra niños, niñas y adolescentes",2014,3,2,1731,115.540150202195,0,889,0,2,842,237.529691211401
16902,70,70670,81,"Tasa de exámenes médico legales por presunto delito sexual contra niños, niñas y adolescentes",2014,3,8,4707,169.959634586786,1,2418,41.3564929693962,7,2289,305.810397553517
16903,73,73449,81,"Tasa de exámenes médico legales por presunto delito sexual contra niños, niñas y adolescentes",2014,3,3,4076,73.6015701668302,0,2131,0,3,1945,154.241645244216
16904,25,25769,81,"Tasa de exámenes médico legales por presunto delito sexual contra niños, niñas y adolescentes",2014,3,2,1595,125.391849529781,0,812,0,2,783,255.427841634738
16905,5,5376,81,"Tasa de exámenes médico legales por presunto delito sexual contra niños, niñas y adolescentes",2014,3,12,5498,218.261185885777,4,2811,142.298114549982,8,2687,297.729810197246
16906,47,47053,81,"Tasa de exámenes médico legales por presunto delito sexual contra niños, niñas y adolescentes",2014,3,4,5671,70.5342973020631,0,2915,0,4,2756,145.137880986938
16907,52,52317,81,"Tasa de exámenes médico legales por presunto delito sexual contra niños, niñas y adolescentes",2014,3,2,1400,142.857142857143,0,711,0,2,689,290.275761973875
16908,41,41006,81,"Tasa de exámenes médico legales por presunto delito sexual contra niños, niñas y adolescentes",2014,3,13,4529,287.039081474939,1,2310,43.2900432900433,12,2219,540.784136998648
16909,68,68324,81,"Tasa de exámenes médico legales por presunto delito sexual contra niños, niñas y adolescentes",2014,3,3,384,781.25,0,199,0,3,185,1621.62162162162
16910,5,5790,81,"Tasa de exámenes médico legales por presunto delito sexual contra niños, niñas y adolescentes",2014,3,1,6119,16.3425396306586,0,3143,0,1,2976,33.6021505376344
16911,15,15109,81,"Tasa de exámenes médico legales por presunto delito sexual contra niños, niñas y adolescentes",2014,3,1,686,145.772594752187,1,364,274.725274725275,0,322,0
16912,15,15806,81,"Tasa de exámenes médico legales por presunto delito sexual contra niños, niñas y adolescentes",2014,3,1,1627,61.4628149969269,0,838,0,1,789,126.742712294043
16913,41,41548,81,"Tasa de exámenes médico legales por presunto delito sexual contra niños, niñas y adolescentes",2014,3,2,1631,122.624156958921,0,845,0,2,786,254.452926208651
16914,73,73443,81,"Tasa de exámenes médico legales por presunto delito sexual contra niños, niñas y adolescentes",2014,3,3,3524,85.1305334846765,1,1800,55.5555555555556,2,1724,116.009280742459
16915,52,52838,81,"Tasa de exámenes médico legales por presunto delito sexual contra niños, niñas y adolescentes",2014,3,4,4224,94.6969696969697,0,2161,0,4,2063,193.892389723703
16916,73,73319,81,"Tasa de exámenes médico legales por presunto delito sexual contra niños, niñas y adolescentes",2014,3,1,3477,28.7604256542997,0,1761,0,1,1716,58.2750582750583
16917,47,47570,81,"Tasa de exámenes médico legales por presunto delito sexual contra niños, niñas y adolescentes",2014,3,1,4669,21.4178624973228,0,2368,0,1,2301,43.4593654932638
16918,73,73349,81,"Tasa de exámenes médico legales por presunto delito sexual contra niños, niñas y adolescentes",2014,3,9,2454,366.748166259169,2,1239,161.420500403551,7,1215,576.131687242798
16919,47,47555,81,"Tasa de exámenes médico legales por presunto delito sexual contra niños, niñas y adolescentes",2014,3,8,7862,101.755278555075,0,4051,0,8,3811,209.918656520598
16920,68,68217,81,"Tasa de exámenes médico legales por presunto delito sexual contra niños, niñas y adolescentes",2014,3,3,796,376.884422110553,0,407,0,3,389,771.20822622108
16921,76,76113,81,"Tasa de exámenes médico legales por presunto delito sexual contra niños, niñas y adolescentes",2014,3,1,1909,52.3834468308015,0,998,0,1,911,109.769484083425
16922,25,25224,81,"Tasa de exámenes médico legales por presunto delito sexual contra niños, niñas y adolescentes",2014,3,3,1003,299.102691924227,0,520,0,3,483,621.11801242236
16923,25,25718,81,"Tasa de exámenes médico legales por presunto delito sexual contra niños, niñas y adolescentes",2014,3,5,1027,486.854917234664,1,530,188.679245283019,4,497,804.828973843058
16924,27,27413,81,"Tasa de exámenes médico legales por presunto delito sexual contra niños, niñas y adolescentes",2014,3,2,1752,114.155251141553,0,862,0,2,890,224.719101123596
16925,23,23660,81,"Tasa de exámenes médico legales por presunto delito sexual contra niños, niñas y adolescentes",2014,3,4,10175,39.3120393120393,0,5179,0,4,4996,80.0640512409928
16926,44,44078,81,"Tasa de exámenes médico legales por presunto delito sexual contra niños, niñas y adolescentes",2014,3,4,4812,83.1255195344971,0,2439,0,4,2373,168.563000421408
16927,13,13780,81,"Tasa de exámenes médico legales por presunto delito sexual contra niños, niñas y adolescentes",2014,3,2,1562,128.040973111396,0,817,0,2,745,268.456375838926
16928,68,68615,81,"Tasa de exámenes médico legales por presunto delito sexual contra niños, niñas y adolescentes",2014,3,1,3040,32.8947368421053,0,1576,0,1,1464,68.3060109289618
16929,68,68575,81,"Tasa de exámenes médico legales por presunto delito sexual contra niños, niñas y adolescentes",2014,3,11,3841,286.383754230669,2,1919,104.220948410631,9,1922,468.262226847034
16930,13,13654,81,"Tasa de exámenes médico legales por presunto delito sexual contra niños, niñas y adolescentes",2014,3,3,2340,128.205128205128,1,1213,82.4402308326463,2,1127,177.462289263532
16931,27,27361,81,"Tasa de exámenes médico legales por presunto delito sexual contra niños, niñas y adolescentes",2014,3,10,3514,284.575981787137,1,1724,58.0046403712297,9,1790,502.793296089385
16932,76,76036,81,"Tasa de exámenes médico legales por presunto delito sexual contra niños, niñas y adolescentes",2014,3,1,1571,63.6537237428389,0,810,0,1,761,131.406044678055
16933,85,85139,81,"Tasa de exámenes médico legales por presunto delito sexual contra niños, niñas y adolescentes",2014,3,1,1330,75.187969924812,0,696,0,1,634,157.728706624606
16934,23,23570,81,"Tasa de exámenes médico legales por presunto delito sexual contra niños, niñas y adolescentes",2014,3,3,4909,61.1122428193115,0,2518,0,3,2391,125.470514429109
16935,52,52788,81,"Tasa de exámenes médico legales por presunto delito sexual contra niños, niñas y adolescentes",2014,3,2,989,202.224469160768,0,502,0,2,487,410.677618069815
16936,41,41676,81,"Tasa de exámenes médico legales por presunto delito sexual contra niños, niñas y adolescentes",2014,3,2,1430,139.86013986014,0,753,0,2,677,295.420974889217
16937,76,76497,81,"Tasa de exámenes médico legales por presunto delito sexual contra niños, niñas y adolescentes",2014,3,3,1602,187.265917602996,1,827,120.918984280532,2,775,258.064516129032
16938,25,25662,81,"Tasa de exámenes médico legales por presunto delito sexual contra niños, niñas y adolescentes",2014,3,6,1006,596.421471172962,1,493,202.839756592292,5,513,974.658869395711
16939,44,44847,81,"Tasa de exámenes médico legales por presunto delito sexual contra niños, niñas y adolescentes",2014,3,5,24599,20.3260295133949,2,12415,16.1095449053564,3,12184,24.6224556795798
16940,81,81736,81,"Tasa de exámenes médico legales por presunto delito sexual contra niños, niñas y adolescentes",2014,3,5,6745,74.1289844329133,3,3397,88.3132175448926,2,3348,59.7371565113501
16941,25,25592,81,"Tasa de exámenes médico legales por presunto delito sexual contra niños, niñas y adolescentes",2014,3,2,503,397.614314115308,0,257,0,2,246,813.008130081301
16942,41,41885,81,"Tasa de exámenes médico legales por presunto delito sexual contra niños, niñas y adolescentes",2014,3,3,890,337.078651685393,1,451,221.729490022173,2,439,455.580865603645
16943,5,5353,81,"Tasa de exámenes médico legales por presunto delito sexual contra niños, niñas y adolescentes",2014,3,1,477,209.643605870021,0,243,0,1,234,427.350427350427
16944,25,25815,81,"Tasa de exámenes médico legales por presunto delito sexual contra niños, niñas y adolescentes",2014,3,1,1807,55.3403431101273,0,935,0,1,872,114.678899082569
16945,15,15808,81,"Tasa de exámenes médico legales por presunto delito sexual contra niños, niñas y adolescentes",2014,3,1,347,288.184438040346,0,184,0,1,163,613.496932515337
16946,15,15516,81,"Tasa de exámenes médico legales por presunto delito sexual contra niños, niñas y adolescentes",2014,3,4,3349,119.438638399522,1,1712,58.411214953271,3,1637,183.262064752596
16947,25,25328,81,"Tasa de exámenes médico legales por presunto delito sexual contra niños, niñas y adolescentes",2014,3,1,394,253.807106598985,0,207,0,1,187,534.75935828877
16948,13,13549,81,"Tasa de exámenes médico legales por presunto delito sexual contra niños, niñas y adolescentes",2014,3,4,3528,113.378684807256,0,1833,0,4,1695,235.98820058997
16949,41,41530,81,"Tasa de exámenes médico legales por presunto delito sexual contra niños, niñas y adolescentes",2014,3,1,1439,69.4927032661571,0,761,0,1,678,147.492625368732
16950,86,86569,81,"Tasa de exámenes médico legales por presunto delito sexual contra niños, niñas y adolescentes",2014,3,1,1887,52.9941706412295,0,944,0,1,943,106.044538706257
16951,76,76736,81,"Tasa de exámenes médico legales por presunto delito sexual contra niños, niñas y adolescentes",2014,3,7,4405,158.910329171396,0,2378,0,7,2027,345.337937839171
16952,15,15232,81,"Tasa de exámenes médico legales por presunto delito sexual contra niños, niñas y adolescentes",2014,3,1,664,150.602409638554,1,350,285.714285714286,0,314,0
16953,27,27050,81,"Tasa de exámenes médico legales por presunto delito sexual contra niños, niñas y adolescentes",2014,3,2,1486,134.589502018843,0,759,0,2,727,275.103163686382
16954,44,44090,81,"Tasa de exámenes médico legales por presunto delito sexual contra niños, niñas y adolescentes",2014,3,3,4454,67.3551863493489,0,2315,0,3,2139,140.252454417952
16955,63,63302,81,"Tasa de exámenes médico legales por presunto delito sexual contra niños, niñas y adolescentes",2014,3,3,799,375.469336670839,0,410,0,3,389,771.20822622108
16956,20,20250,81,"Tasa de exámenes médico legales por presunto delito sexual contra niños, niñas y adolescentes",2014,3,1,3311,30.2023557837511,0,1690,0,1,1621,61.6903146206046
16957,19,19533,81,"Tasa de exámenes médico legales por presunto delito sexual contra niños, niñas y adolescentes",2014,3,1,942,106.157112526539,0,492,0,1,450,222.222222222222
16958,15,15299,81,"Tasa de exámenes médico legales por presunto delito sexual contra niños, niñas y adolescentes",2014,3,3,1961,152.983171851096,1,989,101.112234580384,2,972,205.761316872428
16959,27,27580,81,"Tasa de exámenes médico legales por presunto delito sexual contra niños, niñas y adolescentes",2014,3,1,1484,67.3854447439353,0,731,0,1,753,132.802124833997
16960,25,25873,81,"Tasa de exámenes médico legales por presunto delito sexual contra niños, niñas y adolescentes",2014,3,2,2500,80,1,1307,76.5110941086458,1,1193,83.8222967309304
16961,13,13062,81,"Tasa de exámenes médico legales por presunto delito sexual contra niños, niñas y adolescentes",2014,3,1,1270,78.740157480315,0,682,0,1,588,170.068027210884
16962,20,20621,81,"Tasa de exámenes médico legales por presunto delito sexual contra niños, niñas y adolescentes",2014,3,4,3145,127.186009538951,1,1620,61.7283950617284,3,1525,196.72131147541
16963,25,25053,81,"Tasa de exámenes médico legales por presunto delito sexual contra niños, niñas y adolescentes",2014,3,4,1488,268.817204301075,0,761,0,4,727,550.206327372765
16964,20,20310,81,"Tasa de exámenes médico legales por presunto delito sexual contra niños, niñas y adolescentes",2014,3,3,831,361.01083032491,1,433,230.94688221709,2,398,502.51256281407
16965,17,17614,81,"Tasa de exámenes médico legales por presunto delito sexual contra niños, niñas y adolescentes",2014,3,10,6050,165.289256198347,2,3143,63.6334712058543,8,2907,275.197798417613
16966,88,88001,81,"Tasa de exámenes médico legales por presunto delito sexual contra niños, niñas y adolescentes",2014,3,4,7098,56.3539025077487,0,3617,0,4,3481,114.90950876185
16967,5,5042,81,"Tasa de exámenes médico legales por presunto delito sexual contra niños, niñas y adolescentes",2014,3,10,2892,345.781466113416,0,1501,0,10,1391,718.907260963336
16968,15,15814,81,"Tasa de exámenes médico legales por presunto delito sexual contra niños, niñas y adolescentes",2014,3,1,1271,78.6782061369001,0,662,0,1,609,164.203612479475
16969,23,23182,81,"Tasa de exámenes médico legales por presunto delito sexual contra niños, niñas y adolescentes",2014,3,2,5080,39.3700787401575,1,2547,39.2618767177071,1,2533,39.4788787998421
16970,73,73671,81,"Tasa de exámenes médico legales por presunto delito sexual contra niños, niñas y adolescentes",2014,3,1,1624,61.576354679803,0,849,0,1,775,129.032258064516
16971,50,50577,81,"Tasa de exámenes médico legales por presunto delito sexual contra niños, niñas y adolescentes",2014,3,2,1300,153.846153846154,0,679,0,2,621,322.061191626409
16972,52,52399,81,"Tasa de exámenes médico legales por presunto delito sexual contra niños, niñas y adolescentes",2014,3,1,2644,37.821482602118,0,1333,0,1,1311,76.27765064836
16973,25,25407,81,"Tasa de exámenes médico legales por presunto delito sexual contra niños, niñas y adolescentes",2014,3,1,1125,88.8888888888889,0,581,0,1,544,183.823529411765
16974,68,68572,81,"Tasa de exámenes médico legales por presunto delito sexual contra niños, niñas y adolescentes",2014,3,4,1283,311.769290724864,3,662,453.172205438066,1,621,161.030595813205
16975,13,13468,81,"Tasa de exámenes médico legales por presunto delito sexual contra niños, niñas y adolescentes",2014,3,6,5583,107.469102632993,0,2840,0,6,2743,218.7386073642
16976,23,23466,81,"Tasa de exámenes médico legales por presunto delito sexual contra niños, niñas y adolescentes",2014,3,16,10283,155.596615773607,3,5181,57.9038795599305,13,5102,254.802038416307
16977,8,8685,81,"Tasa de exámenes médico legales por presunto delito sexual contra niños, niñas y adolescentes",2014,3,3,2505,119.760479041916,1,1276,78.3699059561128,2,1229,162.73393002441
16978,86,86760,81,"Tasa de exámenes médico legales por presunto delito sexual contra niños, niñas y adolescentes",2014,3,1,1256,79.6178343949045,1,634,157.728706624606,0,622,0
16979,63,63190,81,"Tasa de exámenes médico legales por presunto delito sexual contra niños, niñas y adolescentes",2014,3,3,2786,107.681263460158,1,1388,72.0461095100865,2,1398,143.061516452074
16980,19,19212,81,"Tasa de exámenes médico legales por presunto delito sexual contra niños, niñas y adolescentes",2014,3,6,3629,165.334802976026,1,1832,54.5851528384279,5,1797,278.241513633834
16981,66,66045,81,"Tasa de exámenes médico legales por presunto delito sexual contra niños, niñas y adolescentes",2014,3,4,2170,184.331797235023,1,1119,89.3655049151028,3,1051,285.442435775452
16982,27,27430,81,"Tasa de exámenes médico legales por presunto delito sexual contra niños, niñas y adolescentes",2014,3,1,2110,47.39336492891,0,1055,0,1,1055,94.7867298578199
16983,5,5541,81,"Tasa de exámenes médico legales por presunto delito sexual contra niños, niñas y adolescentes",2014,3,6,1785,336.134453781513,1,913,109.529025191676,5,872,573.394495412844
16984,68,68179,81,"Tasa de exámenes médico legales por presunto delito sexual contra niños, niñas y adolescentes",2014,3,1,499,200.400801603206,0,262,0,1,237,421.940928270042
16985,13,13052,81,"Tasa de exámenes médico legales por presunto delito sexual contra niños, niñas y adolescentes",2014,3,6,8897,67.4384624030572,1,4506,22.1926320461607,5,4391,113.869278068777
16986,27,27073,81,"Tasa de exámenes médico legales por presunto delito sexual contra niños, niñas y adolescentes",2014,3,1,1247,80.1924619085806,0,638,0,1,609,164.203612479475
16987,5,5649,81,"Tasa de exámenes médico legales por presunto delito sexual contra niños, niñas y adolescentes",2014,3,3,1786,167.973124300112,2,927,215.749730312837,1,859,116.414435389988
16988,52,52585,81,"Tasa de exámenes médico legales por presunto delito sexual contra niños, niñas y adolescentes",2014,3,1,1826,54.7645125958379,0,937,0,1,889,112.485939257593
16989,27,27135,81,"Tasa de exámenes médico legales por presunto delito sexual contra niños, niñas y adolescentes",2014,3,2,1103,181.323662737987,0,560,0,2,543,368.324125230203
16990,5,5792,81,"Tasa de exámenes médico legales por presunto delito sexual contra niños, niñas y adolescentes",2014,3,6,909,660.06600660066,2,471,424.628450106157,4,438,913.24200913242
16991,25,25799,81,"Tasa de exámenes médico legales por presunto delito sexual contra niños, niñas y adolescentes",2014,3,2,2223,89.9685110211426,2,1131,176.83465959328,0,1092,0
16992,13,13657,81,"Tasa de exámenes médico legales por presunto delito sexual contra niños, niñas y adolescentes",2014,3,3,3751,79.9786723540389,0,1941,0,3,1810,165.745856353591
16993,25,25797,81,"Tasa de exámenes médico legales por presunto delito sexual contra niños, niñas y adolescentes",2014,3,5,1180,423.728813559322,1,583,171.526586620926,4,597,670.01675041876
16994,50,50287,81,"Tasa de exámenes médico legales por presunto delito sexual contra niños, niñas y adolescentes",2014,3,1,1617,61.8429189857761,1,825,121.212121212121,0,792,0
16995,68,68432,81,"Tasa de exámenes médico legales por presunto delito sexual contra niños, niñas y adolescentes",2014,3,2,1753,114.090131203651,0,888,0,2,865,231.21387283237
16996,68,68468,81,"Tasa de exámenes médico legales por presunto delito sexual contra niños, niñas y adolescentes",2014,3,1,512,195.3125,0,266,0,1,246,406.50406504065
16997,5,5761,81,"Tasa de exámenes médico legales por presunto delito sexual contra niños, niñas y adolescentes",2014,3,2,1581,126.502213788741,1,827,120.918984280532,1,754,132.62599469496
16998,50,50400,81,"Tasa de exámenes médico legales por presunto delito sexual contra niños, niñas y adolescentes",2014,3,3,1156,259.515570934256,0,622,0,3,534,561.797752808989
16999,19,19075,81,"Tasa de exámenes médico legales por presunto delito sexual contra niños, niñas y adolescentes",2014,3,1,3097,32.2893122376493,0,1603,0,1,1494,66.9344042838019
17000,20,20032,81,"Tasa de exámenes médico legales por presunto delito sexual contra niños, niñas y adolescentes",2014,3,1,2920,34.2465753424658,0,1525,0,1,1395,71.6845878136201
17001,23,23678,81,"Tasa de exámenes médico legales por presunto delito sexual contra niños, niñas y adolescentes",2014,3,2,3342,59.8444045481747,0,1702,0,2,1640,121.951219512195
17002,95,95025,81,"Tasa de exámenes médico legales por presunto delito sexual contra niños, niñas y adolescentes",2014,3,1,3474,28.7852619458837,0,1718,0,1,1756,56.9476082004556
17003,70,70508,81,"Tasa de exámenes médico legales por presunto delito sexual contra niños, niñas y adolescentes",2014,3,2,2621,76.3067531476536,0,1357,0,2,1264,158.227848101266
17004,17,17442,81,"Tasa de exámenes médico legales por presunto delito sexual contra niños, niñas y adolescentes",2014,3,2,1130,176.991150442478,0,583,0,2,547,365.63071297989
17005,5,5480,81,"Tasa de exámenes médico legales por presunto delito sexual contra niños, niñas y adolescentes",2014,3,2,2502,79.9360511590727,1,1284,77.8816199376947,1,1218,82.1018062397373
17006,25,25878,81,"Tasa de exámenes médico legales por presunto delito sexual contra niños, niñas y adolescentes",2014,3,2,1331,150.26296018031601,0,679,0,2,652,306.748466257669
17007,54,54800,81,"Tasa de exámenes médico legales por presunto delito sexual contra niños, niñas y adolescentes",2014,3,1,3180,31.4465408805031,0,1626,0,1,1554,64.3500643500643
17008,54,54245,81,"Tasa de exámenes médico legales por presunto delito sexual contra niños, niñas y adolescentes",2014,3,1,1879,53.2197977647685,0,959,0,1,920,108.695652173913
17009,15,15223,81,"Tasa de exámenes médico legales por presunto delito sexual contra niños, niñas y adolescentes",2014,3,1,939,106.496272630458,0,489,0,1,450,222.222222222222
17010,81,81065,81,"Tasa de exámenes médico legales por presunto delito sexual contra niños, niñas y adolescentes",2014,3,1,6084,16.4365548980934,0,3092,0,1,2992,33.4224598930481
17011,76,76670,81,"Tasa de exámenes médico legales por presunto delito sexual contra niños, niñas y adolescentes",2014,3,2,1598,125.156445556946,0,853,0,2,745,268.456375838926
17012,85,85440,81,"Tasa de exámenes médico legales por presunto delito sexual contra niños, niñas y adolescentes",2014,3,13,2890,449.826989619377,2,1475,135.593220338983,11,1415,777.385159010601
17013,52,52110,81,"Tasa de exámenes médico legales por presunto delito sexual contra niños, niñas y adolescentes",2014,3,3,2649,113.250283125708,0,1325,0,3,1324,226.586102719033
17014,73,73854,81,"Tasa de exámenes médico legales por presunto delito sexual contra niños, niñas y adolescentes",2014,3,1,794,125.944584382872,0,409,0,1,385,259.74025974026
17015,41,41349,81,"Tasa de exámenes médico legales por presunto delito sexual contra niños, niñas y adolescentes",2014,3,1,834,119.904076738609,1,452,221.238938053097,0,382,0
17016,20,20517,81,"Tasa de exámenes médico legales por presunto delito sexual contra niños, niñas y adolescentes",2014,3,1,2126,47.0366886171214,0,1074,0,1,1052,95.0570342205323
17017,5,5055,81,"Tasa de exámenes médico legales por presunto delito sexual contra niños, niñas y adolescentes",2014,3,1,1164,85.9106529209622,0,621,0,1,543,184.162062615101
17018,47,47460,81,"Tasa de exámenes médico legales por presunto delito sexual contra niños, niñas y adolescentes",2014,3,1,2557,39.1083300743058,0,1344,0,1,1213,82.4402308326463
17019,76,76400,81,"Tasa de exámenes médico legales por presunto delito sexual contra niños, niñas y adolescentes",2014,3,2,3525,56.7375886524823,0,1831,0,2,1694,118.063754427391
17020,68,68745,81,"Tasa de exámenes médico legales por presunto delito sexual contra niños, niñas y adolescentes",2014,3,1,889,112.485939257593,0,461,0,1,428,233.644859813084
17021,23,23162,81,"Tasa de exámenes médico legales por presunto delito sexual contra niños, niñas y adolescentes",2014,3,7,9913,70.6143447997579,2,4947,40.428542551041,5,4966,100.684655658478
17022,52,52233,81,"Tasa de exámenes médico legales por presunto delito sexual contra niños, niñas y adolescentes",2014,3,4,1889,211.752249867655,2,965,207.253886010363,2,924,216.450216450216
17023,70,70523,81,"Tasa de exámenes médico legales por presunto delito sexual contra niños, niñas y adolescentes",2014,3,2,1960,102.040816326531,0,1023,0,2,937,213.447171824973
17024,73,73217,81,"Tasa de exámenes médico legales por presunto delito sexual contra niños, niñas y adolescentes",2014,3,2,3715,53.835800807537,0,1937,0,2,1778,112.485939257593
17025,20,20178,81,"Tasa de exámenes médico legales por presunto delito sexual contra niños, niñas y adolescentes",2014,3,6,2811,213.447171824973,1,1438,69.5410292072323,5,1373,364.166059723234
17026,25,25178,81,"Tasa de exámenes médico legales por presunto delito sexual contra niños, niñas y adolescentes",2014,3,4,979,408.580183861083,0,513,0,4,466,858.369098712446
17027,47,47030,81,"Tasa de exámenes médico legales por presunto delito sexual contra niños, niñas y adolescentes",2014,3,1,1992,50.2008032128514,1,1009,99.1080277502478,0,983,0
17028,41,41807,81,"Tasa de exámenes médico legales por presunto delito sexual contra niños, niñas y adolescentes",2014,3,1,2545,39.2927308447937,0,1286,0,1,1259,79.428117553614
17029,5,5686,81,"Tasa de exámenes médico legales por presunto delito sexual contra niños, niñas y adolescentes",2014,3,4,3905,102.432778489117,1,1995,50.125313283208,3,1910,157.068062827225
17030,23,23807,81,"Tasa de exámenes médico legales por presunto delito sexual contra niños, niñas y adolescentes",2014,3,3,13728,21.8531468531469,0,7018,0,3,6710,44.7093889716841
17031,15,15183,81,"Tasa de exámenes médico legales por presunto delito sexual contra niños, niñas y adolescentes",2014,3,1,1361,73.4753857457752,0,717,0,1,644,155.27950310559
17032,15,15087,81,"Tasa de exámenes médico legales por presunto delito sexual contra niños, niñas y adolescentes",2014,3,1,790,126.582278481013,0,407,0,1,383,261.096605744125
17033,25,25386,81,"Tasa de exámenes médico legales por presunto delito sexual contra niños, niñas y adolescentes",2014,3,4,3065,130.505709624796,0,1551,0,4,1514,264.200792602378
17034,23,23079,81,"Tasa de exámenes médico legales por presunto delito sexual contra niños, niñas y adolescentes",2014,3,1,2832,35.3107344632768,0,1499,0,1,1333,75.0187546886722
17035,52,52621,81,"Tasa de exámenes médico legales por presunto delito sexual contra niños, niñas y adolescentes",2014,3,1,3241,30.8546744831842,0,1617,0,1,1624,61.576354679803
17036,70,70233,81,"Tasa de exámenes médico legales por presunto delito sexual contra niños, niñas y adolescentes",2014,3,2,1296,154.320987654321,0,666,0,2,630,317.460317460317
17037,13,13683,81,"Tasa de exámenes médico legales por presunto delito sexual contra niños, niñas y adolescentes",2014,3,2,2939,68.0503572643756,1,1507,66.35700066357,1,1432,69.8324022346369
17038,41,41797,81,"Tasa de exámenes médico legales por presunto delito sexual contra niños, niñas y adolescentes",2014,3,2,1106,180.831826401447,0,574,0,2,532,375.93984962406
17039,47,47288,81,"Tasa de exámenes médico legales por presunto delito sexual contra niños, niñas y adolescentes",2014,3,7,8237,84.9823965035814,1,4177,23.9406272444338,6,4060,147.783251231527
17040,13,13458,81,"Tasa de exámenes médico legales por presunto delito sexual contra niños, niñas y adolescentes",2014,3,2,2730,73.2600732600733,0,1408,0,2,1322,151.285930408472
17041,68,68162,81,"Tasa de exámenes médico legales por presunto delito sexual contra niños, niñas y adolescentes",2014,3,2,643,311.04199066874,1,325,307.692307692308,1,318,314.465408805031
17042,76,76606,81,"Tasa de exámenes médico legales por presunto delito sexual contra niños, niñas y adolescentes",2014,3,2,1570,127.388535031847,0,819,0,2,751,266.311584553928
17043,41,41378,81,"Tasa de exámenes médico legales por presunto delito sexual contra niños, niñas y adolescentes",2014,3,5,1820,274.725274725275,1,924,108.225108225108,4,896,446.428571428571
17044,86,86865,81,"Tasa de exámenes médico legales por presunto delito sexual contra niños, niñas y adolescentes",2014,3,4,6812,58.7199060481503,0,3465,0,4,3347,119.510008963251
17045,41,41013,81,"Tasa de exámenes médico legales por presunto delito sexual contra niños, niñas y adolescentes",2014,3,1,1189,84.1042893187552,0,621,0,1,568,176.056338028169
17046,25,25612,81,"Tasa de exámenes médico legales por presunto delito sexual contra niños, niñas y adolescentes",2014,3,3,887,338.218714768884,1,435,229.885057471264,2,452,442.477876106195
17047,41,41660,81,"Tasa de exámenes médico legales por presunto delito sexual contra niños, niñas y adolescentes",2014,3,1,1587,63.0119722747322,0,825,0,1,762,131.233595800525
17048,73,73861,81,"Tasa de exámenes médico legales por presunto delito sexual contra niños, niñas y adolescentes",2014,3,1,2263,44.1891294741494,0,1190,0,1,1073,93.1966449207828
17049,5,5212,81,"Tasa de exámenes médico legales por presunto delito sexual contra niños, niñas y adolescentes",2014,3,8,6023,132.824173999668,3,3122,96.0922485586163,5,2901,172.354360565322
17050,5,5147,81,"Tasa de exámenes médico legales por presunto delito sexual contra niños, niñas y adolescentes",2014,3,7,7283,96.1142386379239,1,3663,27.3000273000273,6,3620,165.745856353591
17051,73,73236,81,"Tasa de exámenes médico legales por presunto delito sexual contra niños, niñas y adolescentes",2014,3,1,858,116.550116550117,0,443,0,1,415,240.963855421687
17052,50,50370,81,"Tasa de exámenes médico legales por presunto delito sexual contra niños, niñas y adolescentes",2014,3,1,1953,51.2032770097286,0,1003,0,1,950,105.263157894737
17053,17,17541,81,"Tasa de exámenes médico legales por presunto delito sexual contra niños, niñas y adolescentes",2014,3,2,2975,67.2268907563025,1,1536,65.1041666666667,1,1439,69.4927032661571
17054,25,25885,81,"Tasa de exámenes médico legales por presunto delito sexual contra niños, niñas y adolescentes",2014,3,3,1846,162.513542795233,2,971,205.973223480947,1,875,114.285714285714
17055,85,85015,81,"Tasa de exámenes médico legales por presunto delito sexual contra niños, niñas y adolescentes",2014,3,1,291,343.642611683849,0,148,0,1,143,699.300699300699
17056,50,50711,81,"Tasa de exámenes médico legales por presunto delito sexual contra niños, niñas y adolescentes",2014,3,1,3237,30.8928019771393,0,1666,0,1,1571,63.6537237428389
17057,73,73483,81,"Tasa de exámenes médico legales por presunto delito sexual contra niños, niñas y adolescentes",2014,3,1,2361,42.3549343498518,0,1217,0,1,1144,87.4125874125874
17058,76,76890,81,"Tasa de exámenes médico legales por presunto delito sexual contra niños, niñas y adolescentes",2014,3,4,1428,280.11204481792703,0,748,0,4,680,588.235294117647
17059,41,41668,81,"Tasa de exámenes médico legales por presunto delito sexual contra niños, niñas y adolescentes",2014,3,8,3739,213.960952126237,0,1893,0,8,1846,433.369447453954
17060,68,68101,81,"Tasa de exámenes médico legales por presunto delito sexual contra niños, niñas y adolescentes",2014,3,2,1440,138.888888888889,1,718,139.275766016713,1,722,138.504155124654
17061,20,20750,81,"Tasa de exámenes médico legales por presunto delito sexual contra niños, niñas y adolescentes",2014,3,1,1816,55.0660792951542,0,953,0,1,863,115.874855156431
17062,44,44420,81,"Tasa de exámenes médico legales por presunto delito sexual contra niños, niñas y adolescentes",2014,3,1,347,288.184438040346,0,186,0,1,161,621.11801242236
17063,23,23574,81,"Tasa de exámenes médico legales por presunto delito sexual contra niños, niñas y adolescentes",2014,3,2,3879,51.559680329982,1,2046,48.8758553274682,1,1833,54.5553737043099
17064,52,52573,81,"Tasa de exámenes médico legales por presunto delito sexual contra niños, niñas y adolescentes",2014,3,1,858,116.550116550117,0,434,0,1,424,235.849056603774
17065,50,50318,81,"Tasa de exámenes médico legales por presunto delito sexual contra niños, niñas y adolescentes",2014,3,2,985,203.045685279188,0,505,0,2,480,416.666666666667
17066,5,5467,81,"Tasa de exámenes médico legales por presunto delito sexual contra niños, niñas y adolescentes",2014,3,1,697,143.472022955524,1,364,274.725274725275,0,333,0
17067,23,23419,81,"Tasa de exámenes médico legales por presunto delito sexual contra niños, niñas y adolescentes",2014,3,3,3341,89.7934750074828,1,1713,58.3771161704612,2,1628,122.850122850123
17068,76,76020,81,"Tasa de exámenes médico legales por presunto delito sexual contra niños, niñas y adolescentes",2014,3,1,2122,47.1253534401508,1,1081,92.5069380203515,0,1041,0
17069,70,70418,81,"Tasa de exámenes médico legales por presunto delito sexual contra niños, niñas y adolescentes",2014,3,1,2091,47.8240076518412,1,1069,93.5453695042095,0,1022,0
17070,70,70713,81,"Tasa de exámenes médico legales por presunto delito sexual contra niños, niñas y adolescentes",2014,3,1,6858,14.5815106445028,1,3510,28.4900284900285,0,3348,0
17071,41,41615,81,"Tasa de exámenes médico legales por presunto delito sexual contra niños, niñas y adolescentes",2014,3,1,2080,48.0769230769231,1,1058,94.5179584120983,0,1022,0
17072,19,19137,81,"Tasa de exámenes médico legales por presunto delito sexual contra niños, niñas y adolescentes",2014,3,1,4411,22.670596236681,0,2229,0,1,2182,45.8295142071494
17073,20,20614,81,"Tasa de exámenes médico legales por presunto delito sexual contra niños, niñas y adolescentes",2014,3,2,1538,130.039011703511,0,798,0,2,740,270.27027027027
17074,15,15507,81,"Tasa de exámenes médico legales por presunto delito sexual contra niños, niñas y adolescentes",2014,3,1,1461,68.4462696783025,0,753,0,1,708,141.242937853107
17075,47,47545,81,"Tasa de exámenes médico legales por presunto delito sexual contra niños, niñas y adolescentes",2014,3,1,2531,39.5100750691426,0,1360,0,1,1171,85.397096498719
17076,73,73055,81,"Tasa de exámenes médico legales por presunto delito sexual contra niños, niñas y adolescentes",2014,3,3,1314,228.310502283105,1,677,147.710487444609,2,637,313.971742543171
17077,76,76823,81,"Tasa de exámenes médico legales por presunto delito sexual contra niños, niñas y adolescentes",2014,3,3,1732,173.210161662818,0,892,0,3,840,357.142857142857
17078,15,15646,81,"Tasa de exámenes médico legales por presunto delito sexual contra niños, niñas y adolescentes",2014,3,2,2653,75.3863550697324,0,1375,0,2,1278,156.494522691706
17079,18,18785,81,"Tasa de exámenes médico legales por presunto delito sexual contra niños, niñas y adolescentes",2014,3,1,1271,78.6782061369001,0,654,0,1,617,162.074554294976
17080,19,19743,81,"Tasa de exámenes médico legales por presunto delito sexual contra niños, niñas y adolescentes",2014,3,1,3875,25.8064516129032,0,1975,0,1,1900,52.6315789473684
17081,76,76041,81,"Tasa de exámenes médico legales por presunto delito sexual contra niños, niñas y adolescentes",2014,3,2,2083,96.0153624579933,0,1057,0,2,1026,194.931773879142
17082,25,25898,81,"Tasa de exámenes médico legales por presunto delito sexual contra niños, niñas y adolescentes",2014,3,6,681,881.057268722467,0,342,0,6,339,1769.91150442478
17083,52,52560,81,"Tasa de exámenes médico legales por presunto delito sexual contra niños, niñas y adolescentes",2014,3,1,1074,93.1098696461825,1,560,178.571428571429,0,514,0
17084,23,23672,81,"Tasa de exámenes médico legales por presunto delito sexual contra niños, niñas y adolescentes",2014,3,1,3651,27.3897562311695,1,1857,53.850296176629,0,1794,0
17085,76,76100,81,"Tasa de exámenes médico legales por presunto delito sexual contra niños, niñas y adolescentes",2014,3,2,1450,137.931034482759,0,763,0,2,687,291.120815138282
17086,15,15047,81,"Tasa de exámenes médico legales por presunto delito sexual contra niños, niñas y adolescentes",2014,3,1,2020,49.5049504950495,0,1037,0,1,983,101.729399796541
17087,81,81794,81,"Tasa de exámenes médico legales por presunto delito sexual contra niños, niñas y adolescentes",2014,3,2,7452,26.8384326355341,0,3880,0,2,3572,55.9910414333707
17088,15,15740,81,"Tasa de exámenes médico legales por presunto delito sexual contra niños, niñas y adolescentes",2014,3,1,1142,87.5656742556918,0,586,0,1,556,179.856115107914
17089,41,41524,81,"Tasa de exámenes médico legales por presunto delito sexual contra niños, niñas y adolescentes",2014,3,1,3767,26.5463233342182,0,1925,0,1,1842,54.2888165038002
17090,27,27491,81,"Tasa de exámenes médico legales por presunto delito sexual contra niños, niñas y adolescentes",2014,3,1,1229,81.366965012205,0,632,0,1,597,167.50418760469
17091,47,47058,81,"Tasa de exámenes médico legales por presunto delito sexual contra niños, niñas y adolescentes",2014,3,2,4230,47.2813238770686,0,2222,0,2,2008,99.601593625498
17092,17,17616,81,"Tasa de exámenes médico legales por presunto delito sexual contra niños, niñas y adolescentes",2014,3,2,1138,175.746924428822,0,603,0,2,535,373.831775700935
17093,85,85010,81,"Tasa de exámenes médico legales por presunto delito sexual contra niños, niñas y adolescentes",2014,3,4,4527,88.3587364700685,3,2308,129.98266897747,1,2219,45.0653447498873
17094,19,19548,81,"Tasa de exámenes médico legales por presunto delito sexual contra niños, niñas y adolescentes",2014,3,3,4709,63.7077935867488,0,2411,0,3,2298,130.548302872063
17095,54,54673,81,"Tasa de exámenes médico legales por presunto delito sexual contra niños, niñas y adolescentes",2014,3,1,661,151.285930408472,1,337,296.73590504451,0,324,0
17096,76,76126,81,"Tasa de exámenes médico legales por presunto delito sexual contra niños, niñas y adolescentes",2014,3,4,1395,286.73835125448,0,713,0,4,682,586.510263929619
17097,5,5040,81,"Tasa de exámenes médico legales por presunto delito sexual contra niños, niñas y adolescentes",2014,3,17,1949,872.242175474602,3,1018,294.695481335953,14,931,1503.75939849624
17098,27,27450,81,"Tasa de exámenes médico legales por presunto delito sexual contra niños, niñas y adolescentes",2014,3,1,2385,41.9287211740042,0,1209,0,1,1176,85.0340136054422
17099,15,15879,81,"Tasa de exámenes médico legales por presunto delito sexual contra niños, niñas y adolescentes",2014,3,2,373,536.193029490617,0,205,0,2,168,1190.47619047619
17100,13,13670,81,"Tasa de exámenes médico legales por presunto delito sexual contra niños, niñas y adolescentes",2014,3,1,4200,23.8095238095238,0,2020,0,1,2180,45.8715596330275
17101,15,15753,81,"Tasa de exámenes médico legales por presunto delito sexual contra niños, niñas y adolescentes",2014,3,3,736,407.608695652174,3,371,808.625336927224,0,365,0
17102,5,5490,81,"Tasa de exámenes médico legales por presunto delito sexual contra niños, niñas y adolescentes",2014,3,6,8194,73.2243104710764,1,4173,23.9635753654445,5,4021,124.347177319075
17103,73,73411,81,"Tasa de exámenes médico legales por presunto delito sexual contra niños, niñas y adolescentes",2014,3,3,4468,67.1441360787825,2,2314,86.4304235090752,1,2154,46.4252553389044
17104,41,41359,81,"Tasa de exámenes médico legales por presunto delito sexual contra niños, niñas y adolescentes",2014,3,5,3273,152.765047357165,1,1674,59.7371565113501,4,1599,250.156347717323
17105,19,19845,81,"Tasa de exámenes médico legales por presunto delito sexual contra niños, niñas y adolescentes",2014,3,1,1959,51.0464522715671,0,995,0,1,964,103.734439834025
17106,52,52506,81,"Tasa de exámenes médico legales por presunto delito sexual contra niños, niñas y adolescentes",2014,3,1,828,120.772946859903,0,422,0,1,406,246.305418719212
17107,19,19130,81,"Tasa de exámenes médico legales por presunto delito sexual contra niños, niñas y adolescentes",2014,3,1,4632,21.5889464594128,0,2419,0,1,2213,45.1875282422052
17108,8,8372,81,"Tasa de exámenes médico legales por presunto delito sexual contra niños, niñas y adolescentes",2014,3,1,1798,55.6173526140156,0,955,0,1,843,118.623962040332
17109,47,47318,81,"Tasa de exámenes médico legales por presunto delito sexual contra niños, niñas y adolescentes",2014,3,1,3478,28.7521564117309,0,1812,0,1,1666,60.0240096038415
17110,5,5380,81,"Tasa de exámenes médico legales por presunto delito sexual contra niños, niñas y adolescentes",2014,3,3,6149,48.7884208814441,1,3128,31.9693094629156,2,3021,66.203243958954
17111,23,23500,81,"Tasa de exámenes médico legales por presunto delito sexual contra niños, niñas y adolescentes",2014,3,1,3748,26.6808964781217,1,1930,51.8134715025907,0,1818,0
17112,20,20045,81,"Tasa de exámenes médico legales por presunto delito sexual contra niños, niñas y adolescentes",2014,3,2,1894,105.596620908131,1,1000,100,1,894,111.856823266219
17113,70,70230,81,"Tasa de exámenes médico legales por presunto delito sexual contra niños, niñas y adolescentes",2014,3,2,546,366.300366300366,0,283,0,2,263,760.456273764259
17114,8,8137,81,"Tasa de exámenes médico legales por presunto delito sexual contra niños, niñas y adolescentes",2014,3,1,2297,43.535045711798,0,1185,0,1,1112,89.9280575539568
17115,91,91263,81,"Tasa de exámenes médico legales por presunto delito sexual contra niños, niñas y adolescentes",2014,3,1,743,134.589502018843,0,359,0,1,384,260.416666666667
17116,73,73275,81,"Tasa de exámenes médico legales por presunto delito sexual contra niños, niñas y adolescentes",2014,3,2,3054,65.4878847413229,1,1578,63.3713561470215,1,1476,67.7506775067751
17117,25,25324,81,"Tasa de exámenes médico legales por presunto delito sexual contra niños, niñas y adolescentes",2014,3,1,304,328.947368421053,0,155,0,1,149,671.140939597315
17118,41,41799,81,"Tasa de exámenes médico legales por presunto delito sexual contra niños, niñas y adolescentes",2014,3,4,1931,207.146556188503,0,989,0,4,942,424.628450106157
17119,17,17777,81,"Tasa de exámenes médico legales por presunto delito sexual contra niños, niñas y adolescentes",2014,3,1,2879,34.7342827370615,0,1462,0,1,1417,70.5716302046577
17120,13,13268,81,"Tasa de exámenes médico legales por presunto delito sexual contra niños, niñas y adolescentes",2014,3,1,1248,80.1282051282051,0,653,0,1,595,168.067226890756
17121,15,15466,81,"Tasa de exámenes médico legales por presunto delito sexual contra niños, niñas y adolescentes",2014,3,1,568,176.056338028169,0,280,0,1,288,347.222222222222
17122,76,76616,81,"Tasa de exámenes médico legales por presunto delito sexual contra niños, niñas y adolescentes",2014,3,1,1418,70.5218617771509,0,751,0,1,667,149.925037481259
17123,68,68533,81,"Tasa de exámenes médico legales por presunto delito sexual contra niños, niñas y adolescentes",2014,3,1,524,190.839694656489,0,270,0,1,254,393.700787401575
17124,18,18479,81,"Tasa de exámenes médico legales por presunto delito sexual contra niños, niñas y adolescentes",2014,3,2,532,375.93984962406,2,270,740.740740740741,0,262,0
17125,52,52405,81,"Tasa de exámenes médico legales por presunto delito sexual contra niños, niñas y adolescentes",2014,3,1,2000,50,0,1021,0,1,979,102.145045965271
17126,8,8832,81,"Tasa de exámenes médico legales por presunto delito sexual contra niños, niñas y adolescentes",2014,3,1,1146,87.260034904014,0,594,0,1,552,181.159420289855
17127,5,5044,81,"Tasa de exámenes médico legales por presunto delito sexual contra niños, niñas y adolescentes",2014,3,2,889,224.971878515186,2,472,423.728813559322,0,417,0
17128,27,27205,81,"Tasa de exámenes médico legales por presunto delito sexual contra niños, niñas y adolescentes",2014,3,2,2062,96.9932104752667,0,1005,0,2,1057,189.214758751183
17129,19,19573,81,"Tasa de exámenes médico legales por presunto delito sexual contra niños, niñas y adolescentes",2014,3,4,4884,81.9000819000819,1,2465,40.5679513184584,3,2419,124.018189334436
17130,15,15226,81,"Tasa de exámenes médico legales por presunto delito sexual contra niños, niñas y adolescentes",2014,3,1,199,502.51256281407,0,103,0,1,96,1041.66666666667
17131,5,5854,81,"Tasa de exámenes médico legales por presunto delito sexual contra niños, niñas y adolescentes",2014,3,1,2897,34.5184673800483,0,1492,0,1,1405,71.1743772241993
17132,18,18256,81,"Tasa de exámenes médico legales por presunto delito sexual contra niños, niñas y adolescentes",2014,3,1,2905,34.4234079173838,0,1471,0,1,1434,69.7350069735007
17133,25,25524,81,"Tasa de exámenes médico legales por presunto delito sexual contra niños, niñas y adolescentes",2014,3,1,582,171.821305841924,0,310,0,1,272,367.647058823529
17134,52,52022,81,"Tasa de exámenes médico legales por presunto delito sexual contra niños, niñas y adolescentes",2014,3,1,584,171.232876712329,0,294,0,1,290,344.827586206897
17135,25,25596,81,"Tasa de exámenes médico legales por presunto delito sexual contra niños, niñas y adolescentes",2014,3,3,1013,296.150049358342,1,529,189.035916824197,2,484,413.223140495868
17136,68,68385,81,"Tasa de exámenes médico legales por presunto delito sexual contra niños, niñas y adolescentes",2014,3,1,1797,55.6483027267668,0,934,0,1,863,115.874855156431
17137,68,68368,81,"Tasa de exámenes médico legales por presunto delito sexual contra niños, niñas y adolescentes",2014,3,3,352,852.272727272727,0,183,0,3,169,1775.14792899408
17138,25,25594,81,"Tasa de exámenes médico legales por presunto delito sexual contra niños, niñas y adolescentes",2014,3,1,688,145.348837209302,0,369,0,1,319,313.479623824451
17139,73,73283,81,"Tasa de exámenes médico legales por presunto delito sexual contra niños, niñas y adolescentes",2014,3,3,3486,86.0585197934596,0,1821,0,3,1665,180.18018018018
17140,17,17524,81,"Tasa de exámenes médico legales por presunto delito sexual contra niños, niñas y adolescentes",2014,3,1,2067,48.3792936623125,0,1069,0,1,998,100.200400801603
17141,50,50680,81,"Tasa de exámenes médico legales por presunto delito sexual contra niños, niñas y adolescentes",2014,3,1,1215,82.3045267489712,0,625,0,1,590,169.491525423729
17142,17,17877,81,"Tasa de exámenes médico legales por presunto delito sexual contra niños, niñas y adolescentes",2014,3,1,1423,70.2740688685875,0,729,0,1,694,144.092219020173
17143,66,66456,81,"Tasa de exámenes médico legales por presunto delito sexual contra niños, niñas y adolescentes",2014,3,2,2334,85.6898029134533,1,1164,85.9106529209622,1,1170,85.4700854700855
17144,54,54743,81,"Tasa de exámenes médico legales por presunto delito sexual contra niños, niñas y adolescentes",2014,3,2,552,362.31884057971,0,289,0,2,263,760.456273764259
17145,5,5091,81,"Tasa de exámenes médico legales por presunto delito sexual contra niños, niñas y adolescentes",2014,3,6,1131,530.503978779841,0,586,0,6,545,1100.91743119266
17146,25,25288,81,"Tasa de exámenes médico legales por presunto delito sexual contra niños, niñas y adolescentes",2014,3,1,615,162.60162601626,0,319,0,1,296,337.837837837838
17147,15,15407,81,"Tasa de exámenes médico legales por presunto delito sexual contra niños, niñas y adolescentes",2014,3,1,1661,60.2046959662854,0,888,0,1,773,129.366106080207
17148,52,52240,81,"Tasa de exámenes médico legales por presunto delito sexual contra niños, niñas y adolescentes",2014,3,1,1478,67.65899864682,0,733,0,1,745,134.228187919463
17149,15,15162,81,"Tasa de exámenes médico legales por presunto delito sexual contra niños, niñas y adolescentes",2014,3,1,394,253.807106598985,0,208,0,1,186,537.634408602151
17150,25,25488,81,"Tasa de exámenes médico legales por presunto delito sexual contra niños, niñas y adolescentes",2014,3,2,1339,149.365197908887,1,647,154.559505409583,1,692,144.508670520231
17151,5,5282,81,"Tasa de exámenes médico legales por presunto delito sexual contra niños, niñas y adolescentes",2014,3,1,2281,43.8404208680403,0,1169,0,1,1112,89.9280575539568
17152,23,23675,81,"Tasa de exámenes médico legales por presunto delito sexual contra niños, niñas y adolescentes",2014,3,1,4200,23.8095238095238,0,2208,0,1,1992,50.2008032128514
17153,76,76563,81,"Tasa de exámenes médico legales por presunto delito sexual contra niños, niñas y adolescentes",2014,3,4,6005,66.6111573688593,0,3090,0,4,2915,137.221269296741
17154,25,25518,81,"Tasa de exámenes médico legales por presunto delito sexual contra niños, niñas y adolescentes",2014,3,2,452,442.477876106195,1,232,431.034482758621,1,220,454.545454545455
17155,41,41206,81,"Tasa de exámenes médico legales por presunto delito sexual contra niños, niñas y adolescentes",2014,3,4,1438,278.164116828929,0,757,0,4,681,587.371512481645
17156,20,20770,81,"Tasa de exámenes médico legales por presunto delito sexual contra niños, niñas y adolescentes",2014,3,6,2320,258.620689655172,3,1194,251.256281407035,3,1126,266.429840142096
17157,41,41483,81,"Tasa de exámenes médico legales por presunto delito sexual contra niños, niñas y adolescentes",2014,3,3,792,378.787878787879,0,415,0,3,377,795.755968169761
17158,52,52083,81,"Tasa de exámenes médico legales por presunto delito sexual contra niños, niñas y adolescentes",2014,3,1,651,153.609831029186,0,329,0,1,322,310.55900621118
17159,19,19585,81,"Tasa de exámenes médico legales por presunto delito sexual contra niños, niñas y adolescentes",2014,3,1,1781,56.1482313307131,0,918,0,1,863,115.874855156431
17160,63,63272,81,"Tasa de exámenes médico legales por presunto delito sexual contra niños, niñas y adolescentes",2014,3,2,1336,149.700598802395,1,686,145.772594752187,1,650,153.846153846154
17161,68,68498,81,"Tasa de exámenes médico legales por presunto delito sexual contra niños, niñas y adolescentes",2014,3,1,511,195.694716242661,0,266,0,1,245,408.163265306122
17162,19,19455,81,"Tasa de exámenes médico legales por presunto delito sexual contra niños, niñas y adolescentes",2014,3,5,4996,100.080064051241,2,2501,79.968012794882,3,2495,120.240480961924
17163,17,17513,81,"Tasa de exámenes médico legales por presunto delito sexual contra niños, niñas y adolescentes",2014,3,1,1820,54.9450549450549,0,957,0,1,863,115.874855156431
17164,54,54172,81,"Tasa de exámenes médico legales por presunto delito sexual contra niños, niñas y adolescentes",2014,3,1,1844,54.2299349240781,0,933,0,1,911,109.769484083425
17165,73,73585,81,"Tasa de exámenes médico legales por presunto delito sexual contra niños, niñas y adolescentes",2014,3,1,3040,32.8947368421053,0,1567,0,1,1473,67.8886625933469
17166,85,85430,81,"Tasa de exámenes médico legales por presunto delito sexual contra niños, niñas y adolescentes",2014,3,5,1930,259.067357512953,1,959,104.275286757039,4,971,411.946446961895
17167,54,54398,81,"Tasa de exámenes médico legales por presunto delito sexual contra niños, niñas y adolescentes",2014,3,2,975,205.128205128205,0,486,0,2,489,408.997955010225
17168,5,5885,81,"Tasa de exámenes médico legales por presunto delito sexual contra niños, niñas y adolescentes",2014,3,1,1082,92.4214417744917,0,563,0,1,519,192.678227360308
17169,52,52435,81,"Tasa de exámenes médico legales por presunto delito sexual contra niños, niñas y adolescentes",2014,3,1,1080,92.5925925925926,0,558,0,1,522,191.570881226054
17170,17,17013,81,"Tasa de exámenes médico legales por presunto delito sexual contra niños, niñas y adolescentes",2014,3,4,2376,168.350168350168,1,1217,82.1692686935086,3,1159,258.843830888697
17171,17,17433,81,"Tasa de exámenes médico legales por presunto delito sexual contra niños, niñas y adolescentes",2014,3,3,2564,117.004680187207,1,1319,75.8150113722517,2,1245,160.642570281125
17172,85,85230,81,"Tasa de exámenes médico legales por presunto delito sexual contra niños, niñas y adolescentes",2014,3,1,1172,85.3242320819113,0,610,0,1,562,177.935943060498
17173,86,86573,81,"Tasa de exámenes médico legales por presunto delito sexual contra niños, niñas y adolescentes",2014,3,2,2083,96.0153624579933,0,1071,0,2,1012,197.628458498024
17174,85,85225,81,"Tasa de exámenes médico legales por presunto delito sexual contra niños, niñas y adolescentes",2014,3,1,1151,86.8809730668983,0,577,0,1,574,174.216027874564
17175,25,25148,81,"Tasa de exámenes médico legales por presunto delito sexual contra niños, niñas y adolescentes",2014,3,2,1719,116.346713205352,0,891,0,2,828,241.545893719807
17176,85,85300,81,"Tasa de exámenes médico legales por presunto delito sexual contra niños, niñas y adolescentes",2014,3,1,369,271.0027100271,0,183,0,1,186,537.634408602151
17177,86,86320,81,"Tasa de exámenes médico legales por presunto delito sexual contra niños, niñas y adolescentes",2014,3,3,7717,38.8752105740573,2,3911,51.1378164152391,1,3806,26.2743037309511
17178,68,68235,81,"Tasa de exámenes médico legales por presunto delito sexual contra niños, niñas y adolescentes",2014,3,6,2116,283.553875236295,0,1091,0,6,1025,585.365853658537
17179,68,68500,81,"Tasa de exámenes médico legales por presunto delito sexual contra niños, niñas y adolescentes",2014,3,2,1400,142.857142857143,0,720,0,2,680,294.117647058824
17180,85,85162,81,"Tasa de exámenes médico legales por presunto delito sexual contra niños, niñas y adolescentes",2014,3,7,1771,395.256916996047,1,882,113.378684807256,6,889,674.915635545557
17181,5,5310,81,"Tasa de exámenes médico legales por presunto delito sexual contra niños, niñas y adolescentes",2014,3,12,1275,941.176470588235,10,653,1531.39356814701,2,622,321.543408360129
17182,25,25436,81,"Tasa de exámenes médico legales por presunto delito sexual contra niños, niñas y adolescentes",2014,3,2,538,371.747211895911,0,274,0,2,264,757.575757575758
17183,68,68079,81,"Tasa de exámenes médico legales por presunto delito sexual contra niños, niñas y adolescentes",2014,3,1,772,129.533678756477,0,394,0,1,378,264.550264550265
17184,5,5093,81,"Tasa de exámenes médico legales por presunto delito sexual contra niños, niñas y adolescentes",2014,3,3,2134,140.58106841612,1,1063,94.0733772342427,2,1071,186.741363211951
17185,5,5674,81,"Tasa de exámenes médico legales por presunto delito sexual contra niños, niñas y adolescentes",2014,3,5,1744,286.697247706422,2,899,222.469410456062,3,845,355.029585798817
17186,50,50350,81,"Tasa de exámenes médico legales por presunto delito sexual contra niños, niñas y adolescentes",2014,3,3,4261,70.4060079793476,0,2196,0,3,2065,145.278450363196
17187,5,5250,81,"Tasa de exámenes médico legales por presunto delito sexual contra niños, niñas y adolescentes",2014,3,14,6349,220.507166482911,2,3263,61.2932883849219,12,3086,388.852883992223
17188,5,5313,81,"Tasa de exámenes médico legales por presunto delito sexual contra niños, niñas y adolescentes",2014,3,1,1017,98.3284169124877,0,519,0,1,498,200.803212851406
17189,68,68152,81,"Tasa de exámenes médico legales por presunto delito sexual contra niños, niñas y adolescentes",2014,3,1,483,207.03933747412,0,248,0,1,235,425.531914893617
17190,5,5031,81,"Tasa de exámenes médico legales por presunto delito sexual contra niños, niñas y adolescentes",2014,3,4,2647,151.114469210427,1,1355,73.8007380073801,3,1292,232.198142414861
17191,5,5647,81,"Tasa de exámenes médico legales por presunto delito sexual contra niños, niñas y adolescentes",2014,3,1,733,136.425648021828,1,382,261.780104712042,0,351,0
17192,5,5660,81,"Tasa de exámenes médico legales por presunto delito sexual contra niños, niñas y adolescentes",2014,3,4,1267,315.706393054459,0,677,0,4,590,677.966101694915
17193,20,20400,81,"Tasa de exámenes médico legales por presunto delito sexual contra niños, niñas y adolescentes",2014,3,3,2972,100.942126514132,1,1558,64.1848523748395,2,1414,141.442715700141
17194,25,25736,81,"Tasa de exámenes médico legales por presunto delito sexual contra niños, niñas y adolescentes",2014,3,3,1582,189.633375474083,0,799,0,3,783,383.141762452107
17195,5,5101,81,"Tasa de exámenes médico legales por presunto delito sexual contra niños, niñas y adolescentes",2014,3,11,3124,352.112676056338,3,1601,187.38288569644,8,1523,525.279054497702
17196,25,25758,81,"Tasa de exámenes médico legales por presunto delito sexual contra niños, niñas y adolescentes",2014,3,4,2864,139.664804469274,1,1461,68.4462696783025,3,1403,213.827512473272
17197,5,5138,81,"Tasa de exámenes médico legales por presunto delito sexual contra niños, niñas y adolescentes",2014,3,1,2097,47.6871721506915,0,1061,0,1,1036,96.5250965250965
17198,5,5847,81,"Tasa de exámenes médico legales por presunto delito sexual contra niños, niñas y adolescentes",2014,3,16,5333,300.018751171948,4,2799,142.90818149339,12,2534,473.559589581689
17199,5,5756,81,"Tasa de exámenes médico legales por presunto delito sexual contra niños, niñas y adolescentes",2014,3,9,3901,230.710074339913,3,2001,149.925037481259,6,1900,315.789473684211
17200,5,5237,81,"Tasa de exámenes médico legales por presunto delito sexual contra niños, niñas y adolescentes",2014,3,1,2562,39.032006245121,0,1314,0,1,1248,80.1282051282051
17201,25,25530,81,"Tasa de exámenes médico legales por presunto delito sexual contra niños, niñas y adolescentes",2014,3,4,923,433.369447453954,0,463,0,4,460,869.565217391304
17202,18,18460,81,"Tasa de exámenes médico legales por presunto delito sexual contra niños, niñas y adolescentes",2014,3,1,1726,57.9374275782155,0,878,0,1,848,117.924528301887
17203,25,25491,81,"Tasa de exámenes médico legales por presunto delito sexual contra niños, niñas y adolescentes",2014,3,2,614,325.732899022801,0,324,0,2,290,689.655172413793
17204,25,25599,81,"Tasa de exámenes médico legales por presunto delito sexual contra niños, niñas y adolescentes",2014,3,1,780,128.205128205128,0,393,0,1,387,258.397932816537
17205,5,5209,81,"Tasa de exámenes médico legales por presunto delito sexual contra niños, niñas y adolescentes",2014,3,5,2582,193.648334624322,0,1340,0,5,1242,402.576489533011
17206,25,25513,81,"Tasa de exámenes médico legales por presunto delito sexual contra niños, niñas y adolescentes",2014,3,8,2973,269.088462832156,0,1475,0,8,1498,534.045393858478
17207,5,5002,81,"Tasa de exámenes médico legales por presunto delito sexual contra niños, niñas y adolescentes",2014,3,16,1957,817.577925396014,2,1012,197.628458498024,14,945,1481.48148148148
17208,25,25649,81,"Tasa de exámenes médico legales por presunto delito sexual contra niños, niñas y adolescentes",2014,3,2,1124,177.935943060498,1,580,172.413793103448,1,544,183.823529411765
17209,50,50270,81,"Tasa de exámenes médico legales por presunto delito sexual contra niños, niñas y adolescentes",2014,3,2,464,431.034482758621,1,246,406.50406504065,1,218,458.715596330275
17210,25,25839,81,"Tasa de exámenes médico legales por presunto delito sexual contra niños, niñas y adolescentes",2014,3,2,1266,157.977883096366,0,663,0,2,603,331.67495854063
17211,25,25120,81,"Tasa de exámenes médico legales por presunto delito sexual contra niños, niñas y adolescentes",2014,3,3,586,511.945392491468,2,301,664.451827242525,1,285,350.877192982456
17212,5,5154,81,"Tasa de exámenes médico legales por presunto delito sexual contra niños, niñas y adolescentes",2014,3,14,13543,103.374436978513,2,6847,29.2098729370527,12,6696,179.21146953405
17213,25,25295,81,"Tasa de exámenes médico legales por presunto delito sexual contra niños, niñas y adolescentes",2014,3,2,1884,106.157112526539,1,968,103.305785123967,1,916,109.170305676856
17214,68,68689,81,"Tasa de exámenes médico legales por presunto delito sexual contra niños, niñas y adolescentes",2014,3,7,3914,178.845171180378,1,1987,50.3271263210871,6,1927,311.364815775817
17215,5,5483,81,"Tasa de exámenes médico legales por presunto delito sexual contra niños, niñas y adolescentes",2014,3,2,2021,98.9609104403761,0,1046,0,2,975,205.128205128205
17216,5,5425,81,"Tasa de exámenes médico legales por presunto delito sexual contra niños, niñas y adolescentes",2014,3,2,698,286.532951289398,1,356,280.898876404494,1,342,292.397660818713
17217,5,5284,81,"Tasa de exámenes médico legales por presunto delito sexual contra niños, niñas y adolescentes",2014,3,8,2145,372.960372960373,0,1111,0,8,1034,773.694390715667
17218,68,68655,81,"Tasa de exámenes médico legales por presunto delito sexual contra niños, niñas y adolescentes",2014,3,9,2024,444.664031620553,1,1040,96.1538461538462,8,984,813.008130081301
17219,5,5736,81,"Tasa de exámenes médico legales por presunto delito sexual contra niños, niñas y adolescentes",2014,3,11,4857,226.477249330863,2,2507,79.7766254487435,9,2350,382.978723404255
17220,5,5495,81,"Tasa de exámenes médico legales por presunto delito sexual contra niños, niñas y adolescentes",2014,3,3,3206,93.5745477230193,0,1623,0,3,1583,189.513581806696
17221,5,5400,81,"Tasa de exámenes médico legales por presunto delito sexual contra niños, niñas y adolescentes",2014,3,6,2180,275.229357798165,1,1126,88.809946714032,5,1054,474.38330170778
17222,5,5697,81,"Tasa de exámenes médico legales por presunto delito sexual contra niños, niñas y adolescentes",2014,3,3,2672,112.275449101796,1,1383,72.3065798987708,2,1289,155.159038013964
17223,5,5411,81,"Tasa de exámenes médico legales por presunto delito sexual contra niños, niñas y adolescentes",2014,3,1,910,109.89010989011,1,481,207.900207900208,0,429,0
17224,5,5318,81,"Tasa de exámenes médico legales por presunto delito sexual contra niños, niñas y adolescentes",2014,3,6,5299,113.228911115305,1,2715,36.8324125230203,5,2584,193.498452012384
17225,25,25645,81,"Tasa de exámenes médico legales por presunto delito sexual contra niños, niñas y adolescentes",2014,3,3,1293,232.018561484919,0,654,0,3,639,469.483568075117
17226,5,5030,81,"Tasa de exámenes médico legales por presunto delito sexual contra niños, niñas y adolescentes",2014,3,2,3322,60.2046959662854,0,1723,0,2,1599,125.078173858662
17227,5,5190,81,"Tasa de exámenes médico legales por presunto delito sexual contra niños, niñas y adolescentes",2014,3,2,930,215.05376344086,0,481,0,2,449,445.43429844098
17228,68,68327,81,"Tasa de exámenes médico legales por presunto delito sexual contra niños, niñas y adolescentes",2014,3,1,378,264.550264550265,0,194,0,1,184,543.478260869565
17229,70,70708,81,"Tasa de exámenes médico legales por presunto delito sexual contra niños, niñas y adolescentes",2014,3,4,7026,56.9313976658127,2,3488,57.3394495412844,2,3538,56.5291124929339
17230,25,25040,81,"Tasa de exámenes médico legales por presunto delito sexual contra niños, niñas y adolescentes",2014,3,2,1224,163.398692810458,0,630,0,2,594,336.700336700337
17231,15,15599,81,"Tasa de exámenes médico legales por presunto delito sexual contra niños, niñas y adolescentes",2014,3,3,1232,243.506493506494,3,626,479.233226837061,0,606,0
17232,15,15367,81,"Tasa de exámenes médico legales por presunto delito sexual contra niños, niñas y adolescentes",2014,3,1,868,115.207373271889,0,443,0,1,425,235.294117647059
17233,50,50110,81,"Tasa de exámenes médico legales por presunto delito sexual contra niños, niñas y adolescentes",2014,3,1,511,195.694716242661,1,258,387.596899224806,0,253,0
17234,5,5107,81,"Tasa de exámenes médico legales por presunto delito sexual contra niños, niñas y adolescentes",2014,3,3,1081,277.520814061055,1,553,180.831826401447,2,528,378.787878787879
17235,50,50124,81,"Tasa de exámenes médico legales por presunto delito sexual contra niños, niñas y adolescentes",2014,3,6,484,1239.6694214876,0,256,0,6,228,2631.57894736842
17236,5,5113,81,"Tasa de exámenes médico legales por presunto delito sexual contra niños, niñas y adolescentes",2014,3,4,784,510.204081632653,0,416,0,4,368,1086.95652173913
17237,25,25320,81,"Tasa de exámenes médico legales por presunto delito sexual contra niños, niñas y adolescentes",2014,3,2,4316,46.339202965709,0,2196,0,2,2120,94.3396226415094
17238,25,25486,81,"Tasa de exámenes médico legales por presunto delito sexual contra niños, niñas y adolescentes",2014,3,2,1659,120.554550934298,1,840,119.047619047619,1,819,122.100122100122
17239,85,85263,81,"Tasa de exámenes médico legales por presunto delito sexual contra niños, niñas y adolescentes",2014,3,1,984,101.626016260163,1,514,194.552529182879,0,470,0
17240,5,5368,81,"Tasa de exámenes médico legales por presunto delito sexual contra niños, niñas y adolescentes",2014,3,3,1275,235.294117647059,1,648,154.320987654321,2,627,318.979266347687
17241,19,19513,81,"Tasa de exámenes médico legales por presunto delito sexual contra niños, niñas y adolescentes",2014,3,1,925,108.108108108108,0,464,0,1,461,216.919739696312
17242,13,13473,81,"Tasa de exámenes médico legales por presunto delito sexual contra niños, niñas y adolescentes",2014,3,1,2753,36.3240101707229,0,1419,0,1,1334,74.9625187406297
17243,18,18756,81,"Tasa de exámenes médico legales por presunto delito sexual contra niños, niñas y adolescentes",2014,3,1,3230,30.9597523219814,0,1646,0,1,1584,63.1313131313131
17244,5,5658,81,"Tasa de exámenes médico legales por presunto delito sexual contra niños, niñas y adolescentes",2014,3,1,464,215.51724137931,1,237,421.940928270042,0,227,0
17245,25,25260,81,"Tasa de exámenes médico legales por presunto delito sexual contra niños, niñas y adolescentes",2014,3,1,2132,46.9043151969981,1,1073,93.1966449207828,0,1059,0
17246,25,25035,81,"Tasa de exámenes médico legales por presunto delito sexual contra niños, niñas y adolescentes",2014,3,1,1189,84.1042893187552,0,608,0,1,581,172.117039586919
17247,25,25398,81,"Tasa de exámenes médico legales por presunto delito sexual contra niños, niñas y adolescentes",2014,3,1,679,147.275405007364,0,347,0,1,332,301.204819277108
17248,68,68770,81,"Tasa de exámenes médico legales por presunto delito sexual contra niños, niñas y adolescentes",2014,3,1,1015,98.5221674876847,1,530,188.679245283019,0,485,0
17249,5,5543,81,"Tasa de exámenes médico legales por presunto delito sexual contra niños, niñas y adolescentes",2014,3,3,1272,235.849056603774,0,677,0,3,595,504.201680672269
17250,5,5631,81,"Tasa de exámenes médico legales por presunto delito sexual contra niños, niñas y adolescentes",2014,3,3,3494,85.8614768174013,2,1765,113.314447592068,1,1729,57.8368999421631
17251,25,25322,81,"Tasa de exámenes médico legales por presunto delito sexual contra niños, niñas y adolescentes",2014,3,2,1693,118.133490844654,0,870,0,2,823,243.013365735115
17252,5,5051,81,"Tasa de exámenes médico legales por presunto delito sexual contra niños, niñas y adolescentes",2014,3,1,5498,18.1884321571481,0,2815,0,1,2683,37.2717107715244
17253,25,25772,81,"Tasa de exámenes médico legales por presunto delito sexual contra niños, niñas y adolescentes",2014,3,1,2333,42.863266180883,0,1156,0,1,1177,84.9617672047579
17254,25,25394,81,"Tasa de exámenes médico legales por presunto delito sexual contra niños, niñas y adolescentes",2014,3,1,1030,97.0873786407767,0,525,0,1,505,198.019801980198
17255,5,5347,81,"Tasa de exámenes médico legales por presunto delito sexual contra niños, niñas y adolescentes",2014,3,1,703,142.247510668563,0,372,0,1,331,302.114803625378
17256,5,5690,81,"Tasa de exámenes médico legales por presunto delito sexual contra niños, niñas y adolescentes",2014,3,3,1232,243.506493506494,0,636,0,3,596,503.355704697987
17257,5,5858,81,"Tasa de exámenes médico legales por presunto delito sexual contra niños, niñas y adolescentes",2014,3,4,1261,317.208564631245,0,642,0,4,619,646.203554119548
17258,19,19300,81,"Tasa de exámenes médico legales por presunto delito sexual contra niños, niñas y adolescentes",2014,3,1,2566,38.9711613406079,0,1280,0,1,1286,77.7604976671851
17259,25,25126,81,"Tasa de exámenes médico legales por presunto delito sexual contra niños, niñas y adolescentes",2014,3,6,6128,97.911227154047,0,3230,0,6,2898,207.03933747412
17260,25,25151,81,"Tasa de exámenes médico legales por presunto delito sexual contra niños, niñas y adolescentes",2014,3,2,1769,113.058224985868,0,913,0,2,856,233.644859813084
17261,5,5659,81,"Tasa de exámenes médico legales por presunto delito sexual contra niños, niñas y adolescentes",2014,3,1,3665,27.2851296043656,0,1882,0,1,1783,56.0852495793606
17262,41,41078,81,"Tasa de exámenes médico legales por presunto delito sexual contra niños, niñas y adolescentes",2014,3,1,1120,89.2857142857143,0,590,0,1,530,188.679245283019
17263,86,86219,81,"Tasa de exámenes médico legales por presunto delito sexual contra niños, niñas y adolescentes",2014,3,1,584,171.232876712329,1,294,340.136054421769,0,290,0
17264,52,52418,81,"Tasa de exámenes médico legales por presunto delito sexual contra niños, niñas y adolescentes",2014,3,1,3220,31.055900621118,0,1668,0,1,1552,64.4329896907217
17265,25,25867,81,"Tasa de exámenes médico legales por presunto delito sexual contra niños, niñas y adolescentes",2014,3,1,422,236.96682464455,0,205,0,1,217,460.829493087558
17266,15,15531,81,"Tasa de exámenes médico legales por presunto delito sexual contra niños, niñas y adolescentes",2014,3,1,1347,74.2390497401633,0,724,0,1,623,160.513643659711
17267,25,25745,81,"Tasa de exámenes médico legales por presunto delito sexual contra niños, niñas y adolescentes",2014,3,1,1560,64.1025641025641,0,784,0,1,776,128.865979381443
17268,76,76845,81,"Tasa de exámenes médico legales por presunto delito sexual contra niños, niñas y adolescentes",2014,3,1,527,189.753320683112,1,274,364.963503649635,0,253,0
17269,25,25377,81,"Tasa de exámenes médico legales por presunto delito sexual contra niños, niñas y adolescentes",2014,3,1,2767,36.1402240693892,0,1395,0,1,1372,72.8862973760933
17270,5,5390,81,"Tasa de exámenes médico legales por presunto delito sexual contra niños, niñas y adolescentes",2014,3,2,730,273.972602739726,1,373,268.096514745308,1,357,280.112044817927
17271,68,68147,81,"Tasa de exámenes médico legales por presunto delito sexual contra niños, niñas y adolescentes",2014,3,2,552,362.31884057971,1,280,357.142857142857,1,272,367.647058823529
17272,5,5656,81,"Tasa de exámenes médico legales por presunto delito sexual contra niños, niñas y adolescentes",2014,3,1,1400,71.4285714285714,0,721,0,1,679,147.275405007364
17273,81,81001,81,"Tasa de exámenes médico legales por presunto delito sexual contra niños, niñas y adolescentes",2014,4,44,11132,395.256916996047,3,5498,54.5652964714442,41,5634,727.724529641462
17274,13,13001,81,"Tasa de exámenes médico legales por presunto delito sexual contra niños, niñas y adolescentes",2014,4,220,109872,200.232998398136,22,55089,39.9353772985532,198,54783,361.425989814358
17275,13,13683,81,"Tasa de exámenes médico legales por presunto delito sexual contra niños, niñas y adolescentes",2014,4,2,2814,71.0732054015636,0,1450,0,2,1364,146.627565982405
17276,15,15646,81,"Tasa de exámenes médico legales por presunto delito sexual contra niños, niñas y adolescentes",2014,4,4,2469,162.008910490077,1,1295,77.2200772200772,3,1174,255.536626916525
17277,15,15001,81,"Tasa de exámenes médico legales por presunto delito sexual contra niños, niñas y adolescentes",2014,4,43,21064,204.139764527155,6,10587,56.6732785491641,37,10477,353.154528968216
17278,15,15861,81,"Tasa de exámenes médico legales por presunto delito sexual contra niños, niñas y adolescentes",2014,4,5,1915,261.096605744125,1,951,105.15247108307,4,964,414.9377593361
17279,15,15500,81,"Tasa de exámenes médico legales por presunto delito sexual contra niños, niñas y adolescentes",2014,4,1,361,277.008310249307,0,191,0,1,170,588.235294117647
17280,17,17001,81,"Tasa de exámenes médico legales por presunto delito sexual contra niños, niñas y adolescentes",2014,4,92,35476,259.330251437592,8,18058,44.3016945398161,84,17418,482.259731312435
17281,18,18001,81,"Tasa de exámenes médico legales por presunto delito sexual contra niños, niñas y adolescentes",2014,4,30,20394,147.102088849662,3,10265,29.2255236239649,27,10129,266.561358475664
17282,19,19001,81,"Tasa de exámenes médico legales por presunto delito sexual contra niños, niñas y adolescentes",2014,4,58,27155,213.588657705763,5,13695,36.5096750638919,53,13460,393.759286775631
17283,68,68615,81,"Tasa de exámenes médico legales por presunto delito sexual contra niños, niñas y adolescentes",2014,4,7,3178,220.264317180617,0,1659,0,7,1519,460.829493087558
17284,20,20001,81,"Tasa de exámenes médico legales por presunto delito sexual contra niños, niñas y adolescentes",2014,4,125,54734,228.377242664523,15,27753,54.0482110042158,110,26981,407.694303398688
17285,44,44279,81,"Tasa de exámenes médico legales por presunto delito sexual contra niños, niñas y adolescentes",2014,4,7,3618,193.477059148701,0,1839,0,7,1779,393.479482855537
17286,47,47001,81,"Tasa de exámenes médico legales por presunto delito sexual contra niños, niñas y adolescentes",2014,4,118,59887,197.037754437524,5,30000,16.6666666666667,113,29887,378.090808712818
17287,50,50245,81,"Tasa de exámenes médico legales por presunto delito sexual contra niños, niñas y adolescentes",2014,4,1,270,370.37037037037,1,143,699.300699300699,0,127,0
17288,50,50001,81,"Tasa de exámenes médico legales por presunto delito sexual contra niños, niñas y adolescentes",2014,4,167,51484,324.372620619998,19,25839,73.5322574403034,148,25645,577.110547865081
17289,86,86001,81,"Tasa de exámenes médico legales por presunto delito sexual contra niños, niñas y adolescentes",2014,4,9,4793,187.7738368454,0,2446,0,9,2347,383.468257349808
17290,70,70473,81,"Tasa de exámenes médico legales por presunto delito sexual contra niños, niñas y adolescentes",2014,4,5,1709,292.568753657109,0,889,0,5,820,609.756097560976
17291,70,70001,81,"Tasa de exámenes médico legales por presunto delito sexual contra niños, niñas y adolescentes",2014,4,84,31380,267.686424474187,12,15857,75.6763574446617,72,15523,463.827868324422
17292,73,73001,81,"Tasa de exámenes médico legales por presunto delito sexual contra niños, niñas y adolescentes",2014,4,104,60434,172.088559420194,13,30969,41.9774613323,91,29465,308.840997793993
17293,86,86885,81,"Tasa de exámenes médico legales por presunto delito sexual contra niños, niñas y adolescentes",2014,4,12,2868,418.410041841004,1,1434,69.7350069735007,11,1434,767.085076708508
17294,5,5001,81,"Tasa de exámenes médico legales por presunto delito sexual contra niños, niñas y adolescentes",2014,4,361,199280,181.152147731835,45,101587,44.2970065067381,316,97693,323.462274676794
17295,68,68001,81,"Tasa de exámenes médico legales por presunto delito sexual contra niños, niñas y adolescentes",2014,4,126,51809,243.200988245286,21,26396,79.5575087134414,105,25413,413.174359579743
17296,68,68276,81,"Tasa de exámenes médico legales por presunto delito sexual contra niños, niñas y adolescentes",2014,4,38,25940,146.491904394757,1,13317,7.5091987684914,37,12623,293.115741107502
17297,68,68406,81,"Tasa de exámenes médico legales por presunto delito sexual contra niños, niñas y adolescentes",2014,4,14,4312,324.675324675325,4,2243,178.332590280874,10,2069,483.325277912035
17298,8,8001,81,"Tasa de exámenes médico legales por presunto delito sexual contra niños, niñas y adolescentes",2014,4,243,123654,196.516085205493,24,62910,38.1497377205532,219,60744,360.529435005927
17299,8,8758,81,"Tasa de exámenes médico legales por presunto delito sexual contra niños, niñas y adolescentes",2014,4,78,67735,115.154646785266,6,34508,17.3872725165179,72,33227,216.691245071779
17300,66,66045,81,"Tasa de exámenes médico legales por presunto delito sexual contra niños, niñas y adolescentes",2014,4,5,2011,248.632521133764,1,1047,95.5109837631328,4,964,414.9377593361
17301,68,68081,81,"Tasa de exámenes médico legales por presunto delito sexual contra niños, niñas y adolescentes",2014,4,56,20487,273.344071850442,4,10527,37.9975301605396,52,9960,522.088353413655
17302,5,5088,81,"Tasa de exámenes médico legales por presunto delito sexual contra niños, niñas y adolescentes",2014,4,59,47936,123.080774365821,8,23971,33.3736598389721,51,23965,212.810348424786
17303,66,66001,81,"Tasa de exámenes médico legales por presunto delito sexual contra niños, niñas y adolescentes",2014,4,113,44664,253.000179115171,14,22792,61.4250614250614,99,21872,452.633504023409
17304,66,66170,81,"Tasa de exámenes médico legales por presunto delito sexual contra niños, niñas y adolescentes",2014,4,32,20011,159.912048373395,5,10171,49.1593746927539,27,9840,274.390243902439
17305,5,5172,81,"Tasa de exámenes médico legales por presunto delito sexual contra niños, niñas y adolescentes",2014,4,14,9716,144.092219020173,1,4807,20.8029956313709,13,4909,264.819718883683
17306,20,20400,81,"Tasa de exámenes médico legales por presunto delito sexual contra niños, niñas y adolescentes",2014,4,5,2803,178.380306814128,0,1489,0,5,1314,380.517503805175
17307,11,11001,81,"Tasa de exámenes médico legales por presunto delito sexual contra niños, niñas y adolescentes",2014,4,1550,752864,205.880477748969,145,383217,37.8375698364112,1405,369647,380.092358385162
17308,25,25290,81,"Tasa de exámenes médico legales por presunto delito sexual contra niños, niñas y adolescentes",2014,4,38,12076,314.67373302418,2,5883,33.9962604113548,36,6193,581.301469400937
17309,50,50683,81,"Tasa de exámenes médico legales por presunto delito sexual contra niños, niñas y adolescentes",2014,4,2,1058,189.035916824197,0,546,0,2,512,390625
17310,50,50689,81,"Tasa de exámenes médico legales por presunto delito sexual contra niños, niñas y adolescentes",2014,4,5,2508,199.362041467305,0,1260,0,5,1248,400.641025641026
17311,52,52356,81,"Tasa de exámenes médico legales por presunto delito sexual contra niños, niñas y adolescentes",2014,4,22,15151,145.204936967857,0,7534,0,22,7617,288.827622423526
17312,73,73349,81,"Tasa de exámenes médico legales por presunto delito sexual contra niños, niñas y adolescentes",2014,4,15,2684,558.867362146051,3,1489,201.477501678979,12,1195,1004.18410041841
17313,76,76001,81,"Tasa de exámenes médico legales por presunto delito sexual contra niños, niñas y adolescentes",2014,4,297,232563,127.707330916784,26,117683,22.0932505119686,271,114880,235.898328690808
17314,47,47555,81,"Tasa de exámenes médico legales por presunto delito sexual contra niños, niñas y adolescentes",2014,4,16,7381,216.772795014226,2,3833,52.1784503000261,14,3548,394.588500563698
17315,25,25754,81,"Tasa de exámenes médico legales por presunto delito sexual contra niños, niñas y adolescentes",2014,4,152,56720,267.983074753173,11,28961,37.9821138772832,141,27759,507.943369717929
17316,5,5308,81,"Tasa de exámenes médico legales por presunto delito sexual contra niños, niñas y adolescentes",2014,4,9,5792,155.386740331492,1,2942,33.9904826648538,8,2850,280.701754385965
17317,15,15087,81,"Tasa de exámenes médico legales por presunto delito sexual contra niños, niñas y adolescentes",2014,4,2,798,250.62656641604,1,413,242.130750605327,1,385,259.74025974026
17318,50,50150,81,"Tasa de exámenes médico legales por presunto delito sexual contra niños, niñas y adolescentes",2014,4,7,1071,653.59477124183,0,538,0,7,533,1313.32082551595
17319,44,44090,81,"Tasa de exámenes médico legales por presunto delito sexual contra niños, niñas y adolescentes",2014,4,6,4198,142.92520247737,0,2211,0,6,1987,301.962757926522
17320,23,23001,81,"Tasa de exámenes médico legales por presunto delito sexual contra niños, niñas y adolescentes",2014,4,123,48973,251.158801788741,5,24640,20.2922077922078,118,24333,484.938149837669
17321,23,23555,81,"Tasa de exámenes médico legales por presunto delito sexual contra niños, niñas y adolescentes",2014,4,5,7833,63.8325035107877,0,3991,0,5,3842,130.14055179594
17322,23,23686,81,"Tasa de exámenes médico legales por presunto delito sexual contra niños, niñas y adolescentes",2014,4,3,4796,62.5521267723103,0,2440,0,3,2356,127.334465195246
17323,50,50006,81,"Tasa de exámenes médico legales por presunto delito sexual contra niños, niñas y adolescentes",2014,4,17,7207,235.881781601221,2,3570,56.0224089635854,15,3637,412.427825130602
17324,52,52001,81,"Tasa de exámenes médico legales por presunto delito sexual contra niños, niñas y adolescentes",2014,4,55,45218,121.632978017604,4,22556,17.7336407164391,51,22662,225.046333068573
17325,52,52256,81,"Tasa de exámenes médico legales por presunto delito sexual contra niños, niñas y adolescentes",2014,4,1,1241,80.58017727639,0,660,0,1,581,172.117039586919
17326,52,52480,81,"Tasa de exámenes médico legales por presunto delito sexual contra niños, niñas y adolescentes",2014,4,2,490,408.163265306122,1,254,393.700787401575,1,236,423.728813559322
17327,54,54001,81,"Tasa de exámenes médico legales por presunto delito sexual contra niños, niñas y adolescentes",2014,4,69,75890,90.921069969693,11,38279,28.7363828731158,58,37611,154.210204461461
17328,63,63001,81,"Tasa de exámenes médico legales por presunto delito sexual contra niños, niñas y adolescentes",2014,4,65,28557,227.614945547501,12,14484,82.8500414250207,53,14073,376.607688481489
17329,63,63190,81,"Tasa de exámenes médico legales por presunto delito sexual contra niños, niñas y adolescentes",2014,4,6,2919,205.549845837616,0,1454,0,6,1465,409.556313993174
17330,70,70742,81,"Tasa de exámenes médico legales por presunto delito sexual contra niños, niñas y adolescentes",2014,4,8,3934,203.355363497712,0,2044,0,8,1890,423.280423280423
17331,70,70233,81,"Tasa de exámenes médico legales por presunto delito sexual contra niños, niñas y adolescentes",2014,4,2,1279,156.372165754496,0,668,0,2,611,327.332242225859
17332,73,73043,81,"Tasa de exámenes médico legales por presunto delito sexual contra niños, niñas y adolescentes",2014,4,1,2402,41.6319733555371,0,1324,0,1,1078,92.7643784786642
17333,68,68307,81,"Tasa de exámenes médico legales por presunto delito sexual contra niños, niñas y adolescentes",2014,4,25,18802,132.964578236358,2,9552,20.9380234505863,23,9250,248.648648648649
17334,8,8606,81,"Tasa de exámenes médico legales por presunto delito sexual contra niños, niñas y adolescentes",2014,4,3,3035,98.8467874794069,0,1539,0,3,1496,200.534759358289
17335,8,8296,81,"Tasa de exámenes médico legales por presunto delito sexual contra niños, niñas y adolescentes",2014,4,6,4955,121.08980827447,0,2576,0,6,2379,252.206809583859
17336,8,8433,81,"Tasa de exámenes médico legales por presunto delito sexual contra niños, niñas y adolescentes",2014,4,27,13509,199.866755496336,1,6924,14.4425187752744,26,6585,394.836750189825
17337,41,41001,81,"Tasa de exámenes médico legales por presunto delito sexual contra niños, niñas y adolescentes",2014,4,61,36384,167.656112576957,10,18215,54.8998078506725,51,18169,280.69789201387
17338,76,76892,81,"Tasa de exámenes médico legales por presunto delito sexual contra niños, niñas y adolescentes",2014,4,22,11548,190.509179078628,0,6021,0,22,5527,398.045956214945
17339,50,50270,81,"Tasa de exámenes médico legales por presunto delito sexual contra niños, niñas y adolescentes",2014,4,3,429,699.300699300699,1,235,425.531914893617,2,194,1030.92783505155
17340,91,91001,81,"Tasa de exámenes médico legales por presunto delito sexual contra niños, niñas y adolescentes",2014,4,17,5545,306.582506762849,1,2798,35.7398141529664,16,2747,582.453585729887
17341,66,66318,81,"Tasa de exámenes médico legales por presunto delito sexual contra niños, niñas y adolescentes",2014,4,6,1575,380.952380952381,0,785,0,6,790,759.493670886076
17342,76,76109,81,"Tasa de exámenes médico legales por presunto delito sexual contra niños, niñas y adolescentes",2014,4,50,47200,105.932203389831,3,23878,12.5638663204624,47,23322,201.526455707058
17343,76,76113,81,"Tasa de exámenes médico legales por presunto delito sexual contra niños, niñas y adolescentes",2014,4,2,2034,98.3284169124877,0,1087,0,2,947,211.193241816262
17344,47,47189,81,"Tasa de exámenes médico legales por presunto delito sexual contra niños, niñas y adolescentes",2014,4,26,13704,189.725627553999,1,7079,14.1262890238734,25,6625,377.358490566038
17345,13,13268,81,"Tasa de exámenes médico legales por presunto delito sexual contra niños, niñas y adolescentes",2014,4,4,1241,322.32070910556,0,666,0,4,575,695.652173913043
17346,15,15238,81,"Tasa de exámenes médico legales por presunto delito sexual contra niños, niñas y adolescentes",2014,4,22,12916,170.331371941778,3,6305,47.5812846946868,19,6611,287.399788231735
17347,47,47245,81,"Tasa de exámenes médico legales por presunto delito sexual contra niños, niñas y adolescentes",2014,4,15,7423,202.07463289775,0,3822,0,15,3601,416.550958067204
17348,19,19532,81,"Tasa de exámenes médico legales por presunto delito sexual contra niños, niñas y adolescentes",2014,4,4,4718,84.7816871555744,0,2470,0,4,2248,177.935943060498
17349,73,73268,81,"Tasa de exámenes médico legales por presunto delito sexual contra niños, niñas y adolescentes",2014,4,11,8371,131.406044678055,0,4268,0,11,4103,268.096514745308
17350,25,25430,81,"Tasa de exámenes médico legales por presunto delito sexual contra niños, niñas y adolescentes",2014,4,32,8427,379.731814406076,4,4341,92.14466712739,28,4086,685.266764561919
17351,25,25899,81,"Tasa de exámenes médico legales por presunto delito sexual contra niños, niñas y adolescentes",2014,4,17,12950,131.274131274131,1,6517,15.3444836581249,16,6433,248.717550132131
17352,47,47268,81,"Tasa de exámenes médico legales por presunto delito sexual contra niños, niñas y adolescentes",2014,4,3,3088,97.1502590673575,0,1654,0,3,1434,209.205020920502
17353,47,47288,81,"Tasa de exámenes médico legales por presunto delito sexual contra niños, niñas y adolescentes",2014,4,8,7787,102.735328110954,0,3945,0,8,3842,208.224882873503
17354,41,41298,81,"Tasa de exámenes médico legales por presunto delito sexual contra niños, niñas y adolescentes",2014,4,18,11320,159.010600706714,1,5942,16.8293503870751,17,5378,316.102640386761
17355,25,25483,81,"Tasa de exámenes médico legales por presunto delito sexual contra niños, niñas y adolescentes",2014,4,2,257,778.210116731517,0,130,0,2,127,1574.8031496063
17356,50,50313,81,"Tasa de exámenes médico legales por presunto delito sexual contra niños, niñas y adolescentes",2014,4,15,6682,224.483687518707,2,3381,59.1540964211772,13,3301,393.820054528931
17357,27,27361,81,"Tasa de exámenes médico legales por presunto delito sexual contra niños, niñas y adolescentes",2014,4,5,3170,157.728706624606,0,1550,0,5,1620,308.641975308642
17358,5,5129,81,"Tasa de exámenes médico legales por presunto delito sexual contra niños, niñas y adolescentes",2014,4,10,7439,134.426670251378,2,3776,52.9661016949153,8,3663,218.400218400218
17359,23,23417,81,"Tasa de exámenes médico legales por presunto delito sexual contra niños, niñas y adolescentes",2014,4,27,13588,198.704739476008,2,6930,28.8600288600289,25,6658,375.488134574947
17360,13,13430,81,"Tasa de exámenes médico legales por presunto delito sexual contra niños, niñas y adolescentes",2014,4,44,14671,299.911389816645,4,7526,53.1490831783152,40,7145,559.832050384884
17361,44,44430,81,"Tasa de exámenes médico legales por presunto delito sexual contra niños, niñas y adolescentes",2014,4,34,18615,182.648401826484,2,9372,21.3401621852326,32,9243,346.20794114465
17362,54,54344,81,"Tasa de exámenes médico legales por presunto delito sexual contra niños, niñas y adolescentes",2014,4,1,1490,67.1140939597315,0,761,0,1,729,137.174211248285
17363,54,54498,81,"Tasa de exámenes médico legales por presunto delito sexual contra niños, niñas y adolescentes",2014,4,14,11108,126.035289881167,2,5768,34.6740638002774,12,5340,224.719101123596
17364,76,76520,81,"Tasa de exámenes médico legales por presunto delito sexual contra niños, niñas y adolescentes",2014,4,62,28244,219.515649341453,4,14515,27.5576989321392,58,13729,422.463398645204
17365,41,41530,81,"Tasa de exámenes médico legales por presunto delito sexual contra niños, niñas y adolescentes",2014,4,1,1468,68.1198910081744,0,772,0,1,696,143.67816091954
17366,76,76622,81,"Tasa de exámenes médico legales por presunto delito sexual contra niños, niñas y adolescentes",2014,4,6,3203,187.324383390571,0,1653,0,6,1550,387.096774193548
17367,68,68522,81,"Tasa de exámenes médico legales por presunto delito sexual contra niños, niñas y adolescentes",2014,4,2,344,581.395348837209,0,180,0,2,164,1219.51219512195
17368,19,19256,81,"Tasa de exámenes médico legales por presunto delito sexual contra niños, niñas y adolescentes",2014,4,5,4688,106.655290102389,0,2434,0,5,2254,221.827861579414
17369,5,5837,81,"Tasa de exámenes médico legales por presunto delito sexual contra niños, niñas y adolescentes",2014,4,22,21339,103.097614696096,0,10509,0,22,10830,203.139427516159
17370,25,25843,81,"Tasa de exámenes médico legales por presunto delito sexual contra niños, niñas y adolescentes",2014,4,17,4364,389.55087076077,2,2142,93.3706816059757,15,2222,675.067506750675
17371,15,15469,81,"Tasa de exámenes médico legales por presunto delito sexual contra niños, niñas y adolescentes",2014,4,4,2313,172.935581495893,0,1186,0,4,1127,354.924578527063
17372,68,68861,81,"Tasa de exámenes médico legales por presunto delito sexual contra niños, niñas y adolescentes",2014,4,9,2263,397.702165267344,0,1176,0,9,1087,827.966881324747
17373,25,25200,81,"Tasa de exámenes médico legales por presunto delito sexual contra niños, niñas y adolescentes",2014,4,3,2460,121.951219512195,2,1280,156.25,1,1180,84.7457627118644
17374,13,13442,81,"Tasa de exámenes médico legales por presunto delito sexual contra niños, niñas y adolescentes",2014,4,12,6229,192.647294910901,0,3260,0,12,2969,404.176490400808
17375,13,13836,81,"Tasa de exámenes médico legales por presunto delito sexual contra niños, niñas y adolescentes",2014,4,10,8236,121.418164157358,1,4174,23.9578342117873,9,4062,221.565731166913
17376,13,13873,81,"Tasa de exámenes médico legales por presunto delito sexual contra niños, niñas y adolescentes",2014,4,5,2384,209.731543624161,0,1220,0,5,1164,429.553264604811
17377,15,15476,81,"Tasa de exámenes médico legales por presunto delito sexual contra niños, niñas y adolescentes",2014,4,1,798,125.31328320802,0,428,0,1,370,270.27027027027
17378,85,85001,81,"Tasa de exámenes médico legales por presunto delito sexual contra niños, niñas y adolescentes",2014,4,58,16369,354.328303500519,4,8300,48.1927710843373,54,8069,669.227909282439
17379,20,20621,81,"Tasa de exámenes médico legales por presunto delito sexual contra niños, niñas y adolescentes",2014,4,4,3025,132.231404958678,0,1558,0,4,1467,272.66530334015
17380,27,27001,81,"Tasa de exámenes médico legales por presunto delito sexual contra niños, niñas y adolescentes",2014,4,28,16084,174.086048246705,1,8197,12.1995852141027,27,7887,342.335488779003
17381,23,23162,81,"Tasa de exámenes médico legales por presunto delito sexual contra niños, niñas y adolescentes",2014,4,16,9967,160.529748168958,0,5000,0,16,4967,322.126031809946
17382,23,23419,81,"Tasa de exámenes médico legales por presunto delito sexual contra niños, niñas y adolescentes",2014,4,4,3130,127.79552715655,0,1631,0,4,1499,266.844563042028
17383,63,63470,81,"Tasa de exámenes médico legales por presunto delito sexual contra niños, niñas y adolescentes",2014,4,14,4388,319.051959890611,1,2306,43.3651344319167,13,2082,624.399615754083
17384,50,50573,81,"Tasa de exámenes médico legales por presunto delito sexual contra niños, niñas y adolescentes",2014,4,16,3819,418.957842367112,1,2056,48.6381322957198,15,1763,850.822461712989
17385,70,70820,81,"Tasa de exámenes médico legales por presunto delito sexual contra niños, niñas y adolescentes",2014,4,12,4124,290.9796314258,2,2106,94.9667616334283,10,2018,495.540138751239
17386,5,5212,81,"Tasa de exámenes médico legales por presunto delito sexual contra niños, niñas y adolescentes",2014,4,17,7043,241.374414312083,2,3603,55.5092978073827,15,3440,436.046511627907
17387,41,41078,81,"Tasa de exámenes médico legales por presunto delito sexual contra niños, niñas y adolescentes",2014,4,3,1149,261.096605744125,1,600,166.666666666667,2,549,364.298724954463
17388,20,20295,81,"Tasa de exámenes médico legales por presunto delito sexual contra niños, niñas y adolescentes",2014,4,2,1917,104.329681794471,0,988,0,2,929,215.285252960172
17389,73,73168,81,"Tasa de exámenes médico legales por presunto delito sexual contra niños, niñas y adolescentes",2014,4,27,6056,445.838837516513,1,3093,32.3310701584222,26,2963,877.489031387108
17390,5,5045,81,"Tasa de exámenes médico legales por presunto delito sexual contra niños, niñas y adolescentes",2014,4,31,23561,131.573362760494,3,11967,25.0689395838556,28,11594,241.504226323961
17391,25,25183,81,"Tasa de exámenes médico legales por presunto delito sexual contra niños, niñas y adolescentes",2014,4,9,2608,345.092024539877,1,1317,75.9301442672741,8,1291,619.674670797831
17392,20,20710,81,"Tasa de exámenes médico legales por presunto delito sexual contra niños, niñas y adolescentes",2014,4,6,2848,210.674157303371,0,1435,0,6,1413,424.628450106157
17393,50,50680,81,"Tasa de exámenes médico legales por presunto delito sexual contra niños, niñas y adolescentes",2014,4,1,1113,89.8472596585804,0,573,0,1,540,185.185185185185
17394,5,5380,81,"Tasa de exámenes médico legales por presunto delito sexual contra niños, niñas y adolescentes",2014,4,10,6410,156.00624024961,0,3248,0,10,3162,316.255534471853
17395,73,73411,81,"Tasa de exámenes médico legales por presunto delito sexual contra niños, niñas y adolescentes",2014,4,9,4485,200.66889632107,1,2327,42.9737859905458,8,2158,370.713623725672
17396,23,23500,81,"Tasa de exámenes médico legales por presunto delito sexual contra niños, niñas y adolescentes",2014,4,5,3395,147.275405007364,0,1755,0,5,1640,304.878048780488
17397,54,54518,81,"Tasa de exámenes médico legales por presunto delito sexual contra niños, niñas y adolescentes",2014,4,12,7540,159.151193633952,2,3749,53.3475593491598,10,3791,263.782643102084
17398,41,41668,81,"Tasa de exámenes médico legales por presunto delito sexual contra niños, niñas y adolescentes",2014,4,22,3910,562.659846547315,0,1972,0,22,1938,1135.19091847265
17399,41,41551,81,"Tasa de exámenes médico legales por presunto delito sexual contra niños, niñas y adolescentes",2014,4,32,15524,206.13244009276,2,7851,25.4744618519934,30,7673,390.981363221686
17400,86,86568,81,"Tasa de exámenes médico legales por presunto delito sexual contra niños, niñas y adolescentes",2014,4,23,7783,295.515867917256,0,3894,0,23,3889,591.411673952173
17401,68,68547,81,"Tasa de exámenes médico legales por presunto delito sexual contra niños, niñas y adolescentes",2014,4,30,15339,195.579894386857,4,7874,50.8001016002032,26,7465,348.292029470864
17402,13,13657,81,"Tasa de exámenes médico legales por presunto delito sexual contra niños, niñas y adolescentes",2014,4,3,3814,78.6575773466177,0,1924,0,3,1890,158.730158730159
17403,19,19622,81,"Tasa de exámenes médico legales por presunto delito sexual contra niños, niñas y adolescentes",2014,4,2,1387,144.196106705119,0,719,0,2,668,299.40119760479
17404,44,44874,81,"Tasa de exámenes médico legales por presunto delito sexual contra niños, niñas y adolescentes",2014,4,3,2840,105.633802816901,1,1463,68.3526999316473,2,1377,145.243282498184
17405,44,44001,81,"Tasa de exámenes médico legales por presunto delito sexual contra niños, niñas y adolescentes",2014,4,33,29400,112.244897959184,2,14852,13.4661998384056,31,14548,213.087709650811
17406,50,50226,81,"Tasa de exámenes médico legales por presunto delito sexual contra niños, niñas y adolescentes",2014,4,7,2020,346.534653465347,2,1012,197.628458498024,5,1008,496.031746031746
17407,52,52540,81,"Tasa de exámenes médico legales por presunto delito sexual contra niños, niñas y adolescentes",2014,4,1,1983,50.4286434694907,1,1056,94.6969696969697,0,927,0
17408,63,63594,81,"Tasa de exámenes médico legales por presunto delito sexual contra niños, niñas y adolescentes",2014,4,7,3527,198.468953785086,1,1827,54.7345374931582,6,1700,352.941176470588
17409,68,68895,81,"Tasa de exámenes médico legales por presunto delito sexual contra niños, niñas y adolescentes",2014,4,2,916,218.340611353712,0,467,0,2,449,445.43429844098
17410,8,8573,81,"Tasa de exámenes médico legales por presunto delito sexual contra niños, niñas y adolescentes",2014,4,8,2853,280.406589554855,2,1534,130.378096479791,6,1319,454.89006823351
17411,76,76130,81,"Tasa de exámenes médico legales por presunto delito sexual contra niños, niñas y adolescentes",2014,4,9,7548,119.236883942766,0,3927,0,9,3621,248.550124275062
17412,25,25286,81,"Tasa de exámenes médico legales por presunto delito sexual contra niños, niñas y adolescentes",2014,4,24,8004,299.850074962519,3,3984,75.3012048192771,21,4020,522.388059701493
17413,25,25269,81,"Tasa de exámenes médico legales por presunto delito sexual contra niños, niñas y adolescentes",2014,4,33,14120,233.71104815864,2,7285,27.4536719286205,31,6835,453.547915142648
17414,27,27787,81,"Tasa de exámenes médico legales por presunto delito sexual contra niños, niñas y adolescentes",2014,4,4,2626,152.322924600152,0,1317,0,4,1309,305.576776165011
17415,17,17380,81,"Tasa de exámenes médico legales por presunto delito sexual contra niños, niñas y adolescentes",2014,4,9,7908,113.808801213961,4,3996,100.1001001001,5,3912,127.811860940695
17416,23,23464,81,"Tasa de exámenes médico legales por presunto delito sexual contra niños, niñas y adolescentes",2014,4,5,1733,288.517022504328,0,880,0,5,853,586.166471277843
17417,76,76248,81,"Tasa de exámenes médico legales por presunto delito sexual contra niños, niñas y adolescentes",2014,4,5,5339,93.6504963476307,0,2689,0,5,2650,188.679245283019
17418,41,41770,81,"Tasa de exámenes médico legales por presunto delito sexual contra niños, niñas y adolescentes",2014,4,3,2306,130.09540329575,0,1190,0,3,1116,268.817204301075
17419,68,68755,81,"Tasa de exámenes médico legales por presunto delito sexual contra niños, niñas y adolescentes",2014,4,6,3356,178.784266984505,0,1850,0,6,1506,398.406374501992
17420,95,95001,81,"Tasa de exámenes médico legales por presunto delito sexual contra niños, niñas y adolescentes",2014,4,24,8756,274.097761534947,4,4425,90.3954802259887,20,4331,461.78711613946
17421,19,19212,81,"Tasa de exámenes médico legales por presunto delito sexual contra niños, niñas y adolescentes",2014,4,3,4077,73.5835172921266,0,2098,0,3,1979,151.591712986357
17422,81,81065,81,"Tasa de exámenes médico legales por presunto delito sexual contra niños, niñas y adolescentes",2014,4,4,5695,70.2370500438982,0,2904,0,4,2791,143.317807237549
17423,76,76834,81,"Tasa de exámenes médico legales por presunto delito sexual contra niños, niñas y adolescentes",2014,4,35,20213,173.155889773908,5,10412,48.0215136381099,30,9801,306.091215182124
17424,52,52354,81,"Tasa de exámenes médico legales por presunto delito sexual contra niños, niñas y adolescentes",2014,4,2,697,286.944045911047,0,350,0,2,347,576.368876080692
17425,52,52838,81,"Tasa de exámenes médico legales por presunto delito sexual contra niños, niñas y adolescentes",2014,4,4,4506,88.7705281846427,0,2302,0,4,2204,181.488203266788
17426,76,76364,81,"Tasa de exámenes médico legales por presunto delito sexual contra niños, niñas y adolescentes",2014,4,13,12491,104.074933952446,1,6385,15.6617071260767,12,6106,196.528005240747
17427,19,19698,81,"Tasa de exámenes médico legales por presunto delito sexual contra niños, niñas y adolescentes",2014,4,15,10820,138.632162661738,0,5566,0,15,5254,285.496764370004
17428,68,68077,81,"Tasa de exámenes médico legales por presunto delito sexual contra niños, niñas y adolescentes",2014,4,9,3013,298.705609027547,2,1584,126.262626262626,7,1429,489.853044086774
17429,15,15189,81,"Tasa de exámenes médico legales por presunto delito sexual contra niños, niñas y adolescentes",2014,4,1,526,190.114068441065,0,275,0,1,251,398.406374501992
17430,17,17873,81,"Tasa de exámenes médico legales por presunto delito sexual contra niños, niñas y adolescentes",2014,4,8,5321,150.347679007705,1,2745,36.4298724954463,7,2576,271.739130434783
17431,18,18753,81,"Tasa de exámenes médico legales por presunto delito sexual contra niños, niñas y adolescentes",2014,4,8,8841,90.4875014138672,1,4557,21.944261575598,7,4284,163.398692810458
17432,20,20750,81,"Tasa de exámenes médico legales por presunto delito sexual contra niños, niñas y adolescentes",2014,4,2,1687,118.5536455246,0,895,0,2,792,252.525252525253
17433,50,50711,81,"Tasa de exámenes médico legales por presunto delito sexual contra niños, niñas y adolescentes",2014,4,2,2964,67.476383265857,1,1530,65.359477124183,1,1434,69.7350069735007
17434,63,63401,81,"Tasa de exámenes médico legales por presunto delito sexual contra niños, niñas y adolescentes",2014,4,10,4808,207.986688851913,0,2450,0,10,2358,424.088210347752
17435,63,63272,81,"Tasa de exámenes médico legales por presunto delito sexual contra niños, niñas y adolescentes",2014,4,4,1461,273.78507871321,0,754,0,4,707,565.770862800566
17436,63,63130,81,"Tasa de exámenes médico legales por presunto delito sexual contra niños, niñas y adolescentes",2014,4,30,7826,383.337592639918,4,4033,99.1817505578973,26,3793,685.473240179278
17437,70,70230,81,"Tasa de exámenes médico legales por presunto delito sexual contra niños, niñas y adolescentes",2014,4,3,533,562.851782363977,0,279,0,3,254,1181.10236220472
17438,5,5674,81,"Tasa de exámenes médico legales por presunto delito sexual contra niños, niñas y adolescentes",2014,4,3,1816,165.198237885463,0,932,0,3,884,339.366515837104
17439,68,68689,81,"Tasa de exámenes médico legales por presunto delito sexual contra niños, niñas y adolescentes",2014,4,10,3874,258.131130614352,0,1960,0,10,1914,522.466039707419
17440,8,8078,81,"Tasa de exámenes médico legales por presunto delito sexual contra niños, niñas y adolescentes",2014,4,8,6026,132.758048456688,0,3080,0,8,2946,271.554650373388
17441,20,20011,81,"Tasa de exámenes médico legales por presunto delito sexual contra niños, niñas y adolescentes",2014,4,25,11529,216.844479139561,2,5727,34.922297887201,23,5802,396.415029300241
17442,17,17877,81,"Tasa de exámenes médico legales por presunto delito sexual contra niños, niñas y adolescentes",2014,4,1,1423,70.2740688685875,0,730,0,1,693,144.300144300144
17443,68,68190,81,"Tasa de exámenes médico legales por presunto delito sexual contra niños, niñas y adolescentes",2014,4,10,5267,189.861401177141,0,2704,0,10,2563,390.167772142021
17444,5,5266,81,"Tasa de exámenes médico legales por presunto delito sexual contra niños, niñas y adolescentes",2014,4,12,21071,56.9503108537801,3,10780,27.8293135435993,9,10291,87.4550578175105
17445,25,25322,81,"Tasa de exámenes médico legales por presunto delito sexual contra niños, niñas y adolescentes",2014,4,6,1718,349.243306169965,1,900,111.111111111111,5,818,611.246943765281
17446,5,5615,81,"Tasa de exámenes médico legales por presunto delito sexual contra niños, niñas y adolescentes",2014,4,13,12374,105.058994666236,1,6378,15.6788962057071,12,5996,200.133422281521
17447,25,25438,81,"Tasa de exámenes médico legales por presunto delito sexual contra niños, niñas y adolescentes",2014,4,2,1201,166.527893422148,0,646,0,2,555,360.36036036036
17448,85,85230,81,"Tasa de exámenes médico legales por presunto delito sexual contra niños, niñas y adolescentes",2014,4,3,1049,285.986653956149,0,543,0,3,506,592.885375494071
17449,73,73148,81,"Tasa de exámenes médico legales por presunto delito sexual contra niños, niñas y adolescentes",2014,4,1,966,103.51966873706,0,489,0,1,477,209.643605870021
17450,68,68209,81,"Tasa de exámenes médico legales por presunto delito sexual contra niños, niñas y adolescentes",2014,4,1,276,362.31884057971,1,137,729.92700729927,0,139,0
17451,76,76147,81,"Tasa de exámenes médico legales por presunto delito sexual contra niños, niñas y adolescentes",2014,4,17,12090,140.612076095947,2,6195,32.2841000807103,15,5895,254.452926208651
17452,25,25245,81,"Tasa de exámenes médico legales por presunto delito sexual contra niños, niñas y adolescentes",2014,4,3,2230,134.529147982063,0,1150,0,3,1080,277.777777777778
17453,52,52835,81,"Tasa de exámenes médico legales por presunto delito sexual contra niños, niñas y adolescentes",2014,4,15,25155,59.6302921884317,1,12737,7.85114234121065,14,12418,112.739571589628
17454,19,19548,81,"Tasa de exámenes médico legales por presunto delito sexual contra niños, niñas y adolescentes",2014,4,4,4946,80.8734330772341,0,2536,0,4,2410,165.97510373444
17455,52,52378,81,"Tasa de exámenes médico legales por presunto delito sexual contra niños, niñas y adolescentes",2014,4,1,1848,54.1125541125541,0,998,0,1,850,117.647058823529
17456,70,70215,81,"Tasa de exámenes médico legales por presunto delito sexual contra niños, niñas y adolescentes",2014,4,16,7049,226.982550716414,0,3591,0,16,3458,462.695199537305
17457,23,23670,81,"Tasa de exámenes médico legales por presunto delito sexual contra niños, niñas y adolescentes",2014,4,5,5425,92.1658986175115,0,2838,0,5,2587,193.274062620796
17458,23,23168,81,"Tasa de exámenes médico legales por presunto delito sexual contra niños, niñas y adolescentes",2014,4,1,1622,61.652281134402,0,843,0,1,779,128.369704749679
17459,5,5376,81,"Tasa de exámenes médico legales por presunto delito sexual contra niños, niñas y adolescentes",2014,4,18,5671,317.404337859284,2,2829,70.6963591375044,16,2842,562.983814215341
17460,8,8372,81,"Tasa de exámenes médico legales por presunto delito sexual contra niños, niñas y adolescentes",2014,4,4,1858,215.285252960172,0,990,0,4,868,460.829493087558
17461,8,8421,81,"Tasa de exámenes médico legales por presunto delito sexual contra niños, niñas y adolescentes",2014,4,2,2975,67.2268907563025,0,1507,0,2,1468,136.239782016349
17462,66,66400,81,"Tasa de exámenes médico legales por presunto delito sexual contra niños, niñas y adolescentes",2014,4,9,3319,271.166013859596,0,1617,0,9,1702,528.789659224442
17463,17,17042,81,"Tasa de exámenes médico legales por presunto delito sexual contra niños, niñas y adolescentes",2014,4,9,3379,266.350991417579,0,1698,0,9,1681,535.395597858418
17464,13,13244,81,"Tasa de exámenes médico legales por presunto delito sexual contra niños, niñas y adolescentes",2014,4,27,9564,282.308657465496,4,4951,80.7917592405575,23,4613,498.590938651637
17465,13,13894,81,"Tasa de exámenes médico legales por presunto delito sexual contra niños, niñas y adolescentes",2014,4,1,1448,69.060773480663,1,759,131.752305665349,0,689,0
17466,25,25377,81,"Tasa de exámenes médico legales por presunto delito sexual contra niños, niñas y adolescentes",2014,4,10,2786,358.937544867193,1,1452,68.870523415978,9,1334,674.662668665667
17467,25,25307,81,"Tasa de exámenes médico legales por presunto delito sexual contra niños, niñas y adolescentes",2014,4,24,9870,243.161094224924,4,4814,83.0909846281678,20,5056,395.569620253165
17468,54,54245,81,"Tasa de exámenes médico legales por presunto delito sexual contra niños, niñas y adolescentes",2014,4,3,1882,159.404888416578,0,993,0,3,889,337.457817772778
17469,54,54174,81,"Tasa de exámenes médico legales por presunto delito sexual contra niños, niñas y adolescentes",2014,4,3,1346,222.882615156018,0,702,0,3,644,465.83850931677
17470,47,47960,81,"Tasa de exámenes médico legales por presunto delito sexual contra niños, niñas y adolescentes",2014,4,1,1059,94.4287063267233,0,552,0,1,507,197.23865877712
17471,66,66682,81,"Tasa de exámenes médico legales por presunto delito sexual contra niños, niñas y adolescentes",2014,4,4,7599,52.6385050664561,0,3880,0,4,3719,107.555794568432
17472,76,76616,81,"Tasa de exámenes médico legales por presunto delito sexual contra niños, niñas y adolescentes",2014,4,7,1376,508.720930232558,0,728,0,7,648,1080.24691358025
17473,25,25875,81,"Tasa de exámenes médico legales por presunto delito sexual contra niños, niñas y adolescentes",2014,4,11,2668,412.293853073463,0,1374,0,11,1294,850.077279752705
17474,15,15740,81,"Tasa de exámenes médico legales por presunto delito sexual contra niños, niñas y adolescentes",2014,4,1,1050,95.2380952380952,0,548,0,1,502,199.203187250996
17475,17,17486,81,"Tasa de exámenes médico legales por presunto delito sexual contra niños, niñas y adolescentes",2014,4,8,3575,223.776223776224,1,1841,54.3183052688756,7,1734,403.690888119954
17476,85,85440,81,"Tasa de exámenes médico legales por presunto delito sexual contra niños, niñas y adolescentes",2014,4,9,2998,300.200133422282,0,1524,0,9,1474,610.583446404342
17477,44,44098,81,"Tasa de exámenes médico legales por presunto delito sexual contra niños, niñas y adolescentes",2014,4,2,1983,100.857286938981,0,1055,0,2,928,215.51724137931
17478,54,54874,81,"Tasa de exámenes médico legales por presunto delito sexual contra niños, niñas y adolescentes",2014,4,7,10375,67.4698795180723,1,5322,18.7899285982713,6,5053,118.741341777162
17479,70,70670,81,"Tasa de exámenes médico legales por presunto delito sexual contra niños, niñas y adolescentes",2014,4,8,4642,172.33950883240001,0,2423,0,8,2219,360.522757999099
17480,8,8560,81,"Tasa de exámenes médico legales por presunto delito sexual contra niños, niñas y adolescentes",2014,4,3,2560,117.1875,0,1325,0,3,1235,242.914979757085
17481,99,99773,81,"Tasa de exámenes médico legales por presunto delito sexual contra niños, niñas y adolescentes",2014,4,1,5271,18.9717321191425,0,2652,0,1,2619,38.1825124093165
17482,68,68573,81,"Tasa de exámenes médico legales por presunto delito sexual contra niños, niñas y adolescentes",2014,4,2,1018,196.463654223969,0,536,0,2,482,414.9377593361
17483,5,5656,81,"Tasa de exámenes médico legales por presunto delito sexual contra niños, niñas y adolescentes",2014,4,3,1408,213.068181818182,0,723,0,3,685,437.956204379562
17484,17,17174,81,"Tasa de exámenes médico legales por presunto delito sexual contra niños, niñas y adolescentes",2014,4,17,5334,318.710161229846,1,2677,37.3552484124019,16,2657,602.182913059842
17485,20,20178,81,"Tasa de exámenes médico legales por presunto delito sexual contra niños, niñas y adolescentes",2014,4,14,2556,547.73082942097,1,1312,76.219512195122,13,1244,1045.01607717042
17486,47,47318,81,"Tasa de exámenes médico legales por presunto delito sexual contra niños, niñas y adolescentes",2014,4,3,3621,82.8500414250207,1,1925,51.9480519480519,2,1696,117.924528301887
17487,41,41306,81,"Tasa de exámenes médico legales por presunto delito sexual contra niños, niñas y adolescentes",2014,4,6,3872,154.95867768595,0,1943,0,6,1929,311.04199066874
17488,41,41791,81,"Tasa de exámenes médico legales por presunto delito sexual contra niños, niñas y adolescentes",2014,4,1,2230,44.8430493273543,0,1148,0,1,1082,92.4214417744917
17489,15,15572,81,"Tasa de exámenes médico legales por presunto delito sexual contra niños, niñas y adolescentes",2014,4,17,6374,266.708503294634,2,3302,60.5693519079346,15,3072,488.28125
17490,5,5400,81,"Tasa de exámenes médico legales por presunto delito sexual contra niños, niñas y adolescentes",2014,4,3,2120,141.509433962264,0,1096,0,3,1024,292.96875
17491,13,13433,81,"Tasa de exámenes médico legales por presunto delito sexual contra niños, niñas y adolescentes",2014,4,7,2988,234.270414993307,0,1546,0,7,1442,485.436893203883
17492,19,19130,81,"Tasa de exámenes médico legales por presunto delito sexual contra niños, niñas y adolescentes",2014,4,1,4570,21.8818380743982,0,2451,0,1,2119,47.192071731949
17493,27,27075,81,"Tasa de exámenes médico legales por presunto delito sexual contra niños, niñas y adolescentes",2014,4,1,1198,83.4724540901503,0,613,0,1,585,170.940170940171
17494,52,52019,81,"Tasa de exámenes médico legales por presunto delito sexual contra niños, niñas y adolescentes",2014,4,1,2509,39.8565165404544,0,1263,0,1,1246,80.2568218298555
17495,5,5154,81,"Tasa de exámenes médico legales por presunto delito sexual contra niños, niñas y adolescentes",2014,4,16,13986,114.400114400114,0,6978,0,16,7008,228.310502283105
17496,70,70418,81,"Tasa de exámenes médico legales por presunto delito sexual contra niños, niñas y adolescentes",2014,4,3,2156,139.146567717996,0,1104,0,3,1052,285.171102661597
17497,8,8638,81,"Tasa de exámenes médico legales por presunto delito sexual contra niños, niñas y adolescentes",2014,4,19,10897,174.359915573094,4,5633,71.0101189419492,15,5264,284.954407294833
17498,41,41132,81,"Tasa de exámenes médico legales por presunto delito sexual contra niños, niñas y adolescentes",2014,4,4,3928,101.83299389002,0,1972,0,4,1956,204.498977505112
17499,91,91407,81,"Tasa de exámenes médico legales por presunto delito sexual contra niños, niñas y adolescentes",2014,4,1,688,145.348837209302,0,338,0,1,350,285.714285714286
17500,47,47980,81,"Tasa de exámenes médico legales por presunto delito sexual contra niños, niñas y adolescentes",2014,4,15,8671,172.990427862992,1,4519,22.1287895552113,14,4152,337.18689788054
17501,20,20013,81,"Tasa de exámenes médico legales por presunto delito sexual contra niños, niñas y adolescentes",2014,4,12,6787,176.808604685428,0,3447,0,12,3340,359.281437125748
17502,47,47053,81,"Tasa de exámenes médico legales por presunto delito sexual contra niños, niñas y adolescentes",2014,4,10,5385,185.701021355617,0,2781,0,10,2604,384.024577572965
17503,25,25743,81,"Tasa de exámenes médico legales por presunto delito sexual contra niños, niñas y adolescentes",2014,4,7,2488,281.350482315113,1,1276,78.3699059561128,6,1212,495.049504950495
17504,15,15299,81,"Tasa de exámenes médico legales por presunto delito sexual contra niños, niñas y adolescentes",2014,4,8,2017,396.628656420426,1,1006,99.403578528827,7,1011,692.383778437191
17505,5,5631,81,"Tasa de exámenes médico legales por presunto delito sexual contra niños, niñas y adolescentes",2014,4,5,4582,109.122653862942,0,2305,0,5,2277,219.587176108915
17506,23,23300,81,"Tasa de exámenes médico legales por presunto delito sexual contra niños, niñas y adolescentes",2014,4,1,1651,60.5693519079346,0,846,0,1,805,124.223602484472
17507,68,68468,81,"Tasa de exámenes médico legales por presunto delito sexual contra niños, niñas y adolescentes",2014,4,1,626,159.744408945687,0,329,0,1,297,336.700336700337
17508,76,76895,81,"Tasa de exámenes médico legales por presunto delito sexual contra niños, niñas y adolescentes",2014,4,7,4404,158.946412352407,0,2206,0,7,2198,318.471337579618
17509,15,15759,81,"Tasa de exámenes médico legales por presunto delito sexual contra niños, niñas y adolescentes",2014,4,11,12311,89.3509869222646,0,6154,0,11,6157,178.658437550755
17510,25,25486,81,"Tasa de exámenes médico legales por presunto delito sexual contra niños, niñas y adolescentes",2014,4,5,1583,315.855969677827,2,819,244.200244200244,3,764,392.670157068063
17511,86,86573,81,"Tasa de exámenes médico legales por presunto delito sexual contra niños, niñas y adolescentes",2014,4,7,1987,352.289884247609,1,1021,97.9431929480901,6,966,621.11801242236
17512,52,52260,81,"Tasa de exámenes médico legales por presunto delito sexual contra niños, niñas y adolescentes",2014,4,2,1396,143.266475644699,0,710,0,2,686,291.545189504373
17513,5,5079,81,"Tasa de exámenes médico legales por presunto delito sexual contra niños, niñas y adolescentes",2014,4,4,5463,73.2198425773385,0,2766,0,4,2697,148.312940304042
17514,41,41524,81,"Tasa de exámenes médico legales por presunto delito sexual contra niños, niñas y adolescentes",2014,4,2,3683,54.3035568829758,1,1894,52.7983104540655,1,1789,55.8971492453885
17515,13,13074,81,"Tasa de exámenes médico legales por presunto delito sexual contra niños, niñas y adolescentes",2014,4,2,2375,84.2105263157895,0,1224,0,2,1151,173.761946133797
17516,25,25328,81,"Tasa de exámenes médico legales por presunto delito sexual contra niños, niñas y adolescentes",2014,4,2,429,466.200466200466,0,229,0,2,200,1000
17517,50,50577,81,"Tasa de exámenes médico legales por presunto delito sexual contra niños, niñas y adolescentes",2014,4,3,1140,263.157894736842,0,609,0,3,531,564.971751412429
17518,81,81794,81,"Tasa de exámenes médico legales por presunto delito sexual contra niños, niñas y adolescentes",2014,4,2,7022,28.4819139846198,0,3652,0,2,3370,59.3471810089021
17519,47,47170,81,"Tasa de exámenes médico legales por presunto delito sexual contra niños, niñas y adolescentes",2014,4,4,2161,185.0994909764,0,1141,0,4,1020,392.156862745098
17520,17,17653,81,"Tasa de exámenes médico legales por presunto delito sexual contra niños, niñas y adolescentes",2014,4,7,1895,369.393139841689,1,999,100.1001001001,6,896,669.642857142857
17521,76,76111,81,"Tasa de exámenes médico legales por presunto delito sexual contra niños, niñas y adolescentes",2014,4,18,10381,173.393700028899,3,5447,55.07618872774,15,4934,304.012971220105
17522,13,13052,81,"Tasa de exámenes médico legales por presunto delito sexual contra niños, niñas y adolescentes",2014,4,12,8990,133.481646273637,2,4625,43.2432432432432,10,4365,229.095074455899
17523,19,19807,81,"Tasa de exámenes médico legales por presunto delito sexual contra niños, niñas y adolescentes",2014,4,6,3483,172.265288544358,1,1846,54.1711809317443,5,1637,305.43677458766
17524,19,19100,81,"Tasa de exámenes médico legales por presunto delito sexual contra niños, niñas y adolescentes",2014,4,3,4961,60.4716790969563,0,2587,0,3,2374,126.36899747262
17525,20,20238,81,"Tasa de exámenes médico legales por presunto delito sexual contra niños, niñas y adolescentes",2014,4,9,3558,252.951096121417,1,1806,55.3709856035437,8,1752,456.62100456621
17526,70,70235,81,"Tasa de exámenes médico legales por presunto delito sexual contra niños, niñas y adolescentes",2014,4,6,2502,239.808153477218,2,1269,157.604412923562,4,1233,324.41200324412
17527,76,76318,81,"Tasa de exámenes médico legales por presunto delito sexual contra niños, niñas y adolescentes",2014,4,5,3292,151.883353584447,0,1691,0,5,1601,312.304809494066
17528,73,73854,81,"Tasa de exámenes médico legales por presunto delito sexual contra niños, niñas y adolescentes",2014,4,1,686,145.772594752187,0,355,0,1,331,302.114803625378
17529,17,17665,81,"Tasa de exámenes médico legales por presunto delito sexual contra niños, niñas y adolescentes",2014,4,2,782,255.754475703325,0,396,0,2,386,518.134715025907
17530,5,5368,81,"Tasa de exámenes médico legales por presunto delito sexual contra niños, niñas y adolescentes",2014,4,3,1293,232.018561484919,1,653,153.139356814701,2,640,312.5
17531,76,76243,81,"Tasa de exámenes médico legales por presunto delito sexual contra niños, niñas y adolescentes",2014,4,3,1124,266.903914590747,0,581,0,3,543,552.486187845304
17532,73,73067,81,"Tasa de exámenes médico legales por presunto delito sexual contra niños, niñas y adolescentes",2014,4,1,2886,34.6500346500346,0,1478,0,1,1408,71.0227272727273
17533,15,15667,81,"Tasa de exámenes médico legales por presunto delito sexual contra niños, niñas y adolescentes",2014,4,1,588,170.068027210884,0,310,0,1,278,359.712230215827
17534,52,52317,81,"Tasa de exámenes médico legales por presunto delito sexual contra niños, niñas y adolescentes",2014,4,2,1647,121.432908318154,0,849,0,2,798,250.62656641604
17535,5,5360,81,"Tasa de exámenes médico legales por presunto delito sexual contra niños, niñas y adolescentes",2014,4,25,26975,92.678405931418,3,13640,21.9941348973607,22,13335,164.979377577803
17536,73,73283,81,"Tasa de exámenes médico legales por presunto delito sexual contra niños, niñas y adolescentes",2014,4,1,3448,29.0023201856148,0,1814,0,1,1634,61.1995104039168
17537,17,17614,81,"Tasa de exámenes médico legales por presunto delito sexual contra niños, niñas y adolescentes",2014,4,28,5892,475.220638153428,3,3062,97.9751796211626,25,2830,883.39222614841
17538,76,76126,81,"Tasa de exámenes médico legales por presunto delito sexual contra niños, niñas y adolescentes",2014,4,3,1439,208.478109798471,1,733,136.425648021828,2,706,283.28611898017
17539,19,19397,81,"Tasa de exámenes médico legales por presunto delito sexual contra niños, niñas y adolescentes",2014,4,2,5287,37.8286362776622,0,2677,0,2,2610,76.6283524904215
17540,5,5887,81,"Tasa de exámenes médico legales por presunto delito sexual contra niños, niñas y adolescentes",2014,4,11,5541,198.52012272153,1,2823,35.4233085370174,10,2718,367.917586460633
17541,25,25175,81,"Tasa de exámenes médico legales por presunto delito sexual contra niños, niñas y adolescentes",2014,4,20,12568,159.134309357097,4,6297,63.5223122121645,16,6271,255.142720459257
17542,18,18479,81,"Tasa de exámenes médico legales por presunto delito sexual contra niños, niñas y adolescentes",2014,4,1,508,196.850393700787,0,263,0,1,245,408.163265306122
17543,23,23678,81,"Tasa de exámenes médico legales por presunto delito sexual contra niños, niñas y adolescentes",2014,4,4,3106,128.783000643915,1,1590,62.8930817610063,3,1516,197.889182058048
17544,5,5579,81,"Tasa de exámenes médico legales por presunto delito sexual contra niños, niñas y adolescentes",2014,4,11,5136,214.17445482866,1,2599,38.4763370527126,10,2537,394.166338194718
17545,8,8685,81,"Tasa de exámenes médico legales por presunto delito sexual contra niños, niñas y adolescentes",2014,4,7,2696,259.643916913947,0,1369,0,7,1327,527.50565184627
17546,47,47745,81,"Tasa de exámenes médico legales por presunto delito sexual contra niños, niñas y adolescentes",2014,4,2,3991,50.1127536958156,0,2053,0,2,1938,103.199174406605
17547,15,15176,81,"Tasa de exámenes médico legales por presunto delito sexual contra niños, niñas y adolescentes",2014,4,10,8061,124.054087582186,0,4171,0,10,3890,257.06940874036
17548,47,47570,81,"Tasa de exámenes médico legales por presunto delito sexual contra niños, niñas y adolescentes",2014,4,6,4222,142.112742775936,0,2170,0,6,2052,292.397660818713
17549,18,18247,81,"Tasa de exámenes médico legales por presunto delito sexual contra niños, niñas y adolescentes",2014,4,6,2800,214.285714285714,3,1430,209.79020979021,3,1370,218.978102189781
17550,23,23672,81,"Tasa de exámenes médico legales por presunto delito sexual contra niños, niñas y adolescentes",2014,4,4,3603,111.018595614765,0,1855,0,4,1748,228.83295194508
17551,73,73443,81,"Tasa de exámenes médico legales por presunto delito sexual contra niños, niñas y adolescentes",2014,4,10,3456,289.351851851852,2,1762,113.507377979569,8,1694,472.255017709563
17552,76,76863,81,"Tasa de exámenes médico legales por presunto delito sexual contra niños, niñas y adolescentes",2014,4,3,718,417.827298050139,0,378,0,3,340,882.352941176471
17553,5,5854,81,"Tasa de exámenes médico legales por presunto delito sexual contra niños, niñas y adolescentes",2014,4,1,2851,35.0754121360926,0,1478,0,1,1373,72.8332119446468
17554,15,15293,81,"Tasa de exámenes médico legales por presunto delito sexual contra niños, niñas y adolescentes",2014,4,1,272,367.647058823529,1,146,684.931506849315,0,126,0
17555,19,19824,81,"Tasa de exámenes médico legales por presunto delito sexual contra niños, niñas y adolescentes",2014,4,1,2656,37.6506024096386,0,1346,0,1,1310,76.3358778625954
17556,5,5790,81,"Tasa de exámenes médico legales por presunto delito sexual contra niños, niñas y adolescentes",2014,4,2,5515,36.2647325475975,0,2838,0,2,2677,74.7104968248039
17557,23,23660,81,"Tasa de exámenes médico legales por presunto delito sexual contra niños, niñas y adolescentes",2014,4,8,10128,78.9889415481832,1,5169,19.3461017604953,7,4959,141.157491429724
17558,23,23574,81,"Tasa de exámenes médico legales por presunto delito sexual contra niños, niñas y adolescentes",2014,4,3,3643,82.3497117760088,1,1952,51.2295081967213,2,1691,118.273211117682
17559,19,19075,81,"Tasa de exámenes médico legales por presunto delito sexual contra niños, niñas y adolescentes",2014,4,2,2998,66.711140760507,0,1558,0,2,1440,138.888888888889
17560,52,52240,81,"Tasa de exámenes médico legales por presunto delito sexual contra niños, niñas y adolescentes",2014,4,2,1631,122.624156958921,0,818,0,2,813,246.0024600246
17561,5,5321,81,"Tasa de exámenes médico legales por presunto delito sexual contra niños, niñas y adolescentes",2014,4,4,556,719.424460431655,0,287,0,4,269,1486.98884758364
17562,68,68444,81,"Tasa de exámenes médico legales por presunto delito sexual contra niños, niñas y adolescentes",2014,4,2,562,355.871886120996,0,286,0,2,276,724.63768115942
17563,8,8675,81,"Tasa de exámenes médico legales por presunto delito sexual contra niños, niñas y adolescentes",2014,4,2,1483,134.861766689144,0,763,0,2,720,277.777777777778
17564,18,18592,81,"Tasa de exámenes médico legales por presunto delito sexual contra niños, niñas y adolescentes",2014,4,4,4431,90.2730760550666,0,2306,0,4,2125,188.235294117647
17565,68,68655,81,"Tasa de exámenes médico legales por presunto delito sexual contra niños, niñas y adolescentes",2014,4,12,2080,576.923076923077,1,1079,92.678405931418,11,1001,1098.9010989011
17566,17,17013,81,"Tasa de exámenes médico legales por presunto delito sexual contra niños, niñas y adolescentes",2014,4,11,2311,475.984422327997,1,1185,84.3881856540084,10,1126,888.09946714032
17567,73,73504,81,"Tasa de exámenes médico legales por presunto delito sexual contra niños, niñas y adolescentes",2014,4,1,3955,25.2844500632111,0,2026,0,1,1929,51.8403317781234
17568,15,15491,81,"Tasa de exámenes médico legales por presunto delito sexual contra niños, niñas y adolescentes",2014,4,1,1910,52.3560209424084,1,979,102.145045965271,0,931,0
17569,73,73563,81,"Tasa de exámenes médico legales por presunto delito sexual contra niños, niñas y adolescentes",2014,4,2,790,253.164556962025,0,407,0,2,383,522.193211488251
17570,41,41026,81,"Tasa de exámenes médico legales por presunto delito sexual contra niños, niñas y adolescentes",2014,4,1,557,179.533213644524,1,276,362.31884057971,0,281,0
17571,25,25612,81,"Tasa de exámenes médico legales por presunto delito sexual contra niños, niñas y adolescentes",2014,4,3,963,311.526479750779,0,471,0,3,492,609.756097560976
17572,52,52399,81,"Tasa de exámenes médico legales por presunto delito sexual contra niños, niñas y adolescentes",2014,4,3,2850,105.263157894737,1,1442,69.3481276005548,2,1408,142.045454545455
17573,23,23675,81,"Tasa de exámenes médico legales por presunto delito sexual contra niños, niñas y adolescentes",2014,4,2,4001,49.9875031242189,0,2116,0,2,1885,106.100795755968
17574,73,73408,81,"Tasa de exámenes médico legales por presunto delito sexual contra niños, niñas y adolescentes",2014,4,3,1826,164.293537787514,0,937,0,3,889,337.457817772778
17575,68,68432,81,"Tasa de exámenes médico legales por presunto delito sexual contra niños, niñas y adolescentes",2014,4,4,1971,202.942668696093,0,993,0,4,978,408.997955010225
17576,85,85250,81,"Tasa de exámenes médico legales por presunto delito sexual contra niños, niñas y adolescentes",2014,4,11,3386,324.8670998228,0,1730,0,11,1656,664.251207729469
17577,68,68464,81,"Tasa de exámenes médico legales por presunto delito sexual contra niños, niñas y adolescentes",2014,4,1,1191,83.9630562552477,0,614,0,1,577,173.310225303293
17578,73,73616,81,"Tasa de exámenes médico legales por presunto delito sexual contra niños, niñas y adolescentes",2014,4,1,3394,29.4637595757219,1,1786,55.9910414333707,0,1608,0
17579,25,25592,81,"Tasa de exámenes médico legales por presunto delito sexual contra niños, niñas y adolescentes",2014,4,1,533,187.617260787993,0,286,0,1,247,404.858299595142
17580,25,25126,81,"Tasa de exámenes médico legales por presunto delito sexual contra niños, niñas y adolescentes",2014,4,8,6081,131.557309653018,3,3137,95.6327701625757,5,2944,169.836956521739
17581,86,86571,81,"Tasa de exámenes médico legales por presunto delito sexual contra niños, niñas y adolescentes",2014,4,1,3436,29.1036088474971,0,1787,0,1,1649,60.6428138265616
17582,5,5234,81,"Tasa de exámenes médico legales por presunto delito sexual contra niños, niñas y adolescentes",2014,4,5,3140,159.235668789809,0,1673,0,5,1467,340.831629175187
17583,8,8137,81,"Tasa de exámenes médico legales por presunto delito sexual contra niños, niñas y adolescentes",2014,4,2,2250,88.8888888888889,0,1162,0,2,1088,183.823529411765
17584,8,8558,81,"Tasa de exámenes médico legales por presunto delito sexual contra niños, niñas y adolescentes",2014,4,2,1605,124.610591900312,0,827,0,2,778,257.06940874036
17585,41,41020,81,"Tasa de exámenes médico legales por presunto delito sexual contra niños, niñas y adolescentes",2014,4,5,2770,180.505415162455,0,1426,0,5,1344,372.02380952381
17586,91,91798,81,"Tasa de exámenes médico legales por presunto delito sexual contra niños, niñas y adolescentes",2014,4,2,631,316.957210776545,0,308,0,2,323,619.195046439629
17587,66,66456,81,"Tasa de exámenes médico legales por presunto delito sexual contra niños, niñas y adolescentes",2014,4,2,2147,93.1532370749884,0,1113,0,2,1034,193.423597678917
17588,76,76736,81,"Tasa de exámenes médico legales por presunto delito sexual contra niños, niñas y adolescentes",2014,4,7,4485,156.075808249721,0,2389,0,7,2096,333.969465648855
17589,5,5148,81,"Tasa de exámenes médico legales por presunto delito sexual contra niños, niñas y adolescentes",2014,4,16,5408,295.85798816568,4,2794,143.163922691482,12,2614,459.066564651875
17590,25,25120,81,"Tasa de exámenes médico legales por presunto delito sexual contra niños, niñas y adolescentes",2014,4,1,518,193.050193050193,0,259,0,1,259,386.100386100386
17591,52,52224,81,"Tasa de exámenes médico legales por presunto delito sexual contra niños, niñas y adolescentes",2014,4,2,1012,197.628458498024,0,523,0,2,489,408.997955010225
17592,41,41359,81,"Tasa de exámenes médico legales por presunto delito sexual contra niños, niñas y adolescentes",2014,4,10,3378,296.03315571344,2,1766,113.250283125708,8,1612,496.277915632754
17593,47,47058,81,"Tasa de exámenes médico legales por presunto delito sexual contra niños, niñas y adolescentes",2014,4,5,3992,125.250501002004,0,2130,0,5,1862,268.528464017186
17594,17,17388,81,"Tasa de exámenes médico legales por presunto delito sexual contra niños, niñas y adolescentes",2014,4,1,569,175.746924428822,0,294,0,1,275,363.636363636364
17595,68,68167,81,"Tasa de exámenes médico legales por presunto delito sexual contra niños, niñas y adolescentes",2014,4,3,1150,260.869565217391,0,592,0,3,558,537.634408602151
17596,68,68079,81,"Tasa de exámenes médico legales por presunto delito sexual contra niños, niñas y adolescentes",2014,4,1,798,125.31328320802,0,410,0,1,388,257.731958762887
17597,70,70823,81,"Tasa de exámenes médico legales por presunto delito sexual contra niños, niñas y adolescentes",2014,4,5,2231,224.114746750336,3,1174,255.536626916525,2,1057,189.214758751183
17598,25,25740,81,"Tasa de exámenes médico legales por presunto delito sexual contra niños, niñas y adolescentes",2014,4,9,4413,203.942895989123,1,2260,44.2477876106195,8,2153,371.574547143521
17599,70,70702,81,"Tasa de exámenes médico legales por presunto delito sexual contra niños, niñas y adolescentes",2014,4,6,1402,427.960057061341,0,717,0,6,685,875.912408759124
17600,73,73622,81,"Tasa de exámenes médico legales por presunto delito sexual contra niños, niñas y adolescentes",2014,4,1,706,141.643059490085,0,377,0,1,329,303.951367781155
17601,41,41396,81,"Tasa de exámenes médico legales por presunto delito sexual contra niños, niñas y adolescentes",2014,4,16,8062,198.461920119077,1,4165,24.0096038415366,15,3897,384.911470361817
17602,73,73624,81,"Tasa de exámenes médico legales por presunto delito sexual contra niños, niñas y adolescentes",2014,4,1,2517,39.7298371076679,1,1290,77.5193798449612,0,1227,0
17603,47,47703,81,"Tasa de exámenes médico legales por presunto delito sexual contra niños, niñas y adolescentes",2014,4,1,1223,81.7661488143908,0,637,0,1,586,170.648464163823
17604,25,25473,81,"Tasa de exámenes médico legales por presunto delito sexual contra niños, niñas y adolescentes",2014,4,19,9545,199.057097957046,1,4942,20.2347227842979,18,4603,391.049315663698
17605,15,15322,81,"Tasa de exámenes médico legales por presunto delito sexual contra niños, niñas y adolescentes",2014,4,3,986,304.259634888438,1,531,188.323917137476,2,455,439.56043956044
17606,27,27810,81,"Tasa de exámenes médico legales por presunto delito sexual contra niños, niñas y adolescentes",2014,4,4,1276,313.479623824451,1,652,153.374233128834,3,624,480.769230769231
17607,13,13468,81,"Tasa de exámenes médico legales por presunto delito sexual contra niños, niñas y adolescentes",2014,4,14,5640,248.22695035461,0,2843,0,14,2797,500.536288880944
17608,15,15816,81,"Tasa de exámenes médico legales por presunto delito sexual contra niños, niñas y adolescentes",2014,4,1,571,175.131348511384,0,311,0,1,260,384.615384615385
17609,76,76100,81,"Tasa de exámenes médico legales por presunto delito sexual contra niños, niñas y adolescentes",2014,4,2,1393,143.575017946877,0,744,0,2,649,308.166409861325
17610,70,70221,81,"Tasa de exámenes médico legales por presunto delito sexual contra niños, niñas y adolescentes",2014,4,9,1684,534.441805225653,0,841,0,9,843,1067.61565836299
17611,68,68673,81,"Tasa de exámenes médico legales por presunto delito sexual contra niños, niñas y adolescentes",2014,4,2,451,443.458980044346,0,232,0,2,219,913.24200913242
17612,20,20614,81,"Tasa de exámenes médico legales por presunto delito sexual contra niños, niñas y adolescentes",2014,4,2,1606,124.53300124533,0,851,0,2,755,264.900662251656
17613,5,5440,81,"Tasa de exámenes médico legales por presunto delito sexual contra niños, niñas y adolescentes",2014,4,24,6018,398.803589232303,0,3099,0,24,2919,822.199383350463
17614,50,50318,81,"Tasa de exámenes médico legales por presunto delito sexual contra niños, niñas y adolescentes",2014,4,3,959,312.825860271116,1,483,207.03933747412,2,476,420.168067226891
17615,76,76563,81,"Tasa de exámenes médico legales por presunto delito sexual contra niños, niñas y adolescentes",2014,4,13,6029,215.624481671919,1,3084,32.4254215304799,12,2945,407.470288624788
17616,27,27600,81,"Tasa de exámenes médico legales por presunto delito sexual contra niños, niñas y adolescentes",2014,4,1,1128,88.6524822695036,0,575,0,1,553,180.831826401447
17617,23,23189,81,"Tasa de exámenes médico legales por presunto delito sexual contra niños, niñas y adolescentes",2014,4,2,7389,27.0672621464339,0,3812,0,2,3577,55.9127760693318
17618,23,23079,81,"Tasa de exámenes médico legales por presunto delito sexual contra niños, niñas y adolescentes",2014,4,1,2716,36.8188512518409,0,1468,0,1,1248,80.1282051282051
17619,19,19318,81,"Tasa de exámenes médico legales por presunto delito sexual contra niños, niñas y adolescentes",2014,4,1,4612,21.6825672159584,0,2455,0,1,2157,46.3606861381548
17620,70,70110,81,"Tasa de exámenes médico legales por presunto delito sexual contra niños, niñas y adolescentes",2014,4,4,1125,355.555555555556,0,564,0,4,561,713.01247771836
17621,70,70523,81,"Tasa de exámenes médico legales por presunto delito sexual contra niños, niñas y adolescentes",2014,4,2,1862,107.411385606874,0,985,0,2,877,228.050171037628
17622,73,73319,81,"Tasa de exámenes médico legales por presunto delito sexual contra niños, niñas y adolescentes",2014,4,1,3489,28.6615075952995,0,1778,0,1,1711,58.4453535943892
17623,8,8634,81,"Tasa de exámenes médico legales por presunto delito sexual contra niños, niñas y adolescentes",2014,4,9,3455,260.492040520984,1,1793,55.7724484104852,8,1662,481.347773766546
17624,76,76377,81,"Tasa de exámenes médico legales por presunto delito sexual contra niños, niñas y adolescentes",2014,4,3,1026,292.397660818713,0,540,0,3,486,617.283950617284
17625,5,5034,81,"Tasa de exámenes médico legales por presunto delito sexual contra niños, niñas y adolescentes",2014,4,6,4937,121.531294308284,0,2553,0,6,2384,251.677852348993
17626,5,5147,81,"Tasa de exámenes médico legales por presunto delito sexual contra niños, niñas y adolescentes",2014,4,14,7091,197.433366238894,0,3517,0,14,3574,391.717963066592
17627,68,68575,81,"Tasa de exámenes médico legales por presunto delito sexual contra niños, niñas y adolescentes",2014,4,8,3749,213.390237396639,1,1866,53.5905680600214,7,1883,371.747211895911
17628,76,76606,81,"Tasa de exámenes médico legales por presunto delito sexual contra niños, niñas y adolescentes",2014,4,2,1654,120.918984280532,0,868,0,2,786,254.452926208651
17629,76,76670,81,"Tasa de exámenes médico legales por presunto delito sexual contra niños, niñas y adolescentes",2014,4,2,1818,110.01100110011,0,985,0,2,833,240.096038415366
17630,73,73200,81,"Tasa de exámenes médico legales por presunto delito sexual contra niños, niñas y adolescentes",2014,4,2,1076,185.873605947955,1,570,175.438596491228,1,506,197.628458498024
17631,25,25095,81,"Tasa de exámenes médico legales por presunto delito sexual contra niños, niñas y adolescentes",2014,4,2,318,628.930817610063,0,174,0,2,144,1388.88888888889
17632,52,52585,81,"Tasa de exámenes médico legales por presunto delito sexual contra niños, niñas y adolescentes",2014,4,2,1891,105.764145954521,0,964,0,2,927,215.749730312837
17633,54,54223,81,"Tasa de exámenes médico legales por presunto delito sexual contra niños, niñas y adolescentes",2014,4,3,996,301.204819277108,0,526,0,3,470,638.297872340425
17634,68,68500,81,"Tasa de exámenes médico legales por presunto delito sexual contra niños, niñas y adolescentes",2014,4,2,1304,153.374233128834,0,673,0,2,631,316.957210776545
17635,13,13838,81,"Tasa de exámenes médico legales por presunto delito sexual contra niños, niñas y adolescentes",2014,4,1,1862,53.7056928034372,0,957,0,1,905,110.497237569061
17636,19,19355,81,"Tasa de exámenes médico legales por presunto delito sexual contra niños, niñas y adolescentes",2014,4,2,4230,47.2813238770686,0,2184,0,2,2046,97.7517106549365
17637,27,27413,81,"Tasa de exámenes médico legales por presunto delito sexual contra niños, niñas y adolescentes",2014,4,1,1477,67.7048070412999,0,740,0,1,737,135.685210312076
17638,27,27073,81,"Tasa de exámenes médico legales por presunto delito sexual contra niños, niñas y adolescentes",2014,4,1,1082,92.4214417744917,0,556,0,1,526,190.114068441065
17639,70,70717,81,"Tasa de exámenes médico legales por presunto delito sexual contra niños, niñas y adolescentes",2014,4,7,1795,389.972144846797,0,946,0,7,849,824.499411071849
17640,73,73861,81,"Tasa de exámenes médico legales por presunto delito sexual contra niños, niñas y adolescentes",2014,4,2,2045,97.799511002445,0,1070,0,2,975,205.128205128205
17641,13,13473,81,"Tasa de exámenes médico legales por presunto delito sexual contra niños, niñas y adolescentes",2014,4,1,2719,36.7782272894447,0,1402,0,1,1317,75.9301442672741
17642,13,13667,81,"Tasa de exámenes médico legales por presunto delito sexual contra niños, niñas y adolescentes",2014,4,2,2233,89.5656068069861,0,1122,0,2,1111,180.01800180018
17643,47,47660,81,"Tasa de exámenes médico legales por presunto delito sexual contra niños, niñas y adolescentes",2014,4,2,2250,88.8888888888889,0,1189,0,2,1061,188.501413760603
17644,25,25317,81,"Tasa de exámenes médico legales por presunto delito sexual contra niños, niñas y adolescentes",2014,4,2,1172,170.648464163823,0,602,0,2,570,350.877192982456
17645,5,5819,81,"Tasa de exámenes médico legales por presunto delito sexual contra niños, niñas y adolescentes",2014,4,2,728,274.725274725275,1,376,265.957446808511,1,352,284.090909090909
17646,13,13222,81,"Tasa de exámenes médico legales por presunto delito sexual contra niños, niñas y adolescentes",2014,4,1,1722,58.0720092915215,0,920,0,1,802,124.688279301746
17647,15,15407,81,"Tasa de exámenes médico legales por presunto delito sexual contra niños, niñas y adolescentes",2014,4,4,1809,221.116639027087,0,979,0,4,830,481.927710843374
17648,17,17446,81,"Tasa de exámenes médico legales por presunto delito sexual contra niños, niñas y adolescentes",2014,4,1,395,253.164556962025,0,203,0,1,192,520.833333333333
17649,18,18460,81,"Tasa de exámenes médico legales por presunto delito sexual contra niños, niñas y adolescentes",2014,4,2,1641,121.87690432663,0,837,0,2,804,248.756218905473
17650,50,50325,81,"Tasa de exámenes médico legales por presunto delito sexual contra niños, niñas y adolescentes",2014,4,2,1817,110.071546505228,0,909,0,2,908,220.264317180617
17651,54,54405,81,"Tasa de exámenes médico legales por presunto delito sexual contra niños, niñas y adolescentes",2014,4,4,8516,46.9704086425552,0,4313,0,4,4203,95.1701165833928
17652,63,63690,81,"Tasa de exámenes médico legales por presunto delito sexual contra niños, niñas y adolescentes",2014,4,3,734,408.719346049046,2,380,526.315789473684,1,354,282.485875706215
17653,70,70429,81,"Tasa de exámenes médico legales por presunto delito sexual contra niños, niñas y adolescentes",2014,4,1,4154,24.0731824747232,0,2146,0,1,2008,49.800796812749
17654,70,70508,81,"Tasa de exámenes médico legales por presunto delito sexual contra niños, niñas y adolescentes",2014,4,4,2553,156.678417547983,2,1325,150.943396226415,2,1228,162.866449511401
17655,68,68255,81,"Tasa de exámenes médico legales por presunto delito sexual contra niños, niñas y adolescentes",2014,4,1,1368,73.0994152046784,0,746,0,1,622,160.771704180064
17656,66,66572,81,"Tasa de exámenes médico legales por presunto delito sexual contra niños, niñas y adolescentes",2014,4,5,1755,284.900284900285,2,910,219.78021978022,3,845,355.029585798817
17657,13,13654,81,"Tasa de exámenes médico legales por presunto delito sexual contra niños, niñas y adolescentes",2014,4,5,2561,195.236235845373,0,1326,0,5,1235,404.858299595142
17658,15,15676,81,"Tasa de exámenes médico legales por presunto delito sexual contra niños, niñas y adolescentes",2014,4,1,514,194.552529182879,1,278,359.712230215827,0,236,0
17659,25,25662,81,"Tasa de exámenes médico legales por presunto delito sexual contra niños, niñas y adolescentes",2014,4,3,1113,269.541778975741,1,565,176.991150442478,2,548,364.963503649635
17660,47,47030,81,"Tasa de exámenes médico legales por presunto delito sexual contra niños, niñas y adolescentes",2014,4,2,1681,118.976799524093,0,866,0,2,815,245.398773006135
17661,19,19110,81,"Tasa de exámenes médico legales por presunto delito sexual contra niños, niñas y adolescentes",2014,4,1,4006,24.9625561657514,0,2043,0,1,1963,50.9424350483953
17662,76,76306,81,"Tasa de exámenes médico legales por presunto delito sexual contra niños, niñas y adolescentes",2014,4,4,1790,223.463687150838,1,895,111.731843575419,3,895,335.195530726257
17663,13,13673,81,"Tasa de exámenes médico legales por presunto delito sexual contra niños, niñas y adolescentes",2014,4,4,1582,252.844500632111,0,810,0,4,772,518.134715025907
17664,15,15879,81,"Tasa de exámenes médico legales por presunto delito sexual contra niños, niñas y adolescentes",2014,4,2,390,512.820512820513,0,219,0,2,171,1169.59064327485
17665,15,15204,81,"Tasa de exámenes médico legales por presunto delito sexual contra niños, niñas y adolescentes",2014,4,2,1253,159.616919393456,0,691,0,2,562,355.871886120996
17666,15,15051,81,"Tasa de exámenes médico legales por presunto delito sexual contra niños, niñas y adolescentes",2014,4,1,525,190.47619047619,0,282,0,1,243,411.522633744856
17667,85,85430,81,"Tasa de exámenes médico legales por presunto delito sexual contra niños, niñas y adolescentes",2014,4,3,1935,155.038759689922,0,955,0,3,980,306.122448979592
17668,23,23090,81,"Tasa de exámenes médico legales por presunto delito sexual contra niños, niñas y adolescentes",2014,4,5,2692,185.735512630015,1,1491,67.0690811535882,4,1201,333.055786844296
17669,50,50606,81,"Tasa de exámenes médico legales por presunto delito sexual contra niños, niñas y adolescentes",2014,4,3,1143,262.46719160105,1,571,175.131348511384,2,572,349.65034965035
17670,54,54261,81,"Tasa de exámenes médico legales por presunto delito sexual contra niños, niñas y adolescentes",2014,4,1,2868,34.8675034867503,0,1501,0,1,1367,73.1528895391368
17671,68,68235,81,"Tasa de exámenes médico legales por presunto delito sexual contra niños, niñas y adolescentes",2014,4,7,2225,314.606741573034,1,1162,86.0585197934596,6,1063,564.440263405456
17672,47,47605,81,"Tasa de exámenes médico legales por presunto delito sexual contra niños, niñas y adolescentes",2014,4,2,974,205.338809034908,0,502,0,2,472,423.728813559322
17673,25,25769,81,"Tasa de exámenes médico legales por presunto delito sexual contra niños, niñas y adolescentes",2014,4,3,1627,184.388444990781,1,835,119.760479041916,2,792,252.525252525253
17674,25,25099,81,"Tasa de exámenes médico legales por presunto delito sexual contra niños, niñas y adolescentes",2014,4,5,1356,368.731563421829,1,692,144.508670520231,4,664,602.409638554217
17675,25,25649,81,"Tasa de exámenes médico legales por presunto delito sexual contra niños, niñas y adolescentes",2014,4,4,1150,347.826086956522,0,567,0,4,583,686.106346483705
17676,5,5495,81,"Tasa de exámenes médico legales por presunto delito sexual contra niños, niñas y adolescentes",2014,4,3,3312,90.5797101449275,0,1655,0,3,1657,181.050090525045
17677,88,88001,81,"Tasa de exámenes médico legales por presunto delito sexual contra niños, niñas y adolescentes",2014,4,4,7377,54.2225837061136,2,3757,53.2339632685653,2,3620,55.2486187845304
17678,68,68679,81,"Tasa de exámenes médico legales por presunto delito sexual contra niños, niñas y adolescentes",2014,4,8,4238,188.768286927796,2,2072,96.5250965250965,6,2166,277.008310249307
17679,81,81736,81,"Tasa de exámenes médico legales por presunto delito sexual contra niños, niñas y adolescentes",2014,4,12,6719,178.598005655604,1,3464,28.8683602771363,11,3255,337.941628264209
17680,15,15223,81,"Tasa de exámenes médico legales por presunto delito sexual contra niños, niñas y adolescentes",2014,4,2,928,215.51724137931,0,486,0,2,442,452.488687782805
17681,76,76828,81,"Tasa de exámenes médico legales por presunto delito sexual contra niños, niñas y adolescentes",2014,4,2,1795,111.42061281337,0,938,0,2,857,233.372228704784
17682,52,52520,81,"Tasa de exámenes médico legales por presunto delito sexual contra niños, niñas y adolescentes",2014,4,2,2040,98.0392156862745,0,1132,0,2,908,220.264317180617
17683,25,25793,81,"Tasa de exámenes médico legales por presunto delito sexual contra niños, niñas y adolescentes",2014,4,3,937,320.17075773746,0,507,0,3,430,697.674418604651
17684,68,68377,81,"Tasa de exámenes médico legales por presunto delito sexual contra niños, niñas y adolescentes",2014,4,2,1005,199.004975124378,0,530,0,2,475,421.052631578947
17685,5,5051,81,"Tasa de exámenes médico legales por presunto delito sexual contra niños, niñas y adolescentes",2014,4,5,5491,91.0580950646513,0,2789,0,5,2702,185.048112509252
17686,23,23807,81,"Tasa de exámenes médico legales por presunto delito sexual contra niños, niñas y adolescentes",2014,4,3,12922,23.216220399319,0,6616,0,3,6306,47.5737392959087
17687,25,25530,81,"Tasa de exámenes médico legales por presunto delito sexual contra niños, niñas y adolescentes",2014,4,6,860,697.674418604651,0,436,0,6,424,1415.09433962264
17688,23,23182,81,"Tasa de exámenes médico legales por presunto delito sexual contra niños, niñas y adolescentes",2014,4,9,5008,179.712460063898,0,2527,0,9,2481,362.756952841596
17689,25,25151,81,"Tasa de exámenes médico legales por presunto delito sexual contra niños, niñas y adolescentes",2014,4,4,1746,229.095074455899,0,907,0,4,839,476.758045292014
17690,5,5736,81,"Tasa de exámenes médico legales por presunto delito sexual contra niños, niñas y adolescentes",2014,4,11,4897,224.627322850725,0,2538,0,11,2359,466.299279355659
17691,25,25572,81,"Tasa de exámenes médico legales por presunto delito sexual contra niños, niñas y adolescentes",2014,4,2,2193,91.1992704058368,0,1092,0,2,1101,181.653042688465
17692,76,76250,81,"Tasa de exámenes médico legales por presunto delito sexual contra niños, niñas y adolescentes",2014,4,1,883,113.250283125708,0,447,0,1,436,229.357798165138
17693,5,5125,81,"Tasa de exámenes médico legales por presunto delito sexual contra niños, niñas y adolescentes",2014,4,1,1162,86.0585197934596,0,626,0,1,536,186.567164179104
17694,52,52320,81,"Tasa de exámenes médico legales por presunto delito sexual contra niños, niñas y adolescentes",2014,4,2,1347,148.478099480327,0,701,0,2,646,309.597523219814
17695,25,25745,81,"Tasa de exámenes médico legales por presunto delito sexual contra niños, niñas y adolescentes",2014,4,2,1485,134.680134680135,0,748,0,2,737,271.370420624152
17696,68,68385,81,"Tasa de exámenes médico legales por presunto delito sexual contra niños, niñas y adolescentes",2014,4,4,1819,219.901044529962,0,960,0,4,859,465.657741559953
17697,44,44650,81,"Tasa de exámenes médico legales por presunto delito sexual contra niños, niñas y adolescentes",2014,4,5,3936,127.032520325203,2,2036,98.2318271119843,3,1900,157.894736842105
17698,76,76122,81,"Tasa de exámenes médico legales por presunto delito sexual contra niños, niñas y adolescentes",2014,4,4,2915,137.221269296741,2,1506,132.802124833997,2,1409,141.94464158978
17699,25,25386,81,"Tasa de exámenes médico legales por presunto delito sexual contra niños, niñas y adolescentes",2014,4,4,3170,126.182965299685,0,1635,0,4,1535,260.586319218241
17700,50,50400,81,"Tasa de exámenes médico legales por presunto delito sexual contra niños, niñas y adolescentes",2014,4,1,1138,87.8734622144112,0,624,0,1,514,194.552529182879
17701,41,41483,81,"Tasa de exámenes médico legales por presunto delito sexual contra niños, niñas y adolescentes",2014,4,2,831,240.673886883273,0,434,0,2,397,503.778337531486
17702,13,13006,81,"Tasa de exámenes médico legales por presunto delito sexual contra niños, niñas y adolescentes",2014,4,1,2690,37.1747211895911,0,1379,0,1,1311,76.27765064836
17703,54,54520,81,"Tasa de exámenes médico legales por presunto delito sexual contra niños, niñas y adolescentes",2014,4,3,567,529.100529100529,0,289,0,3,278,1079.13669064748
17704,25,25653,81,"Tasa de exámenes médico legales por presunto delito sexual contra niños, niñas y adolescentes",2014,4,1,562,177.935943060498,0,302,0,1,260,384.615384615385
17705,15,15814,81,"Tasa de exámenes médico legales por presunto delito sexual contra niños, niñas y adolescentes",2014,4,2,1191,167.926112510495,0,627,0,2,564,354.609929078014
17706,85,85010,81,"Tasa de exámenes médico legales por presunto delito sexual contra niños, niñas y adolescentes",2014,4,9,4792,187.813021702838,0,2413,0,9,2379,378.310214375788
17707,52,52786,81,"Tasa de exámenes médico legales por presunto delito sexual contra niños, niñas y adolescentes",2014,4,2,2025,98.7654320987654,0,1038,0,2,987,202.634245187437
17708,70,70678,81,"Tasa de exámenes médico legales por presunto delito sexual contra niños, niñas y adolescentes",2014,4,3,3217,93.2545850170967,0,1664,0,3,1553,193.174500965873
17709,68,68092,81,"Tasa de exámenes médico legales por presunto delito sexual contra niños, niñas y adolescentes",2014,4,2,590,338.983050847458,0,299,0,2,291,687.285223367698
17710,13,13140,81,"Tasa de exámenes médico legales por presunto delito sexual contra niños, niñas y adolescentes",2014,4,4,3007,133.022946458264,0,1566,0,4,1441,277.585010409438
17711,91,91540,81,"Tasa de exámenes médico legales por presunto delito sexual contra niños, niñas y adolescentes",2014,4,1,1200,83.3333333333333,0,616,0,1,584,171.232876712329
17712,76,76233,81,"Tasa de exámenes médico legales por presunto delito sexual contra niños, niñas y adolescentes",2014,4,15,3391,442.347390150398,0,1747,0,15,1644,912.408759124088
17713,25,25339,81,"Tasa de exámenes médico legales por presunto delito sexual contra niños, niñas y adolescentes",2014,4,1,474,210.970464135021,0,231,0,1,243,411.522633744856
17714,15,15507,81,"Tasa de exámenes médico legales por presunto delito sexual contra niños, niñas y adolescentes",2014,4,2,1435,139.372822299652,0,742,0,2,693,288.600288600289
17715,15,15516,81,"Tasa de exámenes médico legales por presunto delito sexual contra niños, niñas y adolescentes",2014,4,3,3508,85.5188141391106,0,1818,0,3,1690,177.514792899408
17716,25,25535,81,"Tasa de exámenes médico legales por presunto delito sexual contra niños, niñas y adolescentes",2014,4,3,1295,231.660231660232,0,646,0,3,649,462.249614791988
17717,13,13780,81,"Tasa de exámenes médico legales por presunto delito sexual contra niños, niñas y adolescentes",2014,4,2,1476,135.50135501355,0,785,0,2,691,289.435600578871
17718,76,76403,81,"Tasa de exámenes médico legales por presunto delito sexual contra niños, niñas y adolescentes",2014,4,1,1232,81.1688311688312,0,657,0,1,575,173.913043478261
17719,5,5042,81,"Tasa de exámenes médico legales por presunto delito sexual contra niños, niñas y adolescentes",2014,4,11,2780,395.68345323741,1,1441,69.3962526023595,10,1339,746.825989544436
17720,5,5761,81,"Tasa de exámenes médico legales por presunto delito sexual contra niños, niñas y adolescentes",2014,4,6,1616,371.287128712871,1,867,115.340253748558,5,749,667.556742323098
17721,13,13062,81,"Tasa de exámenes médico legales por presunto delito sexual contra niños, niñas y adolescentes",2014,4,1,1278,78.2472613458529,0,665,0,1,613,163.132137030995
17722,85,85325,81,"Tasa de exámenes médico legales por presunto delito sexual contra niños, niñas y adolescentes",2014,4,2,907,220.507166482911,0,489,0,2,418,478.468899521531
17723,20,20175,81,"Tasa de exámenes médico legales por presunto delito sexual contra niños, niñas y adolescentes",2014,4,3,4284,70.0280112044818,0,2292,0,3,1992,150.602409638554
17724,23,23466,81,"Tasa de exámenes médico legales por presunto delito sexual contra niños, niñas y adolescentes",2014,4,23,9771,235.390441101218,1,4842,20.6526228831062,22,4929,446.337999594238
17725,50,50590,81,"Tasa de exámenes médico legales por presunto delito sexual contra niños, niñas y adolescentes",2014,4,1,2263,44.1891294741494,0,1292,0,1,971,102.986611740474
17726,63,63302,81,"Tasa de exámenes médico legales por presunto delito sexual contra niños, niñas y adolescentes",2014,4,3,817,367.197062423501,1,417,239.808153477218,2,400,500
17727,99,99524,81,"Tasa de exámenes médico legales por presunto delito sexual contra niños, niñas y adolescentes",2014,4,1,1979,50.5305709954523,0,1007,0,1,972,102.880658436214
17728,5,5893,81,"Tasa de exámenes médico legales por presunto delito sexual contra niños, niñas y adolescentes",2014,4,1,2162,46.2534690101758,0,1115,0,1,1047,95.5109837631328
17729,5,5490,81,"Tasa de exámenes médico legales por presunto delito sexual contra niños, niñas y adolescentes",2014,4,10,8230,121.506682867558,0,4180,0,10,4050,246.913580246914
17730,15,15764,81,"Tasa de exámenes médico legales por presunto delito sexual contra niños, niñas y adolescentes",2014,4,1,651,153.609831029186,1,338,295.85798816568,0,313,0
17731,70,70204,81,"Tasa de exámenes médico legales por presunto delito sexual contra niños, niñas y adolescentes",2014,4,1,697,143.472022955524,0,356,0,1,341,293.255131964809
17732,76,76041,81,"Tasa de exámenes médico legales por presunto delito sexual contra niños, niñas y adolescentes",2014,4,3,2092,143.4034416826,0,1063,0,3,1029,291.545189504373
17733,15,15806,81,"Tasa de exámenes médico legales por presunto delito sexual contra niños, niñas y adolescentes",2014,4,1,1595,62.6959247648903,0,826,0,1,769,130.039011703511
17734,15,15693,81,"Tasa de exámenes médico legales por presunto delito sexual contra niños, niñas y adolescentes",2014,4,3,1520,197.368421052632,0,869,0,3,651,460.829493087558
17735,17,17662,81,"Tasa de exámenes médico legales por presunto delito sexual contra niños, niñas y adolescentes",2014,4,1,2869,34.8553502962705,0,1527,0,1,1342,74.5156482861401
17736,25,25817,81,"Tasa de exámenes médico legales por presunto delito sexual contra niños, niñas y adolescentes",2014,4,1,3891,25.7003341043434,0,1959,0,1,1932,51.75983436853
17737,73,73483,81,"Tasa de exámenes médico legales por presunto delito sexual contra niños, niñas y adolescentes",2014,4,1,2272,44.0140845070423,0,1172,0,1,1100,90.9090909090909
17738,66,66440,81,"Tasa de exámenes médico legales por presunto delito sexual contra niños, niñas y adolescentes",2014,4,3,2436,123.152709359606,0,1245,0,3,1191,251.889168765743
17739,68,68051,81,"Tasa de exámenes médico legales por presunto delito sexual contra niños, niñas y adolescentes",2014,4,1,923,108.342361863489,0,515,0,1,408,245.098039215686
17740,25,25781,81,"Tasa de exámenes médico legales por presunto delito sexual contra niños, niñas y adolescentes",2014,4,3,597,502.51256281407,1,325,307.692307692308,2,272,735.294117647059
17741,68,68368,81,"Tasa de exámenes médico legales por presunto delito sexual contra niños, niñas y adolescentes",2014,4,2,373,536.193029490617,2,197,1015.22842639594,0,176,0
17742,85,85225,81,"Tasa de exámenes médico legales por presunto delito sexual contra niños, niñas y adolescentes",2014,4,2,1136,176.056338028169,0,558,0,2,578,346.020761245675
17743,23,23570,81,"Tasa de exámenes médico legales por presunto delito sexual contra niños, niñas y adolescentes",2014,4,2,4578,43.6871996505024,0,2381,0,2,2197,91.0332271279017
17744,5,5686,81,"Tasa de exámenes médico legales por presunto delito sexual contra niños, niñas y adolescentes",2014,4,6,4103,146.23446258835,0,2166,0,6,1937,309.757356737222
17745,25,25288,81,"Tasa de exámenes médico legales por presunto delito sexual contra niños, niñas y adolescentes",2014,4,3,599,500.834724540902,0,313,0,3,286,1048.95104895105
17746,54,54347,81,"Tasa de exámenes médico legales por presunto delito sexual contra niños, niñas y adolescentes",2014,4,2,443,451.467268623025,2,240,833.333333333333,0,203,0
17747,68,68549,81,"Tasa de exámenes médico legales por presunto delito sexual contra niños, niñas y adolescentes",2014,4,3,540,555.555555555556,0,269,0,3,271,1107.0110701107
17748,13,13248,81,"Tasa de exámenes médico legales por presunto delito sexual contra niños, niñas y adolescentes",2014,4,2,862,232.018561484919,0,449,0,2,413,484.261501210654
17749,70,70708,81,"Tasa de exámenes médico legales por presunto delito sexual contra niños, niñas y adolescentes",2014,4,12,7120,168.539325842697,0,3553,0,12,3567,336.417157275021
17750,20,20250,81,"Tasa de exámenes médico legales por presunto delito sexual contra niños, niñas y adolescentes",2014,4,3,3132,95.7854406130268,0,1587,0,3,1545,194.174757281553
17751,25,25295,81,"Tasa de exámenes médico legales por presunto delito sexual contra niños, niñas y adolescentes",2014,4,6,1793,334.634690462911,1,907,110.253583241455,5,886,564.334085778781
17752,52,52323,81,"Tasa de exámenes médico legales por presunto delito sexual contra niños, niñas y adolescentes",2014,4,1,590,169.491525423729,0,296,0,1,294,340.136054421769
17753,41,41006,81,"Tasa de exámenes médico legales por presunto delito sexual contra niños, niñas y adolescentes",2014,4,5,4420,113.122171945701,0,2247,0,5,2173,230.096640589047
17754,47,47798,81,"Tasa de exámenes médico legales por presunto delito sexual contra niños, niñas y adolescentes",2014,4,1,1568,63.7755102040816,0,802,0,1,766,130.548302872063
17755,27,27077,81,"Tasa de exámenes médico legales por presunto delito sexual contra niños, niñas y adolescentes",2014,4,1,2821,35.4484225451967,0,1488,0,1,1333,75.0187546886722
17756,19,19455,81,"Tasa de exámenes médico legales por presunto delito sexual contra niños, niñas y adolescentes",2014,4,5,5048,99.0491283676704,1,2616,38.2262996941896,4,2432,164.473684210526
17757,50,50350,81,"Tasa de exámenes médico legales por presunto delito sexual contra niños, niñas y adolescentes",2014,4,3,3870,77.5193798449612,0,2007,0,3,1863,161.030595813205
17758,52,52683,81,"Tasa de exámenes médico legales por presunto delito sexual contra niños, niñas y adolescentes",2014,4,2,2707,73.882526782416,1,1430,69.9300699300699,1,1277,78.3085356303837
17759,52,52233,81,"Tasa de exámenes médico legales por presunto delito sexual contra niños, niñas y adolescentes",2014,4,1,1843,54.2593597395551,1,955,104.712041884817,0,888,0
17760,25,25181,81,"Tasa de exámenes médico legales por presunto delito sexual contra niños, niñas y adolescentes",2014,4,3,1118,268.336314847943,0,572,0,3,546,549.450549450549
17761,76,76869,81,"Tasa de exámenes médico legales por presunto delito sexual contra niños, niñas y adolescentes",2014,4,1,918,108.932461873638,0,472,0,1,446,224.215246636771
17762,5,5667,81,"Tasa de exámenes médico legales por presunto delito sexual contra niños, niñas y adolescentes",2014,4,3,1398,214.592274678112,0,729,0,3,669,448.430493273543
17763,19,19780,81,"Tasa de exámenes médico legales por presunto delito sexual contra niños, niñas y adolescentes",2014,4,1,2517,39.7298371076679,0,1322,0,1,1195,83.6820083682008
17764,13,13458,81,"Tasa de exámenes médico legales por presunto delito sexual contra niños, niñas y adolescentes",2014,4,2,2608,76.6871165644172,0,1361,0,2,1247,160.384923817161
17765,68,68684,81,"Tasa de exámenes médico legales por presunto delito sexual contra niños, niñas y adolescentes",2014,4,2,484,413.223140495868,0,243,0,2,241,829.875518672199
17766,76,76845,81,"Tasa de exámenes médico legales por presunto delito sexual contra niños, niñas y adolescentes",2014,4,2,572,349.65034965035,0,306,0,2,266,751.87969924812
17767,76,76823,81,"Tasa de exámenes médico legales por presunto delito sexual contra niños, niñas y adolescentes",2014,4,1,1747,57.2409845449342,0,905,0,1,842,118.764845605701
17768,68,68229,81,"Tasa de exámenes médico legales por presunto delito sexual contra niños, niñas y adolescentes",2014,4,4,1256,318.471337579618,0,632,0,4,624,641.025641025641
17769,25,25873,81,"Tasa de exámenes médico legales por presunto delito sexual contra niños, niñas y adolescentes",2014,4,1,2384,41.9463087248322,0,1261,0,1,1123,89.0471950133571
17770,13,13647,81,"Tasa de exámenes médico legales por presunto delito sexual contra niños, niñas y adolescentes",2014,4,1,1866,53.5905680600214,0,970,0,1,896,111.607142857143
17771,20,20060,81,"Tasa de exámenes médico legales por presunto delito sexual contra niños, niñas y adolescentes",2014,4,1,4914,20.3500203500203,0,2535,0,1,2379,42.0344682639765
17772,44,44078,81,"Tasa de exámenes médico legales por presunto delito sexual contra niños, niñas y adolescentes",2014,4,4,4437,90.1510029299076,0,2258,0,4,2179,183.57044515833
17773,70,70713,81,"Tasa de exámenes médico legales por presunto delito sexual contra niños, niñas y adolescentes",2014,4,5,6659,75.086349301697,1,3468,28.8350634371396,4,3191,125.352554058289
17774,20,20787,81,"Tasa de exámenes médico legales por presunto delito sexual contra niños, niñas y adolescentes",2014,4,1,1746,57.2737686139748,0,925,0,1,821,121.802679658952
17775,66,66383,81,"Tasa de exámenes médico legales por presunto delito sexual contra niños, niñas y adolescentes",2014,4,2,928,215.51724137931,0,484,0,2,444,450.45045045045
17776,13,13670,81,"Tasa de exámenes médico legales por presunto delito sexual contra niños, niñas y adolescentes",2014,4,1,3966,25.2143217347453,0,1922,0,1,2044,48.9236790606654
17777,13,13688,81,"Tasa de exámenes médico legales por presunto delito sexual contra niños, niñas y adolescentes",2014,4,1,6014,16.627868307283,0,3152,0,1,2862,34.9406009783368
17778,68,68327,81,"Tasa de exámenes médico legales por presunto delito sexual contra niños, niñas y adolescentes",2014,4,2,415,481.927710843374,0,212,0,2,203,985.221674876847
17779,25,25019,81,"Tasa de exámenes médico legales por presunto delito sexual contra niños, niñas y adolescentes",2014,4,2,655,305.343511450382,1,325,307.692307692308,1,330,303.030303030303
17780,15,15172,81,"Tasa de exámenes médico legales por presunto delito sexual contra niños, niñas y adolescentes",2014,4,1,387,258.397932816537,0,201,0,1,186,537.634408602151
17781,41,41319,81,"Tasa de exámenes médico legales por presunto delito sexual contra niños, niñas y adolescentes",2014,4,1,2626,38.0807311500381,0,1356,0,1,1270,78.740157480315
17782,25,25815,81,"Tasa de exámenes médico legales por presunto delito sexual contra niños, niñas y adolescentes",2014,4,4,1783,224.340998317443,1,923,108.342361863489,3,860,348.837209302326
17783,52,52560,81,"Tasa de exámenes médico legales por presunto delito sexual contra niños, niñas y adolescentes",2014,4,1,1248,80.1282051282051,0,655,0,1,593,168.634064080944
17784,27,27491,81,"Tasa de exámenes médico legales por presunto delito sexual contra niños, niñas y adolescentes",2014,4,4,1061,377.002827521206,0,548,0,4,513,779.727095516569
17785,76,76036,81,"Tasa de exámenes médico legales por presunto delito sexual contra niños, niñas y adolescentes",2014,4,2,1746,114.54753722795,0,899,0,2,847,236.127508854782
17786,13,13580,81,"Tasa de exámenes médico legales por presunto delito sexual contra niños, niñas y adolescentes",2014,4,1,1390,71.9424460431655,0,716,0,1,674,148.367952522255
17787,66,66687,81,"Tasa de exámenes médico legales por presunto delito sexual contra niños, niñas y adolescentes",2014,4,1,1676,59.6658711217184,0,868,0,1,808,123.762376237624
17788,25,25513,81,"Tasa de exámenes médico legales por presunto delito sexual contra niños, niñas y adolescentes",2014,4,13,3027,429.468120251074,1,1575,63.4920634920635,12,1452,826.446280991736
17789,41,41548,81,"Tasa de exámenes médico legales por presunto delito sexual contra niños, niñas y adolescentes",2014,4,1,1634,61.1995104039168,0,842,0,1,792,126.262626262626
17790,20,20443,81,"Tasa de exámenes médico legales por presunto delito sexual contra niños, niñas y adolescentes",2014,4,1,1884,53.0785562632696,0,974,0,1,910,109.89010989011
17791,52,52258,81,"Tasa de exámenes médico legales por presunto delito sexual contra niños, niñas y adolescentes",2014,4,1,1702,58.7544065804935,0,875,0,1,827,120.918984280532
17792,86,86865,81,"Tasa de exámenes médico legales por presunto delito sexual contra niños, niñas y adolescentes",2014,4,7,7128,98.2042648709316,0,3595,0,7,3533,198.131899235777
17793,5,5679,81,"Tasa de exámenes médico legales por presunto delito sexual contra niños, niñas y adolescentes",2014,4,1,2410,41.49377593361,0,1217,0,1,1193,83.8222967309304
17794,15,15690,81,"Tasa de exámenes médico legales por presunto delito sexual contra niños, niñas y adolescentes",2014,4,1,472,211.864406779661,0,247,0,1,225,444.444444444444
17795,68,68855,81,"Tasa de exámenes médico legales por presunto delito sexual contra niños, niñas y adolescentes",2014,4,1,543,184.162062615101,0,281,0,1,262,381.679389312977
17796,19,19585,81,"Tasa de exámenes médico legales por presunto delito sexual contra niños, niñas y adolescentes",2014,4,1,2031,49.2368291482029,0,1050,0,1,981,101.936799184506
17797,20,20570,81,"Tasa de exámenes médico legales por presunto delito sexual contra niños, niñas y adolescentes",2014,4,4,3363,118.941421349985,0,1787,0,4,1576,253.807106598985
17798,50,50110,81,"Tasa de exámenes médico legales por presunto delito sexual contra niños, niñas y adolescentes",2014,4,2,506,395.256916996047,0,254,0,2,252,793.650793650794
17799,52,52287,81,"Tasa de exámenes médico legales por presunto delito sexual contra niños, niñas y adolescentes",2014,4,1,712,140.449438202247,0,359,0,1,353,283.28611898017
17800,15,15600,81,"Tasa de exámenes médico legales por presunto delito sexual contra niños, niñas y adolescentes",2014,4,1,2036,49.1159135559921,0,1129,0,1,907,110.253583241455
17801,27,27205,81,"Tasa de exámenes médico legales por presunto delito sexual contra niños, niñas y adolescentes",2014,4,3,2091,143.472022955524,0,1005,0,3,1086,276.243093922652
17802,68,68266,81,"Tasa de exámenes médico legales por presunto delito sexual contra niños, niñas y adolescentes",2014,4,1,349,286.532951289398,0,177,0,1,172,581.395348837209
17803,47,47460,81,"Tasa de exámenes médico legales por presunto delito sexual contra niños, niñas y adolescentes",2014,4,3,2412,124.378109452736,0,1287,0,3,1125,266.666666666667
17804,5,5107,81,"Tasa de exámenes médico legales por presunto delito sexual contra niños, niñas y adolescentes",2014,4,5,1041,480.30739673391,0,530,0,5,511,978.473581213307
17805,13,13042,81,"Tasa de exámenes médico legales por presunto delito sexual contra niños, niñas y adolescentes",2014,4,2,2598,76.9822940723633,0,1390,0,2,1208,165.562913907285
17806,68,68820,81,"Tasa de exámenes médico legales por presunto delito sexual contra niños, niñas y adolescentes",2014,4,1,772,129.533678756477,0,407,0,1,365,273.972602739726
17807,54,54385,81,"Tasa de exámenes médico legales por presunto delito sexual contra niños, niñas y adolescentes",2014,4,1,1693,59.0667454223272,0,879,0,1,814,122.850122850123
17808,76,76890,81,"Tasa de exámenes médico legales por presunto delito sexual contra niños, niñas y adolescentes",2014,4,4,1592,251.256281407035,1,842,118.764845605701,3,750,400
17809,73,73275,81,"Tasa de exámenes médico legales por presunto delito sexual contra niños, niñas y adolescentes",2014,4,1,3201,31.2402374258044,0,1660,0,1,1541,64.8929266709929
17810,25,25878,81,"Tasa de exámenes médico legales por presunto delito sexual contra niños, niñas y adolescentes",2014,4,1,1415,70.6713780918728,0,736,0,1,679,147.275405007364
17811,68,68121,81,"Tasa de exámenes médico legales por presunto delito sexual contra niños, niñas y adolescentes",2014,4,1,260,384.615384615385,0,132,0,1,128,781.25
17812,95,95025,81,"Tasa de exámenes médico legales por presunto delito sexual contra niños, niñas y adolescentes",2014,4,1,3288,30.4136253041363,0,1613,0,1,1675,59.7014925373134
17813,25,25407,81,"Tasa de exámenes médico legales por presunto delito sexual contra niños, niñas y adolescentes",2014,4,4,1153,346.921075455334,0,596,0,4,557,718.132854578097
17814,52,52381,81,"Tasa de exámenes médico legales por presunto delito sexual contra niños, niñas y adolescentes",2014,4,1,995,100.502512562814,0,511,0,1,484,206.611570247934
17815,54,54810,81,"Tasa de exámenes médico legales por presunto delito sexual contra niños, niñas y adolescentes",2014,4,2,5015,39.8803589232303,0,2642,0,2,2373,84.2815002107038
17816,8,8549,81,"Tasa de exámenes médico legales por presunto delito sexual contra niños, niñas y adolescentes",2014,4,1,610,163.934426229508,0,301,0,1,309,323.624595469256
17817,5,5847,81,"Tasa de exámenes médico legales por presunto delito sexual contra niños, niñas y adolescentes",2014,4,13,5132,253.312548713952,1,2762,36.2056480811006,12,2370,506.329113924051
17818,73,73055,81,"Tasa de exámenes médico legales por presunto delito sexual contra niños, niñas y adolescentes",2014,4,4,1300,307.692307692308,2,686,291.545189504373,2,614,325.732899022801
17819,52,52352,81,"Tasa de exámenes médico legales por presunto delito sexual contra niños, niñas y adolescentes",2014,4,1,905,110.497237569061,0,464,0,1,441,226.757369614512
17820,23,23586,81,"Tasa de exámenes médico legales por presunto delito sexual contra niños, niñas y adolescentes",2014,4,2,1805,110.803324099723,0,934,0,2,871,229.621125143513
17821,18,18029,81,"Tasa de exámenes médico legales por presunto delito sexual contra niños, niñas y adolescentes",2014,4,1,865,115.606936416185,0,446,0,1,419,238.663484486874
17822,8,8520,81,"Tasa de exámenes médico legales por presunto delito sexual contra niños, niñas y adolescentes",2014,4,2,2856,70.0280112044818,0,1480,0,2,1376,145.348837209302
17823,68,68745,81,"Tasa de exámenes médico legales por presunto delito sexual contra niños, niñas y adolescentes",2014,4,3,910,329.67032967033,0,483,0,3,427,702.576112412178
17824,27,27660,81,"Tasa de exámenes médico legales por presunto delito sexual contra niños, niñas y adolescentes",2014,4,2,618,323.624595469256,0,304,0,2,314,636.942675159236
17825,25,25402,81,"Tasa de exámenes médico legales por presunto delito sexual contra niños, niñas y adolescentes",2014,4,2,1482,134.952766531714,0,742,0,2,740,270.27027027027
17826,25,25524,81,"Tasa de exámenes médico legales por presunto delito sexual contra niños, niñas y adolescentes",2014,4,1,626,159.744408945687,0,339,0,1,287,348.432055749129
17827,41,41349,81,"Tasa de exámenes médico legales por presunto delito sexual contra niños, niñas y adolescentes",2014,4,1,787,127.064803049555,0,407,0,1,380,263.157894736842
17828,17,17050,81,"Tasa de exámenes médico legales por presunto delito sexual contra niños, niñas y adolescentes",2014,4,1,1200,83.3333333333333,0,614,0,1,586,170.648464163823
17829,25,25851,81,"Tasa de exámenes médico legales por presunto delito sexual contra niños, niñas y adolescentes",2014,4,2,510,392.156862745098,0,270,0,2,240,833.333333333333
17830,19,19022,81,"Tasa de exámenes médico legales por presunto delito sexual contra niños, niñas y adolescentes",2014,4,2,2410,82.9875518672199,0,1258,0,2,1152,173.611111111111
17831,19,19760,81,"Tasa de exámenes médico legales por presunto delito sexual contra niños, niñas y adolescentes",2014,4,1,1920,52.0833333333333,0,995,0,1,925,108.108108108108
17832,54,54172,81,"Tasa de exámenes médico legales por presunto delito sexual contra niños, niñas y adolescentes",2014,4,2,1863,107.353730542136,0,953,0,2,910,219.78021978022
17833,63,63548,81,"Tasa de exámenes médico legales por presunto delito sexual contra niños, niñas y adolescentes",2014,4,1,625,160,0,319,0,1,306,326.797385620915
17834,5,5044,81,"Tasa de exámenes médico legales por presunto delito sexual contra niños, niñas y adolescentes",2014,4,3,890,337.078651685393,0,482,0,3,408,735.294117647059
17835,76,76497,81,"Tasa de exámenes médico legales por presunto delito sexual contra niños, niñas y adolescentes",2014,4,1,1627,61.4628149969269,0,841,0,1,786,127.226463104326
17836,5,5480,81,"Tasa de exámenes médico legales por presunto delito sexual contra niños, niñas y adolescentes",2014,4,5,2562,195.160031225605,0,1318,0,5,1244,401.929260450161
17837,25,25260,81,"Tasa de exámenes médico legales por presunto delito sexual contra niños, niñas y adolescentes",2014,4,2,2090,95.6937799043062,0,1045,0,2,1045,191.387559808612
17838,44,44847,81,"Tasa de exámenes médico legales por presunto delito sexual contra niños, niñas y adolescentes",2014,4,4,22940,17.43679163034,0,11540,0,4,11400,35.0877192982456
17839,81,81300,81,"Tasa de exámenes médico legales por presunto delito sexual contra niños, niñas y adolescentes",2014,4,1,3490,28.6532951289398,0,1729,0,1,1761,56.785917092561
17840,25,25518,81,"Tasa de exámenes médico legales por presunto delito sexual contra niños, niñas y adolescentes",2014,4,1,452,221.238938053097,0,222,0,1,230,434.782608695652
17841,8,8849,81,"Tasa de exámenes médico legales por presunto delito sexual contra niños, niñas y adolescentes",2014,4,4,971,411.946446961895,4,502,796.812749003984,0,469,0
17842,99,99001,81,"Tasa de exámenes médico legales por presunto delito sexual contra niños, niñas y adolescentes",2014,4,2,2260,88.4955752212389,0,1182,0,2,1078,185.528756957328
17843,25,25214,81,"Tasa de exámenes médico legales por presunto delito sexual contra niños, niñas y adolescentes",2014,4,1,2548,39.2464678178964,0,1272,0,1,1276,78.3699059561128
17844,47,47720,81,"Tasa de exámenes médico legales por presunto delito sexual contra niños, niñas y adolescentes",2014,4,1,1752,57.0776255707763,0,904,0,1,848,117.924528301887
17845,41,41885,81,"Tasa de exámenes médico legales por presunto delito sexual contra niños, niñas y adolescentes",2014,4,2,958,208.768267223382,0,481,0,2,477,419.287211740042
17846,41,41615,81,"Tasa de exámenes médico legales por presunto delito sexual contra niños, niñas y adolescentes",2014,4,2,1968,101.626016260163,0,986,0,2,982,203.665987780041
17847,73,73555,81,"Tasa de exámenes médico legales por presunto delito sexual contra niños, niñas y adolescentes",2014,4,1,4131,24.2072137496974,0,2186,0,1,1945,51.413881748072
17848,19,19573,81,"Tasa de exámenes médico legales por presunto delito sexual contra niños, niñas y adolescentes",2014,4,4,5392,74.1839762611276,0,2745,0,4,2647,151.114469210427
17849,20,20228,81,"Tasa de exámenes médico legales por presunto delito sexual contra niños, niñas y adolescentes",2014,4,6,3184,188.442211055276,0,1603,0,6,1581,379.506641366224
17850,44,44560,81,"Tasa de exámenes médico legales por presunto delito sexual contra niños, niñas y adolescentes",2014,4,1,13607,7.34915852134931,0,6757,0,1,6850,14.5985401459854
17851,68,68101,81,"Tasa de exámenes médico legales por presunto delito sexual contra niños, niñas y adolescentes",2014,4,1,1418,70.5218617771509,0,711,0,1,707,141.442715700141
17852,54,54820,81,"Tasa de exámenes médico legales por presunto delito sexual contra niños, niñas y adolescentes",2014,4,1,2063,48.4730974309258,0,1051,0,1,1012,98.8142292490118
17853,41,41807,81,"Tasa de exámenes médico legales por presunto delito sexual contra niños, niñas y adolescentes",2014,4,2,2571,77.7907429015947,0,1290,0,2,1281,156.128024980484
17854,76,76400,81,"Tasa de exámenes médico legales por presunto delito sexual contra niños, niñas y adolescentes",2014,4,1,3581,27.9251605696733,0,1811,0,1,1770,56.4971751412429
17855,44,44110,81,"Tasa de exámenes médico legales por presunto delito sexual contra niños, niñas y adolescentes",2014,4,1,859,116.414435389988,0,447,0,1,412,242.718446601942
17856,15,15681,81,"Tasa de exámenes médico legales por presunto delito sexual contra niños, niñas y adolescentes",2014,4,1,1191,83.9630562552477,0,644,0,1,547,182.815356489945
17857,25,25772,81,"Tasa de exámenes médico legales por presunto delito sexual contra niños, niñas y adolescentes",2014,4,2,2255,88.6917960088692,0,1102,0,2,1153,173.460537727667
17858,25,25035,81,"Tasa de exámenes médico legales por presunto delito sexual contra niños, niñas y adolescentes",2014,4,3,1365,219.78021978022,1,701,142.65335235378,2,664,301.204819277108
17859,44,44035,81,"Tasa de exámenes médico legales por presunto delito sexual contra niños, niñas y adolescentes",2014,4,2,3356,59.5947556615018,0,1745,0,2,1611,124.146492861577
17860,73,73449,81,"Tasa de exámenes médico legales por presunto delito sexual contra niños, niñas y adolescentes",2014,4,2,4153,48.1579581025765,0,2173,0,2,1980,101.010101010101
17861,20,20550,81,"Tasa de exámenes médico legales por presunto delito sexual contra niños, niñas y adolescentes",2014,4,2,2316,86.3557858376511,0,1181,0,2,1135,176.211453744493
17862,50,50568,81,"Tasa de exámenes médico legales por presunto delito sexual contra niños, niñas y adolescentes",2014,4,5,2448,204.248366013072,0,1236,0,5,1212,412.541254125412
17863,41,41503,81,"Tasa de exámenes médico legales por presunto delito sexual contra niños, niñas y adolescentes",2014,4,1,1962,50.9683995922528,0,1012,0,1,950,105.263157894737
17864,20,20383,81,"Tasa de exámenes médico legales por presunto delito sexual contra niños, niñas y adolescentes",2014,4,1,1648,60.6796116504854,0,874,0,1,774,129.198966408269
17865,15,15839,81,"Tasa de exámenes médico legales por presunto delito sexual contra niños, niñas y adolescentes",2014,4,1,159,628.930817610063,0,87,0,1,72,1388.88888888889
17866,52,52612,81,"Tasa de exámenes médico legales por presunto delito sexual contra niños, niñas y adolescentes",2014,4,1,2592,38.5802469135802,0,1353,0,1,1239,80.7102502017756
17867,47,47541,81,"Tasa de exámenes médico legales por presunto delito sexual contra niños, niñas y adolescentes",2014,4,2,977,204.708290685773,0,504,0,2,473,422.832980972516
17868,15,15599,81,"Tasa de exámenes médico legales por presunto delito sexual contra niños, niñas y adolescentes",2014,4,4,1254,318.979266347687,0,663,0,4,591,676.818950930626
17869,54,54660,81,"Tasa de exámenes médico legales por presunto delito sexual contra niños, niñas y adolescentes",2014,4,4,1194,335.00837520938,0,623,0,4,571,700.525394045534
17870,25,25658,81,"Tasa de exámenes médico legales por presunto delito sexual contra niños, niñas y adolescentes",2014,4,6,1022,587.084148727984,1,540,185.185185185185,5,482,1037.34439834025
17871,15,15224,81,"Tasa de exámenes médico legales por presunto delito sexual contra niños, niñas y adolescentes",2014,4,1,596,167.785234899329,0,326,0,1,270,370.37037037037
17872,68,68533,81,"Tasa de exámenes médico legales por presunto delito sexual contra niños, niñas y adolescentes",2014,4,1,469,213.219616204691,0,243,0,1,226,442.477876106195
17873,17,17513,81,"Tasa de exámenes médico legales por presunto delito sexual contra niños, niñas y adolescentes",2014,4,1,1658,60.313630880579,0,834,0,1,824,121.359223300971
17874,50,50370,81,"Tasa de exámenes médico legales por presunto delito sexual contra niños, niñas y adolescentes",2014,4,2,1814,110.253583241455,0,943,0,2,871,229.621125143513
17875,8,8141,81,"Tasa de exámenes médico legales por presunto delito sexual contra niños, niñas y adolescentes",2014,4,1,1623,61.6142945163278,0,860,0,1,763,131.061598951507
17876,23,23068,81,"Tasa de exámenes médico legales por presunto delito sexual contra niños, niñas y adolescentes",2014,4,1,6380,15.6739811912226,0,3447,0,1,2933,34.0947834981248
17877,47,47545,81,"Tasa de exámenes médico legales por presunto delito sexual contra niños, niñas y adolescentes",2014,4,1,2478,40.3551251008878,0,1338,0,1,1140,87.719298245614
17878,23,23815,81,"Tasa de exámenes médico legales por presunto delito sexual contra niños, niñas y adolescentes",2014,4,1,5336,18.7406296851574,0,2711,0,1,2625,38.0952380952381
17879,5,5591,81,"Tasa de exámenes médico legales por presunto delito sexual contra niños, niñas y adolescentes",2014,4,1,2353,42.4989375265618,1,1260,79.3650793650794,0,1093,0
17880,44,44420,81,"Tasa de exámenes médico legales por presunto delito sexual contra niños, niñas y adolescentes",2014,4,2,325,615.384615384615,0,176,0,2,149,1342.28187919463
17881,27,27135,81,"Tasa de exámenes médico legales por presunto delito sexual contra niños, niñas y adolescentes",2014,4,1,936,106.837606837607,0,476,0,1,460,217.391304347826
17882,68,68211,81,"Tasa de exámenes médico legales por presunto delito sexual contra niños, niñas y adolescentes",2014,4,2,473,422.832980972516,0,242,0,2,231,865.800865800866
17883,54,54673,81,"Tasa de exámenes médico legales por presunto delito sexual contra niños, niñas y adolescentes",2014,4,1,621,161.030595813205,0,316,0,1,305,327.868852459016
17884,41,41799,81,"Tasa de exámenes médico legales por presunto delito sexual contra niños, niñas y adolescentes",2014,4,2,1833,109.11074740862,0,946,0,2,887,225.479143179256
17885,68,68418,81,"Tasa de exámenes médico legales por presunto delito sexual contra niños, niñas y adolescentes",2014,4,1,1346,74.2942050520059,0,708,0,1,638,156.739811912226
17886,20,20517,81,"Tasa de exámenes médico legales por presunto delito sexual contra niños, niñas y adolescentes",2014,4,1,2079,48.1000481000481,0,1046,0,1,1033,96.8054211035818
17887,17,17777,81,"Tasa de exámenes médico legales por presunto delito sexual contra niños, niñas y adolescentes",2014,4,2,2754,72.6216412490922,0,1395,0,2,1359,147.167034584253
17888,50,50287,81,"Tasa de exámenes médico legales por presunto delito sexual contra niños, niñas y adolescentes",2014,4,1,1590,62.8930817610063,0,816,0,1,774,129.198966408269
17889,13,13549,81,"Tasa de exámenes médico legales por presunto delito sexual contra niños, niñas y adolescentes",2014,4,1,3282,30.4692260816575,0,1733,0,1,1549,64.5577792123951
17890,73,73671,81,"Tasa de exámenes médico legales por presunto delito sexual contra niños, niñas y adolescentes",2014,4,1,1559,64.143681847338,0,802,0,1,757,132.100396301189
17891,52,52427,81,"Tasa de exámenes médico legales por presunto delito sexual contra niños, niñas y adolescentes",2014,4,1,3043,32.8623069339468,0,1656,0,1,1387,72.0980533525595
17892,52,52079,81,"Tasa de exámenes médico legales por presunto delito sexual contra niños, niñas y adolescentes",2014,4,1,5469,18.2848784055586,0,2805,0,1,2664,37.5375375375375
17893,41,41801,81,"Tasa de exámenes médico legales por presunto delito sexual contra niños, niñas y adolescentes",2014,4,2,1036,193.050193050193,0,560,0,2,476,420.168067226891
17894,68,68770,81,"Tasa de exámenes médico legales por presunto delito sexual contra niños, niñas y adolescentes",2014,4,4,1048,381.679389312977,2,549,364.298724954463,2,499,400.801603206413
17895,68,68217,81,"Tasa de exámenes médico legales por presunto delito sexual contra niños, niñas y adolescentes",2014,4,1,864,115.740740740741,0,445,0,1,419,238.663484486874
17896,25,25178,81,"Tasa de exámenes médico legales por presunto delito sexual contra niños, niñas y adolescentes",2014,4,3,910,329.67032967033,0,480,0,3,430,697.674418604651
17897,44,44378,81,"Tasa de exámenes médico legales por presunto delito sexual contra niños, niñas y adolescentes",2014,4,1,3032,32.9815303430079,0,1562,0,1,1470,68.0272108843537
17898,25,25320,81,"Tasa de exámenes médico legales por presunto delito sexual contra niños, niñas y adolescentes",2014,4,4,4071,98.255956767379,0,2036,0,4,2035,196.560196560197
17899,73,73686,81,"Tasa de exámenes médico legales por presunto delito sexual contra niños, niñas y adolescentes",2014,4,1,781,128.040973111396,0,411,0,1,370,270.27027027027
17900,52,52203,81,"Tasa de exámenes médico legales por presunto delito sexual contra niños, niñas y adolescentes",2014,4,1,1197,83.5421888053467,0,644,0,1,553,180.831826401447
17901,54,54743,81,"Tasa de exámenes médico legales por presunto delito sexual contra niños, niñas y adolescentes",2014,4,2,587,340.715502555366,0,307,0,2,280,714.285714285714
17902,15,15232,81,"Tasa de exámenes médico legales por presunto delito sexual contra niños, niñas y adolescentes",2014,4,1,698,143.266475644699,0,381,0,1,317,315.457413249211
17903,41,41206,81,"Tasa de exámenes médico legales por presunto delito sexual contra niños, niñas y adolescentes",2014,4,1,1476,67.7506775067751,0,771,0,1,705,141.843971631206
17904,54,54003,81,"Tasa de exámenes médico legales por presunto delito sexual contra niños, niñas y adolescentes",2014,4,1,4616,21.6637781629116,0,2311,0,1,2305,43.3839479392625
17905,66,66088,81,"Tasa de exámenes médico legales por presunto delito sexual contra niños, niñas y adolescentes",2014,4,1,3081,32.4569944823109,0,1594,0,1,1487,67.2494956287828
17906,25,25001,81,"Tasa de exámenes médico legales por presunto delito sexual contra niños, niñas y adolescentes",2014,4,1,1082,92.4214417744917,0,556,0,1,526,190.114068441065
17907,50,50251,81,"Tasa de exámenes médico legales por presunto delito sexual contra niños, niñas y adolescentes",2014,4,1,699,143.061516452074,0,366,0,1,333,300.3003003003
17908,5,5659,81,"Tasa de exámenes médico legales por presunto delito sexual contra niños, niñas y adolescentes",2014,4,11,3143,349.984091632199,2,1623,123.228589032656,9,1520,592.105263157895
17909,41,41797,81,"Tasa de exámenes médico legales por presunto delito sexual contra niños, niñas y adolescentes",2014,4,1,1075,93.0232558139535,0,561,0,1,514,194.552529182879
17910,68,68498,81,"Tasa de exámenes médico legales por presunto delito sexual contra niños, niñas y adolescentes",2014,4,2,499,400.801603206413,0,262,0,2,237,843.881856540084
17911,47,47551,81,"Tasa de exámenes médico legales por presunto delito sexual contra niños, niñas y adolescentes",2014,4,1,4096,24.4140625,0,2149,0,1,1947,51.3610683102209
17912,15,15837,81,"Tasa de exámenes médico legales por presunto delito sexual contra niños, niñas y adolescentes",2014,4,1,1055,94.7867298578199,0,549,0,1,506,197.628458498024
17913,19,19137,81,"Tasa de exámenes médico legales por presunto delito sexual contra niños, niñas y adolescentes",2014,4,1,4386,22.7998176014592,0,2235,0,1,2151,46.4900046490005
17914,5,5541,81,"Tasa de exámenes médico legales por presunto delito sexual contra niños, niñas y adolescentes",2014,4,7,1864,375.536480686695,3,951,315.457413249211,4,913,438.116100766703
17915,73,73026,81,"Tasa de exámenes médico legales por presunto delito sexual contra niños, niñas y adolescentes",2014,4,1,928,107.758620689655,0,485,0,1,443,225.733634311512
17916,54,54051,81,"Tasa de exámenes médico legales por presunto delito sexual contra niños, niñas y adolescentes",2014,4,1,1134,88.1834215167548,0,608,0,1,526,190.114068441065
17917,52,52435,81,"Tasa de exámenes médico legales por presunto delito sexual contra niños, niñas y adolescentes",2014,4,1,1032,96.8992248062015,0,542,0,1,490,204.081632653061
17918,52,52250,81,"Tasa de exámenes médico legales por presunto delito sexual contra niños, niñas y adolescentes",2014,4,1,5208,19.2012288786482,0,2629,0,1,2579,38.7747188832881
17919,17,17541,81,"Tasa de exámenes médico legales por presunto delito sexual contra niños, niñas y adolescentes",2014,4,2,2720,73.5294117647059,2,1431,139.762403913347,0,1289,0
17920,17,17433,81,"Tasa de exámenes médico legales por presunto delito sexual contra niños, niñas y adolescentes",2014,4,8,2686,297.840655249442,2,1388,144.092219020173,6,1298,462.249614791988
17921,25,25807,81,"Tasa de exámenes médico legales por presunto delito sexual contra niños, niñas y adolescentes",2014,4,1,348,287.35632183908,0,178,0,1,170,588.235294117647
17922,85,85300,81,"Tasa de exámenes médico legales por presunto delito sexual contra niños, niñas y adolescentes",2014,4,2,366,546.448087431694,0,180,0,2,186,1075.2688172043
17923,85,85125,81,"Tasa de exámenes médico legales por presunto delito sexual contra niños, niñas y adolescentes",2014,4,1,1620,61.7283950617284,0,842,0,1,778,128.53470437018
17924,5,5002,81,"Tasa de exámenes médico legales por presunto delito sexual contra niños, niñas y adolescentes",2014,4,10,1928,518.672199170124,3,1004,298.804780876494,7,924,757.575757575758
17925,85,85139,81,"Tasa de exámenes médico legales por presunto delito sexual contra niños, niñas y adolescentes",2014,4,4,1338,298.953662182362,0,712,0,4,626,638.977635782748
17926,41,41378,81,"Tasa de exámenes médico legales por presunto delito sexual contra niños, niñas y adolescentes",2014,4,4,1797,222.593210907067,0,911,0,4,886,451.467268623025
17927,85,85162,81,"Tasa de exámenes médico legales por presunto delito sexual contra niños, niñas y adolescentes",2014,4,5,1794,278.706800445931,0,885,0,5,909,550.05500550055
17928,5,5310,81,"Tasa de exámenes médico legales por presunto delito sexual contra niños, niñas y adolescentes",2014,4,5,1328,376.506024096386,0,688,0,5,640,781.25
17929,25,25885,81,"Tasa de exámenes médico legales por presunto delito sexual contra niños, niñas y adolescentes",2014,4,7,1874,373.532550693703,1,969,103.199174406605,6,905,662.983425414365
17930,5,5021,81,"Tasa de exámenes médico legales por presunto delito sexual contra niños, niñas y adolescentes",2014,4,1,343,291.545189504373,0,179,0,1,164,609.756097560976
17931,5,5209,81,"Tasa de exámenes médico legales por presunto delito sexual contra niños, niñas y adolescentes",2014,4,4,2408,166.112956810631,1,1252,79.8722044728434,3,1156,259.515570934256
17932,5,5664,81,"Tasa de exámenes médico legales por presunto delito sexual contra niños, niñas y adolescentes",2014,4,7,2966,236.008091706001,1,1544,64.7668393782383,6,1422,421.940928270042
17933,25,25148,81,"Tasa de exámenes médico legales por presunto delito sexual contra niños, niñas y adolescentes",2014,4,2,1703,117.439812096301,0,901,0,2,802,249.376558603491
17934,5,5250,81,"Tasa de exámenes médico legales por presunto delito sexual contra niños, niñas y adolescentes",2014,4,23,6205,370.668815471394,4,3211,124.571784490813,19,2994,634.602538410154
17935,5,5895,81,"Tasa de exámenes médico legales por presunto delito sexual contra niños, niñas y adolescentes",2014,4,2,3826,52.2739153162572,0,1980,0,2,1846,108.342361863489
17936,25,25040,81,"Tasa de exámenes médico legales por presunto delito sexual contra niños, niñas y adolescentes",2014,4,4,1146,349.040139616056,0,601,0,4,545,733.94495412844
17937,86,86320,81,"Tasa de exámenes médico legales por presunto delito sexual contra niños, niñas y adolescentes",2014,4,8,7712,103.734439834025,1,3979,25.1319426991706,7,3733,187.516742566301
17938,5,5093,81,"Tasa de exámenes médico legales por presunto delito sexual contra niños, niñas y adolescentes",2014,4,6,1984,302.41935483871,3,999,300.3003003003,3,985,304.568527918782
17939,25,25053,81,"Tasa de exámenes médico legales por presunto delito sexual contra niños, niñas y adolescentes",2014,4,1,1439,69.4927032661571,0,713,0,1,726,137.741046831956
17940,68,68152,81,"Tasa de exámenes médico legales por presunto delito sexual contra niños, niñas y adolescentes",2014,4,1,504,198.412698412698,0,253,0,1,251,398.406374501992
17941,5,5652,81,"Tasa de exámenes médico legales por presunto delito sexual contra niños, niñas y adolescentes",2014,4,1,568,176.056338028169,0,296,0,1,272,367.647058823529
17942,5,5036,81,"Tasa de exámenes médico legales por presunto delito sexual contra niños, niñas y adolescentes",2014,4,2,853,234.466588511137,0,446,0,2,407,491.400491400491
17943,5,5284,81,"Tasa de exámenes médico legales por presunto delito sexual contra niños, niñas y adolescentes",2014,4,8,2124,376.647834274953,1,1115,89.6860986547085,7,1009,693.756194251734
17944,25,25736,81,"Tasa de exámenes médico legales por presunto delito sexual contra niños, niñas y adolescentes",2014,4,1,1547,64.6412411118293,0,775,0,1,772,129.533678756477
17945,20,20770,81,"Tasa de exámenes médico legales por presunto delito sexual contra niños, niñas y adolescentes",2014,4,3,2333,128.589798542649,1,1201,83.2639467110741,2,1132,176.678445229682
17946,25,25758,81,"Tasa de exámenes médico legales por presunto delito sexual contra niños, niñas y adolescentes",2014,4,4,2917,137.127185464518,1,1490,67.1140939597315,3,1427,210.231254379818
17947,5,5101,81,"Tasa de exámenes médico legales por presunto delito sexual contra niños, niñas y adolescentes",2014,4,12,3098,387.346675274371,2,1591,125.707102451289,10,1507,663.5700066357
17948,5,5543,81,"Tasa de exámenes médico legales por presunto delito sexual contra niños, niñas y adolescentes",2014,4,4,1271,314.7128245476,1,687,145.560407569141,3,584,513.698630136986
17949,5,5697,81,"Tasa de exámenes médico legales por presunto delito sexual contra niños, niñas y adolescentes",2014,4,6,2802,214.132762312634,0,1454,0,6,1348,445.103857566766
17950,5,5197,81,"Tasa de exámenes médico legales por presunto delito sexual contra niños, niñas y adolescentes",2014,4,3,1528,196.335078534031,1,771,129.70168612192,2,757,264.200792602378
17951,25,25599,81,"Tasa de exámenes médico legales por presunto delito sexual contra niños, niñas y adolescentes",2014,4,1,763,131.061598951507,0,388,0,1,375,266.666666666667
17952,5,5858,81,"Tasa de exámenes médico legales por presunto delito sexual contra niños, niñas y adolescentes",2014,4,4,1163,343.938091143594,0,598,0,4,565,707.964601769911
17953,5,5030,81,"Tasa de exámenes médico legales por presunto delito sexual contra niños, niñas y adolescentes",2014,4,5,3159,158.277936055714,1,1609,62.1504039776258,4,1550,258.064516129032
17954,5,5040,81,"Tasa de exámenes médico legales por presunto delito sexual contra niños, niñas y adolescentes",2014,4,5,1948,256.673511293634,0,1033,0,5,915,546.448087431694
17955,25,25799,81,"Tasa de exámenes médico legales por presunto delito sexual contra niños, niñas y adolescentes",2014,4,6,2281,263.042525208242,0,1151,0,6,1130,530.973451327434
17956,5,5113,81,"Tasa de exámenes médico legales por presunto delito sexual contra niños, niñas y adolescentes",2014,4,8,783,1021.71136653895,0,424,0,8,359,2228.41225626741
17957,18,18756,81,"Tasa de exámenes médico legales por presunto delito sexual contra niños, niñas y adolescentes",2014,4,2,3073,65.0829808005207,0,1587,0,2,1486,134.589502018843
17958,5,5240,81,"Tasa de exámenes médico legales por presunto delito sexual contra niños, niñas y adolescentes",2014,4,3,1385,216.606498194946,0,713,0,3,672,446.428571428571
17959,5,5425,81,"Tasa de exámenes médico legales por presunto delito sexual contra niños, niñas y adolescentes",2014,4,5,728,686.813186813187,0,377,0,5,351,1424.50142450142
17960,5,5483,81,"Tasa de exámenes médico legales por presunto delito sexual contra niños, niñas y adolescentes",2014,4,2,2042,97.9431929480901,1,1078,92.7643784786642,1,964,103.734439834025
17961,5,5756,81,"Tasa de exámenes médico legales por presunto delito sexual contra niños, niñas y adolescentes",2014,4,9,3923,229.416263063982,0,2008,0,9,1915,469.973890339426
17962,5,5318,81,"Tasa de exámenes médico legales por presunto delito sexual contra niños, niñas y adolescentes",2014,4,7,5149,135.948727908332,0,2664,0,7,2485,281.69014084507
17963,5,5658,81,"Tasa de exámenes médico legales por presunto delito sexual contra niños, niñas y adolescentes",2014,4,4,419,954.653937947494,0,214,0,4,205,1951.21951219512
17964,5,5411,81,"Tasa de exámenes médico legales por presunto delito sexual contra niños, niñas y adolescentes",2014,4,1,1139,87.7963125548727,0,608,0,1,531,188.323917137476
17965,5,5660,81,"Tasa de exámenes médico legales por presunto delito sexual contra niños, niñas y adolescentes",2014,4,3,1201,249.791840133222,0,656,0,3,545,550.45871559633
17966,19,19845,81,"Tasa de exámenes médico legales por presunto delito sexual contra niños, niñas y adolescentes",2014,4,3,1992,150.602409638554,0,1017,0,3,975,307.692307692308
17967,25,25645,81,"Tasa de exámenes médico legales por presunto delito sexual contra niños, niñas y adolescentes",2014,4,3,1335,224.719101123596,0,688,0,3,647,463.678516228748
17968,5,5390,81,"Tasa de exámenes médico legales por presunto delito sexual contra niños, niñas y adolescentes",2014,4,3,715,419.58041958042,0,361,0,3,354,847.457627118644
17969,15,15757,81,"Tasa de exámenes médico legales por presunto delito sexual contra niños, niñas y adolescentes",2014,4,2,750,266.666666666667,1,398,251.256281407035,1,352,284.090909090909
17970,25,25839,81,"Tasa de exámenes médico legales por presunto delito sexual contra niños, niñas y adolescentes",2014,4,1,1299,76.9822940723633,0,729,0,1,570,175.438596491228
17971,19,19142,81,"Tasa de exámenes médico legales por presunto delito sexual contra niños, niñas y adolescentes",2014,4,2,2060,97.0873786407767,0,1060,0,2,1000,200
17972,5,5607,81,"Tasa de exámenes médico legales por presunto delito sexual contra niños, niñas y adolescentes",2014,4,1,1966,50.8646998982706,0,1022,0,1,944,105.932203389831
17973,41,41660,81,"Tasa de exámenes médico legales por presunto delito sexual contra niños, niñas y adolescentes",2014,4,1,1503,66.5335994677312,0,773,0,1,730,136.986301369863
17974,5,5138,81,"Tasa de exámenes médico legales por presunto delito sexual contra niños, niñas y adolescentes",2014,4,3,2101,142.78914802475,2,1060,188.679245283019,1,1041,96.0614793467819
17975,50,50124,81,"Tasa de exámenes médico legales por presunto delito sexual contra niños, niñas y adolescentes",2014,4,2,476,420.168067226891,0,254,0,2,222,900.900900900901
17976,19,19300,81,"Tasa de exámenes médico legales por presunto delito sexual contra niños, niñas y adolescentes",2014,4,1,2509,39.8565165404544,0,1217,0,1,1292,77.3993808049536
17977,66,66594,81,"Tasa de exámenes médico legales por presunto delito sexual contra niños, niñas y adolescentes",2014,4,1,3795,26.3504611330698,0,1925,0,1,1870,53.475935828877
17978,5,5885,81,"Tasa de exámenes médico legales por presunto delito sexual contra niños, niñas y adolescentes",2014,4,3,1011,296.73590504451,0,531,0,3,480,625
17979,25,25168,81,"Tasa de exámenes médico legales por presunto delito sexual contra niños, niñas y adolescentes",2014,4,1,439,227.790432801822,0,229,0,1,210,476.190476190476
17980,5,5091,81,"Tasa de exámenes médico legales por presunto delito sexual contra niños, niñas y adolescentes",2014,4,2,1063,188.146754468485,0,558,0,2,505,396.039603960396
17981,15,15686,81,"Tasa de exámenes médico legales por presunto delito sexual contra niños, niñas y adolescentes",2014,4,2,885,225.988700564972,0,466,0,2,419,477.326968973747
17982,85,85263,81,"Tasa de exámenes médico legales por presunto delito sexual contra niños, niñas y adolescentes",2014,4,6,1022,587.084148727984,1,533,187.617260787993,5,489,1022.49488752556
17983,5,5190,81,"Tasa de exámenes médico legales por presunto delito sexual contra niños, niñas y adolescentes",2014,4,3,931,322.234156820623,0,486,0,3,445,674.157303370787
17984,19,19513,81,"Tasa de exámenes médico legales por presunto delito sexual contra niños, niñas y adolescentes",2014,4,1,922,108.459869848156,0,460,0,1,462,216.450216450216
17985,5,5792,81,"Tasa de exámenes médico legales por presunto delito sexual contra niños, niñas y adolescentes",2014,4,2,885,225.988700564972,0,461,0,2,424,471.698113207547
17986,5,5237,81,"Tasa de exámenes médico legales por presunto delito sexual contra niños, niñas y adolescentes",2014,4,1,2555,39.1389432485323,0,1287,0,1,1268,78.8643533123028
17987,76,76275,81,"Tasa de exámenes médico legales por presunto delito sexual contra niños, niñas y adolescentes",2014,4,1,6107,16.3746520386442,0,3128,0,1,2979,33.5683115139309
17988,85,85410,81,"Tasa de exámenes médico legales por presunto delito sexual contra niños, niñas y adolescentes",2014,4,1,2472,40.453074433657,0,1352,0,1,1120,89.2857142857143
17989,86,86749,81,"Tasa de exámenes médico legales por presunto delito sexual contra niños, niñas y adolescentes",2014,4,1,1740,57.4712643678161,0,891,0,1,849,117.785630153121
17990,68,68162,81,"Tasa de exámenes médico legales por presunto delito sexual contra niños, niñas y adolescentes",2014,4,1,667,149.925037481259,0,342,0,1,325,307.692307692308
17991,25,25777,81,"Tasa de exámenes médico legales por presunto delito sexual contra niños, niñas y adolescentes",2014,4,1,689,145.137880986938,0,337,0,1,352,284.090909090909
17992,5,5809,81,"Tasa de exámenes médico legales por presunto delito sexual contra niños, niñas y adolescentes",2014,4,3,1382,217.076700434153,1,720,138.888888888889,2,662,302.114803625378
17993,5,5347,81,"Tasa de exámenes médico legales por presunto delito sexual contra niños, niñas y adolescentes",2014,4,1,655,152.671755725191,0,351,0,1,304,328.947368421053
17994,15,15790,81,"Tasa de exámenes médico legales por presunto delito sexual contra niños, niñas y adolescentes",2014,4,1,669,149.476831091181,0,340,0,1,329,303.951367781155
17995,25,25281,81,"Tasa de exámenes médico legales por presunto delito sexual contra niños, niñas y adolescentes",2014,4,1,878,113.895216400911,0,460,0,1,418,239.234449760766
17996,25,25394,81,"Tasa de exámenes médico legales por presunto delito sexual contra niños, niñas y adolescentes",2014,4,3,1115,269.058295964126,1,559,178.890876565295,2,556,359.712230215827
17997,68,68296,81,"Tasa de exámenes médico legales por presunto delito sexual contra niños, niñas y adolescentes",2014,4,1,234,427.350427350427,0,126,0,1,108,925.925925925926
17998,5,5031,81,"Tasa de exámenes médico legales por presunto delito sexual contra niños, niñas y adolescentes",2014,4,2,2647,75.5572346052135,0,1353,0,2,1294,154.559505409583
17999,25,25867,81,"Tasa de exámenes médico legales por presunto delito sexual contra niños, niñas y adolescentes",2014,4,1,435,229.885057471264,0,201,0,1,234,427.350427350427
18000,5,5361,81,"Tasa de exámenes médico legales por presunto delito sexual contra niños, niñas y adolescentes",2014,4,1,2837,35.2485019386676,0,1448,0,1,1389,71.9942404607631
18001,25,25258,81,"Tasa de exámenes médico legales por presunto delito sexual contra niños, niñas y adolescentes",2014,4,1,475,210.526315789474,0,244,0,1,231,432.900432900433
18002,25,25898,81,"Tasa de exámenes médico legales por presunto delito sexual contra niños, niñas y adolescentes",2014,4,1,586,170.648464163823,0,294,0,1,292,342.465753424658
18003,5,5313,81,"Tasa de exámenes médico legales por presunto delito sexual contra niños, niñas y adolescentes",2014,4,1,1063,94.0733772342427,0,545,0,1,518,193.050193050193
18004,5,5059,81,"Tasa de exámenes médico legales por presunto delito sexual contra niños, niñas y adolescentes",2014,4,1,476,210.084033613445,1,252,396.825396825397,0,224,0
18005,5,5134,81,"Tasa de exámenes médico legales por presunto delito sexual contra niños, niñas y adolescentes",2014,4,1,1058,94.5179584120983,0,560,0,1,498,200.803212851406
18006,68,68147,81,"Tasa de exámenes médico legales por presunto delito sexual contra niños, niñas y adolescentes",2014,4,2,573,349.040139616056,1,287,348.432055749129,1,286,349.65034965035
18007,5,5306,81,"Tasa de exámenes médico legales por presunto delito sexual contra niños, niñas y adolescentes",2014,4,1,483,207.03933747412,1,251,398.406374501992,0,232,0
18008,68,68502,81,"Tasa de exámenes médico legales por presunto delito sexual contra niños, niñas y adolescentes",2014,4,1,577,173.310225303293,0,294,0,1,283,353.356890459364
18009,73,73675,81,"Tasa de exámenes médico legales por presunto delito sexual contra niños, niñas y adolescentes",2014,4,2,1757,113.830392714855,0,900,0,2,857,233.372228704784
18010,5,5642,81,"Tasa de exámenes médico legales por presunto delito sexual contra niños, niñas y adolescentes",2014,4,1,2004,49.9001996007984,0,1057,0,1,947,105.596620908131
18011,15,15097,81,"Tasa de exámenes médico legales por presunto delito sexual contra niños, niñas y adolescentes",2014,4,1,742,134.770889487871,0,376,0,1,366,273.224043715847
18012,54,54720,81,"Tasa de exámenes médico legales por presunto delito sexual contra niños, niñas y adolescentes",2014,4,1,3008,33.2446808510638,0,1632,0,1,1376,72.6744186046512
18013,20,20001,121,Tasa de exámenes médico legales por presunto delito sexual (18 a 28 años),2014,5,27,90102,29.9660384897117,3,45600,6.57894736842105,24,44502,53.9301604422273
18014,23,23001,121,Tasa de exámenes médico legales por presunto delito sexual (18 a 28 años),2014,5,22,87510,25.1399840018284,0,44208,0,22,43302,50.8059673918064
18015,50,50001,121,Tasa de exámenes médico legales por presunto delito sexual (18 a 28 años),2014,5,27,94296,28.6332400101807,5,45527,10.9824939047159,22,48769,45.1106235518465
18016,54,54001,121,Tasa de exámenes médico legales por presunto delito sexual (18 a 28 años),2014,5,27,127417,21.1902650352779,2,63888,3.13047833708991,25,63529,39.3521069118041
18017,63,63401,121,Tasa de exámenes médico legales por presunto delito sexual (18 a 28 años),2014,5,2,7660,26.1096605744125,0,3787,0,2,3873,51.6395558998193
18018,70,70001,121,Tasa de exámenes médico legales por presunto delito sexual (18 a 28 años),2014,5,17,54299,31.3081272214958,2,27376,7.30566919929865,15,26923,55.714444898414
18019,68,68276,121,Tasa de exámenes médico legales por presunto delito sexual (18 a 28 años),2014,5,14,49025,28.556858745538,2,24588,8.13404912965674,12,24437,49.1058640585997
18020,8,8638,121,Tasa de exámenes médico legales por presunto delito sexual (18 a 28 años),2014,5,2,18029,11.09323867103,0,9215,0,2,8814,22.691173133651
18021,19,19110,121,Tasa de exámenes médico legales por presunto delito sexual (18 a 28 años),2014,5,1,6499,15.3869826127096,0,3369,0,1,3130,31.9488817891374
18022,76,76001,121,Tasa de exámenes médico legales por presunto delito sexual (18 a 28 años),2014,5,79,445425,17.7358702362912,6,224372,2.67413046191147,73,221053,33.0237544842187
18023,11,11001,121,Tasa de exámenes médico legales por presunto delito sexual (18 a 28 años),2014,5,389,1432208,27.1608593165239,34,722145,4.70819572246571,355,710063,49.9955637739186
18024,76,76520,121,Tasa de exámenes médico legales por presunto delito sexual (18 a 28 años),2014,5,17,56857,29.8995726119915,2,29035,6.88823833304632,15,27822,53.9141686435195
18025,5,5001,121,Tasa de exámenes médico legales por presunto delito sexual (18 a 28 años),2014,5,119,436509,27.2617517622775,6,220185,2.7249812657538,113,216324,52.2364601246279
18026,13,13433,121,Tasa de exámenes médico legales por presunto delito sexual (18 a 28 años),2014,5,3,4721,63.5458589281932,2,2491,80.2890405459655,1,2230,44.8430493273543
18027,15,15001,121,Tasa de exámenes médico legales por presunto delito sexual (18 a 28 años),2014,5,18,34082,52.8138020069245,0,17510,0,18,16572,108.616944243302
18028,17,17174,121,Tasa de exámenes médico legales por presunto delito sexual (18 a 28 años),2014,5,2,9703,20.6121817994435,1,4741,21.092596498629,1,4962,20.1531640467553
18029,17,17001,121,Tasa de exámenes médico legales por presunto delito sexual (18 a 28 años),2014,5,25,77628,32.2048745298088,1,40046,2.49712830245218,24,37582,63.8603586823479
18030,19,19001,121,Tasa de exámenes médico legales por presunto delito sexual (18 a 28 años),2014,5,29,52497,55.2412518810599,1,26183,3.81927204674789,28,26314,106.407235692027
18031,27,27495,121,Tasa de exámenes médico legales por presunto delito sexual (18 a 28 años),2014,5,1,1768,56.5610859728507,0,921,0,1,847,118.063754427391
18032,52,52110,121,Tasa de exámenes médico legales por presunto delito sexual (18 a 28 años),2014,5,1,4450,22.4719101123596,0,2300,0,1,2150,46.5116279069767
18033,73,73001,121,Tasa de exámenes médico legales por presunto delito sexual (18 a 28 años),2014,5,24,104645,22.9346839313871,1,53854,1.85687228432428,23,50791,45.2836132385659
18034,5,5088,121,Tasa de exámenes médico legales por presunto delito sexual (18 a 28 años),2014,5,20,91840,21.7770034843206,3,45201,6.63702130483839,17,46639,36.4501811788417
18035,66,66001,121,Tasa de exámenes médico legales por presunto delito sexual (18 a 28 años),2014,5,33,85180,38.7414886123503,7,43080,16.2488393686165,26,42100,61.7577197149644
18036,76,76147,121,Tasa de exámenes médico legales por presunto delito sexual (18 a 28 años),2014,5,4,23738,16.8506192602578,0,12055,0,4,11683,34.2377813917658
18037,5,5045,121,Tasa de exámenes médico legales por presunto delito sexual (18 a 28 años),2014,5,25,38253,65.3543512927091,0,19166,0,25,19087,130.97920050296
18038,15,15087,121,Tasa de exámenes médico legales por presunto delito sexual (18 a 28 años),2014,5,1,1271,78.6782061369001,0,666,0,1,605,165.289256198347
18039,73,73268,121,Tasa de exámenes médico legales por presunto delito sexual (18 a 28 años),2014,5,4,14114,28.3406546691229,0,7594,0,4,6520,61.3496932515337
18040,41,41013,121,Tasa de exámenes médico legales por presunto delito sexual (18 a 28 años),2014,5,1,1744,57.3394495412844,0,897,0,1,847,118.063754427391
18041,25,25307,121,Tasa de exámenes médico legales por presunto delito sexual (18 a 28 años),2014,5,8,19655,40.70211142203,1,9539,10.4832791697243,7,10116,69.1973111901937
18042,52,52356,121,Tasa de exámenes médico legales por presunto delito sexual (18 a 28 años),2014,5,5,24453,20.4473888684415,0,12494,0,5,11959,41.8095158458065
18043,23,23417,121,Tasa de exámenes médico legales por presunto delito sexual (18 a 28 años),2014,5,5,23275,21.4822771213749,0,12013,0,5,11262,44.3970875510567
18044,41,41551,121,Tasa de exámenes médico legales por presunto delito sexual (18 a 28 años),2014,5,6,24914,24.0828449867544,0,12433,0,6,12481,48.0730710680234
18045,5,5266,121,Tasa de exámenes médico legales por presunto delito sexual (18 a 28 años),2014,5,7,40834,17.1425772640447,1,20765,4.81579581025764,6,20069,29.8968558473267
18046,25,25817,121,Tasa de exámenes médico legales por presunto delito sexual (18 a 28 años),2014,5,1,6201,16.1264312207708,0,3070,0,1,3131,31.9386777387416
18047,13,13052,121,Tasa de exámenes médico legales por presunto delito sexual (18 a 28 años),2014,5,2,13832,14.4592249855408,2,7247,27.597626604112,0,6585,0
18048,13,13001,121,Tasa de exámenes médico legales por presunto delito sexual (18 a 28 años),2014,5,48,190465,25.2014805869845,3,95643,3.13666447100154,45,94822,47.457341123368
18049,52,52001,121,Tasa de exámenes médico legales por presunto delito sexual (18 a 28 años),2014,5,26,83202,31.2492488161342,2,42194,4.74001042802294,24,41008,58.5251658213032
18050,63,63001,121,Tasa de exámenes médico legales por presunto delito sexual (18 a 28 años),2014,5,16,53705,29.7923843217577,3,27037,11.0959056108296,13,26668,48.7475626218689
18051,68,68615,121,Tasa de exámenes médico legales por presunto delito sexual (18 a 28 años),2014,5,1,5237,19.0949016612564,1,2756,36.2844702467344,0,2481,0
18052,68,68547,121,Tasa de exámenes médico legales por presunto delito sexual (18 a 28 años),2014,5,5,28111,17.7866315677137,2,13979,14.3071750482867,3,14132,21.2284177752618
18053,13,13673,121,Tasa de exámenes médico legales por presunto delito sexual (18 a 28 años),2014,5,1,2469,40.5022276225192,0,1254,0,1,1215,82.3045267489712
18054,76,76364,121,Tasa de exámenes médico legales por presunto delito sexual (18 a 28 años),2014,5,9,22718,39.616163394665,3,11464,26.168876482903,6,11254,53.3143771103608
18055,76,76109,121,Tasa de exámenes médico legales por presunto delito sexual (18 a 28 años),2014,5,10,81551,12.2622653308972,0,40583,0,10,40968,24.4092950595587
18056,50,50006,121,Tasa de exámenes médico legales por presunto delito sexual (18 a 28 años),2014,5,7,12917,54.1921498800031,1,6314,15.8378207158695,6,6603,90.8677873693776
18057,20,20710,121,Tasa de exámenes médico legales por presunto delito sexual (18 a 28 años),2014,5,6,5112,117.370892018779,0,2543,0,6,2569,233.553912028026
18058,25,25290,121,Tasa de exámenes médico legales por presunto delito sexual (18 a 28 años),2014,5,13,25552,50.8766437069505,3,13012,23.0556409468183,10,12540,79.7448165869219
18059,27,27361,121,Tasa de exámenes médico legales por presunto delito sexual (18 a 28 años),2014,5,2,6243,32.0358801858081,0,2982,0,2,3261,61.3308800981294
18060,76,76130,121,Tasa de exámenes médico legales por presunto delito sexual (18 a 28 años),2014,5,3,15421,19.4539913105505,0,7666,0,3,7755,38.6847195357834
18061,76,76622,121,Tasa de exámenes médico legales por presunto delito sexual (18 a 28 años),2014,5,1,5877,17.0154840905224,1,2948,33.921302578019,0,2929,0
18062,68,68679,121,Tasa de exámenes médico legales por presunto delito sexual (18 a 28 años),2014,5,6,8056,74.4786494538232,1,4033,24.7954376394743,5,4023,124.285359184688
18063,18,18001,121,Tasa de exámenes médico legales por presunto delito sexual (18 a 28 años),2014,5,8,34552,23.1535077564251,3,17707,16.9424521375727,5,16845,29.6823983377857
18064,44,44001,121,Tasa de exámenes médico legales por presunto delito sexual (18 a 28 años),2014,5,16,48066,33.2875629342987,0,23654,0,16,24412,65.5415369490415
18065,52,52480,121,Tasa de exámenes médico legales por presunto delito sexual (18 a 28 años),2014,5,2,939,212.992545260916,0,483,0,2,456,438.59649122807
18066,5,5079,121,Tasa de exámenes médico legales por presunto delito sexual (18 a 28 años),2014,5,2,10089,19.8235702249975,0,5138,0,2,4951,40.3958796202787
18067,8,8001,121,Tasa de exámenes médico legales por presunto delito sexual (18 a 28 años),2014,5,53,226765,23.3722135250149,7,115127,6.08024181990324,46,111638,41.2046077500493
18068,68,68081,121,Tasa de exámenes médico legales por presunto delito sexual (18 a 28 años),2014,5,15,36949,40.5964978754499,1,19244,5.19642485969653,14,17705,79.0737079920926
18069,66,66088,121,Tasa de exámenes médico legales por presunto delito sexual (18 a 28 años),2014,5,1,5055,19.782393669634,0,2654,0,1,2401,41.649312786339
18070,73,73483,121,Tasa de exámenes médico legales por presunto delito sexual (18 a 28 años),2014,5,2,3801,52.6177321757432,0,1926,0,2,1875,106.666666666667
18071,52,52317,121,Tasa de exámenes médico legales por presunto delito sexual (18 a 28 años),2014,5,2,2980,67.1140939597315,0,1569,0,2,1411,141.743444365698
18072,76,76306,121,Tasa de exámenes médico legales por presunto delito sexual (18 a 28 años),2014,5,1,3793,26.3643553915107,0,1937,0,1,1856,53.8793103448276
18073,5,5615,121,Tasa de exámenes médico legales por presunto delito sexual (18 a 28 años),2014,5,6,23701,25.3153875363909,1,12071,8.28431778643029,5,11630,42.9922613929493
18074,5,5837,121,Tasa de exámenes médico legales por presunto delito sexual (18 a 28 años),2014,5,12,34411,34.8725698177908,0,17396,0,12,17015,70.5260064648839
18075,27,27001,121,Tasa de exámenes médico legales por presunto delito sexual (18 a 28 años),2014,5,13,26313,49.4052369551172,0,13654,0,13,12659,102.693735682123
18076,86,86001,121,Tasa de exámenes médico legales por presunto delito sexual (18 a 28 años),2014,5,7,8382,83.5122882366977,0,4047,0,7,4335,161.476355247982
18077,68,68001,121,Tasa de exámenes médico legales por presunto delito sexual (18 a 28 años),2014,5,22,100130,21.9714371317288,1,50924,1.96371062760192,21,49206,42.6777222289965
18078,8,8558,121,Tasa de exámenes médico legales por presunto delito sexual (18 a 28 años),2014,5,2,2843,70.3482237073514,0,1466,0,2,1377,145.243282498184
18079,41,41001,121,Tasa de exámenes médico legales por presunto delito sexual (18 a 28 años),2014,5,24,67869,35.3622419661407,6,33341,17.995860951981,18,34528,52.1316033364226
18080,66,66572,121,Tasa de exámenes médico legales por presunto delito sexual (18 a 28 años),2014,5,1,2513,39.7930760047752,0,1337,0,1,1176,85.0340136054422
18081,5,5172,121,Tasa de exámenes médico legales por presunto delito sexual (18 a 28 años),2014,5,4,16049,24.9236712567761,0,7834,0,4,8215,48.6914181375533
18082,25,25151,121,Tasa de exámenes médico legales por presunto delito sexual (18 a 28 años),2014,5,3,3360,89.2857142857143,0,1752,0,3,1608,186.567164179104
18083,41,41396,121,Tasa de exámenes médico legales por presunto delito sexual (18 a 28 años),2014,5,6,12347,48.5948003563619,0,6367,0,6,5980,100.334448160535
18084,25,25754,121,Tasa de exámenes médico legales por presunto delito sexual (18 a 28 años),2014,5,22,102008,21.566935926594,3,50884,5.89576291172078,19,51124,37.1645411157186
18085,25,25612,121,Tasa de exámenes médico legales por presunto delito sexual (18 a 28 años),2014,5,2,1758,113.765642775882,0,828,0,2,930,215.05376344086
18086,73,73283,121,Tasa de exámenes médico legales por presunto delito sexual (18 a 28 años),2014,5,1,5667,17.6460208223046,0,2957,0,1,2710,36.90036900369
18087,54,54498,121,Tasa de exámenes médico legales por presunto delito sexual (18 a 28 años),2014,5,4,15867,25.2095544211256,0,8136,0,4,7731,51.739749062217
18088,15,15759,121,Tasa de exámenes médico legales por presunto delito sexual (18 a 28 años),2014,5,3,19013,15.7786777468048,0,9863,0,3,9150,32.7868852459016
18089,47,47001,121,Tasa de exámenes médico legales por presunto delito sexual (18 a 28 años),2014,5,11,89136,12.3406928738108,0,44879,0,11,44257,24.8548252253881
18090,8,8758,121,Tasa de exámenes médico legales por presunto delito sexual (18 a 28 años),2014,5,15,117400,12.7768313458262,1,59766,1.67319211591875,14,57634,24.2912169899712
18091,13,13683,121,Tasa de exámenes médico legales por presunto delito sexual (18 a 28 años),2014,5,2,4244,47.1253534401508,0,2247,0,2,1997,100.150225338007
18092,17,17042,121,Tasa de exámenes médico legales por presunto delito sexual (18 a 28 años),2014,5,4,5562,71.9165767709457,0,2801,0,4,2761,144.875045273452
18093,13,13212,121,Tasa de exámenes médico legales por presunto delito sexual (18 a 28 años),2014,5,2,2605,76.7754318618042,0,1334,0,2,1271,157.3564122738
18094,73,73168,121,Tasa de exámenes médico legales por presunto delito sexual (18 a 28 años),2014,5,8,9153,87.4030372555446,1,4551,21.9731927049,7,4602,152.107779226423
18095,5,5376,121,Tasa de exámenes médico legales por presunto delito sexual (18 a 28 años),2014,5,2,10917,18.3200512961436,0,5522,0,2,5395,37.0713623725672
18096,47,47245,121,Tasa de exámenes médico legales por presunto delito sexual (18 a 28 años),2014,5,5,10973,45.5663902305659,0,5709,0,5,5264,94.9848024316109
18097,19,19532,121,Tasa de exámenes médico legales por presunto delito sexual (18 a 28 años),2014,5,1,7453,13.4174158057158,0,3926,0,1,3527,28.3527076835838
18098,13,13430,121,Tasa de exámenes médico legales por presunto delito sexual (18 a 28 años),2014,5,9,24244,37.1225870318429,1,12365,8.08734330772341,8,11879,67.3457361730785
18099,5,5212,121,Tasa de exámenes médico legales por presunto delito sexual (18 a 28 años),2014,5,5,12923,38.6907064923005,0,6486,0,5,6437,77.6759359950287
18100,76,76892,121,Tasa de exámenes médico legales por presunto delito sexual (18 a 28 años),2014,5,7,22128,31.6341287057122,0,11429,0,7,10699,65.4266753902234
18101,13,13042,121,Tasa de exámenes médico legales por presunto delito sexual (18 a 28 años),2014,5,1,3656,27.3522975929978,0,1956,0,1,1700,58.8235294117647
18102,66,66400,121,Tasa de exámenes médico legales por presunto delito sexual (18 a 28 años),2014,5,2,5937,33.6870473303015,0,2852,0,2,3085,64.8298217179903
18103,91,91001,121,Tasa de exámenes médico legales por presunto delito sexual (18 a 28 años),2014,5,5,9798,51.0308226168606,1,4826,20.7210940737671,4,4972,80.450522928399
18104,25,25269,121,Tasa de exámenes médico legales por presunto delito sexual (18 a 28 años),2014,5,9,25747,34.9555287994718,3,13113,22.878059940517,6,12634,47.4908975779642
18105,86,86568,121,Tasa de exámenes médico legales por presunto delito sexual (18 a 28 años),2014,5,2,12456,16.0565189466924,0,6273,0,2,6183,32.3467572375869
18106,85,85001,121,Tasa de exámenes médico legales por presunto delito sexual (18 a 28 años),2014,5,13,27952,46.508299942759,1,13773,7.26058229870036,12,14179,84.6322025530714
18107,52,52079,121,Tasa de exámenes médico legales por presunto delito sexual (18 a 28 años),2014,5,1,7579,13.1943528169943,0,3846,0,1,3733,26.7881060809001
18108,66,66170,121,Tasa de exámenes médico legales por presunto delito sexual (18 a 28 años),2014,5,7,37715,18.5602545406337,1,19090,5.23834468308015,6,18625,32.2147651006711
18109,5,5576,121,Tasa de exámenes médico legales por presunto delito sexual (18 a 28 años),2014,5,1,1428,70.0280112044818,0,721,0,1,707,141.442715700141
18110,25,25718,121,Tasa de exámenes médico legales por presunto delito sexual (18 a 28 años),2014,5,1,1861,53.7345513164965,0,982,0,1,879,113.765642775882
18111,76,76834,121,Tasa de exámenes médico legales por presunto delito sexual (18 a 28 años),2014,5,7,39956,17.5192711983181,0,20256,0,7,19700,35.5329949238579
18112,52,52838,121,Tasa de exámenes médico legales por presunto delito sexual (18 a 28 años),2014,5,2,7715,25.9235255994815,0,4003,0,2,3712,53.8793103448276
18113,73,73449,121,Tasa de exámenes médico legales por presunto delito sexual (18 a 28 años),2014,5,1,6630,15.0829562594268,0,3564,0,1,3066,32.6157860404436
18114,63,63470,121,Tasa de exámenes médico legales por presunto delito sexual (18 a 28 años),2014,5,1,7894,12.6678489992399,1,4172,23.9693192713327,0,3722,0
18115,68,68385,121,Tasa de exámenes médico legales por presunto delito sexual (18 a 28 años),2014,5,1,2877,34.7584289190129,0,1571,0,1,1306,76.5696784073507
18116,5,5360,121,Tasa de exámenes médico legales por presunto delito sexual (18 a 28 años),2014,5,8,51837,15.432991878388,2,25964,7.70297334771222,6,25873,23.1901982761953
18117,44,44279,121,Tasa de exámenes médico legales por presunto delito sexual (18 a 28 años),2014,5,2,7124,28.0741156653565,0,3559,0,2,3565,56.1009817671809
18118,63,63130,121,Tasa de exámenes médico legales por presunto delito sexual (18 a 28 años),2014,5,2,14135,14.149274849664,0,7240,0,2,6895,29.0065264684554
18119,17,17088,121,Tasa de exámenes médico legales por presunto delito sexual (18 a 28 años),2014,5,1,2064,48.4496124031008,0,1069,0,1,995,100.502512562814
18120,23,23300,121,Tasa de exámenes médico legales por presunto delito sexual (18 a 28 años),2014,5,1,2854,35.0385423966363,0,1457,0,1,1397,71.5819613457409
18121,13,13468,121,Tasa de exámenes médico legales por presunto delito sexual (18 a 28 años),2014,5,1,9202,10.8672027820039,0,4723,0,1,4479,22.3264121455682
18122,81,81736,121,Tasa de exámenes médico legales por presunto delito sexual (18 a 28 años),2014,5,1,9601,10.4155817102385,0,5150,0,1,4451,22.4668613794653
18123,52,52240,121,Tasa de exámenes médico legales por presunto delito sexual (18 a 28 años),2014,5,1,2650,37.7358490566038,0,1369,0,1,1281,78.064012490242
18124,8,8573,121,Tasa de exámenes médico legales por presunto delito sexual (18 a 28 años),2014,5,2,5127,39.0091671542813,0,2705,0,2,2422,82.5763831544178
18125,17,17524,121,Tasa de exámenes médico legales por presunto delito sexual (18 a 28 años),2014,5,3,3462,86.6551126516464,0,1794,0,3,1668,179.856115107914
18126,5,5154,121,Tasa de exámenes médico legales por presunto delito sexual (18 a 28 años),2014,5,1,23312,4.28963623884695,0,11103,0,1,12209,8.1906790072897
18127,68,68406,121,Tasa de exámenes médico legales por presunto delito sexual (18 a 28 años),2014,5,3,7056,42.5170068027211,0,3638,0,3,3418,87.7706260971328
18128,68,68307,121,Tasa de exámenes médico legales por presunto delito sexual (18 a 28 años),2014,5,8,33662,23.7656704889787,3,17158,17.4845553094766,5,16504,30.2956858943286
18129,5,5480,121,Tasa de exámenes médico legales por presunto delito sexual (18 a 28 años),2014,5,1,4476,22.3413762287757,0,2289,0,1,2187,45.7247370827618
18130,5,5129,121,Tasa de exámenes médico legales por presunto delito sexual (18 a 28 años),2014,5,2,14679,13.624906328769,0,7419,0,2,7260,27.5482093663912
18131,17,17380,121,Tasa de exámenes médico legales por presunto delito sexual (18 a 28 años),2014,5,2,15015,13.3200133200133,0,7663,0,2,7352,27.2034820457019
18132,54,54206,121,Tasa de exámenes médico legales por presunto delito sexual (18 a 28 años),2014,5,1,2537,39.4166338194718,0,1357,0,1,1180,84.7457627118644
18133,76,76111,121,Tasa de exámenes médico legales por presunto delito sexual (18 a 28 años),2014,5,5,21003,23.8061229348188,1,11094,9.01388137732108,4,9909,40.3673428196589
18134,15,15861,121,Tasa de exámenes médico legales por presunto delito sexual (18 a 28 años),2014,5,1,2497,40.048057669203,0,1267,0,1,1230,81.3008130081301
18135,70,70670,121,Tasa de exámenes médico legales por presunto delito sexual (18 a 28 años),2014,5,4,7852,50.9424350483953,0,4084,0,4,3768,106.157112526539
18136,66,66440,121,Tasa de exámenes médico legales por presunto delito sexual (18 a 28 años),2014,5,1,4276,23.3863423760524,0,2198,0,1,2078,48.1231953801732
18137,50,50313,121,Tasa de exámenes médico legales por presunto delito sexual (18 a 28 años),2014,5,4,13811,28.9624212584172,2,8506,23.5128144838937,2,5305,37.7002827521206
18138,25,25430,121,Tasa de exámenes médico legales por presunto delito sexual (18 a 28 años),2014,5,5,15453,32.35617679415,0,7848,0,5,7605,65.7462195923734
18139,41,41359,121,Tasa de exámenes médico legales por presunto delito sexual (18 a 28 años),2014,5,1,5432,18.4094256259205,0,2803,0,1,2629,38.0372765310004
18140,86,86569,121,Tasa de exámenes médico legales por presunto delito sexual (18 a 28 años),2014,5,1,3142,31.8268618714195,0,1561,0,1,1581,63.2511068943707
18141,47,47053,121,Tasa de exámenes médico legales por presunto delito sexual (18 a 28 años),2014,5,2,7141,28.0072818932923,0,3669,0,2,3472,57.6036866359447
18142,52,52215,121,Tasa de exámenes médico legales por presunto delito sexual (18 a 28 años),2014,5,1,2656,37.6506024096386,0,1371,0,1,1285,77.8210116731518
18143,68,68755,121,Tasa de exámenes médico legales por presunto delito sexual (18 a 28 años),2014,5,1,6688,14.9521531100478,0,3997,0,1,2691,37.1609067261241
18144,19,19142,121,Tasa de exámenes médico legales por presunto delito sexual (18 a 28 años),2014,5,2,3551,56.3221627710504,0,1765,0,2,1786,111.982082866741
18145,70,70820,121,Tasa de exámenes médico legales por presunto delito sexual (18 a 28 años),2014,5,2,6343,31.5308213778969,0,3166,0,2,3177,62.9524708844822
18146,52,52320,121,Tasa de exámenes médico legales por presunto delito sexual (18 a 28 años),2014,5,1,2308,43.3275563258232,0,1209,0,1,1099,90.9918107370337
18147,5,5686,121,Tasa de exámenes médico legales por presunto delito sexual (18 a 28 años),2014,5,4,7518,53.2056397978186,0,3951,0,4,3567,112.139052425007
18148,8,8078,121,Tasa de exámenes médico legales por presunto delito sexual (18 a 28 años),2014,5,1,10675,9.36768149882904,0,5525,0,1,5150,19.4174757281553
18149,41,41668,121,Tasa de exámenes médico legales por presunto delito sexual (18 a 28 años),2014,5,2,6822,29.3169158604515,0,3583,0,2,3239,61.7474529175672
18150,19,19845,121,Tasa de exámenes médico legales por presunto delito sexual (18 a 28 años),2014,5,1,3137,31.8775900541919,0,1592,0,1,1545,64.7249190938511
18151,76,76041,121,Tasa de exámenes médico legales por presunto delito sexual (18 a 28 años),2014,5,1,3762,26.581605528974,0,1961,0,1,1801,55.5247084952804
18152,47,47189,121,Tasa de exámenes médico legales por presunto delito sexual (18 a 28 años),2014,5,2,18804,10.6360348861944,0,9545,0,2,9259,21.6006048169349
18153,88,88001,121,Tasa de exámenes médico legales por presunto delito sexual (18 a 28 años),2014,5,3,13278,22.5937641211026,0,6801,0,3,6477,46.3177396943029
18154,17,17486,121,Tasa de exámenes médico legales por presunto delito sexual (18 a 28 años),2014,5,1,5321,18.7934598759632,0,2801,0,1,2520,39.6825396825397
18155,8,8296,121,Tasa de exámenes médico legales por presunto delito sexual (18 a 28 años),2014,5,2,7978,25.0689395838556,0,4114,0,2,3864,51.75983436853
18156,41,41530,121,Tasa de exámenes médico legales por presunto delito sexual (18 a 28 años),2014,5,2,2368,84.4594594594595,0,1214,0,2,1154,173.310225303293
18157,86,86885,121,Tasa de exámenes médico legales por presunto delito sexual (18 a 28 años),2014,5,1,4558,21.9394471259324,1,2265,44.1501103752759,0,2293,0
18158,25,25473,121,Tasa de exámenes médico legales por presunto delito sexual (18 a 28 años),2014,5,3,16450,18.2370820668693,0,8185,0,3,8265,36.2976406533575
18159,25,25086,121,Tasa de exámenes médico legales por presunto delito sexual (18 a 28 años),2014,5,1,444,225.225225225225,0,218,0,1,226,442.477876106195
18160,20,20310,121,Tasa de exámenes médico legales por presunto delito sexual (18 a 28 años),2014,5,1,1414,70.7213578500707,0,757,0,1,657,152.20700152207
18161,76,76563,121,Tasa de exámenes médico legales por presunto delito sexual (18 a 28 años),2014,5,2,10363,19.2994306667953,0,5135,0,2,5228,38.2555470543229
18162,52,52835,121,Tasa de exámenes médico legales por presunto delito sexual (18 a 28 años),2014,5,3,38970,7.69822940723634,0,19769,0,3,19201,15.6241862403
18163,52,52540,121,Tasa de exámenes médico legales por presunto delito sexual (18 a 28 años),2014,5,1,3368,29.6912114014252,0,1806,0,1,1562,64.0204865556978
18164,63,63190,121,Tasa de exámenes médico legales por presunto delito sexual (18 a 28 años),2014,5,3,5328,56.3063063063063,0,2698,0,3,2630,114.068441064639
18165,70,70508,121,Tasa de exámenes médico legales por presunto delito sexual (18 a 28 años),2014,5,2,4370,45.766590389016,0,2241,0,2,2129,93.9408172851104
18166,5,5315,121,Tasa de exámenes médico legales por presunto delito sexual (18 a 28 años),2014,5,1,1176,85.0340136054422,0,630,0,1,546,183.150183150183
18167,20,20011,121,Tasa de exámenes médico legales por presunto delito sexual (18 a 28 años),2014,5,1,18806,5.31745187706051,0,9374,0,1,9432,10.6022052586938
18168,25,25019,121,Tasa de exámenes médico legales por presunto delito sexual (18 a 28 años),2014,5,1,1146,87.260034904014,0,575,0,1,571,175.131348511384
18169,70,70215,121,Tasa de exámenes médico legales por presunto delito sexual (18 a 28 años),2014,5,3,13480,22.2551928783383,0,7494,0,3,5986,50.1169395255596
18170,68,68079,121,Tasa de exámenes médico legales por presunto delito sexual (18 a 28 años),2014,5,2,1388,144.092219020173,0,679,0,2,709,282.087447108604
18171,8,8433,121,Tasa de exámenes médico legales por presunto delito sexual (18 a 28 años),2014,5,4,23795,16.8102542550956,0,12541,0,4,11254,35.5429180735738
18172,8,8137,121,Tasa de exámenes médico legales por presunto delito sexual (18 a 28 años),2014,5,1,3444,29.0360046457607,0,1778,0,1,1666,60.0240096038415
18173,5,5361,121,Tasa de exámenes médico legales por presunto delito sexual (18 a 28 años),2014,5,1,3982,25.1130085384229,0,2055,0,1,1927,51.8941359626362
18174,20,20013,121,Tasa de exámenes médico legales por presunto delito sexual (18 a 28 años),2014,5,2,10060,19.8807157057654,0,5251,0,2,4809,41.5886878768975
18175,13,13667,121,Tasa de exámenes médico legales por presunto delito sexual (18 a 28 años),2014,5,1,3546,28.2007896221094,0,1827,0,1,1719,58.173356602676
18176,5,5347,121,Tasa de exámenes médico legales por presunto delito sexual (18 a 28 años),2014,5,1,1224,81.6993464052288,0,672,0,1,552,181.159420289855
18177,25,25407,121,Tasa de exámenes médico legales por presunto delito sexual (18 a 28 años),2014,5,1,2196,45.5373406193078,0,1135,0,1,1061,94.2507068803016
18178,52,52585,121,Tasa de exámenes médico legales por presunto delito sexual (18 a 28 años),2014,5,1,3305,30.2571860816944,0,1680,0,1,1625,61.5384615384615
18179,15,15223,121,Tasa de exámenes médico legales por presunto delito sexual (18 a 28 años),2014,5,1,1210,82.6446280991735,0,632,0,1,578,173.010380622837
18180,54,54405,121,Tasa de exámenes médico legales por presunto delito sexual (18 a 28 años),2014,5,2,14610,13.6892539356605,0,7263,0,2,7347,27.2219953722608
18181,20,20295,121,Tasa de exámenes médico legales por presunto delito sexual (18 a 28 años),2014,5,1,3366,29.708853238265,0,1774,0,1,1592,62.8140703517588
18182,76,76895,121,Tasa de exámenes médico legales por presunto delito sexual (18 a 28 años),2014,5,3,8233,36.4387222154743,1,4136,24.1779497098646,2,4097,48.8162069807176
18183,76,76113,121,Tasa de exámenes médico legales por presunto delito sexual (18 a 28 años),2014,5,1,3860,25.9067357512953,0,2071,0,1,1789,55.8971492453885
18184,25,25899,121,Tasa de exámenes médico legales por presunto delito sexual (18 a 28 años),2014,5,5,23331,21.4307145000214,0,11630,0,5,11701,42.7313904794462
18185,41,41524,121,Tasa de exámenes médico legales por presunto delito sexual (18 a 28 años),2014,5,1,5985,16.7084377610693,0,3082,0,1,2903,34.447123665174
18186,19,19455,121,Tasa de exámenes médico legales por presunto delito sexual (18 a 28 años),2014,5,5,7835,63.8162093171666,0,4039,0,5,3796,131.717597471022
18187,66,66682,121,Tasa de exámenes médico legales por presunto delito sexual (18 a 28 años),2014,5,2,13312,15.0240384615385,0,6834,0,2,6478,30.8737264587836
18188,25,25592,121,Tasa de exámenes médico legales por presunto delito sexual (18 a 28 años),2014,5,2,817,244.798041615667,0,454,0,2,363,550.964187327824
18189,13,13442,121,Tasa de exámenes médico legales por presunto delito sexual (18 a 28 años),2014,5,3,9668,31.0302027306578,0,5053,0,3,4615,65.0054171180932
18190,13,13222,121,Tasa de exámenes médico legales por presunto delito sexual (18 a 28 años),2014,5,3,2605,115.163147792706,0,1400,0,3,1205,248.96265560166
18191,13,13140,121,Tasa de exámenes médico legales por presunto delito sexual (18 a 28 años),2014,5,1,4466,22.3914017017465,0,2392,0,1,2074,48.2160077145612
18192,47,47030,121,Tasa de exámenes médico legales por presunto delito sexual (18 a 28 años),2014,5,2,2255,88.6917960088692,0,1212,0,2,1043,191.754554170662
18193,76,76400,121,Tasa de exámenes médico legales por presunto delito sexual (18 a 28 años),2014,5,1,6942,14.4050705848459,0,3537,0,1,3405,29.3685756240822
18194,15,15494,121,Tasa de exámenes médico legales por presunto delito sexual (18 a 28 años),2014,5,1,898,111.358574610245,0,457,0,1,441,226.757369614512
18195,5,5893,121,Tasa de exámenes médico legales por presunto delito sexual (18 a 28 años),2014,5,2,3915,51.0855683269476,0,2013,0,2,1902,105.15247108307
18196,52,52473,121,Tasa de exámenes médico legales por presunto delito sexual (18 a 28 años),2014,5,1,3411,29.3169158604515,0,1751,0,1,1660,60.2409638554217
18197,25,25488,121,Tasa de exámenes médico legales por presunto delito sexual (18 a 28 años),2014,5,1,7043,14.1984949595343,1,5878,17.0125893160939,0,1165,0
18198,52,52227,121,Tasa de exámenes médico legales por presunto delito sexual (18 a 28 años),2014,5,1,6980,14.3266475644699,0,3565,0,1,3415,29.2825768667643
18199,70,70233,121,Tasa de exámenes médico legales por presunto delito sexual (18 a 28 años),2014,5,2,2184,91.5750915750916,0,1149,0,2,1035,193.236714975845
18200,25,25524,121,Tasa de exámenes médico legales por presunto delito sexual (18 a 28 años),2014,5,1,1056,94.6969696969697,1,579,172.711571675302,0,477,0
18201,41,41298,121,Tasa de exámenes médico legales por presunto delito sexual (18 a 28 años),2014,5,2,18801,10.63773203553,0,10723,0,2,8078,24.7586036147561
18202,47,47268,121,Tasa de exámenes médico legales por presunto delito sexual (18 a 28 años),2014,5,1,4079,24.515812699191,0,2221,0,1,1858,53.8213132400431
18203,86,86571,121,Tasa de exámenes médico legales por presunto delito sexual (18 a 28 años),2014,5,1,4843,20.6483584555028,0,2526,0,1,2317,43.1592576607682
18204,50,50223,121,Tasa de exámenes médico legales por presunto delito sexual (18 a 28 años),2014,5,1,1243,80.450522928399,1,621,161.030595813205,0,622,0
18205,44,44090,121,Tasa de exámenes médico legales por presunto delito sexual (18 a 28 años),2014,5,3,6454,46.4828013634955,0,3338,0,3,3116,96.2772785622593
18206,73,73443,121,Tasa de exámenes médico legales por presunto delito sexual (18 a 28 años),2014,5,1,6161,16.2311313098523,0,3074,0,1,3087,32.3939099449303
18207,13,13836,121,Tasa de exámenes médico legales por presunto delito sexual (18 a 28 años),2014,5,2,13499,14.8159122897992,0,6936,0,2,6563,30.4738686576261
18208,23,23570,121,Tasa de exámenes médico legales por presunto delito sexual (18 a 28 años),2014,5,2,7549,26.4935753079878,0,3938,0,2,3611,55.386319579064
18209,5,5664,121,Tasa de exámenes médico legales por presunto delito sexual (18 a 28 años),2014,5,3,5668,52.9287226534933,0,2911,0,3,2757,108.813928182807
18210,18,18753,121,Tasa de exámenes médico legales por presunto delito sexual (18 a 28 años),2014,5,3,13768,21.7896571760604,1,7101,14.082523588227,2,6667,29.9985000749963
18211,76,76122,121,Tasa de exámenes médico legales por presunto delito sexual (18 a 28 años),2014,5,1,5595,17.8731009830206,1,2853,35.0508236943568,0,2742,0
18212,25,25286,121,Tasa de exámenes médico legales por presunto delito sexual (18 a 28 años),2014,5,2,14890,13.4318334452653,0,7093,0,2,7797,25.6508913684751
18213,15,15572,121,Tasa de exámenes médico legales por presunto delito sexual (18 a 28 años),2014,5,1,9297,10.756157900398,0,4952,0,1,4345,23.0149597238205
18214,41,41791,121,Tasa de exámenes médico legales por presunto delito sexual (18 a 28 años),2014,5,1,3365,29.7176820208024,0,1765,0,1,1600,62.5
18215,25,25245,121,Tasa de exámenes médico legales por presunto delito sexual (18 a 28 años),2014,5,2,4010,49.8753117206982,0,1991,0,2,2019,99.0589400693412
18216,23,23555,121,Tasa de exámenes médico legales por presunto delito sexual (18 a 28 años),2014,5,1,13668,7.31635937957272,0,6944,0,1,6724,14.8720999405116
18217,50,50150,121,Tasa de exámenes médico legales por presunto delito sexual (18 a 28 años),2014,5,1,1960,51.0204081632653,0,977,0,1,983,101.729399796541
18218,5,5147,121,Tasa de exámenes médico legales por presunto delito sexual (18 a 28 años),2014,5,5,11685,42.7899015832264,0,5695,0,5,5990,83.4724540901503
18219,25,25805,121,Tasa de exámenes médico legales por presunto delito sexual (18 a 28 años),2014,5,1,862,116.009280742459,0,409,0,1,453,220.75055187638
18220,15,15763,121,Tasa de exámenes médico legales por presunto delito sexual (18 a 28 años),2014,5,1,1218,82.1018062397373,0,643,0,1,575,173.913043478261
18221,27,27615,121,Tasa de exámenes médico legales por presunto delito sexual (18 a 28 años),2014,5,1,6675,14.9812734082397,0,3422,0,1,3253,30.7408545957578
18222,85,85440,121,Tasa de exámenes médico legales por presunto delito sexual (18 a 28 años),2014,5,5,4873,102.606197414324,1,2417,41.3736036408771,4,2456,162.866449511401
18223,19,19821,121,Tasa de exámenes médico legales por presunto delito sexual (18 a 28 años),2014,5,1,6265,15.9616919393456,0,3328,0,1,2937,34.0483486550902
18224,86,86865,121,Tasa de exámenes médico legales por presunto delito sexual (18 a 28 años),2014,5,2,10318,19.3836014731537,0,5282,0,2,5036,39.714058776807
18225,76,76233,121,Tasa de exámenes médico legales por presunto delito sexual (18 a 28 años),2014,5,4,6523,61.3214778476161,0,3436,0,4,3087,129.575639779721
18226,25,25001,121,Tasa de exámenes médico legales por presunto delito sexual (18 a 28 años),2014,5,1,1960,51.0204081632653,0,996,0,1,964,103.734439834025
18227,23,23162,121,Tasa de exámenes médico legales por presunto delito sexual (18 a 28 años),2014,5,5,17575,28.4495021337127,0,8804,0,5,8771,57.0060426405199
18228,70,70221,121,Tasa de exámenes médico legales por presunto delito sexual (18 a 28 años),2014,5,1,2598,38.4911470361817,0,1280,0,1,1318,75.8725341426404
18229,17,17877,121,Tasa de exámenes médico legales por presunto delito sexual (18 a 28 años),2014,5,1,2396,41.7362270450751,0,1219,0,1,1177,84.9617672047579
18230,17,17614,121,Tasa de exámenes médico legales por presunto delito sexual (18 a 28 años),2014,5,3,10727,27.9668127155775,0,5391,0,3,5336,56.2218890554723
18231,20,20060,121,Tasa de exámenes médico legales por presunto delito sexual (18 a 28 años),2014,5,2,7220,27.7008310249307,0,3715,0,2,3505,57.0613409415121
18232,5,5756,121,Tasa de exámenes médico legales por presunto delito sexual (18 a 28 años),2014,5,2,7642,26.1711593823606,0,3860,0,2,3782,52.8820729772607
18233,76,76248,121,Tasa de exámenes médico legales por presunto delito sexual (18 a 28 años),2014,5,2,10508,19.0331176246669,0,5214,0,2,5294,37.7786173026067
18234,5,5380,121,Tasa de exámenes médico legales por presunto delito sexual (18 a 28 años),2014,5,2,12427,16.0939888951477,0,6220,0,2,6207,32.2216851941357
18235,70,70713,121,Tasa de exámenes médico legales por presunto delito sexual (18 a 28 años),2014,5,2,10152,19.7005516154452,0,5447,0,2,4705,42.5079702444208
18236,15,15693,121,Tasa de exámenes médico legales por presunto delito sexual (18 a 28 años),2014,5,1,2864,34.9162011173184,0,1817,0,1,1047,95.5109837631328
18237,19,19824,121,Tasa de exámenes médico legales por presunto delito sexual (18 a 28 años),2014,5,4,3825,104.575163398693,0,1974,0,4,1851,216.099405726634
18238,73,73671,121,Tasa de exámenes médico legales por presunto delito sexual (18 a 28 años),2014,5,1,2509,39.8565165404544,0,1315,0,1,1194,83.7520938023451
18239,99,99001,121,Tasa de exámenes médico legales por presunto delito sexual (18 a 28 años),2014,5,3,3917,76.5892264488129,1,2076,48.1695568400771,2,1841,108.636610537751
18240,54,54377,121,Tasa de exámenes médico legales por presunto delito sexual (18 a 28 años),2014,5,1,1161,86.1326442721791,0,649,0,1,512,195.3125
18241,5,5034,121,Tasa de exámenes médico legales por presunto delito sexual (18 a 28 años),2014,5,3,9537,31.4564328405159,0,4877,0,3,4660,64.3776824034335
18242,73,73067,121,Tasa de exámenes médico legales por presunto delito sexual (18 a 28 años),2014,5,1,4381,22.8258388495777,0,2194,0,1,2187,45.7247370827618
18243,25,25898,121,Tasa de exámenes médico legales por presunto delito sexual (18 a 28 años),2014,5,1,975,102.564102564103,0,503,0,1,472,211.864406779661
18244,25,25386,121,Tasa de exámenes médico legales por presunto delito sexual (18 a 28 años),2014,5,1,5708,17.5192711983181,0,2836,0,1,2872,34.8189415041783
18245,68,68861,121,Tasa de exámenes médico legales por presunto delito sexual (18 a 28 años),2014,5,2,3978,50.2765208647562,0,2241,0,2,1737,115.141047783535
18246,17,17873,121,Tasa de exámenes médico legales por presunto delito sexual (18 a 28 años),2014,5,1,10935,9.14494741655236,0,5471,0,1,5464,18.3016105417277
18247,19,19256,121,Tasa de exámenes médico legales por presunto delito sexual (18 a 28 años),2014,5,1,8095,12.3533045089561,0,4256,0,1,3839,26.048450117218
18248,68,68092,121,Tasa de exámenes médico legales por presunto delito sexual (18 a 28 años),2014,5,1,932,107.296137339056,0,507,0,1,425,235.294117647059
18249,25,25260,121,Tasa de exámenes médico legales por presunto delito sexual (18 a 28 años),2014,5,1,3337,29.9670362601139,1,1701,58.7889476778366,0,1636,0
18250,44,44430,121,Tasa de exámenes médico legales por presunto delito sexual (18 a 28 años),2014,5,2,29375,6.80851063829787,0,14813,0,2,14562,13.7343771459964
18251,25,25288,121,Tasa de exámenes médico legales por presunto delito sexual (18 a 28 años),2014,5,1,1134,88.1834215167548,0,601,0,1,533,187.617260787993
18252,18,18150,121,Tasa de exámenes médico legales por presunto delito sexual (18 a 28 años),2014,5,1,6110,16.366612111293,0,3023,0,1,3087,32.3939099449303
18253,5,5656,121,Tasa de exámenes médico legales por presunto delito sexual (18 a 28 años),2014,5,1,2494,40.0962309542903,0,1294,0,1,1200,83.3333333333333
18254,19,19548,121,Tasa de exámenes médico legales por presunto delito sexual (18 a 28 años),2014,5,1,8341,11.9889701474643,0,4229,0,1,4112,24.3190661478599
18255,5,5308,121,Tasa de exámenes médico legales por presunto delito sexual (18 a 28 años),2014,5,2,10961,18.2465103548946,0,5479,0,2,5482,36.4830353885443
18256,25,25040,121,Tasa de exámenes médico legales por presunto delito sexual (18 a 28 años),2014,5,3,2250,133.333333333333,0,1206,0,3,1044,287.35632183908
18257,5,5113,121,Tasa de exámenes médico legales por presunto delito sexual (18 a 28 años),2014,5,1,1321,75.7002271006813,0,722,0,1,599,166.944908180301
18258,44,44378,121,Tasa de exámenes médico legales por presunto delito sexual (18 a 28 años),2014,5,1,4982,20.0722601364914,0,2519,0,1,2463,40.6008932196508
18259,85,85010,121,Tasa de exámenes médico legales por presunto delito sexual (18 a 28 años),2014,5,1,7953,12.5738714950333,0,3896,0,1,4057,24.6487552378605
18260,50,50226,121,Tasa de exámenes médico legales por presunto delito sexual (18 a 28 años),2014,5,1,3723,26.86005909213,0,1805,0,1,1918,52.1376433785193
18261,13,13244,121,Tasa de exámenes médico legales por presunto delito sexual (18 a 28 años),2014,5,1,14628,6.83620453923981,0,7713,0,1,6915,14.4613159797542
18262,5,5107,121,Tasa de exámenes médico legales por presunto delito sexual (18 a 28 años),2014,5,1,1820,54.9450549450549,0,916,0,1,904,110.619469026549
18263,91,91540,121,Tasa de exámenes médico legales por presunto delito sexual (18 a 28 años),2014,5,1,1604,62.3441396508728,0,821,0,1,783,127.713920817369
18264,19,19698,121,Tasa de exámenes médico legales por presunto delito sexual (18 a 28 años),2014,5,1,18593,5.37836820308718,0,9229,0,1,9364,10.6791969243913
18265,25,25843,121,Tasa de exámenes médico legales por presunto delito sexual (18 a 28 años),2014,5,2,7836,25.5232261357836,0,3753,0,2,4083,48.9835904971834
18266,5,5264,121,Tasa de exámenes médico legales por presunto delito sexual (18 a 28 años),2014,5,1,2052,48.7329434697856,0,1089,0,1,963,103.842159916926
18267,23,23466,121,Tasa de exámenes médico legales por presunto delito sexual (18 a 28 años),2014,5,4,16748,23.8834487700024,0,8291,0,4,8457,47.2980962516259
18268,50,50573,121,Tasa de exámenes médico legales por presunto delito sexual (18 a 28 años),2014,5,3,6539,45.8785747056125,0,3442,0,3,3097,96.867936712948
18269,5,5042,121,Tasa de exámenes médico legales por presunto delito sexual (18 a 28 años),2014,5,4,4858,82.3384108686702,0,2556,0,4,2302,173.761946133797
18270,68,68162,121,Tasa de exámenes médico legales por presunto delito sexual (18 a 28 años),2014,5,2,1112,179.856115107914,0,593,0,2,519,385.356454720617
18271,8,8685,121,Tasa de exámenes médico legales por presunto delito sexual (18 a 28 años),2014,5,1,4859,20.5803663305207,0,2476,0,1,2383,41.9639110365086
18272,68,68682,121,Tasa de exámenes médico legales por presunto delito sexual (18 a 28 años),2014,5,1,453,220.75055187638,0,248,0,1,205,487.80487804878
18273,25,25875,121,Tasa de exámenes médico legales por presunto delito sexual (18 a 28 años),2014,5,2,4842,41.3052457662123,0,2470,0,2,2372,84.3170320404722
18274,52,52260,121,Tasa de exámenes médico legales por presunto delito sexual (18 a 28 años),2014,5,1,2376,42.0875420875421,0,1220,0,1,1156,86.5051903114187
18275,70,70473,121,Tasa de exámenes médico legales por presunto delito sexual (18 a 28 años),2014,5,1,2939,34.0251786321878,0,1550,0,1,1389,71.9942404607631
18276,68,68217,121,Tasa de exámenes médico legales por presunto delito sexual (18 a 28 años),2014,5,1,1503,66.5335994677312,0,823,0,1,680,147.058823529412
18277,76,76377,121,Tasa de exámenes médico legales por presunto delito sexual (18 a 28 años),2014,5,1,2041,48.9955903968643,0,1087,0,1,954,104.82180293501
18278,23,23182,121,Tasa de exámenes médico legales por presunto delito sexual (18 a 28 años),2014,5,1,9469,10.5607772732073,0,4865,0,1,4604,21.7202432667246
18279,8,8606,121,Tasa de exámenes médico legales por presunto delito sexual (18 a 28 años),2014,5,1,5236,19.0985485103132,0,2691,0,1,2545,39.2927308447937
18280,15,15238,121,Tasa de exámenes médico legales por presunto delito sexual (18 a 28 años),2014,5,1,18845,5.30644733351022,0,9461,0,1,9384,10.6564364876385
18281,25,25781,121,Tasa de exámenes médico legales por presunto delito sexual (18 a 28 años),2014,5,1,1156,86.5051903114187,0,601,0,1,555,180.18018018018
18282,13,13760,121,Tasa de exámenes médico legales por presunto delito sexual (18 a 28 años),2014,5,1,1601,62.4609618988132,1,820,121.951219512195,0,781,0
18283,73,73504,121,Tasa de exámenes médico legales por presunto delito sexual (18 a 28 años),2014,5,1,6578,15.2021891152326,0,3505,0,1,3073,32.5414904002603
18284,73,73770,121,Tasa de exámenes médico legales por presunto delito sexual (18 a 28 años),2014,5,1,804,124.378109452736,0,406,0,1,398,251.256281407035
18285,17,17777,121,Tasa de exámenes médico legales por presunto delito sexual (18 a 28 años),2014,5,1,5038,19.8491464867011,0,2536,0,1,2502,39.9680255795364
18286,15,15104,121,Tasa de exámenes médico legales por presunto delito sexual (18 a 28 años),2014,5,1,760,131.578947368421,0,394,0,1,366,273.224043715847
18287,47,47745,121,Tasa de exámenes médico legales por presunto delito sexual (18 a 28 años),2014,5,1,5165,19.3610842207164,0,2681,0,1,2484,40.2576489533011
18288,54,54518,121,Tasa de exámenes médico legales por presunto delito sexual (18 a 28 años),2014,5,1,14384,6.95216907675195,0,7369,0,1,7015,14.2551674982181
18289,41,41799,121,Tasa de exámenes médico legales por presunto delito sexual (18 a 28 años),2014,5,1,2758,36.2581580855693,0,1442,0,1,1316,75.9878419452887
18290,20,20178,121,Tasa de exámenes médico legales por presunto delito sexual (18 a 28 años),2014,5,2,3884,51.4933058702369,0,1991,0,2,1893,105.652403592182
18291,25,25183,121,Tasa de exámenes médico legales por presunto delito sexual (18 a 28 años),2014,5,1,4601,21.7344055640078,1,2332,42.8816466552316,0,2269,0
18292,25,25772,121,Tasa de exámenes médico legales por presunto delito sexual (18 a 28 años),2014,5,2,3414,58.5823081429408,0,1673,0,2,1741,114.876507754164
18293,25,25320,121,Tasa de exámenes médico legales por presunto delito sexual (18 a 28 años),2014,5,2,6918,28.9100896212778,1,3398,29.4290759270159,1,3520,28.4090909090909
18294,15,15407,121,Tasa de exámenes médico legales por presunto delito sexual (18 a 28 años),2014,5,1,2641,37.8644452858766,0,1364,0,1,1277,78.3085356303837
18295,86,86757,121,Tasa de exámenes médico legales por presunto delito sexual (18 a 28 años),2014,5,1,5347,18.7020759304283,1,2759,36.2450163102573,0,2588,0
18296,41,41006,121,Tasa de exámenes médico legales por presunto delito sexual (18 a 28 años),2014,5,2,6372,31.3873195229127,0,3287,0,2,3085,64.8298217179903
18297,47,47980,121,Tasa de exámenes médico legales por presunto delito sexual (18 a 28 años),2014,5,2,11421,17.5116014359513,0,5986,0,2,5435,36.7985280588776
18298,41,41206,121,Tasa de exámenes médico legales por presunto delito sexual (18 a 28 años),2014,5,2,2428,82.3723228995058,0,1244,0,2,1184,168.918918918919
18299,15,15162,121,Tasa de exámenes médico legales por presunto delito sexual (18 a 28 años),2014,5,1,595,168.067226890756,0,321,0,1,274,364.963503649635
18300,81,81794,121,Tasa de exámenes médico legales por presunto delito sexual (18 a 28 años),2014,5,1,10168,9.83477576711251,0,5443,0,1,4725,21.1640211640212
18301,73,73675,121,Tasa de exámenes médico legales por presunto delito sexual (18 a 28 años),2014,5,2,2919,68.5166152792052,0,1555,0,2,1364,146.627565982405
18302,25,25377,121,Tasa de exámenes médico legales por presunto delito sexual (18 a 28 años),2014,5,3,5304,56.5610859728507,0,2715,0,3,2589,115.874855156431
18303,25,25258,121,Tasa de exámenes médico legales por presunto delito sexual (18 a 28 años),2014,5,1,883,113.250283125708,0,444,0,1,439,227.790432801822
18304,5,5093,121,Tasa de exámenes médico legales por presunto delito sexual (18 a 28 años),2014,5,1,3847,25.9942812581232,0,1990,0,1,1857,53.850296176629
18305,27,27077,121,Tasa de exámenes médico legales por presunto delito sexual (18 a 28 años),2014,5,1,3863,25.8866166192079,0,2085,0,1,1778,56.2429696287964
18306,95,95001,121,Tasa de exámenes médico legales por presunto delito sexual (18 a 28 años),2014,5,1,13759,7.26797005596337,0,6785,0,1,6974,14.3389733295096
18307,17,17433,121,Tasa de exámenes médico legales por presunto delito sexual (18 a 28 años),2014,5,3,4509,66.5335994677312,0,2345,0,3,2164,138.632162661738
18308,5,5579,121,Tasa de exámenes médico legales por presunto delito sexual (18 a 28 años),2014,5,2,9495,21.0637177461822,1,4670,21.4132762312634,1,4825,20.7253886010363
18309,85,85139,121,Tasa de exámenes médico legales por presunto delito sexual (18 a 28 años),2014,5,2,2278,87.7963125548727,0,1207,0,2,1071,186.741363211951
18310,85,85125,121,Tasa de exámenes médico legales por presunto delito sexual (18 a 28 años),2014,5,1,2570,38.9105058365759,0,1348,0,1,1222,81.8330605564648
18311,86,86320,121,Tasa de exámenes médico legales por presunto delito sexual (18 a 28 años),2014,5,3,10558,28.4144724379617,0,5462,0,3,5096,58.8697017268446
18312,50,50270,121,Tasa de exámenes médico legales por presunto delito sexual (18 a 28 años),2014,5,1,657,152.20700152207,0,358,0,1,299,334.448160535117
18313,15,15757,121,Tasa de exámenes médico legales por presunto delito sexual (18 a 28 años),2014,5,1,1144,87.4125874125874,0,619,0,1,525,190.47619047619
18314,41,41378,121,Tasa de exámenes médico legales por presunto delito sexual (18 a 28 años),2014,5,1,2760,36.231884057971,0,1377,0,1,1383,72.3065798987708
18315,66,66318,121,Tasa de exámenes médico legales por presunto delito sexual (18 a 28 años),2014,5,1,2546,39.2772977219167,0,1294,0,1,1252,79.8722044728434
18316,5,5250,121,Tasa de exámenes médico legales por presunto delito sexual (18 a 28 años),2014,5,6,10811,55.4990287669966,0,5662,0,6,5149,116.527481064284
18317,5,5284,121,Tasa de exámenes médico legales por presunto delito sexual (18 a 28 años),2014,5,1,3560,28.0898876404494,0,1881,0,1,1679,59.5592614651578
18318,25,25513,121,Tasa de exámenes médico legales por presunto delito sexual (18 a 28 años),2014,5,1,5309,18.8359389715577,0,2677,0,1,2632,37.9939209726444
18319,50,50251,121,Tasa de exámenes médico legales por presunto delito sexual (18 a 28 años),2014,5,1,1240,80.6451612903226,0,685,0,1,555,180.18018018018
18320,25,25662,121,Tasa de exámenes médico legales por presunto delito sexual (18 a 28 años),2014,5,1,1933,51.7330574236937,0,942,0,1,991,100.908173562059
18321,81,81001,121,Tasa de exámenes médico legales por presunto delito sexual (18 a 28 años),2014,5,4,15261,26.210602188585302,0,7265,0,4,7996,50.0250125062531
18322,25,25815,121,Tasa de exámenes médico legales por presunto delito sexual (18 a 28 años),2014,5,1,3234,30.9214594928881,0,1643,0,1,1591,62.8535512256443
18323,5,5036,121,Tasa de exámenes médico legales por presunto delito sexual (18 a 28 años),2014,5,1,1605,62.3052959501558,0,835,0,1,770,129.87012987013
18324,5,5138,121,Tasa de exámenes médico legales por presunto delito sexual (18 a 28 años),2014,5,2,3239,61.7474529175672,0,1648,0,2,1591,125.707102451289
18325,25,25758,121,Tasa de exámenes médico legales por presunto delito sexual (18 a 28 años),2014,5,1,5024,19.9044585987261,0,2524,0,1,2500,40
18326,25,25594,121,Tasa de exámenes médico legales por presunto delito sexual (18 a 28 años),2014,5,1,1325,75.4716981132075,0,711,0,1,614,162.866449511401
18327,19,19212,121,Tasa de exámenes médico legales por presunto delito sexual (18 a 28 años),2014,5,1,6579,15.1998784009728,0,3476,0,1,3103,32.2268772155978
18328,68,68235,121,Tasa de exámenes médico legales por presunto delito sexual (18 a 28 años),2014,5,2,3890,51.413881748072,0,2059,0,2,1831,109.229929000546
18329,25,25599,121,Tasa de exámenes médico legales por presunto delito sexual (18 a 28 años),2014,5,1,1480,67.5675675675676,0,779,0,1,701,142.65335235378
18330,5,5541,121,Tasa de exámenes médico legales por presunto delito sexual (18 a 28 años),2014,5,1,3122,32.0307495195388,1,1569,63.7348629700446,0,1553,0
18331,5,5030,121,Tasa de exámenes médico legales por presunto delito sexual (18 a 28 años),2014,5,2,6016,33.2446808510638,0,3114,0,2,2902,68.9179875947622
18332,5,5209,121,Tasa de exámenes médico legales por presunto delito sexual (18 a 28 años),2014,5,3,4357,68.8547165480835,0,2271,0,3,2086,143.815915627996
18333,25,25175,121,Tasa de exámenes médico legales por presunto delito sexual (18 a 28 años),2014,5,8,23950,33.4029227557411,0,11771,0,8,12179,65.6868379998358
18334,5,5658,121,Tasa de exámenes médico legales por presunto delito sexual (18 a 28 años),2014,5,1,625,160,1,316,316.455696202532,0,309,0
18335,5,5440,121,Tasa de exámenes médico legales por presunto delito sexual (18 a 28 años),2014,5,3,11307,26.5322366675511,0,5802,0,3,5505,54.4959128065395
18336,5,5318,121,Tasa de exámenes médico legales por presunto delito sexual (18 a 28 años),2014,5,6,9521,63.0185904841928,0,4854,0,6,4667,128.562245553889
18337,25,25885,121,Tasa de exámenes médico legales por presunto delito sexual (18 a 28 años),2014,5,1,3053,32.7546675401245,1,1536,65.1041666666667,0,1517,0
18338,5,5237,121,Tasa de exámenes médico legales por presunto delito sexual (18 a 28 años),2014,5,2,4729,42.2922393740749,0,2309,0,2,2420,82.6446280991735
18339,5,5051,121,Tasa de exámenes médico legales por presunto delito sexual (18 a 28 años),2014,5,1,8676,11.5260488704472,0,4345,0,1,4331,23.089355806973
18340,18,18247,121,Tasa de exámenes médico legales por presunto delito sexual (18 a 28 años),2014,5,2,4441,45.034902049088,0,2247,0,2,2194,91.1577028258888
18341,5,5847,121,Tasa de exámenes médico legales por presunto delito sexual (18 a 28 años),2014,5,3,8085,37.1057513914657,1,4265,23.4466588511137,2,3820,52.3560209424084
18342,5,5490,121,Tasa de exámenes médico legales por presunto delito sexual (18 a 28 años),2014,5,3,13430,22.3380491437081,0,6729,0,3,6701,44.7694373974034
18343,5,5697,121,Tasa de exámenes médico legales por presunto delito sexual (18 a 28 años),2014,5,2,5210,38.3877159309021,1,2666,37.5093773443361,1,2544,39.3081761006289
18344,68,68655,121,Tasa de exámenes médico legales por presunto delito sexual (18 a 28 años),2014,5,4,3777,105.904156738152,0,2011,0,4,1766,226.500566251416
18345,5,5400,121,Tasa de exámenes médico legales por presunto delito sexual (18 a 28 años),2014,5,1,3915,25.5427841634738,0,2038,0,1,1877,53.276505061268
18346,20,20400,121,Tasa de exámenes médico legales por presunto delito sexual (18 a 28 años),2014,5,1,4448,22.4820143884892,0,2332,0,1,2116,47.2589792060491
18347,5,5101,121,Tasa de exámenes médico legales por presunto delito sexual (18 a 28 años),2014,5,6,5583,107.469102632993,0,2861,0,6,2722,220.426157237325
18348,19,19300,121,Tasa de exámenes médico legales por presunto delito sexual (18 a 28 años),2014,5,1,4013,24.919013207077,0,1974,0,1,2039,49.0436488474743
18349,76,76126,121,Tasa de exámenes médico legales por presunto delito sexual (18 a 28 años),2014,5,1,2820,35.4609929078014,0,1401,0,1,1419,70.4721634954193
18350,15,15097,121,Tasa de exámenes médico legales por presunto delito sexual (18 a 28 años),2014,5,1,1187,84.24599831508,0,605,0,1,582,171.821305841924
18351,25,25053,121,Tasa de exámenes médico legales por presunto delito sexual (18 a 28 años),2014,5,1,2397,41.7188151856487,1,1230,81.3008130081301,0,1167,0
18352,50,50124,121,Tasa de exámenes médico legales por presunto delito sexual (18 a 28 años),2014,5,2,806,248.138957816377,0,407,0,2,399,501.25313283208
18353,73,73349,121,Tasa de exámenes médico legales por presunto delito sexual (18 a 28 años),2014,5,1,5366,18.6358553857622,0,3187,0,1,2179,45.8926112895824
18354,5,5674,121,Tasa de exámenes médico legales por presunto delito sexual (18 a 28 años),2014,5,2,3387,59.0493061706525,0,1737,0,2,1650,121.212121212121
18355,85,85250,121,Tasa de exámenes médico legales por presunto delito sexual (18 a 28 años),2014,5,1,5313,18.8217579521927,0,2634,0,1,2679,37.3273609555804
18356,54,54810,121,Tasa de exámenes médico legales por presunto delito sexual (18 a 28 años),2014,5,2,6988,28.6204922724671,0,3681,0,2,3307,60.4777744179014
18357,85,85263,121,Tasa de exámenes médico legales por presunto delito sexual (18 a 28 años),2014,5,1,1641,60.9384521633151,0,841,0,1,800,125
18358,15,15686,121,Tasa de exámenes médico legales por presunto delito sexual (18 a 28 años),2014,5,1,1270,78.740157480315,0,674,0,1,596,167.785234899329
18359,50,50711,121,Tasa de exámenes médico legales por presunto delito sexual (18 a 28 años),2014,5,1,4737,21.1104074308634,1,2371,42.1762969211303,0,2366,0
18360,41,41770,121,Tasa de exámenes médico legales por presunto delito sexual (18 a 28 años),2014,5,2,3747,53.3760341606619,0,1933,0,2,1814,110.253583241455
18361,50,50245,121,Tasa de exámenes médico legales por presunto delito sexual (18 a 28 años),2014,5,1,448,223.214285714286,0,225,0,1,223,448.430493273543
18362,5,5148,121,Tasa de exámenes médico legales por presunto delito sexual (18 a 28 años),2014,5,3,10044,29.868578255675,0,5136,0,3,4908,61.1246943765281
18363,68,68077,121,Tasa de exámenes médico legales por presunto delito sexual (18 a 28 años),2014,5,1,5231,19.1168036704263,0,2630,0,1,2601,38.4467512495194
18364,25,25785,121,Tasa de exámenes médico legales por presunto delito sexual (18 a 28 años),2014,5,2,5142,38.8953714507974,1,2632,37.9939209726444,1,2510,39.8406374501992
18365,5,5240,121,Tasa de exámenes médico legales por presunto delito sexual (18 a 28 años),2014,5,2,2649,75.5001887504719,1,1376,72.6744186046512,1,1273,78.5545954438335
18366,54,54743,121,Tasa de exámenes médico legales por presunto delito sexual (18 a 28 años),2014,5,1,853,117.233294255569,0,445,0,1,408,245.098039215686
18367,5,5483,121,Tasa de exámenes médico legales por presunto delito sexual (18 a 28 años),2014,5,1,3480,28.735632183908,0,1883,0,1,1597,62.6174076393237
18368,5,5736,121,Tasa de exámenes médico legales por presunto delito sexual (18 a 28 años),2014,5,3,8527,35.1823619092295,0,4417,0,3,4110,72.992700729927
18369,20,20238,121,Tasa de exámenes médico legales por presunto delito sexual (18 a 28 años),2014,5,1,5260,19.0114068441065,0,2722,0,1,2538,39.4011032308905
18370,5,5761,121,Tasa de exámenes médico legales por presunto delito sexual (18 a 28 años),2014,5,1,2968,33.6927223719677,0,1597,0,1,1371,72.9394602479942
18371,25,25295,121,Tasa de exámenes médico legales por presunto delito sexual (18 a 28 años),2014,5,1,2784,35.9195402298851,0,1336,0,1,1448,69.060773480663
18372,25,25126,121,Tasa de exámenes médico legales por presunto delito sexual (18 a 28 años),2014,5,5,11274,44.3498314706404,1,5830,17.1526586620926,4,5444,73.4753857457752
18373,68,68770,121,Tasa de exámenes médico legales por presunto delito sexual (18 a 28 años),2014,5,1,1875,53.3333333333333,0,976,0,1,899,111.234705228031
18374,5,5353,121,Tasa de exámenes médico legales por presunto delito sexual (18 a 28 años),2014,5,1,826,121.065375302663,0,421,0,1,405,246.913580246914
18375,25,25438,121,Tasa de exámenes médico legales por presunto delito sexual (18 a 28 años),2014,5,1,2190,45.662100456621,0,1216,0,1,974,102.669404517454
18376,68,68575,121,Tasa de exámenes médico legales por presunto delito sexual (18 a 28 años),2014,5,1,6258,15.9795461808885,0,3155,0,1,3103,32.2268772155978
18377,19,19573,121,Tasa de exámenes médico legales por presunto delito sexual (18 a 28 años),2014,5,1,9276,10.7805088400172,0,4600,0,1,4676,21.3857998289136
18378,11,11001,81,"Tasa de exámenes médico legales por presunto delito sexual contra niños, niñas y adolescentes",2014,1,4,121491,3.29242495328872,2,62267,3.2119742399666,2,59224,3.37700932054572
18379,54,54344,81,"Tasa de exámenes médico legales por presunto delito sexual contra niños, niñas y adolescentes",2014,1,1,313,319.488817891374,0,159,0,1,154,649.350649350649
18380,85,85001,81,"Tasa de exámenes médico legales por presunto delito sexual contra niños, niñas y adolescentes",2014,1,1,2568,38.9408099688474,1,1304,76.6871165644172,0,1264,0
18381,44,44001,81,"Tasa de exámenes médico legales por presunto delito sexual contra niños, niñas y adolescentes",2014,1,1,6909,14.4738746562455,1,3544,28.216704288939,0,3365,0
18382,41,41020,81,"Tasa de exámenes médico legales por presunto delito sexual contra niños, niñas y adolescentes",2014,1,1,532,187.96992481203,0,273,0,1,259,386.100386100386
18383,68,68081,81,"Tasa de exámenes médico legales por presunto delito sexual contra niños, niñas y adolescentes",2014,1,1,3116,32.0924261874198,0,1595,0,1,1521,65.7462195923734
18384,50,50573,81,"Tasa de exámenes médico legales por presunto delito sexual contra niños, niñas y adolescentes",2014,1,1,676,147.92899408284,0,348,0,1,328,304.878048780488
18385,5,5001,81,"Tasa de exámenes médico legales por presunto delito sexual contra niños, niñas y adolescentes",2014,1,3,29192,10.27678816114,0,14914,0,3,14278,21.0113461269085
18386,76,76001,81,"Tasa de exámenes médico legales por presunto delito sexual contra niños, niñas y adolescentes",2014,1,3,35554,8.43786915677561,0,18257,0,3,17297,17.3440481008267
18387,66,66001,81,"Tasa de exámenes médico legales por presunto delito sexual contra niños, niñas y adolescentes",2014,1,1,6866,14.5645208272648,0,3516,0,1,3350,29.8507462686567
18388,41,41078,81,"Tasa de exámenes médico legales por presunto delito sexual contra niños, niñas y adolescentes",2014,1,1,201,497.512437810945,1,103,970.873786407767,0,98,0
18389,23,23001,81,"Tasa de exámenes médico legales por presunto delito sexual contra niños, niñas y adolescentes",2014,1,1,7996,12.5062531265633,0,4087,0,1,3909,25.5819902788437
18390,76,76109,81,"Tasa de exámenes médico legales por presunto delito sexual contra niños, niñas y adolescentes",2014,1,1,8819,11.3391540991042,0,4533,0,1,4286,23.3317778814746
18391,25,25754,81,"Tasa de exámenes médico legales por presunto delito sexual contra niños, niñas y adolescentes",2014,1,2,9543,20.9577700932621,1,4858,20.5846027171676,1,4685,21.3447171824973
18392,15,15667,81,"Tasa de exámenes médico legales por presunto delito sexual contra niños, niñas y adolescentes",2014,1,1,93,1075.2688172043,1,48,2083.33333333333,0,45,0
18393,5,5376,81,"Tasa de exámenes médico legales por presunto delito sexual contra niños, niñas y adolescentes",2014,1,1,892,112.107623318386,0,451,0,1,441,226.757369614512
18394,8,8638,81,"Tasa de exámenes médico legales por presunto delito sexual contra niños, niñas y adolescentes",2014,1,1,1957,51.0986203372509,0,999,0,1,958,104.384133611691
18395,73,73001,81,"Tasa de exámenes médico legales por presunto delito sexual contra niños, niñas y adolescentes",2014,1,1,8601,11.6265550517382,0,4432,0,1,4169,23.9865675221876
18396,5,5380,81,"Tasa de exámenes médico legales por presunto delito sexual contra niños, niñas y adolescentes",2014,1,1,1010,99.009900990099,0,519,0,1,491,203.665987780041
18397,76,76248,81,"Tasa de exámenes médico legales por presunto delito sexual contra niños, niñas y adolescentes",2014,1,1,887,112.739571589628,0,452,0,1,435,229.885057471264
18398,50,50001,81,"Tasa de exámenes médico legales por presunto delito sexual contra niños, niñas y adolescentes",2014,1,1,8370,11.94743130227,0,4291,0,1,4079,24.515812699191
18399,68,68307,81,"Tasa de exámenes médico legales por presunto delito sexual contra niños, niñas y adolescentes",2014,1,1,2913,34.3288705801579,1,1495,66.8896321070234,0,1418,0
18400,63,63001,81,"Tasa de exámenes médico legales por presunto delito sexual contra niños, niñas y adolescentes",2014,1,1,4606,21.7108119843682,1,2367,42.247570764681,0,2239,0
18401,13,13001,81,"Tasa de exámenes médico legales por presunto delito sexual contra niños, niñas y adolescentes",2014,1,1,16293,6.13760510648745,0,8316,0,1,7977,12.5360411182149
18402,25,25307,81,"Tasa de exámenes médico legales por presunto delito sexual contra niños, niñas y adolescentes",2014,1,1,1542,64.8508430609598,0,792,0,1,750,133.333333333333
