id,cdep,cmun,cindica,nomind,periodo,edadR,casos,poblacion,tasa,casosh,poblacionh,tasah,casosm,poblacionm,tasam
30215,91,91001,81,"Tasa de exámenes médico legales por presunto delito sexual contra niños, niñas y adolescentes",2020,2,7,5719,122.399020807834,2,2943,67.9578661230037,5,2776,180.115273775216
30216,91,91001,81,"Tasa de exámenes médico legales por presunto delito sexual contra niños, niñas y adolescentes",2020,3,28,6786,412.614205717654,2,3457,57.8536303153023,26,3329,781.015319915891
30217,91,91001,81,"Tasa de exámenes médico legales por presunto delito sexual contra niños, niñas y adolescentes",2020,4,35,6281,557.236108899857,0,3237,0,35,3044,1149.80289093298
30218,91,91001,121,Tasa de exámenes médico legales por presunto delito sexual cuando la víctima está entre 18 y 28 años,2020,5,6,9593,62.5456061711665,1,5140,19.4552529182879,5,4453,112.283853581855
30219,91,91540,81,"Tasa de exámenes médico legales por presunto delito sexual contra niños, niñas y adolescentes",2020,3,1,1645,60.790273556231,0,839,0,1,806,124.069478908189
30220,5,5002,81,"Tasa de exámenes médico legales por presunto delito sexual contra niños, niñas y adolescentes",2020,2,2,1306,153.139356814701,2,658,303.951367781155,0,648,0
30221,5,5002,81,"Tasa de exámenes médico legales por presunto delito sexual contra niños, niñas y adolescentes",2020,3,4,1796,222.71714922049,1,938,106.609808102345,3,858,349.65034965035
30222,5,5002,81,"Tasa de exámenes médico legales por presunto delito sexual contra niños, niñas y adolescentes",2020,4,9,1966,457.782299084435,0,1057,0,9,909,990.09900990099
30223,5,5030,81,"Tasa de exámenes médico legales por presunto delito sexual contra niños, niñas y adolescentes",2020,2,3,2029,147.856086742238,1,1038,96.3391136801541,2,991,201.816347124117
30224,5,5030,81,"Tasa de exámenes médico legales por presunto delito sexual contra niños, niñas y adolescentes",2020,3,4,2528,158.227848101266,0,1286,0,4,1242,322.061191626409
30225,5,5030,81,"Tasa de exámenes médico legales por presunto delito sexual contra niños, niñas y adolescentes",2020,4,6,2763,217.155266015201,2,1406,142.247510668563,4,1357,294.767870302137
30226,5,5030,121,Tasa de exámenes médico legales por presunto delito sexual cuando la víctima está entre 18 y 28 años,2020,5,3,5682,52.7983104540655,0,2906,0,3,2776,108.06916426513
30227,5,5031,81,"Tasa de exámenes médico legales por presunto delito sexual contra niños, niñas y adolescentes",2020,2,1,2200,45.4545454545455,0,1133,0,1,1067,93.7207122774133
30228,5,5031,81,"Tasa de exámenes médico legales por presunto delito sexual contra niños, niñas y adolescentes",2020,3,4,2903,137.788494660696,0,1480,0,4,1423,281.09627547435
30229,5,5031,81,"Tasa de exámenes médico legales por presunto delito sexual contra niños, niñas y adolescentes",2020,4,6,3058,196.206671026815,1,1557,64.2260757867694,5,1501,333.11125916056
30230,5,5031,121,Tasa de exámenes médico legales por presunto delito sexual cuando la víctima está entre 18 y 28 años,2020,5,2,4973,40.2171727327569,0,2525,0,2,2448,81.6993464052288
30231,5,5034,81,"Tasa de exámenes médico legales por presunto delito sexual contra niños, niñas y adolescentes",2020,2,6,3160,189.873417721519,2,1661,120.409391932571,4,1499,266.844563042028
30232,5,5034,81,"Tasa de exámenes médico legales por presunto delito sexual contra niños, niñas y adolescentes",2020,3,7,3883,180.272984805563,1,2037,49.0918016691213,6,1846,325.027085590466
30233,5,5034,81,"Tasa de exámenes médico legales por presunto delito sexual contra niños, niñas y adolescentes",2020,4,5,4069,122.880314573605,1,2126,47.0366886171214,4,1943,205.867215645908
30234,5,5034,121,Tasa de exámenes médico legales por presunto delito sexual cuando la víctima está entre 18 y 28 años,2020,5,2,7917,25.2620942276115,0,4355,0,2,3562,56.1482313307131
30235,5,5040,81,"Tasa de exámenes médico legales por presunto delito sexual contra niños, niñas y adolescentes",2020,2,2,1961,101.988781234064,0,967,0,2,994,201.207243460765
30236,5,5040,81,"Tasa de exámenes médico legales por presunto delito sexual contra niños, niñas y adolescentes",2020,3,6,2315,259.179265658747,2,1198,166.944908180301,4,1117,358.10205908684
30237,5,5040,81,"Tasa de exámenes médico legales por presunto delito sexual contra niños, niñas y adolescentes",2020,4,7,2227,314.324202963628,0,1181,0,7,1046,669.216061185468
30238,5,5044,81,"Tasa de exámenes médico legales por presunto delito sexual contra niños, niñas y adolescentes",2020,2,2,626,319.488817891374,2,338,591.715976331361,0,288,0
30239,5,5044,81,"Tasa de exámenes médico legales por presunto delito sexual contra niños, niñas y adolescentes",2020,3,3,775,387.096774193548,2,404,495.049504950495,1,371,269.541778975741
30240,5,5044,81,"Tasa de exámenes médico legales por presunto delito sexual contra niños, niñas y adolescentes",2020,4,5,779,641.848523748395,0,401,0,5,378,1322.75132275132
30241,5,5045,81,"Tasa de exámenes médico legales por presunto delito sexual contra niños, niñas y adolescentes",2020,2,1,11630,8.59845227858985,0,6017,0,1,5613,17.8157847853198
30242,5,5045,81,"Tasa de exámenes médico legales por presunto delito sexual contra niños, niñas y adolescentes",2020,3,2,14280,14.0056022408964,0,7324,0,2,6956,28.7521564117309
30243,5,5045,81,"Tasa de exámenes médico legales por presunto delito sexual contra niños, niñas y adolescentes",2020,4,4,14412,27.7546489036914,0,7275,0,4,7137,56.0459576853019
30244,5,5051,81,"Tasa de exámenes médico legales por presunto delito sexual contra niños, niñas y adolescentes",2020,3,2,3922,50.9943906170321,1,2062,48.4966052376334,1,1860,53.7634408602151
30245,5,5051,81,"Tasa de exámenes médico legales por presunto delito sexual contra niños, niñas y adolescentes",2020,4,1,3687,27.122321670735,0,1999,0,1,1688,59.2417061611374
30246,5,5059,81,"Tasa de exámenes médico legales por presunto delito sexual contra niños, niñas y adolescentes",2020,3,2,401,498.753117206983,2,196,1020.40816326531,0,205,0
30247,5,5059,121,Tasa de exámenes médico legales por presunto delito sexual cuando la víctima está entre 18 y 28 años,2020,5,1,623,160.513643659711,0,302,0,1,321,311.526479750779
30248,5,5079,81,"Tasa de exámenes médico legales por presunto delito sexual contra niños, niñas y adolescentes",2020,2,2,3327,60.1142170123234,0,1666,0,2,1661,120.409391932571
30249,5,5079,81,"Tasa de exámenes médico legales por presunto delito sexual contra niños, niñas y adolescentes",2020,3,9,4250,211.764705882353,4,2161,185.0994909764,5,2089,239.348970799426
30250,5,5079,81,"Tasa de exámenes médico legales por presunto delito sexual contra niños, niñas y adolescentes",2020,4,8,4746,168.563000421408,0,2437,0,8,2309,346.470333477696
30251,5,5079,121,Tasa de exámenes médico legales por presunto delito sexual cuando la víctima está entre 18 y 28 años,2020,5,3,9671,31.0205769827319,1,4954,20.185708518369,2,4717,42.3998304006784
30252,5,5088,81,"Tasa de exámenes médico legales por presunto delito sexual contra niños, niñas y adolescentes",2020,2,21,35528,59.1083089394281,9,18267,49.2691739201839,12,17261,69.5208852326053
30253,5,5088,81,"Tasa de exámenes médico legales por presunto delito sexual contra niños, niñas y adolescentes",2020,3,31,42826,72.3859337785457,9,21833,41.2220033893647,22,20993,104.796837040918
30254,5,5088,81,"Tasa de exámenes médico legales por presunto delito sexual contra niños, niñas y adolescentes",2020,4,37,46943,78.8189932471295,7,23626,29.6283755184966,30,23317,128.661491615559
30255,5,5088,121,Tasa de exámenes médico legales por presunto delito sexual cuando la víctima está entre 18 y 28 años,2020,5,9,113143,7.95453541094014,1,57153,1.74968943012615,8,55990,14.2882657617432
30256,5,5086,81,"Tasa de exámenes médico legales por presunto delito sexual contra niños, niñas y adolescentes",2020,3,1,671,149.03129657228,0,336,0,1,335,298.507462686567
30257,5,5091,81,"Tasa de exámenes médico legales por presunto delito sexual contra niños, niñas y adolescentes",2020,2,5,795,628.930817610063,3,414,724.63768115942,2,381,524.9343832021
30258,5,5091,81,"Tasa de exámenes médico legales por presunto delito sexual contra niños, niñas y adolescentes",2020,3,1,1068,93.6329588014981,1,539,185.528756957328,0,529,0
30259,5,5091,81,"Tasa de exámenes médico legales por presunto delito sexual contra niños, niñas y adolescentes",2020,4,2,1125,177.777777777778,0,568,0,2,557,359.066427289048
30260,5,5091,121,Tasa de exámenes médico legales por presunto delito sexual cuando la víctima está entre 18 y 28 años,2020,5,1,1718,58.2072176949942,0,893,0,1,825,121.212121212121
30261,5,5093,81,"Tasa de exámenes médico legales por presunto delito sexual contra niños, niñas y adolescentes",2020,2,1,1382,72.3589001447178,0,714,0,1,668,149.700598802395
30262,5,5093,81,"Tasa de exámenes médico legales por presunto delito sexual contra niños, niñas y adolescentes",2020,3,6,1744,344.036697247706,6,904,663.716814159292,0,840,0
30263,5,5093,81,"Tasa de exámenes médico legales por presunto delito sexual contra niños, niñas y adolescentes",2020,4,6,1788,335.570469798658,0,927,0,6,861,696.864111498258
30264,5,5107,81,"Tasa de exámenes médico legales por presunto delito sexual contra niños, niñas y adolescentes",2020,2,3,839,357.568533969011,0,420,0,3,419,715.990453460621
30265,5,5107,81,"Tasa de exámenes médico legales por presunto delito sexual contra niños, niñas y adolescentes",2020,3,2,1002,199.600798403194,0,534,0,2,468,427.350427350427
30266,5,5107,81,"Tasa de exámenes médico legales por presunto delito sexual contra niños, niñas y adolescentes",2020,4,5,965,518.134715025907,0,526,0,5,439,1138.95216400911
30267,5,5113,81,"Tasa de exámenes médico legales por presunto delito sexual contra niños, niñas y adolescentes",2020,4,1,1050,95.2380952380952,0,524,0,1,526,190.114068441065
30268,5,5120,81,"Tasa de exámenes médico legales por presunto delito sexual contra niños, niñas y adolescentes",2020,3,2,4251,47.0477534697718,0,2247,0,2,2004,99.8003992015968
30269,5,5120,81,"Tasa de exámenes médico legales por presunto delito sexual contra niños, niñas y adolescentes",2020,4,4,3850,103.896103896104,0,2090,0,4,1760,227.272727272727
30270,5,5129,81,"Tasa de exámenes médico legales por presunto delito sexual contra niños, niñas y adolescentes",2020,2,6,4495,133.481646273637,0,2301,0,6,2194,273.473108477666
30271,5,5129,81,"Tasa de exámenes médico legales por presunto delito sexual contra niños, niñas y adolescentes",2020,3,8,5634,141.995030173944,2,2852,70.1262272089762,6,2782,215.672178289001
30272,5,5129,81,"Tasa de exámenes médico legales por presunto delito sexual contra niños, niñas y adolescentes",2020,4,5,6430,77.7604976671851,0,3217,0,5,3213,155.617802676626
30273,5,5129,121,Tasa de exámenes médico legales por presunto delito sexual cuando la víctima está entre 18 y 28 años,2020,5,2,15495,12.9073894804776,0,7706,0,2,7789,25.6772371292849
30274,5,5134,81,"Tasa de exámenes médico legales por presunto delito sexual contra niños, niñas y adolescentes",2020,3,4,1120,357.142857142857,0,597,0,4,523,764.818355640535
30275,5,5134,81,"Tasa de exámenes médico legales por presunto delito sexual contra niños, niñas y adolescentes",2020,4,2,1145,174.672489082969,0,620,0,2,525,380.952380952381
30276,5,5138,81,"Tasa de exámenes médico legales por presunto delito sexual contra niños, niñas y adolescentes",2020,2,2,1246,160.513643659711,1,627,159.489633173844,1,619,161.550888529887
30277,5,5138,81,"Tasa de exámenes médico legales por presunto delito sexual contra niños, niñas y adolescentes",2020,3,3,1582,189.633375474083,1,788,126.903553299492,2,794,251.889168765743
30278,5,5138,81,"Tasa de exámenes médico legales por presunto delito sexual contra niños, niñas y adolescentes",2020,4,6,1632,367.647058823529,2,813,246.0024600246,4,819,488.400488400488
30279,5,5147,81,"Tasa de exámenes médico legales por presunto delito sexual contra niños, niñas y adolescentes",2020,3,1,6208,16.1082474226804,0,3162,0,1,3046,32.8299409061064
30280,5,5150,81,"Tasa de exámenes médico legales por presunto delito sexual contra niños, niñas y adolescentes",2020,3,2,266,751.87969924812,1,139,719.424460431655,1,127,787.40157480315
30281,5,5150,81,"Tasa de exámenes médico legales por presunto delito sexual contra niños, niñas y adolescentes",2020,4,2,323,619.195046439629,0,165,0,2,158,1265.82278481013
30282,5,5154,81,"Tasa de exámenes médico legales por presunto delito sexual contra niños, niñas y adolescentes",2020,3,9,11394,78.9889415481832,1,5796,17.2532781228433,8,5598,142.90818149339
30283,5,5154,81,"Tasa de exámenes médico legales por presunto delito sexual contra niños, niñas y adolescentes",2020,4,9,10861,82.8652978547095,1,5429,18.4195984527537,8,5432,147.275405007364
30284,5,5154,121,Tasa de exámenes médico legales por presunto delito sexual cuando la víctima está entre 18 y 28 años,2020,5,5,17770,28.137310073157,0,8580,0,5,9190,54.4069640914037
30285,5,5172,81,"Tasa de exámenes médico legales por presunto delito sexual contra niños, niñas y adolescentes",2020,3,5,7326,68.2500682500683,0,3753,0,5,3573,139.93842709208
30286,5,5172,81,"Tasa de exámenes médico legales por presunto delito sexual contra niños, niñas y adolescentes",2020,4,1,7370,13.5685210312076,0,3705,0,1,3665,27.2851296043656
30287,5,5172,121,Tasa de exámenes médico legales por presunto delito sexual cuando la víctima está entre 18 y 28 años,2020,5,3,11928,25.1509054325956,1,5757,17.3701580684384,2,6171,32.4096580781073
30288,5,5190,81,"Tasa de exámenes médico legales por presunto delito sexual contra niños, niñas y adolescentes",2020,3,1,844,118.483412322275,0,423,0,1,421,237.529691211401
30289,5,5190,81,"Tasa de exámenes médico legales por presunto delito sexual contra niños, niñas y adolescentes",2020,4,5,875,571.428571428571,1,436,229.357798165138,4,439,911.161731207289
30290,5,5101,81,"Tasa de exámenes médico legales por presunto delito sexual contra niños, niñas y adolescentes",2020,2,2,1865,107.238605898123,0,969,0,2,896,223.214285714286
30291,5,5101,81,"Tasa de exámenes médico legales por presunto delito sexual contra niños, niñas y adolescentes",2020,3,6,2440,245.901639344262,0,1273,0,6,1167,514.13881748072
30292,5,5101,81,"Tasa de exámenes médico legales por presunto delito sexual contra niños, niñas y adolescentes",2020,4,4,2551,156.801254410035,0,1324,0,4,1227,325.99837000815
30293,5,5101,121,Tasa de exámenes médico legales por presunto delito sexual cuando la víctima está entre 18 y 28 años,2020,5,1,4295,23.2828870779977,0,2214,0,1,2081,48.0538202787122
30294,5,5197,81,"Tasa de exámenes médico legales por presunto delito sexual contra niños, niñas y adolescentes",2020,2,1,1326,75.4147812971342,0,682,0,1,644,155.27950310559
30295,5,5197,81,"Tasa de exámenes médico legales por presunto delito sexual contra niños, niñas y adolescentes",2020,4,1,1408,71.0227272727273,0,693,0,1,715,139.86013986014
30296,5,5209,81,"Tasa de exámenes médico legales por presunto delito sexual contra niños, niñas y adolescentes",2020,2,4,1501,266.489007328448,1,776,128.865979381443,3,725,413.793103448276
30297,5,5209,81,"Tasa de exámenes médico legales por presunto delito sexual contra niños, niñas y adolescentes",2020,3,5,2055,243.30900243309,4,1057,378.429517502365,1,998,100.200400801603
30298,5,5209,81,"Tasa de exámenes médico legales por presunto delito sexual contra niños, niñas y adolescentes",2020,4,5,2241,223.114680946006,1,1144,87.4125874125874,4,1097,364.630811303555
30299,5,5209,121,Tasa de exámenes médico legales por presunto delito sexual cuando la víctima está entre 18 y 28 años,2020,5,1,3605,27.7392510402219,1,1813,55.1571980143409,0,1792,0
30300,5,5212,81,"Tasa de exámenes médico legales por presunto delito sexual contra niños, niñas y adolescentes",2020,2,10,4423,226.090888537192,2,2254,88.7311446317658,8,2169,368.833563854311
30301,5,5212,81,"Tasa de exámenes médico legales por presunto delito sexual contra niños, niñas y adolescentes",2020,3,6,5642,106.34526763559,2,2895,69.0846286701209,4,2747,145.613396432472
30302,5,5212,81,"Tasa de exámenes médico legales por presunto delito sexual contra niños, niñas y adolescentes",2020,4,7,6574,106.480073014907,0,3353,0,7,3221,217.323812480596
30303,5,5212,121,Tasa de exámenes médico legales por presunto delito sexual cuando la víctima está entre 18 y 28 años,2020,5,1,15406,6.49097754121771,0,7797,0,1,7609,13.1423314495992
30304,5,5234,81,"Tasa de exámenes médico legales por presunto delito sexual contra niños, niñas y adolescentes",2020,2,4,3091,129.407958589453,1,1607,62.2277535780958,3,1484,202.156334231806
30305,5,5234,81,"Tasa de exámenes médico legales por presunto delito sexual contra niños, niñas y adolescentes",2020,3,7,3288,212.895377128954,2,1698,117.785630153121,5,1590,314.465408805031
30306,5,5234,81,"Tasa de exámenes médico legales por presunto delito sexual contra niños, niñas y adolescentes",2020,4,12,2781,431.499460625674,4,1418,282.087447108604,8,1363,586.940572267058
30307,5,5240,81,"Tasa de exámenes médico legales por presunto delito sexual contra niños, niñas y adolescentes",2020,3,2,976,204.918032786885,1,494,202.429149797571,1,482,207.46887966805
30308,5,5240,81,"Tasa de exámenes médico legales por presunto delito sexual contra niños, niñas y adolescentes",2020,4,2,1049,190.657769304099,0,570,0,2,479,417.536534446764
30309,5,5250,81,"Tasa de exámenes médico legales por presunto delito sexual contra niños, niñas y adolescentes",2020,3,1,7386,13.5391280801516,1,3753,26.6453503863576,0,3633,0
30310,5,5250,81,"Tasa de exámenes médico legales por presunto delito sexual contra niños, niñas y adolescentes",2020,4,2,6809,29.3728888236158,0,3487,0,2,3322,60.2046959662854
30311,5,5148,81,"Tasa de exámenes médico legales por presunto delito sexual contra niños, niñas y adolescentes",2020,2,15,5022,298.68578255675,2,2574,77.7000777000777,13,2448,531.045751633987
30312,5,5148,81,"Tasa de exámenes médico legales por presunto delito sexual contra niños, niñas y adolescentes",2020,3,9,5737,156.876416245424,4,2900,137.931034482759,5,2837,176.242509693338
30313,5,5148,81,"Tasa de exámenes médico legales por presunto delito sexual contra niños, niñas y adolescentes",2020,4,14,5785,242.005185825411,2,2887,69.2760651195012,12,2898,414.07867494824
30314,5,5148,121,Tasa de exámenes médico legales por presunto delito sexual cuando la víctima está entre 18 y 28 años,2020,5,3,11917,25.1741210036083,0,6005,0,3,5912,50.744248985115
30315,5,5697,81,"Tasa de exámenes médico legales por presunto delito sexual contra niños, niñas y adolescentes",2020,3,2,3894,51.3610683102209,2,1998,100.1001001001,0,1896,0
30316,5,5697,81,"Tasa de exámenes médico legales por presunto delito sexual contra niños, niñas y adolescentes",2020,4,4,3632,110.132158590308,2,1830,109.289617486339,2,1802,110.987791342952
30317,5,5697,121,Tasa de exámenes médico legales por presunto delito sexual cuando la víctima está entre 18 y 28 años,2020,5,3,6371,47.0883691728143,0,3050,0,3,3321,90.3342366757001
30318,5,5264,81,"Tasa de exámenes médico legales por presunto delito sexual contra niños, niñas y adolescentes",2020,2,1,959,104.275286757039,1,458,218.340611353712,0,501,0
30319,5,5264,81,"Tasa de exámenes médico legales por presunto delito sexual contra niños, niñas y adolescentes",2020,3,1,1156,86.5051903114187,1,554,180.505415162455,0,602,0
30320,5,5264,81,"Tasa de exámenes médico legales por presunto delito sexual contra niños, niñas y adolescentes",2020,4,2,1178,169.779286926995,0,581,0,2,597,335.00837520938
30321,5,5264,121,Tasa de exámenes médico legales por presunto delito sexual cuando la víctima está entre 18 y 28 años,2020,5,2,2154,92.8505106778087,0,1113,0,2,1041,192.122958693564
30322,5,5266,81,"Tasa de exámenes médico legales por presunto delito sexual contra niños, niñas y adolescentes",2020,2,4,10815,36.9856680536292,2,5518,36.2450163102573,2,5297,37.7572210685294
30323,5,5266,81,"Tasa de exámenes médico legales por presunto delito sexual contra niños, niñas y adolescentes",2020,3,5,13420,37.25782414307,2,6951,28.7728384405122,3,6469,46.3750193229247
30324,5,5266,81,"Tasa de exámenes médico legales por presunto delito sexual contra niños, niñas y adolescentes",2020,4,5,15331,32.6136586002218,0,7905,0,5,7426,67.330999192028
30325,5,5266,121,Tasa de exámenes médico legales por presunto delito sexual cuando la víctima está entre 18 y 28 años,2020,5,7,39018,17.940437746681,2,19157,10.4400480242209,5,19861,25.1749660137959
30326,5,5282,81,"Tasa de exámenes médico legales por presunto delito sexual contra niños, niñas y adolescentes",2020,2,1,1390,71.9424460431655,1,669,149.476831091181,0,721,0
30327,5,5282,81,"Tasa de exámenes médico legales por presunto delito sexual contra niños, niñas y adolescentes",2020,3,3,1920,156.25,1,954,104.82180293501,2,966,207.03933747412
30328,5,5282,81,"Tasa de exámenes médico legales por presunto delito sexual contra niños, niñas y adolescentes",2020,4,4,2131,187.705302674801,1,1098,91.0746812386157,3,1033,290.416263310745
30329,5,5284,81,"Tasa de exámenes médico legales por presunto delito sexual contra niños, niñas y adolescentes",2020,4,1,2246,44.5235975066785,0,1168,0,1,1078,92.7643784786642
30330,5,5308,81,"Tasa de exámenes médico legales por presunto delito sexual contra niños, niñas y adolescentes",2020,2,1,3321,30.1114122252334,0,1755,0,1,1566,63.8569604086846
30331,5,5308,81,"Tasa de exámenes médico legales por presunto delito sexual contra niños, niñas y adolescentes",2020,3,7,4106,170.482221139795,3,2125,141.176470588235,4,1981,201.918223119637
30332,5,5308,81,"Tasa de exámenes médico legales por presunto delito sexual contra niños, niñas y adolescentes",2020,4,1,4520,22.1238938053097,0,2299,0,1,2221,45.024763619991
30333,5,5308,121,Tasa de exámenes médico legales por presunto delito sexual cuando la víctima está entre 18 y 28 años,2020,5,2,10086,19.8294665873488,0,5119,0,2,4967,40.2657539762432
30334,5,5310,81,"Tasa de exámenes médico legales por presunto delito sexual contra niños, niñas y adolescentes",2020,2,2,625,320,0,297,0,2,328,609.756097560976
30335,5,5310,81,"Tasa de exámenes médico legales por presunto delito sexual contra niños, niñas y adolescentes",2020,3,5,862,580.046403712297,0,446,0,5,416,1201.92307692308
30336,5,5313,81,"Tasa de exámenes médico legales por presunto delito sexual contra niños, niñas y adolescentes",2020,2,2,978,204.498977505112,0,516,0,2,462,432.900432900433
30337,5,5313,81,"Tasa de exámenes médico legales por presunto delito sexual contra niños, niñas y adolescentes",2020,3,2,1081,185.013876040703,0,578,0,2,503,397.614314115308
30338,5,5313,81,"Tasa de exámenes médico legales por presunto delito sexual contra niños, niñas y adolescentes",2020,4,2,976,204.918032786885,0,511,0,2,465,430.10752688172
30339,5,5318,81,"Tasa de exámenes médico legales por presunto delito sexual contra niños, niñas y adolescentes",2020,2,3,3853,77.861406696081,1,2048,48.828125,2,1805,110.803324099723
30340,5,5318,81,"Tasa de exámenes médico legales por presunto delito sexual contra niños, niñas y adolescentes",2020,3,7,4425,158.19209039548,2,2338,85.5431993156544,5,2087,239.578342117873
30341,5,5318,81,"Tasa de exámenes médico legales por presunto delito sexual contra niños, niñas y adolescentes",2020,4,14,4669,299.850074962519,1,2454,40.7497962510187,13,2215,586.907449209932
30342,5,5318,121,Tasa de exámenes médico legales por presunto delito sexual cuando la víctima está entre 18 y 28 años,2020,5,2,10515,19.020446980504,0,5423,0,2,5092,39.2772977219167
30343,5,5321,81,"Tasa de exámenes médico legales por presunto delito sexual contra niños, niñas y adolescentes",2020,3,1,709,141.043723554302,0,354,0,1,355,281.69014084507
30344,5,5347,81,"Tasa de exámenes médico legales por presunto delito sexual contra niños, niñas y adolescentes",2020,4,1,468,213.675213675214,0,260,0,1,208,480.769230769231
30345,5,5353,81,"Tasa de exámenes médico legales por presunto delito sexual contra niños, niñas y adolescentes",2020,3,1,493,202.839756592292,1,240,416.666666666667,0,253,0
30346,5,5353,81,"Tasa de exámenes médico legales por presunto delito sexual contra niños, niñas y adolescentes",2020,4,1,508,196.850393700787,0,255,0,1,253,395.256916996047
30347,5,5360,81,"Tasa de exámenes médico legales por presunto delito sexual contra niños, niñas y adolescentes",2020,2,16,16230,98.5828712261245,3,8368,35.8508604206501,13,7862,165.352327651997
30348,5,5360,81,"Tasa de exámenes médico legales por presunto delito sexual contra niños, niñas y adolescentes",2020,3,23,19485,118.039517577624,6,10009,59.9460485562993,17,9476,179.400590966653
30349,5,5360,81,"Tasa de exámenes médico legales por presunto delito sexual contra niños, niñas y adolescentes",2020,4,21,21724,96.6672804271773,2,11046,18.1061017562919,19,10678,177.935943060498
30350,5,5360,121,Tasa de exámenes médico legales por presunto delito sexual cuando la víctima está entre 18 y 28 años,2020,5,14,55473,25.237502929353,1,27853,3.59027752845295,13,27620,47.0673425054309
30351,5,5360,81,"Tasa de exámenes médico legales por presunto delito sexual contra niños, niñas y adolescentes",2020,1,1,3209,31.1623558741041,0,1656,0,1,1553,64.3915003219575
30352,5,5361,81,"Tasa de exámenes médico legales por presunto delito sexual contra niños, niñas y adolescentes",2020,2,2,2062,96.9932104752667,1,1020,98.0392156862745,1,1042,95.9692898272553
30353,5,5361,81,"Tasa de exámenes médico legales por presunto delito sexual contra niños, niñas y adolescentes",2020,3,3,2644,113.464447806354,0,1379,0,3,1265,237.154150197628
30354,5,5361,81,"Tasa de exámenes médico legales por presunto delito sexual contra niños, niñas y adolescentes",2020,4,2,2704,73.9644970414201,0,1460,0,2,1244,160.771704180064
30355,5,5364,81,"Tasa de exámenes médico legales por presunto delito sexual contra niños, niñas y adolescentes",2020,3,2,1241,161.16035455278,0,639,0,2,602,332.225913621262
30356,5,5364,81,"Tasa de exámenes médico legales por presunto delito sexual contra niños, niñas y adolescentes",2020,4,5,1320,378.787878787879,1,700,142.857142857143,4,620,645.161290322581
30357,5,5364,121,Tasa de exámenes médico legales por presunto delito sexual cuando la víctima está entre 18 y 28 años,2020,5,1,2397,41.7188151856487,0,1290,0,1,1107,90.3342366757001
30358,5,5368,81,"Tasa de exámenes médico legales por presunto delito sexual contra niños, niñas y adolescentes",2020,2,3,801,374.531835205993,2,410,487.80487804878,1,391,255.754475703325
30359,5,5368,81,"Tasa de exámenes médico legales por presunto delito sexual contra niños, niñas y adolescentes",2020,3,7,1058,661.625708884688,4,545,733.94495412844,3,513,584.795321637427
30360,5,5368,81,"Tasa de exámenes médico legales por presunto delito sexual contra niños, niñas y adolescentes",2020,4,8,1144,699.300699300699,2,578,346.020761245675,6,566,1060.07067137809
30361,5,5368,121,Tasa de exámenes médico legales por presunto delito sexual cuando la víctima está entre 18 y 28 años,2020,5,2,2011,99.4530084535057,0,1028,0,2,983,203.458799593082
30362,5,5376,81,"Tasa de exámenes médico legales por presunto delito sexual contra niños, niñas y adolescentes",2020,2,4,4170,95.9232613908873,1,2077,48.1463649494463,3,2093,143.334925943622
30363,5,5376,81,"Tasa de exámenes médico legales por presunto delito sexual contra niños, niñas y adolescentes",2020,3,6,5321,112.760759255779,2,2696,74.1839762611276,4,2625,152.380952380952
30364,5,5376,81,"Tasa de exámenes médico legales por presunto delito sexual contra niños, niñas y adolescentes",2020,4,15,5929,252.993759487266,4,3033,131.882624464227,11,2896,379.834254143646
30365,5,5376,121,Tasa de exámenes médico legales por presunto delito sexual cuando la víctima está entre 18 y 28 años,2020,5,6,12604,47.6039352586481,0,6370,0,6,6234,96.2463907603465
30366,5,5380,81,"Tasa de exámenes médico legales por presunto delito sexual contra niños, niñas y adolescentes",2020,2,4,4298,93.0665425779432,1,2199,45.475216007276,3,2099,142.92520247737
30367,5,5380,81,"Tasa de exámenes médico legales por presunto delito sexual contra niños, niñas y adolescentes",2020,3,7,5256,133.181126331811,3,2729,109.930377427629,4,2527,158.290462999604
30368,5,5380,81,"Tasa de exámenes médico legales por presunto delito sexual contra niños, niñas y adolescentes",2020,4,9,5855,153.714773697694,0,3042,0,9,2813,319.943121222894
30369,5,5380,121,Tasa de exámenes médico legales por presunto delito sexual cuando la víctima está entre 18 y 28 años,2020,5,3,14120,21.2464589235127,0,7137,0,3,6983,42.9614778748389
30370,5,5400,81,"Tasa de exámenes médico legales por presunto delito sexual contra niños, niñas y adolescentes",2020,3,1,2038,49.0677134445535,0,1051,0,1,987,101.317122593718
30371,5,5411,81,"Tasa de exámenes médico legales por presunto delito sexual contra niños, niñas y adolescentes",2020,3,1,979,102.145045965271,0,520,0,1,459,217.864923747277
30372,5,5440,81,"Tasa de exámenes médico legales por presunto delito sexual contra niños, niñas y adolescentes",2020,2,1,5204,19.2159877017679,0,2754,0,1,2450,40.8163265306122
30373,5,5440,81,"Tasa de exámenes médico legales por presunto delito sexual contra niños, niñas y adolescentes",2020,3,3,6081,49.3339911198816,1,3169,31.5556958030925,2,2912,68.6813186813187
30374,5,5440,81,"Tasa de exámenes médico legales por presunto delito sexual contra niños, niñas y adolescentes",2020,4,8,6272,127.551020408163,2,3199,62.5195373554236,6,3073,195.248942401562
30375,5,5001,81,"Tasa de exámenes médico legales por presunto delito sexual contra niños, niñas y adolescentes",2020,2,109,149238,73.0376981733875,29,76198,38.0587416992572,80,73040,109.529025191676
30376,5,5001,81,"Tasa de exámenes médico legales por presunto delito sexual contra niños, niñas y adolescentes",2020,3,164,183347,89.4478775218575,29,93233,31.104866302704,135,90114,149.810240362208
30377,5,5001,81,"Tasa de exámenes médico legales por presunto delito sexual contra niños, niñas y adolescentes",2020,4,214,206135,103.815460741747,18,104226,17.2701629152035,196,101909,192.32844989157
30378,5,5001,121,Tasa de exámenes médico legales por presunto delito sexual cuando la víctima está entre 18 y 28 años,2020,5,83,499039,16.6319666398819,5,250577,1.99539462919582,78,248462,31.3931305390764
30379,5,5001,81,"Tasa de exámenes médico legales por presunto delito sexual contra niños, niñas y adolescentes",2020,1,1,29257,3.41798543938203,0,14957,0,1,14300,6.99300699300699
30380,5,5467,81,"Tasa de exámenes médico legales por presunto delito sexual contra niños, niñas y adolescentes",2020,3,2,571,350.262697022767,1,283,353.356890459364,1,288,347.222222222222
30381,5,5467,81,"Tasa de exámenes médico legales por presunto delito sexual contra niños, niñas y adolescentes",2020,4,3,593,505.902192242833,1,309,323.624595469256,2,284,704.225352112676
30382,5,5480,81,"Tasa de exámenes médico legales por presunto delito sexual contra niños, niñas y adolescentes",2020,2,2,1848,108.225108225108,2,926,215.982721382289,0,922,0
30383,5,5480,81,"Tasa de exámenes médico legales por presunto delito sexual contra niños, niñas y adolescentes",2020,3,7,2036,343.811394891945,0,1047,0,7,989,707.78564206269
30384,5,5480,81,"Tasa de exámenes médico legales por presunto delito sexual contra niños, niñas y adolescentes",2020,4,7,1782,392.817059483726,1,934,107.066381156317,6,848,707.547169811321
30385,5,5483,81,"Tasa de exámenes médico legales por presunto delito sexual contra niños, niñas y adolescentes",2020,4,1,1102,90.7441016333938,0,583,0,1,519,192.678227360308
30386,5,5495,81,"Tasa de exámenes médico legales por presunto delito sexual contra niños, niñas y adolescentes",2020,3,1,3817,26.1985852763951,1,1933,51.7330574236937,0,1884,0
30387,5,5490,81,"Tasa de exámenes médico legales por presunto delito sexual contra niños, niñas y adolescentes",2020,2,1,5164,19.3648334624322,0,2628,0,1,2536,39.4321766561514
30388,5,5490,81,"Tasa de exámenes médico legales por presunto delito sexual contra niños, niñas y adolescentes",2020,3,13,6185,210.18593371059,3,3190,94.0438871473354,10,2995,333.889816360601
30389,5,5490,81,"Tasa de exámenes médico legales por presunto delito sexual contra niños, niñas y adolescentes",2020,4,5,5763,86.7603678639597,1,2975,33.6134453781513,4,2788,143.472022955524
30390,5,5541,81,"Tasa de exámenes médico legales por presunto delito sexual contra niños, niñas y adolescentes",2020,2,2,1649,121.285627653123,0,816,0,2,833,240.096038415366
30391,5,5541,81,"Tasa de exámenes médico legales por presunto delito sexual contra niños, niñas y adolescentes",2020,4,4,1907,209.753539590981,0,972,0,4,935,427.807486631016
30392,5,5576,81,"Tasa de exámenes médico legales por presunto delito sexual contra niños, niñas y adolescentes",2020,3,1,848,117.924528301887,0,428,0,1,420,238.095238095238
30393,5,5579,81,"Tasa de exámenes médico legales por presunto delito sexual contra niños, niñas y adolescentes",2020,2,3,3110,96.4630225080386,0,1588,0,3,1522,197.109067017083
30394,5,5579,81,"Tasa de exámenes médico legales por presunto delito sexual contra niños, niñas y adolescentes",2020,3,9,3884,231.719876416066,2,1984,100.806451612903,7,1900,368.421052631579
30395,5,5579,81,"Tasa de exámenes médico legales por presunto delito sexual contra niños, niñas y adolescentes",2020,4,6,3948,151.975683890577,0,2005,0,6,1943,308.800823468863
30396,5,5591,81,"Tasa de exámenes médico legales por presunto delito sexual contra niños, niñas y adolescentes",2020,3,1,1871,53.4473543559594,0,961,0,1,910,109.89010989011
30397,5,5591,81,"Tasa de exámenes médico legales por presunto delito sexual contra niños, niñas y adolescentes",2020,4,6,1816,330.396475770925,0,947,0,6,869,690.448791714614
30398,5,5591,121,Tasa de exámenes médico legales por presunto delito sexual cuando la víctima está entre 18 y 28 años,2020,5,1,3946,25.3421186011151,0,2356,0,1,1590,62.8930817610063
30399,5,5604,81,"Tasa de exámenes médico legales por presunto delito sexual contra niños, niñas y adolescentes",2020,2,2,3127,63.9590661976335,1,1620,61.7283950617284,1,1507,66.35700066357
30400,5,5604,81,"Tasa de exámenes médico legales por presunto delito sexual contra niños, niñas y adolescentes",2020,3,1,3583,27.9095729835334,0,1853,0,1,1730,57.8034682080925
30401,5,5604,81,"Tasa de exámenes médico legales por presunto delito sexual contra niños, niñas y adolescentes",2020,4,1,3353,29.8240381747689,0,1716,0,1,1637,61.0873549175321
30402,5,5607,81,"Tasa de exámenes médico legales por presunto delito sexual contra niños, niñas y adolescentes",2020,2,1,1519,65.8327847267939,0,804,0,1,715,139.86013986014
30403,5,5607,81,"Tasa de exámenes médico legales por presunto delito sexual contra niños, niñas y adolescentes",2020,3,2,1840,108.695652173913,1,960,104.166666666667,1,880,113.636363636364
30404,5,5607,81,"Tasa de exámenes médico legales por presunto delito sexual contra niños, niñas y adolescentes",2020,4,3,1916,156.576200417537,0,996,0,3,920,326.086956521739
30405,5,5607,121,Tasa de exámenes médico legales por presunto delito sexual cuando la víctima está entre 18 y 28 años,2020,5,3,3950,75.9493670886076,0,1997,0,3,1953,153.609831029186
30406,5,5615,81,"Tasa de exámenes médico legales por presunto delito sexual contra niños, niñas y adolescentes",2020,2,5,8454,59.1436006624083,3,4296,69.8324022346369,2,4158,48.1000481000481
30407,5,5615,81,"Tasa de exámenes médico legales por presunto delito sexual contra niños, niñas y adolescentes",2020,3,9,10374,86.7553499132446,0,5322,0,9,5052,178.147268408551
30408,5,5615,81,"Tasa de exámenes médico legales por presunto delito sexual contra niños, niñas y adolescentes",2020,4,10,11686,85.5724798904672,1,6112,16.3612565445026,9,5574,161.463939720129
30409,5,5615,121,Tasa de exámenes médico legales por presunto delito sexual cuando la víctima está entre 18 y 28 años,2020,5,3,27016,11.1045306485046,2,14062,14.2227279192149,1,12954,7.71962328238382
30410,5,5631,81,"Tasa de exámenes médico legales por presunto delito sexual contra niños, niñas y adolescentes",2020,2,3,4984,60.1926163723916,1,2579,38.7747188832881,2,2405,83.1600831600832
30411,5,5631,81,"Tasa de exámenes médico legales por presunto delito sexual contra niños, niñas y adolescentes",2020,3,9,5265,170.940170940171,3,2724,110.132158590308,6,2541,236.127508854782
30412,5,5631,81,"Tasa de exámenes médico legales por presunto delito sexual contra niños, niñas y adolescentes",2020,4,6,5301,113.186191284663,1,2683,37.2717107715244,5,2618,190.985485103132
30413,5,5631,121,Tasa de exámenes médico legales por presunto delito sexual cuando la víctima está entre 18 y 28 años,2020,5,3,15678,19.1350937619594,0,7538,0,3,8140,36.8550368550369
30414,5,5642,81,"Tasa de exámenes médico legales por presunto delito sexual contra niños, niñas y adolescentes",2020,2,1,1401,71.3775874375446,0,700,0,1,701,142.65335235378
30415,5,5642,81,"Tasa de exámenes médico legales por presunto delito sexual contra niños, niñas y adolescentes",2020,3,13,1741,746.697300402068,2,862,232.018561484919,11,879,1251.4220705347
30416,5,5642,81,"Tasa de exámenes médico legales por presunto delito sexual contra niños, niñas y adolescentes",2020,4,3,1817,165.107319757843,0,907,0,3,910,329.67032967033
30417,5,5642,121,Tasa de exámenes médico legales por presunto delito sexual cuando la víctima está entre 18 y 28 años,2020,5,1,3109,32.1646831778707,0,1589,0,1,1520,65.7894736842105
30418,5,5647,81,"Tasa de exámenes médico legales por presunto delito sexual contra niños, niñas y adolescentes",2020,2,2,731,273.59781121751,2,376,531.914893617021,0,355,0
30419,5,5647,81,"Tasa de exámenes médico legales por presunto delito sexual contra niños, niñas y adolescentes",2020,3,2,846,236.406619385343,1,435,229.885057471264,1,411,243.30900243309
30420,5,5647,121,Tasa de exámenes médico legales por presunto delito sexual cuando la víctima está entre 18 y 28 años,2020,5,2,1281,156.128024980484,0,650,0,2,631,316.957210776545
30421,5,5649,81,"Tasa de exámenes médico legales por presunto delito sexual contra niños, niñas y adolescentes",2020,2,1,1288,77.639751552795,0,649,0,1,639,156.494522691706
30422,5,5649,81,"Tasa de exámenes médico legales por presunto delito sexual contra niños, niñas y adolescentes",2020,3,2,1599,125.078173858662,1,823,121.506682867558,1,776,128.865979381443
30423,5,5649,81,"Tasa de exámenes médico legales por presunto delito sexual contra niños, niñas y adolescentes",2020,4,6,1580,379.746835443038,0,839,0,6,741,809.716599190283
30424,5,5649,121,Tasa de exámenes médico legales por presunto delito sexual cuando la víctima está entre 18 y 28 años,2020,5,3,2458,122.050447518308,0,1306,0,3,1152,260.416666666667
30425,5,5656,81,"Tasa de exámenes médico legales por presunto delito sexual contra niños, niñas y adolescentes",2020,3,1,1439,69.4927032661571,0,710,0,1,729,137.174211248285
30426,5,5656,81,"Tasa de exámenes médico legales por presunto delito sexual contra niños, niñas y adolescentes",2020,4,3,1502,199.733688415446,1,771,129.70168612192,2,731,273.59781121751
30427,5,5659,81,"Tasa de exámenes médico legales por presunto delito sexual contra niños, niñas y adolescentes",2020,3,1,2972,33.6473755047106,1,1533,65.2315720808871,0,1439,0
30428,5,5659,81,"Tasa de exámenes médico legales por presunto delito sexual contra niños, niñas y adolescentes",2020,4,1,2711,36.8867576540022,0,1391,0,1,1320,75.7575757575758
30429,5,5660,81,"Tasa de exámenes médico legales por presunto delito sexual contra niños, niñas y adolescentes",2020,2,2,1340,149.253731343284,0,681,0,2,659,303.490136570561
30430,5,5660,81,"Tasa de exámenes médico legales por presunto delito sexual contra niños, niñas y adolescentes",2020,3,4,1533,260.926288323549,1,788,126.903553299492,3,745,402.684563758389
30431,5,5660,81,"Tasa de exámenes médico legales por presunto delito sexual contra niños, niñas y adolescentes",2020,4,6,1384,433.526011560694,0,716,0,6,668,898.203592814371
30432,5,5660,121,Tasa de exámenes médico legales por presunto delito sexual cuando la víctima está entre 18 y 28 años,2020,5,1,2158,46.339202965709,0,1070,0,1,1088,91.9117647058823
30433,5,5664,81,"Tasa de exámenes médico legales por presunto delito sexual contra niños, niñas y adolescentes",2020,2,1,1723,58.0383052814858,1,864,115.740740740741,0,859,0
30434,5,5664,81,"Tasa de exámenes médico legales por presunto delito sexual contra niños, niñas y adolescentes",2020,3,3,2136,140.449438202247,1,1079,92.678405931418,2,1057,189.214758751183
30435,5,5664,81,"Tasa de exámenes médico legales por presunto delito sexual contra niños, niñas y adolescentes",2020,4,3,2265,132.450331125828,0,1138,0,3,1127,266.193433895297
30436,5,5664,121,Tasa de exámenes médico legales por presunto delito sexual cuando la víctima está entre 18 y 28 años,2020,5,3,4285,70.0116686114352,0,2126,0,3,2159,138.953219082909
30437,5,5665,81,"Tasa de exámenes médico legales por presunto delito sexual contra niños, niñas y adolescentes",2020,3,1,4056,24.65483234714,1,2113,47.3260766682442,0,1943,0
30438,5,5665,81,"Tasa de exámenes médico legales por presunto delito sexual contra niños, niñas y adolescentes",2020,4,1,3999,25.0062515628907,0,2144,0,1,1855,53.9083557951483
30439,5,5665,121,Tasa de exámenes médico legales por presunto delito sexual cuando la víctima está entre 18 y 28 años,2020,5,1,5637,17.7399325882562,1,3001,33.3222259246918,0,2636,0
30440,5,5667,81,"Tasa de exámenes médico legales por presunto delito sexual contra niños, niñas y adolescentes",2020,2,2,1198,166.944908180301,0,627,0,2,571,350.262697022767
30441,5,5667,81,"Tasa de exámenes médico legales por presunto delito sexual contra niños, niñas y adolescentes",2020,3,2,1445,138.40830449827,2,772,259.067357512953,0,673,0
30442,5,5667,81,"Tasa de exámenes médico legales por presunto delito sexual contra niños, niñas y adolescentes",2020,4,2,1467,136.332651670075,0,781,0,2,686,291.545189504373
30443,5,5667,121,Tasa de exámenes médico legales por presunto delito sexual cuando la víctima está entre 18 y 28 años,2020,5,2,2545,78.5854616895874,0,1269,0,2,1276,156.739811912226
30444,5,5670,81,"Tasa de exámenes médico legales por presunto delito sexual contra niños, niñas y adolescentes",2020,2,2,1731,115.540150202195,0,855,0,2,876,228.310502283105
30445,5,5670,81,"Tasa de exámenes médico legales por presunto delito sexual contra niños, niñas y adolescentes",2020,3,1,2164,46.2107208872458,0,1098,0,1,1066,93.8086303939963
30446,5,5670,81,"Tasa de exámenes médico legales por presunto delito sexual contra niños, niñas y adolescentes",2020,4,2,2185,91.533180778032,0,1131,0,2,1054,189.753320683112
30447,5,5670,121,Tasa de exámenes médico legales por presunto delito sexual cuando la víctima está entre 18 y 28 años,2020,5,1,3511,28.4819139846198,0,1813,0,1,1698,58.8928150765607
30448,5,5674,81,"Tasa de exámenes médico legales por presunto delito sexual contra niños, niñas y adolescentes",2020,3,2,2028,98.6193293885602,0,1063,0,2,965,207.253886010363
30449,5,5674,81,"Tasa de exámenes médico legales por presunto delito sexual contra niños, niñas y adolescentes",2020,4,1,2107,47.4608448030375,0,1149,0,1,958,104.384133611691
30450,5,5679,81,"Tasa de exámenes médico legales por presunto delito sexual contra niños, niñas y adolescentes",2020,2,3,1534,195.567144719687,1,798,125.31328320802,2,736,271.739130434783
30451,5,5679,81,"Tasa de exámenes médico legales por presunto delito sexual contra niños, niñas y adolescentes",2020,3,4,2155,185.614849187935,1,1135,88.1057268722467,3,1020,294.117647058824
30452,5,5679,81,"Tasa de exámenes médico legales por presunto delito sexual contra niños, niñas y adolescentes",2020,4,8,2418,330.85194375517,2,1279,156.372165754496,6,1139,526.777875329236
30453,5,5679,121,Tasa de exámenes médico legales por presunto delito sexual cuando la víctima está entre 18 y 28 años,2020,5,1,4147,24.1138172172655,0,2161,0,1,1986,50.3524672708963
30454,5,5042,81,"Tasa de exámenes médico legales por presunto delito sexual contra niños, niñas y adolescentes",2020,2,4,1969,203.148806500762,0,1002,0,4,967,413.650465356774
30455,5,5042,81,"Tasa de exámenes médico legales por presunto delito sexual contra niños, niñas y adolescentes",2020,3,4,2522,158.604282315623,1,1301,76.8639508070715,3,1221,245.700245700246
30456,5,5042,81,"Tasa de exámenes médico legales por presunto delito sexual contra niños, niñas y adolescentes",2020,4,3,2657,112.90929619872,0,1377,0,3,1280,234375
30457,5,5042,121,Tasa de exámenes médico legales por presunto delito sexual cuando la víctima está entre 18 y 28 años,2020,5,1,4861,20.571898786258,0,2452,0,1,2409,41.51100041511
30458,5,5686,81,"Tasa de exámenes médico legales por presunto delito sexual contra niños, niñas y adolescentes",2020,2,1,3113,32.123353678124,0,1583,0,1,1530,65.359477124183
30459,5,5686,81,"Tasa de exámenes médico legales por presunto delito sexual contra niños, niñas y adolescentes",2020,3,6,3800,157.894736842105,0,1909,0,6,1891,317.292437863564
30460,5,5686,81,"Tasa de exámenes médico legales por presunto delito sexual contra niños, niñas y adolescentes",2020,4,8,3954,202.326757713708,0,1982,0,8,1972,405.679513184584
30461,5,5686,121,Tasa de exámenes médico legales por presunto delito sexual cuando la víctima está entre 18 y 28 años,2020,5,1,7323,13.6556056261095,0,3781,0,1,3542,28.2326369282891
30462,5,5690,81,"Tasa de exámenes médico legales por presunto delito sexual contra niños, niñas y adolescentes",2020,2,3,821,365.408038976857,1,415,240.963855421687,2,406,492.610837438424
30463,5,5690,81,"Tasa de exámenes médico legales por presunto delito sexual contra niños, niñas y adolescentes",2020,3,1,1100,90.9090909090909,1,571,175.131348511384,0,529,0
30464,5,5690,81,"Tasa de exámenes médico legales por presunto delito sexual contra niños, niñas y adolescentes",2020,4,2,1168,171.232876712329,0,619,0,2,549,364.298724954463
30465,5,5736,81,"Tasa de exámenes médico legales por presunto delito sexual contra niños, niñas y adolescentes",2020,2,4,3784,105.708245243129,0,1948,0,4,1836,217.864923747277
30466,5,5736,81,"Tasa de exámenes médico legales por presunto delito sexual contra niños, niñas y adolescentes",2020,3,4,4418,90.5387052965143,1,2275,43.956043956044,3,2143,139.990667288847
30467,5,5736,81,"Tasa de exámenes médico legales por presunto delito sexual contra niños, niñas y adolescentes",2020,4,10,4372,228.728270814273,2,2257,88.6132033673017,8,2115,378.250591016548
30468,5,5736,121,Tasa de exámenes médico legales por presunto delito sexual cuando la víctima está entre 18 y 28 años,2020,5,2,8046,24.8570718369376,0,4085,0,2,3961,50.4922999242616
30469,5,5756,81,"Tasa de exámenes médico legales por presunto delito sexual contra niños, niñas y adolescentes",2020,3,6,3526,170.164492342598,2,1816,110.132158590308,4,1710,233.918128654971
30470,5,5756,81,"Tasa de exámenes médico legales por presunto delito sexual contra niños, niñas y adolescentes",2020,4,4,3754,106.553010122536,0,1925,0,4,1829,218.698742482231
30471,5,5756,121,Tasa de exámenes médico legales por presunto delito sexual cuando la víctima está entre 18 y 28 años,2020,5,3,6328,47.4083438685209,0,3306,0,3,3022,99.2720052945069
30472,5,5790,81,"Tasa de exámenes médico legales por presunto delito sexual contra niños, niñas y adolescentes",2020,2,2,3075,65.0406504065041,0,1570,0,2,1505,132.890365448505
30473,5,5790,81,"Tasa de exámenes médico legales por presunto delito sexual contra niños, niñas y adolescentes",2020,3,5,3813,131.1303435615,1,1949,51.3083632632119,4,1864,214.592274678112
30474,5,5790,81,"Tasa de exámenes médico legales por presunto delito sexual contra niños, niñas y adolescentes",2020,4,6,3620,165.745856353591,0,1845,0,6,1775,338.028169014085
30475,5,5790,121,Tasa de exámenes médico legales por presunto delito sexual cuando la víctima está entre 18 y 28 años,2020,5,1,4800,20.8333333333333,0,2365,0,1,2435,41.0677618069815
30476,5,5809,81,"Tasa de exámenes médico legales por presunto delito sexual contra niños, niñas y adolescentes",2020,3,1,818,122.249388753056,0,412,0,1,406,246.305418719212
30477,5,5819,81,"Tasa de exámenes médico legales por presunto delito sexual contra niños, niñas y adolescentes",2020,4,1,543,184.162062615101,0,284,0,1,259,386.100386100386
30478,5,5819,121,Tasa de exámenes médico legales por presunto delito sexual cuando la víctima está entre 18 y 28 años,2020,5,1,842,118.764845605701,0,450,0,1,392,255.102040816327
30479,5,5837,81,"Tasa de exámenes médico legales por presunto delito sexual contra niños, niñas y adolescentes",2020,3,6,17404,34.4748333716387,1,8899,11.2372176649062,5,8505,58.7889476778366
30480,5,5837,81,"Tasa de exámenes médico legales por presunto delito sexual contra niños, niñas y adolescentes",2020,4,7,16263,43.0424890856546,0,8281,0,7,7982,87.6973189676773
30481,5,5837,121,Tasa de exámenes médico legales por presunto delito sexual cuando la víctima está entre 18 y 28 años,2020,5,3,25001,11.9995200191992,1,11951,8.36750062756255,2,13050,15.3256704980843
30482,5,5842,81,"Tasa de exámenes médico legales por presunto delito sexual contra niños, niñas y adolescentes",2020,2,1,689,145.137880986938,0,357,0,1,332,301.204819277108
30483,5,5842,81,"Tasa de exámenes médico legales por presunto delito sexual contra niños, niñas y adolescentes",2020,3,3,800,375,0,416,0,3,384,781.25
30484,5,5842,81,"Tasa de exámenes médico legales por presunto delito sexual contra niños, niñas y adolescentes",2020,4,6,745,805.369127516779,1,390,256.410256410256,5,355,1408.45070422535
30485,5,5847,81,"Tasa de exámenes médico legales por presunto delito sexual contra niños, niñas y adolescentes",2020,2,4,3028,132.100396301189,0,1528,0,4,1500,266.666666666667
30486,5,5847,81,"Tasa de exámenes médico legales por presunto delito sexual contra niños, niñas y adolescentes",2020,3,4,3542,112.930547713156,0,1788,0,4,1754,228.050171037628
30487,5,5847,81,"Tasa de exámenes médico legales por presunto delito sexual contra niños, niñas y adolescentes",2020,4,3,3379,88.7836638058597,0,1734,0,3,1645,182.370820668693
30488,5,5847,121,Tasa de exámenes médico legales por presunto delito sexual cuando la víctima está entre 18 y 28 años,2020,5,1,5319,18.8005264147396,0,2693,0,1,2626,38.0807311500381
30489,5,5854,81,"Tasa de exámenes médico legales por presunto delito sexual contra niños, niñas y adolescentes",2020,2,3,1449,207.03933747412,0,751,0,3,698,429.799426934097
30490,5,5854,81,"Tasa de exámenes médico legales por presunto delito sexual contra niños, niñas y adolescentes",2020,3,2,1760,113.636363636364,1,911,109.769484083425,1,849,117.785630153121
30491,5,5854,81,"Tasa de exámenes médico legales por presunto delito sexual contra niños, niñas y adolescentes",2020,4,5,1711,292.226767971946,0,884,0,5,827,604.59492140266
30492,5,5854,81,"Tasa de exámenes médico legales por presunto delito sexual contra niños, niñas y adolescentes",2020,1,1,291,343.642611683849,0,151,0,1,140,714.285714285714
30493,5,5856,81,"Tasa de exámenes médico legales por presunto delito sexual contra niños, niñas y adolescentes",2020,4,1,531,188.323917137476,0,280,0,1,251,398.406374501992
30494,5,5858,81,"Tasa de exámenes médico legales por presunto delito sexual contra niños, niñas y adolescentes",2020,4,2,1354,147.710487444609,1,718,139.275766016713,1,636,157.232704402516
30495,5,5861,81,"Tasa de exámenes médico legales por presunto delito sexual contra niños, niñas y adolescentes",2020,2,3,558,537.634408602151,1,297,336.700336700337,2,261,766.283524904215
30496,5,5861,81,"Tasa de exámenes médico legales por presunto delito sexual contra niños, niñas y adolescentes",2020,3,3,865,346.820809248555,0,440,0,3,425,705.882352941176
30497,5,5861,81,"Tasa de exámenes médico legales por presunto delito sexual contra niños, niñas y adolescentes",2020,4,5,1025,487.80487804878,0,517,0,5,508,984.251968503937
30498,5,5885,81,"Tasa de exámenes médico legales por presunto delito sexual contra niños, niñas y adolescentes",2020,4,2,787,254.129606099111,1,404,247.524752475248,1,383,261.096605744125
30499,5,5887,81,"Tasa de exámenes médico legales por presunto delito sexual contra niños, niñas y adolescentes",2020,2,5,3292,151.883353584447,2,1644,121.654501216545,3,1648,182.038834951456
30500,5,5887,81,"Tasa de exámenes médico legales por presunto delito sexual contra niños, niñas y adolescentes",2020,3,4,4453,89.8270828654839,1,2233,44.7828034034931,3,2220,135.135135135135
30501,5,5887,81,"Tasa de exámenes médico legales por presunto delito sexual contra niños, niñas y adolescentes",2020,4,14,4760,294.117647058824,0,2411,0,14,2349,595.998297147722
30502,5,5887,121,Tasa de exámenes médico legales por presunto delito sexual cuando la víctima está entre 18 y 28 años,2020,5,2,7849,25.4809529876417,0,4017,0,2,3832,52.1920668058455
30503,5,5890,81,"Tasa de exámenes médico legales por presunto delito sexual contra niños, niñas y adolescentes",2020,3,4,2380,168.067226890756,1,1240,80.6451612903226,3,1140,263.157894736842
30504,5,5890,81,"Tasa de exámenes médico legales por presunto delito sexual contra niños, niñas y adolescentes",2020,4,6,2484,241.545893719807,0,1297,0,6,1187,505.47598989048
30505,5,5890,121,Tasa de exámenes médico legales por presunto delito sexual cuando la víctima está entre 18 y 28 años,2020,5,2,3644,54.8847420417124,0,1839,0,2,1805,110.803324099723
30506,5,5893,81,"Tasa de exámenes médico legales por presunto delito sexual contra niños, niñas y adolescentes",2020,2,1,2436,41.0509031198686,0,1235,0,1,1201,83.2639467110741
30507,5,5893,81,"Tasa de exámenes médico legales por presunto delito sexual contra niños, niñas y adolescentes",2020,3,6,2566,233.826968043648,1,1298,77.0416024653313,5,1268,394.321766561514
30508,5,5893,81,"Tasa de exámenes médico legales por presunto delito sexual contra niños, niñas y adolescentes",2020,4,3,2127,141.043723554302,0,1083,0,3,1044,287.35632183908
30509,5,5895,81,"Tasa de exámenes médico legales por presunto delito sexual contra niños, niñas y adolescentes",2020,4,1,3096,32.2997416020672,0,1572,0,1,1524,65.6167979002625
30510,81,81001,81,"Tasa de exámenes médico legales por presunto delito sexual contra niños, niñas y adolescentes",2020,2,9,8900,101.123595505618,4,4490,89.086859688196,5,4410,113.378684807256
30511,81,81001,81,"Tasa de exámenes médico legales por presunto delito sexual contra niños, niñas y adolescentes",2020,3,24,10075,238.213399503722,6,5093,117.808757117612,18,4982,361.300682456845
30512,81,81001,81,"Tasa de exámenes médico legales por presunto delito sexual contra niños, niñas y adolescentes",2020,4,41,10049,408.000796099114,6,5116,117.279124315872,35,4933,709.507399148591
30513,81,81001,121,Tasa de exámenes médico legales por presunto delito sexual cuando la víctima está entre 18 y 28 años,2020,5,9,20549,43.7977517154119,0,10410,0,9,10139,88.7661505079396
30514,81,81001,81,"Tasa de exámenes médico legales por presunto delito sexual contra niños, niñas y adolescentes",2020,1,1,1767,56.5930956423316,0,893,0,1,874,114.41647597254
30515,81,81065,81,"Tasa de exámenes médico legales por presunto delito sexual contra niños, niñas y adolescentes",2020,2,3,6152,48.7646293888166,1,3211,31.1429461227032,2,2941,68.0040802448147
30516,81,81065,81,"Tasa de exámenes médico legales por presunto delito sexual contra niños, niñas y adolescentes",2020,3,11,6899,159.443397593854,3,3602,83.2870627429206,8,3297,242.64482863209
30517,81,81065,81,"Tasa de exámenes médico legales por presunto delito sexual contra niños, niñas y adolescentes",2020,4,13,6555,198.321891685736,1,3436,29.1036088474971,12,3119,384.738698300737
30518,81,81065,121,Tasa de exámenes médico legales por presunto delito sexual cuando la víctima está entre 18 y 28 años,2020,5,1,11049,9.05059281382931,0,5725,0,1,5324,18.7828700225394
30519,81,81220,81,"Tasa de exámenes médico legales por presunto delito sexual contra niños, niñas y adolescentes",2020,2,1,424,235.849056603774,0,229,0,1,195,512.820512820513
30520,81,81220,81,"Tasa de exámenes médico legales por presunto delito sexual contra niños, niñas y adolescentes",2020,3,3,425,705.882352941176,0,226,0,3,199,1507.53768844221
30521,81,81220,81,"Tasa de exámenes médico legales por presunto delito sexual contra niños, niñas y adolescentes",2020,4,1,400,250,0,204,0,1,196,510.204081632653
30522,81,81300,81,"Tasa de exámenes médico legales por presunto delito sexual contra niños, niñas y adolescentes",2020,2,4,2251,177.698800533096,0,1146,0,4,1105,361.990950226244
30523,81,81300,81,"Tasa de exámenes médico legales por presunto delito sexual contra niños, niñas y adolescentes",2020,3,7,2538,275.807722616233,1,1265,79.0513833992095,6,1273,471.327572663001
30524,81,81300,81,"Tasa de exámenes médico legales por presunto delito sexual contra niños, niñas y adolescentes",2020,4,3,2385,125.786163522013,2,1166,171.526586620926,1,1219,82.0344544708778
30525,81,81300,121,Tasa de exámenes médico legales por presunto delito sexual cuando la víctima está entre 18 y 28 años,2020,5,2,3999,50.0125031257814,1,1972,50.709939148073,1,2027,49.3339911198816
30526,81,81591,81,"Tasa de exámenes médico legales por presunto delito sexual contra niños, niñas y adolescentes",2020,2,1,488,204.918032786885,0,265,0,1,223,448.430493273543
30527,81,81591,81,"Tasa de exámenes médico legales por presunto delito sexual contra niños, niñas y adolescentes",2020,3,4,536,746.268656716418,0,272,0,4,264,1515.15151515152
30528,81,81591,81,"Tasa de exámenes médico legales por presunto delito sexual contra niños, niñas y adolescentes",2020,4,1,513,194.931773879142,0,250,0,1,263,380.228136882129
30529,81,81736,81,"Tasa de exámenes médico legales por presunto delito sexual contra niños, niñas y adolescentes",2020,2,3,6292,47.6795931341386,1,3138,31.8674314850223,2,3154,63.4115409004439
30530,81,81736,81,"Tasa de exámenes médico legales por presunto delito sexual contra niños, niñas y adolescentes",2020,3,9,7172,125.488008923592,2,3590,55.7103064066852,7,3582,195.421552205472
30531,81,81736,81,"Tasa de exámenes médico legales por presunto delito sexual contra niños, niñas y adolescentes",2020,4,20,7029,284.535495803101,2,3527,56.7054153671676,18,3502,513.992004568818
30532,81,81736,121,Tasa de exámenes médico legales por presunto delito sexual cuando la víctima está entre 18 y 28 años,2020,5,6,12705,47.2255017709563,0,6241,0,6,6464,92.8217821782178
30533,81,81794,81,"Tasa de exámenes médico legales por presunto delito sexual contra niños, niñas y adolescentes",2020,2,10,5292,188.96447467876,4,2720,147.058823529412,6,2572,233.281493001555
30534,81,81794,81,"Tasa de exámenes médico legales por presunto delito sexual contra niños, niñas y adolescentes",2020,3,15,5956,251.846877098724,5,3063,163.238654913484,10,2893,345.661942620118
30535,81,81794,81,"Tasa de exámenes médico legales por presunto delito sexual contra niños, niñas y adolescentes",2020,4,13,5663,229.56030372594,1,2905,34.4234079173838,12,2758,435.097897026831
30536,81,81794,121,Tasa de exámenes médico legales por presunto delito sexual cuando la víctima está entre 18 y 28 años,2020,5,4,9829,40.6958998880863,0,4956,0,4,4873,82.0849579314591
30537,88,88001,81,"Tasa de exámenes médico legales por presunto delito sexual contra niños, niñas y adolescentes",2020,2,3,4447,67.4612098043625,0,2287,0,3,2160,138.888888888889
30538,88,88001,81,"Tasa de exámenes médico legales por presunto delito sexual contra niños, niñas y adolescentes",2020,3,10,5003,199.880071956826,3,2548,117.739403453689,7,2455,285.132382892057
30539,88,88001,81,"Tasa de exámenes médico legales por presunto delito sexual contra niños, niñas y adolescentes",2020,4,10,4928,202.922077922078,0,2486,0,10,2442,409.500409500409
30540,88,88001,121,Tasa de exámenes médico legales por presunto delito sexual cuando la víctima está entre 18 y 28 años,2020,5,4,9622,41.5713988775722,0,4961,0,4,4661,85.8184938854323
30541,8,8078,81,"Tasa de exámenes médico legales por presunto delito sexual contra niños, niñas y adolescentes",2020,2,2,5558,35.9841669665347,0,2852,0,2,2706,73.909830007391
30542,8,8078,81,"Tasa de exámenes médico legales por presunto delito sexual contra niños, niñas y adolescentes",2020,3,4,6770,59.0841949778434,1,3450,28.9855072463768,3,3320,90.3614457831325
30543,8,8078,81,"Tasa de exámenes médico legales por presunto delito sexual contra niños, niñas y adolescentes",2020,4,5,6859,72.8969237498178,0,3481,0,5,3378,148.01657785672
30544,8,8078,121,Tasa de exámenes médico legales por presunto delito sexual cuando la víctima está entre 18 y 28 años,2020,5,4,12098,33.0633162506199,0,6144,0,4,5954,67.1817265703729
30545,8,8001,81,"Tasa de exámenes médico legales por presunto delito sexual contra niños, niñas y adolescentes",2020,2,58,98084,59.1329880510583,14,49391,28.345245085137,44,48693,90.362064362434
30546,8,8001,81,"Tasa de exámenes médico legales por presunto delito sexual contra niños, niñas y adolescentes",2020,3,139,117346,118.453121538016,21,59207,35.4687790295066,118,58139,202.961867249179
30547,8,8001,81,"Tasa de exámenes médico legales por presunto delito sexual contra niños, niñas y adolescentes",2020,4,161,121378,132.643477401176,11,61219,17.9682778222447,150,60159,249.33925098489
30548,8,8001,121,Tasa de exámenes médico legales por presunto delito sexual cuando la víctima está entre 18 y 28 años,2020,5,44,238000,18.4873949579832,1,118556,0.843483248422686,43,119444,36.0001339539868
30549,8,8001,81,"Tasa de exámenes médico legales por presunto delito sexual contra niños, niñas y adolescentes",2020,1,1,19267,5.19022162246328,0,9715,0,1,9552,10.4690117252931
30550,8,8137,81,"Tasa de exámenes médico legales por presunto delito sexual contra niños, niñas y adolescentes",2020,2,1,2355,42.4628450106157,1,1202,83.1946755407654,0,1153,0
30551,8,8137,81,"Tasa de exámenes médico legales por presunto delito sexual contra niños, niñas y adolescentes",2020,3,4,2744,145.772594752187,0,1412,0,4,1332,300.3003003003
30552,8,8137,81,"Tasa de exámenes médico legales por presunto delito sexual contra niños, niñas y adolescentes",2020,4,2,2599,76.9526741054252,0,1340,0,2,1259,158.856235107228
30553,8,8141,81,"Tasa de exámenes médico legales por presunto delito sexual contra niños, niñas y adolescentes",2020,2,3,1759,170.551449687322,2,898,222.71714922049,1,861,116.144018583043
30554,8,8141,81,"Tasa de exámenes médico legales por presunto delito sexual contra niños, niñas y adolescentes",2020,3,1,2018,49.5540138751239,0,1056,0,1,962,103.950103950104
30555,8,8141,81,"Tasa de exámenes médico legales por presunto delito sexual contra niños, niñas y adolescentes",2020,4,4,1890,211.640211640212,0,993,0,4,897,445.930880713489
30556,8,8141,81,"Tasa de exámenes médico legales por presunto delito sexual contra niños, niñas y adolescentes",2020,1,1,344,290.697674418605,0,176,0,1,168,595.238095238095
30557,8,8296,81,"Tasa de exámenes médico legales por presunto delito sexual contra niños, niñas y adolescentes",2020,2,7,6396,109.443402126329,2,3349,59.7193191997611,5,3047,164.095831965868
30558,8,8296,81,"Tasa de exámenes médico legales por presunto delito sexual contra niños, niñas y adolescentes",2020,3,4,7562,52.8960592435864,0,3946,0,4,3616,110.619469026549
30559,8,8296,81,"Tasa de exámenes médico legales por presunto delito sexual contra niños, niñas y adolescentes",2020,4,9,7333,122.73285149325,0,3798,0,9,3535,254.596888260255
30560,8,8296,121,Tasa de exámenes médico legales por presunto delito sexual cuando la víctima está entre 18 y 28 años,2020,5,2,12616,15.852885225111,0,6326,0,2,6290,31.7965023847377
30561,8,8372,81,"Tasa de exámenes médico legales por presunto delito sexual contra niños, niñas y adolescentes",2020,2,2,1940,103.092783505155,0,1058,0,2,882,226.757369614512
30562,8,8372,81,"Tasa de exámenes médico legales por presunto delito sexual contra niños, niñas y adolescentes",2020,4,2,2307,86.6926744690074,0,1197,0,2,1110,180.18018018018
30563,8,8421,81,"Tasa de exámenes médico legales por presunto delito sexual contra niños, niñas y adolescentes",2020,2,1,2979,33.5683115139309,0,1500,0,1,1479,67.6132521974307
30564,8,8421,81,"Tasa de exámenes médico legales por presunto delito sexual contra niños, niñas y adolescentes",2020,3,3,3507,85.5431993156544,0,1772,0,3,1735,172.910662824207
30565,8,8421,81,"Tasa de exámenes médico legales por presunto delito sexual contra niños, niñas y adolescentes",2020,4,2,3389,59.0144585423429,1,1706,58.6166471277843,1,1683,59.41770647653
30566,8,8433,81,"Tasa de exámenes médico legales por presunto delito sexual contra niños, niñas y adolescentes",2020,2,7,12875,54.3689320388349,1,6482,15.4273372415921,6,6393,93.8526513374003
30567,8,8433,81,"Tasa de exámenes médico legales por presunto delito sexual contra niños, niñas y adolescentes",2020,3,10,15469,64.6454198720021,3,7810,38.4122919334187,7,7659,91.3957435696566
30568,8,8433,81,"Tasa de exámenes médico legales por presunto delito sexual contra niños, niñas y adolescentes",2020,4,15,15504,96.7492260061919,2,7888,25.3549695740365,13,7616,170.693277310924
30569,8,8433,121,Tasa de exámenes médico legales por presunto delito sexual cuando la víctima está entre 18 y 28 años,2020,5,2,27496,7.2737852778586,0,14069,0,2,13427,14.8953600953303
30570,8,8436,81,"Tasa de exámenes médico legales por presunto delito sexual contra niños, niñas y adolescentes",2020,2,1,2297,43.535045711798,0,1235,0,1,1062,94.1619585687382
30571,8,8436,81,"Tasa de exámenes médico legales por presunto delito sexual contra niños, niñas y adolescentes",2020,3,1,2662,37.5657400450789,1,1399,71.4796283059328,0,1263,0
30572,8,8436,81,"Tasa de exámenes médico legales por presunto delito sexual contra niños, niñas y adolescentes",2020,4,6,2550,235.294117647059,0,1313,0,6,1237,485.044462409054
30573,8,8436,121,Tasa de exámenes médico legales por presunto delito sexual cuando la víctima está entre 18 y 28 años,2020,5,1,4099,24.3961941937058,0,2103,0,1,1996,50.1002004008016
30574,8,8520,81,"Tasa de exámenes médico legales por presunto delito sexual contra niños, niñas y adolescentes",2020,2,3,2692,111.441307578009,0,1381,0,3,1311,228.83295194508
30575,8,8520,81,"Tasa de exámenes médico legales por presunto delito sexual contra niños, niñas y adolescentes",2020,3,1,3181,31.4366551398931,0,1610,0,1,1571,63.6537237428389
30576,8,8520,81,"Tasa de exámenes médico legales por presunto delito sexual contra niños, niñas y adolescentes",2020,4,3,3151,95.2078705172961,0,1571,0,3,1580,189.873417721519
30577,8,8549,81,"Tasa de exámenes médico legales por presunto delito sexual contra niños, niñas y adolescentes",2020,4,1,703,142.247510668563,0,375,0,1,328,304.878048780488
30578,8,8558,81,"Tasa de exámenes médico legales por presunto delito sexual contra niños, niñas y adolescentes",2020,3,1,2108,47.438330170778,0,1074,0,1,1034,96.7117988394584
30579,8,8558,81,"Tasa de exámenes médico legales por presunto delito sexual contra niños, niñas y adolescentes",2020,4,8,2181,366.80421824851,1,1086,92.0810313075506,7,1095,639.269406392694
30580,8,8558,121,Tasa de exámenes médico legales por presunto delito sexual cuando la víctima está entre 18 y 28 años,2020,5,1,3423,29.2141396435875,0,1726,0,1,1697,58.9275191514437
30581,8,8560,81,"Tasa de exámenes médico legales por presunto delito sexual contra niños, niñas y adolescentes",2020,3,2,3009,66.4672648720505,1,1557,64.2260757867694,1,1452,68.870523415978
30582,8,8560,81,"Tasa de exámenes médico legales por presunto delito sexual contra niños, niñas y adolescentes",2020,4,4,2898,138.026224982747,0,1485,0,4,1413,283.085633404105
30583,8,8573,81,"Tasa de exámenes médico legales por presunto delito sexual contra niños, niñas y adolescentes",2020,3,3,5063,59.2534070709066,1,2600,38.4615384615385,2,2463,81.2017864393017
30584,8,8573,81,"Tasa de exámenes médico legales por presunto delito sexual contra niños, niñas y adolescentes",2020,4,4,5255,76.1179828734539,0,2683,0,4,2572,155.52099533437
30585,8,8573,121,Tasa de exámenes médico legales por presunto delito sexual cuando la víctima está entre 18 y 28 años,2020,5,3,9540,31.4465408805031,0,4694,0,3,4846,61.9067271976888
30586,8,8606,81,"Tasa de exámenes médico legales por presunto delito sexual contra niños, niñas y adolescentes",2020,3,1,3236,30.902348578492,1,1667,59.9880023995201,0,1569,0
30587,8,8606,81,"Tasa de exámenes médico legales por presunto delito sexual contra niños, niñas y adolescentes",2020,4,1,3181,31.4366551398931,0,1623,0,1,1558,64.1848523748395
30588,8,8634,81,"Tasa de exámenes médico legales por presunto delito sexual contra niños, niñas y adolescentes",2020,2,3,3142,95.4805856142584,1,1569,63.7348629700446,2,1573,127.145581691036
30589,8,8634,81,"Tasa de exámenes médico legales por presunto delito sexual contra niños, niñas y adolescentes",2020,3,2,3714,53.850296176629,0,1851,0,2,1863,107.353730542136
30590,8,8634,81,"Tasa de exámenes médico legales por presunto delito sexual contra niños, niñas y adolescentes",2020,4,9,3713,242.391597091301,1,1856,53.8793103448276,8,1857,430.802369413032
30591,8,8634,121,Tasa de exámenes médico legales por presunto delito sexual cuando la víctima está entre 18 y 28 años,2020,5,3,6712,44.6960667461263,0,3419,0,3,3293,91.1023382933495
30592,8,8638,81,"Tasa de exámenes médico legales por presunto delito sexual contra niños, niñas y adolescentes",2020,2,1,9342,10.7043459644616,1,4765,20.9863588667366,0,4577,0
30593,8,8638,81,"Tasa de exámenes médico legales por presunto delito sexual contra niños, niñas y adolescentes",2020,3,10,10877,91.9371150133309,1,5573,17.9436569172797,9,5304,169.683257918552
30594,8,8638,81,"Tasa de exámenes médico legales por presunto delito sexual contra niños, niñas y adolescentes",2020,4,15,10480,143.129770992366,1,5342,18.7195806813927,14,5138,272.479564032698
30595,8,8638,121,Tasa de exámenes médico legales por presunto delito sexual cuando la víctima está entre 18 y 28 años,2020,5,3,18204,16.479894528675,1,9088,11.0035211267606,2,9116,21.9394471259324
30596,8,8675,81,"Tasa de exámenes médico legales por presunto delito sexual contra niños, niñas y adolescentes",2020,3,2,2044,97.8473581213307,0,1050,0,2,994,201.207243460765
30597,8,8675,81,"Tasa de exámenes médico legales por presunto delito sexual contra niños, niñas y adolescentes",2020,4,2,2048,97.65625,1,1036,96.5250965250965,1,1012,98.8142292490118
30598,8,8685,81,"Tasa de exámenes médico legales por presunto delito sexual contra niños, niñas y adolescentes",2020,3,1,3077,32.499187520312,1,1554,64.3500643500643,0,1523,0
30599,8,8685,81,"Tasa de exámenes médico legales por presunto delito sexual contra niños, niñas y adolescentes",2020,4,7,3158,221.659278024066,1,1574,63.5324015247776,6,1584,378.787878787879
30600,8,8758,81,"Tasa de exámenes médico legales por presunto delito sexual contra niños, niñas y adolescentes",2020,2,13,58347,22.2804942841963,6,30218,19.8557151366735,7,28129,24.8853496391624
30601,8,8758,81,"Tasa de exámenes médico legales por presunto delito sexual contra niños, niñas y adolescentes",2020,3,50,68374,73.127212098166,10,35130,28.4656988329063,40,33244,120.322464204067
30602,8,8758,81,"Tasa de exámenes médico legales por presunto delito sexual contra niños, niñas y adolescentes",2020,4,65,68441,94.9723119182946,4,34556,11.5754138210441,61,33885,180.020658108308
30603,8,8758,121,Tasa de exámenes médico legales por presunto delito sexual cuando la víctima está entre 18 y 28 años,2020,5,12,131978,9.09242449499159,1,65117,1.53569728335151,11,66861,16.4520422967051
30604,8,8770,81,"Tasa de exámenes médico legales por presunto delito sexual contra niños, niñas y adolescentes",2020,3,1,1432,69.8324022346369,0,702,0,1,730,136.986301369863
30605,8,8832,81,"Tasa de exámenes médico legales por presunto delito sexual contra niños, niñas y adolescentes",2020,3,2,1855,107.816711590297,0,934,0,2,921,217.155266015201
30606,8,8832,81,"Tasa de exámenes médico legales por presunto delito sexual contra niños, niñas y adolescentes",2020,4,1,1803,55.4631170271769,0,890,0,1,913,109.529025191676
30607,8,8832,121,Tasa de exámenes médico legales por presunto delito sexual cuando la víctima está entre 18 y 28 años,2020,5,1,3454,28.9519397799653,0,1752,0,1,1702,58.7544065804935
30608,8,8849,81,"Tasa de exámenes médico legales por presunto delito sexual contra niños, niñas y adolescentes",2020,2,1,1068,93.6329588014981,0,544,0,1,524,190.839694656489
30609,8,8849,81,"Tasa de exámenes médico legales por presunto delito sexual contra niños, niñas y adolescentes",2020,3,1,1287,77.7000777000777,0,652,0,1,635,157.48031496063
30610,8,8849,81,"Tasa de exámenes médico legales por presunto delito sexual contra niños, niñas y adolescentes",2020,4,4,1303,306.983883346124,0,657,0,4,646,619.195046439629
30611,11,11001,81,"Tasa de exámenes médico legales por presunto delito sexual contra niños, niñas y adolescentes",2020,2,518,490875,105.525846702317,143,250565,57.0710194959392,375,240310,156.04843743498
30612,11,11001,81,"Tasa de exámenes médico legales por presunto delito sexual contra niños, niñas y adolescentes",2020,3,1003,579198,173.170487467153,195,295252,66.0452765772967,808,283946,284.561148950857
30613,11,11001,81,"Tasa de exámenes médico legales por presunto delito sexual contra niños, niñas y adolescentes",2020,4,1464,614429,238.270003531734,157,311030,50.4774459055397,1307,303399,430.785862840682
30614,11,11001,121,Tasa de exámenes médico legales por presunto delito sexual cuando la víctima está entre 18 y 28 años,2020,5,371,1549802,23.9385418266333,34,773217,4.39721320146867,337,776585,43.3951209461939
30615,11,11001,81,"Tasa de exámenes médico legales por presunto delito sexual contra niños, niñas y adolescentes",2020,1,4,99552,4.0180006428801,0,50868,0,4,48684,8.2162517459535
30616,13,13030,81,"Tasa de exámenes médico legales por presunto delito sexual contra niños, niñas y adolescentes",2020,2,1,1352,73.9644970414201,0,665,0,1,687,145.560407569141
30617,13,13030,81,"Tasa de exámenes médico legales por presunto delito sexual contra niños, niñas y adolescentes",2020,3,3,1586,189.155107187894,0,801,0,3,785,382.165605095541
30618,13,13030,81,"Tasa de exámenes médico legales por presunto delito sexual contra niños, niñas y adolescentes",2020,4,4,1514,264.200792602378,0,789,0,4,725,551.724137931034
30619,13,13052,81,"Tasa de exámenes médico legales por presunto delito sexual contra niños, niñas y adolescentes",2020,2,3,6816,44.0140845070423,0,3456,0,3,3360,89.2857142857143
30620,13,13052,81,"Tasa de exámenes médico legales por presunto delito sexual contra niños, niñas y adolescentes",2020,3,4,8033,49.7945972861945,1,4064,24.6062992125984,3,3969,75.5857898715042
30621,13,13052,81,"Tasa de exámenes médico legales por presunto delito sexual contra niños, niñas y adolescentes",2020,4,11,8035,136.901057871811,1,4035,24.7831474597274,10,4000,250
30622,13,13074,81,"Tasa de exámenes médico legales por presunto delito sexual contra niños, niñas y adolescentes",2020,2,1,1742,57.4052812858783,0,857,0,1,885,112.994350282486
30623,13,13074,81,"Tasa de exámenes médico legales por presunto delito sexual contra niños, niñas y adolescentes",2020,3,2,2044,97.8473581213307,0,1040,0,2,1004,199.203187250996
30624,13,13140,81,"Tasa de exámenes médico legales por presunto delito sexual contra niños, niñas y adolescentes",2020,3,1,2649,37.7500943752359,0,1371,0,1,1278,78.2472613458529
30625,13,13140,81,"Tasa de exámenes médico legales por presunto delito sexual contra niños, niñas y adolescentes",2020,4,2,2618,76.3941940412529,0,1355,0,2,1263,158.353127474268
30626,13,13001,81,"Tasa de exámenes médico legales por presunto delito sexual contra niños, niñas y adolescentes",2020,2,48,86915,55.2263705919577,8,44474,17.9880379547601,40,42441,94.2484861336915
30627,13,13001,81,"Tasa de exámenes médico legales por presunto delito sexual contra niños, niñas y adolescentes",2020,3,86,100565,85.5168299110028,12,51547,23.2797252992415,74,49018,150.964951650414
30628,13,13001,81,"Tasa de exámenes médico legales por presunto delito sexual contra niños, niñas y adolescentes",2020,4,157,101747,154.304303812397,18,51696,34.8189415041783,139,50051,277.716728936485
30629,13,13001,121,Tasa de exámenes médico legales por presunto delito sexual cuando la víctima está entre 18 y 28 años,2020,5,35,199624,17.5329619685008,1,98458,1.01566150033517,34,101166,33.6081292133721
30630,13,13188,81,"Tasa de exámenes médico legales por presunto delito sexual contra niños, niñas y adolescentes",2020,2,1,1553,64.3915003219575,1,814,122.850122850123,0,739,0
30631,13,13188,81,"Tasa de exámenes médico legales por presunto delito sexual contra niños, niñas y adolescentes",2020,3,7,1835,381.471389645777,1,947,105.596620908131,6,888,675.675675675676
30632,13,13188,81,"Tasa de exámenes médico legales por presunto delito sexual contra niños, niñas y adolescentes",2020,4,6,1748,343.24942791762,1,878,113.895216400911,5,870,574.712643678161
30633,13,13222,81,"Tasa de exámenes médico legales por presunto delito sexual contra niños, niñas y adolescentes",2020,2,1,1638,61.0500610500611,0,829,0,1,809,123.609394313968
30634,13,13222,81,"Tasa de exámenes médico legales por presunto delito sexual contra niños, niñas y adolescentes",2020,3,2,1845,108.40108401084,0,933,0,2,912,219.298245614035
30635,13,13222,81,"Tasa de exámenes médico legales por presunto delito sexual contra niños, niñas y adolescentes",2020,4,1,1767,56.5930956423316,0,892,0,1,875,114.285714285714
30636,13,13222,121,Tasa de exámenes médico legales por presunto delito sexual cuando la víctima está entre 18 y 28 años,2020,5,1,3032,32.9815303430079,0,1528,0,1,1504,66.4893617021277
30637,13,13212,81,"Tasa de exámenes médico legales por presunto delito sexual contra niños, niñas y adolescentes",2020,2,1,1572,63.6132315521629,0,843,0,1,729,137.174211248285
30638,13,13212,81,"Tasa de exámenes médico legales por presunto delito sexual contra niños, niñas y adolescentes",2020,3,3,1800,166.666666666667,1,940,106.382978723404,2,860,232.558139534884
30639,13,13212,81,"Tasa de exámenes médico legales por presunto delito sexual contra niños, niñas y adolescentes",2020,4,1,1765,56.657223796034,0,892,0,1,873,114.54753722795
30640,13,13244,81,"Tasa de exámenes médico legales por presunto delito sexual contra niños, niñas y adolescentes",2020,2,3,7041,42.6075841499787,0,3584,0,3,3457,86.7804454729534
30641,13,13244,81,"Tasa de exámenes médico legales por presunto delito sexual contra niños, niñas y adolescentes",2020,3,10,8152,122.669283611384,1,4199,23.8151940938319,9,3953,227.675183405009
30642,13,13244,81,"Tasa de exámenes médico legales por presunto delito sexual contra niños, niñas y adolescentes",2020,4,10,7977,125.360411182149,1,4160,24.0384615384615,9,3817,235.787267487556
30643,13,13244,121,Tasa de exámenes médico legales por presunto delito sexual cuando la víctima está entre 18 y 28 años,2020,5,3,13425,22.3463687150838,1,6970,14.3472022955524,2,6455,30.9837335398916
30644,13,13248,81,"Tasa de exámenes médico legales por presunto delito sexual contra niños, niñas y adolescentes",2020,4,1,892,112.107623318386,0,474,0,1,418,239.234449760766
30645,13,13268,81,"Tasa de exámenes médico legales por presunto delito sexual contra niños, niñas y adolescentes",2020,4,2,1012,197.628458498024,0,551,0,2,461,433.839479392625
30646,13,13300,81,"Tasa de exámenes médico legales por presunto delito sexual contra niños, niñas y adolescentes",2020,4,1,1691,59.1366055588409,0,878,0,1,813,123.0012300123
30647,13,13430,81,"Tasa de exámenes médico legales por presunto delito sexual contra niños, niñas y adolescentes",2020,2,8,13129,60.9338106481834,3,6817,44.0076279888514,5,6312,79.2141951837769
30648,13,13430,81,"Tasa de exámenes médico legales por presunto delito sexual contra niños, niñas y adolescentes",2020,3,17,15921,106.777212486653,7,8240,84.9514563106796,10,7681,130.191381330556
30649,13,13430,81,"Tasa de exámenes médico legales por presunto delito sexual contra niños, niñas y adolescentes",2020,4,34,15990,212.632895559725,4,8208,48.7329434697856,30,7782,385.50501156515
30650,13,13430,121,Tasa de exámenes médico legales por presunto delito sexual cuando la víctima está entre 18 y 28 años,2020,5,4,25478,15.6998194520763,1,12758,7.83821915660762,3,12720,23.5849056603774
30651,13,13433,81,"Tasa de exámenes médico legales por presunto delito sexual contra niños, niñas y adolescentes",2020,3,4,3164,126.422250316056,0,1609,0,4,1555,257.234726688103
30652,13,13433,81,"Tasa de exámenes médico legales por presunto delito sexual contra niños, niñas y adolescentes",2020,4,3,3302,90.8540278619019,0,1747,0,3,1555,192.926045016077
30653,13,13442,81,"Tasa de exámenes médico legales por presunto delito sexual contra niños, niñas y adolescentes",2020,2,3,5015,59.8205383848455,0,2559,0,3,2456,122.14983713355
30654,13,13442,81,"Tasa de exámenes médico legales por presunto delito sexual contra niños, niñas y adolescentes",2020,3,3,5947,50.4456028249538,0,3090,0,3,2857,105.005250262513
30655,13,13442,81,"Tasa de exámenes médico legales por presunto delito sexual contra niños, niñas y adolescentes",2020,4,8,5884,135.961930659415,0,3111,0,8,2773,288.496213487198
30656,13,13442,121,Tasa de exámenes médico legales por presunto delito sexual cuando la víctima está entre 18 y 28 años,2020,5,1,9072,11.0229276895944,0,4629,0,1,4443,22.5073148773351
30657,13,13468,81,"Tasa de exámenes médico legales por presunto delito sexual contra niños, niñas y adolescentes",2020,3,2,5468,36.5764447695684,0,2782,0,2,2686,74.4601638123604
30658,13,13458,81,"Tasa de exámenes médico legales por presunto delito sexual contra niños, niñas y adolescentes",2020,3,1,2282,43.8212094653812,0,1205,0,1,1077,92.8505106778087
30659,13,13473,81,"Tasa de exámenes médico legales por presunto delito sexual contra niños, niñas y adolescentes",2020,4,2,2669,74.9344323716748,0,1439,0,2,1230,162.60162601626
30660,13,13490,81,"Tasa de exámenes médico legales por presunto delito sexual contra niños, niñas y adolescentes",2020,4,1,1068,93.6329588014981,0,550,0,1,518,193.050193050193
30661,13,13549,81,"Tasa de exámenes médico legales por presunto delito sexual contra niños, niñas y adolescentes",2020,2,1,2620,38.1679389312977,0,1351,0,1,1269,78.8022064617809
30662,13,13549,81,"Tasa de exámenes médico legales por presunto delito sexual contra niños, niñas y adolescentes",2020,4,1,3154,31.705770450221902,0,1615,0,1,1539,64.9772579597141
30663,13,13620,81,"Tasa de exámenes médico legales por presunto delito sexual contra niños, niñas y adolescentes",2020,2,1,766,130.548302872063,0,369,0,1,397,251.889168765743
30664,13,13620,81,"Tasa de exámenes médico legales por presunto delito sexual contra niños, niñas y adolescentes",2020,4,1,932,107.296137339056,0,509,0,1,423,236.406619385343
30665,13,13650,81,"Tasa de exámenes médico legales por presunto delito sexual contra niños, niñas y adolescentes",2020,3,1,1608,62.1890547263682,1,850,117.647058823529,0,758,0
30666,13,13650,81,"Tasa de exámenes médico legales por presunto delito sexual contra niños, niñas y adolescentes",2020,4,3,1604,187.032418952618,0,847,0,3,757,396.301188903567
30667,13,13655,81,"Tasa de exámenes médico legales por presunto delito sexual contra niños, niñas y adolescentes",2020,3,1,1323,75.5857898715042,1,678,147.492625368732,0,645,0
30668,13,13655,121,Tasa de exámenes médico legales por presunto delito sexual cuando la víctima está entre 18 y 28 años,2020,5,1,1752,57.0776255707763,0,904,0,1,848,117.924528301887
30669,13,13654,81,"Tasa de exámenes médico legales por presunto delito sexual contra niños, niñas y adolescentes",2020,2,1,2103,47.5511174512601,0,1042,0,1,1061,94.2507068803016
30670,13,13654,81,"Tasa de exámenes médico legales por presunto delito sexual contra niños, niñas y adolescentes",2020,4,4,2676,149.476831091181,1,1387,72.0980533525595,3,1289,232.738557020946
30671,13,13657,81,"Tasa de exámenes médico legales por presunto delito sexual contra niños, niñas y adolescentes",2020,3,1,3832,26.0960334029228,0,1956,0,1,1876,53.3049040511727
30672,13,13657,81,"Tasa de exámenes médico legales por presunto delito sexual contra niños, niñas y adolescentes",2020,4,2,3985,50.1882057716437,1,2071,48.2858522452921,1,1914,52.2466039707419
30673,13,13657,121,Tasa de exámenes médico legales por presunto delito sexual cuando la víctima está entre 18 y 28 años,2020,5,2,6773,29.5290122545401,1,3485,28.6944045911047,1,3288,30.4136253041363
30674,13,13667,81,"Tasa de exámenes médico legales por presunto delito sexual contra niños, niñas y adolescentes",2020,3,5,1938,257.99793601651203,0,1046,0,5,892,560.538116591928
30675,13,13667,81,"Tasa de exámenes médico legales por presunto delito sexual contra niños, niñas y adolescentes",2020,4,11,1834,599.781897491821,0,982,0,11,852,1291.07981220657
30676,13,13667,121,Tasa de exámenes médico legales por presunto delito sexual cuando la víctima está entre 18 y 28 años,2020,5,1,2551,39.2003136025088,0,1318,0,1,1233,81.10300081103
30677,13,13673,81,"Tasa de exámenes médico legales por presunto delito sexual contra niños, niñas y adolescentes",2020,3,2,1674,119.4743130227,0,866,0,2,808,247.524752475248
30678,13,13673,81,"Tasa de exámenes médico legales por presunto delito sexual contra niños, niñas y adolescentes",2020,4,2,1684,118.764845605701,0,855,0,2,829,241.254523522316
30679,13,13673,121,Tasa de exámenes médico legales por presunto delito sexual cuando la víctima está entre 18 y 28 años,2020,5,3,2785,107.719928186715,1,1369,73.0460189919649,2,1416,141.242937853107
30680,13,13688,81,"Tasa de exámenes médico legales por presunto delito sexual contra niños, niñas y adolescentes",2020,4,2,4310,46.4037122969838,0,2202,0,2,2108,94.876660341556
30681,13,13683,81,"Tasa de exámenes médico legales por presunto delito sexual contra niños, niñas y adolescentes",2020,3,3,2529,118.623962040332,0,1271,0,3,1258,238.473767885533
30682,13,13683,121,Tasa de exámenes médico legales por presunto delito sexual cuando la víctima está entre 18 y 28 años,2020,5,2,4340,46.0829493087558,0,2172,0,2,2168,92.2509225092251
30683,13,13760,81,"Tasa de exámenes médico legales por presunto delito sexual contra niños, niñas y adolescentes",2020,3,1,1067,93.7207122774133,0,523,0,1,544,183.823529411765
30684,13,13760,81,"Tasa de exámenes médico legales por presunto delito sexual contra niños, niñas y adolescentes",2020,4,3,1063,282.220131702728,0,535,0,3,528,568.181818181818
30685,13,13780,81,"Tasa de exámenes médico legales por presunto delito sexual contra niños, niñas y adolescentes",2020,2,1,1435,69.6864111498258,0,691,0,1,744,134.408602150538
30686,13,13780,81,"Tasa de exámenes médico legales por presunto delito sexual contra niños, niñas y adolescentes",2020,3,1,1654,60.459492140266,0,824,0,1,830,120.481927710843
30687,13,13780,81,"Tasa de exámenes médico legales por presunto delito sexual contra niños, niñas y adolescentes",2020,4,3,1551,193.423597678917,0,802,0,3,749,400.534045393858
30688,13,13810,81,"Tasa de exámenes médico legales por presunto delito sexual contra niños, niñas y adolescentes",2020,4,2,2433,82.203041512536,0,1284,0,2,1149,174.064403829417
30689,13,13836,81,"Tasa de exámenes médico legales por presunto delito sexual contra niños, niñas y adolescentes",2020,3,3,11528,26.0235947258848,2,5924,33.7609723160027,1,5604,17.8443968593862
30690,13,13836,81,"Tasa de exámenes médico legales por presunto delito sexual contra niños, niñas y adolescentes",2020,4,12,11784,101.83299389002,0,6013,0,12,5771,207.936232888581
30691,13,13836,121,Tasa de exámenes médico legales por presunto delito sexual cuando la víctima está entre 18 y 28 años,2020,5,5,20772,24.0708646254573,2,10384,19.2604006163328,3,10388,28.8794763188294
30692,13,13838,81,"Tasa de exámenes médico legales por presunto delito sexual contra niños, niñas y adolescentes",2020,4,1,1771,56.4652738565782,0,902,0,1,869,115.074798619102
30693,13,13873,81,"Tasa de exámenes médico legales por presunto delito sexual contra niños, niñas y adolescentes",2020,3,2,2980,67.1140939597315,1,1518,65.8761528326746,1,1462,68.3994528043776
30694,13,13873,81,"Tasa de exámenes médico legales por presunto delito sexual contra niños, niñas y adolescentes",2020,4,1,2933,34.0947834981248,0,1503,0,1,1430,69.9300699300699
30695,13,13894,81,"Tasa de exámenes médico legales por presunto delito sexual contra niños, niñas y adolescentes",2020,2,1,1166,85.7632933104631,0,619,0,1,547,182.815356489945
30696,13,13894,81,"Tasa de exámenes médico legales por presunto delito sexual contra niños, niñas y adolescentes",2020,4,3,1379,217.548948513416,0,741,0,3,638,470.219435736677
30697,15,15022,81,"Tasa de exámenes médico legales por presunto delito sexual contra niños, niñas y adolescentes",2020,4,1,131,763.358778625954,0,70,0,1,61,1639.34426229508
30698,15,15047,81,"Tasa de exámenes médico legales por presunto delito sexual contra niños, niñas y adolescentes",2020,4,1,1586,63.0517023959647,0,804,0,1,782,127.877237851662
30699,15,15047,121,Tasa de exámenes médico legales por presunto delito sexual cuando la víctima está entre 18 y 28 años,2020,5,1,2432,41.1184210526316,0,1263,0,1,1169,85.5431993156544
30700,15,15051,81,"Tasa de exámenes médico legales por presunto delito sexual contra niños, niñas y adolescentes",2020,4,1,601,166.389351081531,0,310,0,1,291,343.642611683849
30701,15,15087,81,"Tasa de exámenes médico legales por presunto delito sexual contra niños, niñas y adolescentes",2020,3,3,710,422.535211267606,0,353,0,3,357,840.336134453781
30702,15,15087,121,Tasa de exámenes médico legales por presunto delito sexual cuando la víctima está entre 18 y 28 años,2020,5,1,1178,84.889643463497407,0,593,0,1,585,170.940170940171
30703,15,15104,81,"Tasa de exámenes médico legales por presunto delito sexual contra niños, niñas y adolescentes",2020,4,1,520,192.307692307692,0,275,0,1,245,408.163265306122
30704,15,15162,81,"Tasa de exámenes médico legales por presunto delito sexual contra niños, niñas y adolescentes",2020,4,1,331,302.114803625378,1,178,561.797752808989,0,153,0
30705,15,15172,81,"Tasa de exámenes médico legales por presunto delito sexual contra niños, niñas y adolescentes",2020,4,2,259,772.200772200772,0,121,0,2,138,1449.27536231884
30706,15,15176,81,"Tasa de exámenes médico legales por presunto delito sexual contra niños, niñas y adolescentes",2020,2,2,4195,47.6758045292014,0,2123,0,2,2072,96.5250965250965
30707,15,15176,81,"Tasa de exámenes médico legales por presunto delito sexual contra niños, niñas y adolescentes",2020,3,6,5651,106.175898071138,1,2880,34.7222222222222,5,2771,180.440274269217
30708,15,15176,81,"Tasa de exámenes médico legales por presunto delito sexual contra niños, niñas y adolescentes",2020,4,9,6258,143.815915627996,0,3239,0,9,3019,298.111957601855
30709,15,15176,121,Tasa de exámenes médico legales por presunto delito sexual cuando la víctima está entre 18 y 28 años,2020,5,2,10549,18.9591430467343,0,5337,0,2,5212,38.3729854182655
30710,15,15232,81,"Tasa de exámenes médico legales por presunto delito sexual contra niños, niñas y adolescentes",2020,3,1,506,197.628458498024,0,265,0,1,241,414.9377593361
30711,15,15185,81,"Tasa de exámenes médico legales por presunto delito sexual contra niños, niñas y adolescentes",2020,3,1,619,161.550888529887,1,310,322.58064516129,0,309,0
30712,15,15185,81,"Tasa de exámenes médico legales por presunto delito sexual contra niños, niñas y adolescentes",2020,4,1,561,178.25311942959,0,276,0,1,285,350.877192982456
30713,15,15187,81,"Tasa de exámenes médico legales por presunto delito sexual contra niños, niñas y adolescentes",2020,2,1,317,315.457413249211,0,146,0,1,171,584.795321637427
30714,15,15187,81,"Tasa de exámenes médico legales por presunto delito sexual contra niños, niñas y adolescentes",2020,3,1,330,303.030303030303,0,167,0,1,163,613.496932515337
30715,15,15187,121,Tasa de exámenes médico legales por presunto delito sexual cuando la víctima está entre 18 y 28 años,2020,5,2,451,443.458980044346,0,236,0,2,215,930.232558139535
30716,15,15236,121,Tasa de exámenes médico legales por presunto delito sexual cuando la víctima está entre 18 y 28 años,2020,5,1,328,304.878048780488,0,160,0,1,168,595.238095238095
30717,15,15204,81,"Tasa de exámenes médico legales por presunto delito sexual contra niños, niñas y adolescentes",2020,2,1,793,126.103404791929,0,403,0,1,390,256.410256410256
30718,15,15204,81,"Tasa de exámenes médico legales por presunto delito sexual contra niños, niñas y adolescentes",2020,3,2,954,209.643605870021,2,499,400.801603206413,0,455,0
30719,15,15204,121,Tasa de exámenes médico legales por presunto delito sexual cuando la víctima está entre 18 y 28 años,2020,5,2,2318,86.2812769628991,2,1508,132.62599469496,0,810,0
30720,15,15215,81,"Tasa de exámenes médico legales por presunto delito sexual contra niños, niñas y adolescentes",2020,4,1,215,465.116279069767,0,128,0,1,87,1149.42528735632
30721,15,15223,81,"Tasa de exámenes médico legales por presunto delito sexual contra niños, niñas y adolescentes",2020,3,1,1700,58.8235294117647,0,860,0,1,840,119.047619047619
30722,15,15223,121,Tasa de exámenes médico legales por presunto delito sexual cuando la víctima está entre 18 y 28 años,2020,5,1,1930,51.8134715025907,1,967,103.412616339193,0,963,0
30723,15,15238,81,"Tasa de exámenes médico legales por presunto delito sexual contra niños, niñas y adolescentes",2020,2,5,8310,60.1684717208183,2,4316,46.339202965709,3,3994,75.1126690035053
30724,15,15238,81,"Tasa de exámenes médico legales por presunto delito sexual contra niños, niñas y adolescentes",2020,3,15,10853,138.210633004699,2,5604,35.6887937187723,13,5249,247.66622213755
30725,15,15238,81,"Tasa de exámenes médico legales por presunto delito sexual contra niños, niñas y adolescentes",2020,4,23,11886,193.504963822985,1,6126,16.3238654913484,22,5760,381.944444444444
30726,15,15238,121,Tasa de exámenes médico legales por presunto delito sexual cuando la víctima está entre 18 y 28 años,2020,5,8,22317,35.8471120670341,0,11174,0,8,11143,71.793951359598
30727,15,15272,81,"Tasa de exámenes médico legales por presunto delito sexual contra niños, niñas y adolescentes",2020,3,1,582,171.821305841924,0,306,0,1,276,362.31884057971
30728,15,15272,81,"Tasa de exámenes médico legales por presunto delito sexual contra niños, niñas y adolescentes",2020,4,1,583,171.526586620926,0,321,0,1,262,381.679389312977
30729,15,15276,81,"Tasa de exámenes médico legales por presunto delito sexual contra niños, niñas y adolescentes",2020,4,1,283,353.356890459364,0,151,0,1,132,757.575757575758
30730,15,15293,81,"Tasa de exámenes médico legales por presunto delito sexual contra niños, niñas y adolescentes",2020,4,1,260,384.615384615385,0,138,0,1,122,819.672131147541
30731,15,15299,81,"Tasa de exámenes médico legales por presunto delito sexual contra niños, niñas y adolescentes",2020,2,1,1274,78.4929356357928,0,653,0,1,621,161.030595813205
30732,15,15299,81,"Tasa de exámenes médico legales por presunto delito sexual contra niños, niñas y adolescentes",2020,3,7,1551,451.321727917473,1,786,127.226463104326,6,765,784.313725490196
30733,15,15299,81,"Tasa de exámenes médico legales por presunto delito sexual contra niños, niñas y adolescentes",2020,4,10,1537,650.618087182824,1,776,128.865979381443,9,761,1182.6544021025
30734,15,15332,81,"Tasa de exámenes médico legales por presunto delito sexual contra niños, niñas y adolescentes",2020,4,1,462,216.450216450216,0,249,0,1,213,469.483568075117
30735,15,15362,81,"Tasa de exámenes médico legales por presunto delito sexual contra niños, niñas y adolescentes",2020,3,1,187,534.75935828877,0,102,0,1,85,1176.47058823529
30736,15,15367,81,"Tasa de exámenes médico legales por presunto delito sexual contra niños, niñas y adolescentes",2020,2,1,598,167.224080267559,1,293,341.296928327645,0,305,0
30737,15,15367,81,"Tasa de exámenes médico legales por presunto delito sexual contra niños, niñas y adolescentes",2020,3,2,740,270.27027027027,0,364,0,2,376,531.914893617021
30738,15,15367,81,"Tasa de exámenes médico legales por presunto delito sexual contra niños, niñas y adolescentes",2020,4,5,709,705.218617771509,0,357,0,5,352,1420.45454545455
30739,15,15367,81,"Tasa de exámenes médico legales por presunto delito sexual contra niños, niñas y adolescentes",2020,1,1,116,862.068965517241,1,57,1754.38596491228,0,59,0
30740,15,15368,81,"Tasa de exámenes médico legales por presunto delito sexual contra niños, niñas y adolescentes",2020,4,1,361,277.008310249307,0,185,0,1,176,568.181818181818
30741,15,15377,81,"Tasa de exámenes médico legales por presunto delito sexual contra niños, niñas y adolescentes",2020,3,1,267,374.531835205993,0,131,0,1,136,735.294117647059
30742,15,15377,81,"Tasa de exámenes médico legales por presunto delito sexual contra niños, niñas y adolescentes",2020,4,1,253,395.256916996047,1,124,806.451612903226,0,129,0
30743,15,15425,81,"Tasa de exámenes médico legales por presunto delito sexual contra niños, niñas y adolescentes",2020,4,2,433,461.89376443418,1,234,427.350427350427,1,199,502.51256281407
30744,15,15425,121,Tasa de exámenes médico legales por presunto delito sexual cuando la víctima está entre 18 y 28 años,2020,5,2,649,308.166409861325,0,357,0,2,292,684.931506849315
30745,15,15442,81,"Tasa de exámenes médico legales por presunto delito sexual contra niños, niñas y adolescentes",2020,4,1,596,167.785234899329,0,326,0,1,270,370.37037037037
30746,15,15455,81,"Tasa de exámenes médico legales por presunto delito sexual contra niños, niñas y adolescentes",2020,4,4,798,501.25313283208,1,431,232.018561484919,3,367,817.438692098093
30747,15,15466,81,"Tasa de exámenes médico legales por presunto delito sexual contra niños, niñas y adolescentes",2020,3,1,450,222.222222222222,0,222,0,1,228,438.59649122807
30748,15,15466,121,Tasa de exámenes médico legales por presunto delito sexual cuando la víctima está entre 18 y 28 años,2020,5,1,674,148.367952522255,0,331,0,1,343,291.545189504373
30749,15,15469,81,"Tasa de exámenes médico legales por presunto delito sexual contra niños, niñas y adolescentes",2020,3,1,2055,48.661800486618,0,1069,0,1,986,101.419878296146
30750,15,15469,81,"Tasa de exámenes médico legales por presunto delito sexual contra niños, niñas y adolescentes",2020,4,3,2105,142.517814726841,0,1095,0,3,1010,297.029702970297
30751,15,15476,81,"Tasa de exámenes médico legales por presunto delito sexual contra niños, niñas y adolescentes",2020,4,3,597,502.51256281407,0,295,0,3,302,993.377483443709
30752,15,15480,81,"Tasa de exámenes médico legales por presunto delito sexual contra niños, niñas y adolescentes",2020,4,1,833,120.048019207683,0,439,0,1,394,253.807106598985
30753,15,15491,81,"Tasa de exámenes médico legales por presunto delito sexual contra niños, niñas y adolescentes",2020,4,3,1565,191.693290734824,0,794,0,3,771,389.105058365759
30754,15,15491,121,Tasa de exámenes médico legales por presunto delito sexual cuando la víctima está entre 18 y 28 años,2020,5,2,2914,68.6341798215511,0,1444,0,2,1470,136.054421768707
30755,15,15494,81,"Tasa de exámenes médico legales por presunto delito sexual contra niños, niñas y adolescentes",2020,4,4,511,782.778864970646,0,275,0,4,236,1694.91525423729
30756,15,15500,81,"Tasa de exámenes médico legales por presunto delito sexual contra niños, niñas y adolescentes",2020,3,1,283,353.356890459364,0,161,0,1,122,819.672131147541
30757,15,15507,81,"Tasa de exámenes médico legales por presunto delito sexual contra niños, niñas y adolescentes",2020,4,1,869,115.074798619102,0,467,0,1,402,248.756218905473
30758,15,15507,121,Tasa de exámenes médico legales por presunto delito sexual cuando la víctima está entre 18 y 28 años,2020,5,2,1242,161.030595813205,0,613,0,2,629,317.965023847377
30759,15,15511,81,"Tasa de exámenes médico legales por presunto delito sexual contra niños, niñas y adolescentes",2020,4,1,199,502.51256281407,0,108,0,1,91,1098.9010989011
30760,15,15516,81,"Tasa de exámenes médico legales por presunto delito sexual contra niños, niñas y adolescentes",2020,3,1,3168,31.5656565656566,0,1644,0,1,1524,65.6167979002625
30761,15,15516,81,"Tasa de exámenes médico legales por presunto delito sexual contra niños, niñas y adolescentes",2020,4,3,3373,88.9415950192707,0,1732,0,3,1641,182.815356489945
30762,15,15516,121,Tasa de exámenes médico legales por presunto delito sexual cuando la víctima está entre 18 y 28 años,2020,5,7,5713,122.527568702958,1,2813,35.5492356914326,6,2900,206.896551724138
30763,15,15518,81,"Tasa de exámenes médico legales por presunto delito sexual contra niños, niñas y adolescentes",2020,3,1,240,416.666666666667,0,127,0,1,113,884.955752212389
30764,15,15531,81,"Tasa de exámenes médico legales por presunto delito sexual contra niños, niñas y adolescentes",2020,4,4,742,539.083557951482,0,395,0,4,347,1152.73775216138
30765,15,15533,81,"Tasa de exámenes médico legales por presunto delito sexual contra niños, niñas y adolescentes",2020,3,1,325,307.692307692308,0,164,0,1,161,621.11801242236
30766,15,15537,81,"Tasa de exámenes médico legales por presunto delito sexual contra niños, niñas y adolescentes",2020,3,1,371,269.541778975741,0,192,0,1,179,558.659217877095
30767,15,15572,81,"Tasa de exámenes médico legales por presunto delito sexual contra niños, niñas y adolescentes",2020,2,1,4255,23.5017626321974,0,2110,0,1,2145,46.6200466200466
30768,15,15572,81,"Tasa de exámenes médico legales por presunto delito sexual contra niños, niñas y adolescentes",2020,3,4,5030,79.5228628230616,0,2529,0,4,2501,159.936025589764
30769,15,15572,81,"Tasa de exámenes médico legales por presunto delito sexual contra niños, niñas y adolescentes",2020,4,11,4826,227.932034811438,0,2492,0,11,2334,471.293916023993
30770,15,15572,121,Tasa de exámenes médico legales por presunto delito sexual cuando la víctima está entre 18 y 28 años,2020,5,1,8291,12.0612712579906,0,4217,0,1,4074,24.5459008345606
30771,15,15580,81,"Tasa de exámenes médico legales por presunto delito sexual contra niños, niñas y adolescentes",2020,2,1,297,336.700336700337,1,147,680.272108843537,0,150,0
30772,15,15580,81,"Tasa de exámenes médico legales por presunto delito sexual contra niños, niñas y adolescentes",2020,1,1,55,1818.18181818182,1,27,3703.7037037037,0,28,0
30773,15,15599,81,"Tasa de exámenes médico legales por presunto delito sexual contra niños, niñas y adolescentes",2020,4,2,1086,184.162062615101,0,559,0,2,527,379.506641366224
30774,15,15632,81,"Tasa de exámenes médico legales por presunto delito sexual contra niños, niñas y adolescentes",2020,3,1,1452,68.870523415978,0,717,0,1,735,136.054421768707
30775,15,15632,81,"Tasa de exámenes médico legales por presunto delito sexual contra niños, niñas y adolescentes",2020,4,1,1450,68.9655172413793,0,728,0,1,722,138.504155124654
30776,15,15632,121,Tasa de exámenes médico legales por presunto delito sexual cuando la víctima está entre 18 y 28 años,2020,5,1,2149,46.5332712889716,0,1092,0,1,1057,94.6073793755913
30777,15,15646,81,"Tasa de exámenes médico legales por presunto delito sexual contra niños, niñas y adolescentes",2020,2,1,1871,53.4473543559594,0,967,0,1,904,110.619469026549
30778,15,15646,81,"Tasa de exámenes médico legales por presunto delito sexual contra niños, niñas y adolescentes",2020,3,2,2110,94.7867298578199,1,1075,93.0232558139535,1,1035,96.6183574879227
30779,15,15646,81,"Tasa de exámenes médico legales por presunto delito sexual contra niños, niñas y adolescentes",2020,4,3,1974,151.975683890577,0,1007,0,3,967,310.23784901758
30780,15,15664,81,"Tasa de exámenes médico legales por presunto delito sexual contra niños, niñas y adolescentes",2020,3,2,440,454.545454545455,1,231,432.900432900433,1,209,478.468899521531
30781,15,15667,81,"Tasa de exámenes médico legales por presunto delito sexual contra niños, niñas y adolescentes",2020,3,1,519,192.678227360308,0,274,0,1,245,408.163265306122
30782,15,15667,81,"Tasa de exámenes médico legales por presunto delito sexual contra niños, niñas y adolescentes",2020,4,1,524,190.839694656489,0,280,0,1,244,409.83606557377
30783,15,15667,121,Tasa de exámenes médico legales por presunto delito sexual cuando la víctima está entre 18 y 28 años,2020,5,1,779,128.369704749679,0,407,0,1,372,268.817204301075
30784,15,15681,81,"Tasa de exámenes médico legales por presunto delito sexual contra niños, niñas y adolescentes",2020,3,1,712,140.449438202247,0,356,0,1,356,280.898876404494
30785,15,15690,81,"Tasa de exámenes médico legales por presunto delito sexual contra niños, niñas y adolescentes",2020,2,2,247,809.716599190283,0,119,0,2,128,1562.5
30786,15,15693,121,Tasa de exámenes médico legales por presunto delito sexual cuando la víctima está entre 18 y 28 años,2020,5,1,2622,38.13882532418,1,1681,59.4883997620464,0,941,0
30787,15,15686,81,"Tasa de exámenes médico legales por presunto delito sexual contra niños, niñas y adolescentes",2020,4,2,754,265.25198938992,0,390,0,2,364,549.450549450549
30788,15,15723,81,"Tasa de exámenes médico legales por presunto delito sexual contra niños, niñas y adolescentes",2020,3,1,96,1041.66666666667,1,46,2173.91304347826,0,50,0
30789,15,15723,81,"Tasa de exámenes médico legales por presunto delito sexual contra niños, niñas y adolescentes",2020,4,1,99,1010.10101010101,0,50,0,1,49,2040.81632653061
30790,15,15723,121,Tasa de exámenes médico legales por presunto delito sexual cuando la víctima está entre 18 y 28 años,2020,5,1,150,666.666666666667,0,76,0,1,74,1351.35135135135
30791,15,15740,81,"Tasa de exámenes médico legales por presunto delito sexual contra niños, niñas y adolescentes",2020,3,1,820,121.951219512195,0,422,0,1,398,251.256281407035
30792,15,15740,81,"Tasa de exámenes médico legales por presunto delito sexual contra niños, niñas y adolescentes",2020,4,1,731,136.798905608755,0,370,0,1,361,277.008310249307
30793,15,15757,81,"Tasa de exámenes médico legales por presunto delito sexual contra niños, niñas y adolescentes",2020,3,1,830,120.481927710843,0,415,0,1,415,240.963855421687
30794,15,15755,81,"Tasa de exámenes médico legales por presunto delito sexual contra niños, niñas y adolescentes",2020,2,1,724,138.121546961326,0,376,0,1,348,287.35632183908
30795,15,15755,81,"Tasa de exámenes médico legales por presunto delito sexual contra niños, niñas y adolescentes",2020,3,1,808,123.762376237624,0,405,0,1,403,248.138957816377
30796,15,15755,81,"Tasa de exámenes médico legales por presunto delito sexual contra niños, niñas y adolescentes",2020,4,1,706,141.643059490085,0,358,0,1,348,287.35632183908
30797,15,15759,81,"Tasa de exámenes médico legales por presunto delito sexual contra niños, niñas y adolescentes",2020,2,2,8827,22.6577546165175,0,4492,0,2,4335,46.1361014994233
30798,15,15759,81,"Tasa de exámenes médico legales por presunto delito sexual contra niños, niñas y adolescentes",2020,3,7,11114,62.983624257693,1,5760,17.3611111111111,6,5354,112.065745237206
30799,15,15759,81,"Tasa de exámenes médico legales por presunto delito sexual contra niños, niñas y adolescentes",2020,4,15,11880,126.262626262626,1,6209,16.1056530842326,14,5671,246.870040557221
30800,15,15759,121,Tasa de exámenes médico legales por presunto delito sexual cuando la víctima está entre 18 y 28 años,2020,5,2,22891,8.73705823249312,0,11440,0,2,11451,17.4657235175967
30801,15,15762,81,"Tasa de exámenes médico legales por presunto delito sexual contra niños, niñas y adolescentes",2020,4,1,313,319.488817891374,0,165,0,1,148,675.675675675676
30802,15,15764,81,"Tasa de exámenes médico legales por presunto delito sexual contra niños, niñas y adolescentes",2020,4,2,688,290.697674418605,0,347,0,2,341,586.510263929619
30803,15,15763,81,"Tasa de exámenes médico legales por presunto delito sexual contra niños, niñas y adolescentes",2020,3,1,887,112.739571589628,0,463,0,1,424,235.849056603774
30804,15,15763,81,"Tasa de exámenes médico legales por presunto delito sexual contra niños, niñas y adolescentes",2020,4,2,837,238.9486260454,1,444,225.225225225225,1,393,254.452926208651
30805,15,15776,81,"Tasa de exámenes médico legales por presunto delito sexual contra niños, niñas y adolescentes",2020,4,1,608,164.473684210526,0,332,0,1,276,362.31884057971
30806,15,15778,81,"Tasa de exámenes médico legales por presunto delito sexual contra niños, niñas y adolescentes",2020,4,1,355,281.69014084507,0,181,0,1,174,574.712643678161
30807,15,15790,81,"Tasa de exámenes médico legales por presunto delito sexual contra niños, niñas y adolescentes",2020,3,1,597,167.50418760469,0,316,0,1,281,355.871886120996
30808,15,15790,81,"Tasa de exámenes médico legales por presunto delito sexual contra niños, niñas y adolescentes",2020,4,2,578,346.020761245675,0,295,0,2,283,706.713780918728
30809,15,15790,121,Tasa de exámenes médico legales por presunto delito sexual cuando la víctima está entre 18 y 28 años,2020,5,1,840,119.047619047619,0,442,0,1,398,251.256281407035
30810,15,15804,81,"Tasa de exámenes médico legales por presunto delito sexual contra niños, niñas y adolescentes",2020,2,1,714,140.056022408964,0,377,0,1,337,296.73590504451
30811,15,15804,81,"Tasa de exámenes médico legales por presunto delito sexual contra niños, niñas y adolescentes",2020,3,1,870,114.942528735632,0,457,0,1,413,242.130750605327
30812,15,15804,81,"Tasa de exámenes médico legales por presunto delito sexual contra niños, niñas y adolescentes",2020,4,1,835,119.760479041916,0,431,0,1,404,247.524752475248
30813,15,15806,81,"Tasa de exámenes médico legales por presunto delito sexual contra niños, niñas y adolescentes",2020,4,2,1236,161.812297734628,0,642,0,2,594,336.700336700337
30814,15,15806,121,Tasa de exámenes médico legales por presunto delito sexual cuando la víctima está entre 18 y 28 años,2020,5,1,2322,43.0663221360896,0,1195,0,1,1127,88.7311446317658
30815,15,15808,81,"Tasa de exámenes médico legales por presunto delito sexual contra niños, niñas y adolescentes",2020,4,1,287,348.432055749129,0,154,0,1,133,751.87969924812
30816,15,15814,81,"Tasa de exámenes médico legales por presunto delito sexual contra niños, niñas y adolescentes",2020,4,2,915,218.579234972678,0,472,0,2,443,451.467268623025
30817,15,15814,121,Tasa de exámenes médico legales por presunto delito sexual cuando la víctima está entre 18 y 28 años,2020,5,1,1465,68.259385665529,0,731,0,1,734,136.239782016349
30818,15,15820,81,"Tasa de exámenes médico legales por presunto delito sexual contra niños, niñas y adolescentes",2020,4,1,371,269.541778975741,0,173,0,1,198,505.050505050505
30819,15,15822,81,"Tasa de exámenes médico legales por presunto delito sexual contra niños, niñas y adolescentes",2020,4,1,532,187.96992481203,0,270,0,1,262,381.679389312977
30820,15,15001,81,"Tasa de exámenes médico legales por presunto delito sexual contra niños, niñas y adolescentes",2020,2,11,12186,90.2675201050386,0,6186,0,11,6000,183.333333333333
30821,15,15001,81,"Tasa de exámenes médico legales por presunto delito sexual contra niños, niñas y adolescentes",2020,3,37,15452,239.451203727673,4,7925,50.4731861198738,33,7527,438.421681944998
30822,15,15001,81,"Tasa de exámenes médico legales por presunto delito sexual contra niños, niñas y adolescentes",2020,4,41,17276,237.323454503357,2,8879,22.5250591282802,39,8397,464.451589853519
30823,15,15001,121,Tasa de exámenes médico legales por presunto delito sexual cuando la víctima está entre 18 y 28 años,2020,5,16,35748,44.7577486852411,1,17642,5.66829157691872,15,18106,82.8454655915166
30824,15,15835,81,"Tasa de exámenes médico legales por presunto delito sexual contra niños, niñas y adolescentes",2020,3,1,583,171.526586620926,0,306,0,1,277,361.01083032491
30825,15,15835,81,"Tasa de exámenes médico legales por presunto delito sexual contra niños, niñas y adolescentes",2020,4,3,576,520.833333333333,0,298,0,3,278,1079.13669064748
30826,15,15835,121,Tasa de exámenes médico legales por presunto delito sexual cuando la víctima está entre 18 y 28 años,2020,5,2,723,276.625172890733,1,366,273.224043715847,1,357,280.112044817927
30827,15,15837,81,"Tasa de exámenes médico legales por presunto delito sexual contra niños, niñas y adolescentes",2020,3,1,877,114.025085518814,1,439,227.790432801822,0,438,0
30828,15,15837,81,"Tasa de exámenes médico legales por presunto delito sexual contra niños, niñas y adolescentes",2020,4,3,828,362.31884057971,0,411,0,3,417,719.424460431655
30829,15,15842,81,"Tasa de exámenes médico legales por presunto delito sexual contra niños, niñas y adolescentes",2020,4,1,749,133.511348464619,0,396,0,1,353,283.28611898017
30830,15,15861,81,"Tasa de exámenes médico legales por presunto delito sexual contra niños, niñas y adolescentes",2020,2,1,1458,68.5871056241427,0,773,0,1,685,145.985401459854
30831,15,15861,81,"Tasa de exámenes médico legales por presunto delito sexual contra niños, niñas y adolescentes",2020,4,3,1672,179.425837320574,0,872,0,3,800,375
30832,15,15407,81,"Tasa de exámenes médico legales por presunto delito sexual contra niños, niñas y adolescentes",2020,2,3,1294,231.839258114374,0,656,0,3,638,470.219435736677
30833,15,15407,81,"Tasa de exámenes médico legales por presunto delito sexual contra niños, niñas y adolescentes",2020,3,3,1506,199.203187250996,0,777,0,3,729,411.522633744856
30834,15,15407,81,"Tasa de exámenes médico legales por presunto delito sexual contra niños, niñas y adolescentes",2020,4,3,1517,197.7587343441,0,787,0,3,730,410.958904109589
30835,15,15897,81,"Tasa de exámenes médico legales por presunto delito sexual contra niños, niñas y adolescentes",2020,3,1,448,223.214285714286,0,234,0,1,214,467.289719626168
30836,17,17013,81,"Tasa de exámenes médico legales por presunto delito sexual contra niños, niñas y adolescentes",2020,2,1,1681,59.4883997620464,0,889,0,1,792,126.262626262626
30837,17,17013,81,"Tasa de exámenes médico legales por presunto delito sexual contra niños, niñas y adolescentes",2020,4,1,1961,50.9943906170321,1,989,101.112234580384,0,972,0
30838,17,17042,81,"Tasa de exámenes médico legales por presunto delito sexual contra niños, niñas y adolescentes",2020,2,4,2416,165.562913907285,1,1243,80.450522928399,3,1173,255.754475703325
30839,17,17042,81,"Tasa de exámenes médico legales por presunto delito sexual contra niños, niñas y adolescentes",2020,3,7,3006,232.867598137059,5,1553,321.957501609787,2,1453,137.646249139711
30840,17,17042,81,"Tasa de exámenes médico legales por presunto delito sexual contra niños, niñas y adolescentes",2020,4,6,3163,189.693329117926,0,1634,0,6,1529,392.41334205363
30841,17,17042,121,Tasa de exámenes médico legales por presunto delito sexual cuando la víctima está entre 18 y 28 años,2020,5,1,5640,17.7304964539007,0,2878,0,1,2762,36.2056480811006
30842,17,17050,81,"Tasa de exámenes médico legales por presunto delito sexual contra niños, niñas y adolescentes",2020,2,1,788,126.903553299492,0,412,0,1,376,265.957446808511
30843,17,17088,81,"Tasa de exámenes médico legales por presunto delito sexual contra niños, niñas y adolescentes",2020,3,3,1054,284.629981024668,0,560,0,3,494,607.287449392713
30844,17,17174,81,"Tasa de exámenes médico legales por presunto delito sexual contra niños, niñas y adolescentes",2020,3,3,4032,74.4047619047619,0,2051,0,3,1981,151.438667339727
30845,17,17174,81,"Tasa de exámenes médico legales por presunto delito sexual contra niños, niñas y adolescentes",2020,4,2,4473,44.7127207690588,0,2219,0,2,2254,88.7311446317658
30846,17,17272,81,"Tasa de exámenes médico legales por presunto delito sexual contra niños, niñas y adolescentes",2020,2,1,761,131.406044678055,0,382,0,1,379,263.852242744063
30847,17,17272,81,"Tasa de exámenes médico legales por presunto delito sexual contra niños, niñas y adolescentes",2020,4,1,1012,98.8142292490118,0,523,0,1,489,204.498977505112
30848,17,17380,81,"Tasa de exámenes médico legales por presunto delito sexual contra niños, niñas y adolescentes",2020,2,3,5596,53.6097212294496,1,2842,35.1864883884588,2,2754,72.6216412490922
30849,17,17380,81,"Tasa de exámenes médico legales por presunto delito sexual contra niños, niñas y adolescentes",2020,3,8,6723,118.994496504537,2,3386,59.0667454223272,6,3337,179.802217560683
30850,17,17380,81,"Tasa de exámenes médico legales por presunto delito sexual contra niños, niñas y adolescentes",2020,4,12,6797,176.548477269384,2,3384,59.1016548463357,10,3413,292.997363023733
30851,17,17380,121,Tasa de exámenes médico legales por presunto delito sexual cuando la víctima está entre 18 y 28 años,2020,5,6,12191,49.2166352227053,1,6039,16.5590329524756,5,6152,81.2743823146944
30852,17,17388,81,"Tasa de exámenes médico legales por presunto delito sexual contra niños, niñas y adolescentes",2020,1,1,71,1408.45070422535,0,38,0,1,33,3030.30303030303
30853,17,17001,81,"Tasa de exámenes médico legales por presunto delito sexual contra niños, niñas y adolescentes",2020,2,29,23749,122.110404648617,7,11976,58.4502338009352,22,11773,186.868257878196
30854,17,17001,81,"Tasa de exámenes médico legales por presunto delito sexual contra niños, niñas y adolescentes",2020,3,49,29320,167.121418826739,10,14874,67.2314105149926,39,14446,269.970926207947
30855,17,17001,81,"Tasa de exámenes médico legales por presunto delito sexual contra niños, niñas y adolescentes",2020,4,67,34329,195.170264208104,10,17430,57.372346528973,57,16899,337.298064974259
30856,17,17001,121,Tasa de exámenes médico legales por presunto delito sexual cuando la víctima está entre 18 y 28 años,2020,5,16,79595,20.1017651862554,2,39727,5.03435950361215,14,39868,35.1158824119595
30857,17,17442,81,"Tasa de exámenes médico legales por presunto delito sexual contra niños, niñas y adolescentes",2020,3,4,953,419.727177334732,1,500,200,3,453,662.251655629139
30858,17,17444,81,"Tasa de exámenes médico legales por presunto delito sexual contra niños, niñas y adolescentes",2020,3,1,1307,76.5110941086458,0,678,0,1,629,158.982511923688
30859,17,17486,81,"Tasa de exámenes médico legales por presunto delito sexual contra niños, niñas y adolescentes",2020,2,1,1521,65.7462195923734,1,795,125.786163522013,0,726,0
30860,17,17486,81,"Tasa de exámenes médico legales por presunto delito sexual contra niños, niñas y adolescentes",2020,3,2,1833,109.11074740862,0,977,0,2,856,233.644859813084
30861,17,17486,81,"Tasa de exámenes médico legales por presunto delito sexual contra niños, niñas y adolescentes",2020,4,2,1876,106.609808102345,0,1003,0,2,873,229.095074455899
30862,17,17495,81,"Tasa de exámenes médico legales por presunto delito sexual contra niños, niñas y adolescentes",2020,2,1,530,188.679245283019,0,282,0,1,248,403.225806451613
30863,17,17495,81,"Tasa de exámenes médico legales por presunto delito sexual contra niños, niñas y adolescentes",2020,4,2,654,305.810397553517,0,333,0,2,321,623.052959501558
30864,17,17495,121,Tasa de exámenes médico legales por presunto delito sexual cuando la víctima está entre 18 y 28 años,2020,5,2,1033,193.610842207164,0,500,0,2,533,375.234521575985
30865,17,17513,81,"Tasa de exámenes médico legales por presunto delito sexual contra niños, niñas y adolescentes",2020,2,1,935,106.951871657754,0,456,0,1,479,208.768267223382
30866,17,17524,81,"Tasa de exámenes médico legales por presunto delito sexual contra niños, niñas y adolescentes",2020,4,1,1362,73.4214390602056,0,674,0,1,688,145.348837209302
30867,17,17614,81,"Tasa de exámenes médico legales por presunto delito sexual contra niños, niñas y adolescentes",2020,2,1,4046,24.7157686604053,0,2042,0,1,2004,49.9001996007984
30868,17,17614,81,"Tasa de exámenes médico legales por presunto delito sexual contra niños, niñas y adolescentes",2020,3,4,4577,87.3934891850557,1,2349,42.571306939123,3,2228,134.649910233393
30869,17,17614,81,"Tasa de exámenes médico legales por presunto delito sexual contra niños, niñas y adolescentes",2020,4,7,4564,153.374233128834,0,2384,0,7,2180,321.100917431193
30870,17,17614,121,Tasa de exámenes médico legales por presunto delito sexual cuando la víctima está entre 18 y 28 años,2020,5,2,8306,24.0789790512882,1,4246,23.551577955723,1,4060,24.6305418719212
30871,17,17616,81,"Tasa de exámenes médico legales por presunto delito sexual contra niños, niñas y adolescentes",2020,3,2,882,226.757369614512,1,471,212.314225053079,1,411,243.30900243309
30872,17,17616,81,"Tasa de exámenes médico legales por presunto delito sexual contra niños, niñas y adolescentes",2020,4,3,929,322.927879440258,0,505,0,3,424,707.547169811321
30873,17,17616,121,Tasa de exámenes médico legales por presunto delito sexual cuando la víctima está entre 18 y 28 años,2020,5,1,1630,61.3496932515337,0,858,0,1,772,129.533678756477
30874,17,17653,81,"Tasa de exámenes médico legales por presunto delito sexual contra niños, niñas y adolescentes",2020,3,1,1525,65.5737704918033,0,795,0,1,730,136.986301369863
30875,17,17653,81,"Tasa de exámenes médico legales por presunto delito sexual contra niños, niñas y adolescentes",2020,4,5,1613,309.981401115933,2,850,235.294117647059,3,763,393.184796854522
30876,17,17653,121,Tasa de exámenes médico legales por presunto delito sexual cuando la víctima está entre 18 y 28 años,2020,5,2,2701,74.0466493891151,0,1398,0,2,1303,153.491941673062
30877,17,17662,81,"Tasa de exámenes médico legales por presunto delito sexual contra niños, niñas y adolescentes",2020,4,5,1889,264.690312334569,0,983,0,5,906,551.876379690949
30878,17,17665,81,"Tasa de exámenes médico legales por presunto delito sexual contra niños, niñas y adolescentes",2020,3,1,438,228.310502283105,0,221,0,1,217,460.829493087558
30879,17,17665,81,"Tasa de exámenes médico legales por presunto delito sexual contra niños, niñas y adolescentes",2020,4,1,405,246.913580246914,0,201,0,1,204,490.196078431373
30880,17,17777,81,"Tasa de exámenes médico legales por presunto delito sexual contra niños, niñas y adolescentes",2020,2,1,2316,43.1778929188256,0,1238,0,1,1078,92.7643784786642
30881,17,17777,81,"Tasa de exámenes médico legales por presunto delito sexual contra niños, niñas y adolescentes",2020,3,5,2597,192.529842125529,0,1356,0,5,1241,402.90088638195
30882,17,17777,81,"Tasa de exámenes médico legales por presunto delito sexual contra niños, niñas y adolescentes",2020,4,11,2597,423.565652676165,0,1321,0,11,1276,862.068965517241
30883,17,17867,81,"Tasa de exámenes médico legales por presunto delito sexual contra niños, niñas y adolescentes",2020,3,1,993,100.704934541793,0,496,0,1,497,201.207243460765
30884,17,17873,81,"Tasa de exámenes médico legales por presunto delito sexual contra niños, niñas y adolescentes",2020,2,4,4397,90.9711166704571,1,2249,44.4642063139173,3,2148,139.664804469274
30885,17,17873,81,"Tasa de exámenes médico legales por presunto delito sexual contra niños, niñas y adolescentes",2020,3,11,5266,208.887200911508,3,2736,109.649122807018,8,2530,316.205533596838
30886,17,17873,81,"Tasa de exámenes médico legales por presunto delito sexual contra niños, niñas y adolescentes",2020,4,13,5636,230.660042583392,1,2921,34.2348510783978,12,2715,441.988950276243
30887,17,17873,121,Tasa de exámenes médico legales por presunto delito sexual cuando la víctima está entre 18 y 28 años,2020,5,4,11543,34.6530364723209,0,5715,0,4,5828,68.6341798215511
30888,17,17877,81,"Tasa de exámenes médico legales por presunto delito sexual contra niños, niñas y adolescentes",2020,3,1,1002,99.8003992015968,0,514,0,1,488,204.918032786885
30889,17,17877,81,"Tasa de exámenes médico legales por presunto delito sexual contra niños, niñas y adolescentes",2020,4,1,1152,86.8055555555556,0,560,0,1,592,168.918918918919
30890,18,18094,81,"Tasa de exámenes médico legales por presunto delito sexual contra niños, niñas y adolescentes",2020,3,5,1431,349.406009783368,4,752,531.914893617021,1,679,147.275405007364
30891,18,18150,81,"Tasa de exámenes médico legales por presunto delito sexual contra niños, niñas y adolescentes",2020,2,2,3790,52.7704485488127,0,1901,0,2,1889,105.876124933827
30892,18,18150,81,"Tasa de exámenes médico legales por presunto delito sexual contra niños, niñas y adolescentes",2020,3,5,4401,113.610543058396,0,2248,0,5,2153,232.2340919647
30893,18,18150,81,"Tasa de exámenes médico legales por presunto delito sexual contra niños, niñas y adolescentes",2020,4,15,3987,376.222723852521,1,2051,48.7567040468064,14,1936,723.140495867769
30894,18,18150,121,Tasa de exámenes médico legales por presunto delito sexual cuando la víctima está entre 18 y 28 años,2020,5,2,5536,36.1271676300578,0,2716,0,2,2820,70.9219858156028
30895,18,18205,121,Tasa de exámenes médico legales por presunto delito sexual cuando la víctima está entre 18 y 28 años,2020,5,1,1341,74.5712155108128,0,686,0,1,655,152.671755725191
30896,18,18247,81,"Tasa de exámenes médico legales por presunto delito sexual contra niños, niñas y adolescentes",2020,2,4,1801,222.098833981122,2,928,215.51724137931,2,873,229.095074455899
30897,18,18247,81,"Tasa de exámenes médico legales por presunto delito sexual contra niños, niñas y adolescentes",2020,3,2,2284,87.5656742556918,0,1179,0,2,1105,180.995475113122
30898,18,18247,81,"Tasa de exámenes médico legales por presunto delito sexual contra niños, niñas y adolescentes",2020,4,3,2259,132.802124833997,0,1166,0,3,1093,274.473924977127
30899,18,18256,81,"Tasa de exámenes médico legales por presunto delito sexual contra niños, niñas y adolescentes",2020,3,6,2324,258.175559380379,1,1196,83.6120401337793,5,1128,443.262411347518
30900,18,18256,81,"Tasa de exámenes médico legales por presunto delito sexual contra niños, niñas y adolescentes",2020,4,1,2200,45.4545454545455,0,1146,0,1,1054,94.876660341556
30901,18,18256,121,Tasa de exámenes médico legales por presunto delito sexual cuando la víctima está entre 18 y 28 años,2020,5,1,3336,29.9760191846523,0,1724,0,1,1612,62.0347394540943
30902,18,18001,81,"Tasa de exámenes médico legales por presunto delito sexual contra niños, niñas y adolescentes",2020,2,6,14804,40.5295865982167,0,7649,0,6,7155,83.8574423480084
30903,18,18001,81,"Tasa de exámenes médico legales por presunto delito sexual contra niños, niñas y adolescentes",2020,3,36,17860,201.567749160134,7,9162,76.40253219821,29,8698,333.409979305588
30904,18,18001,81,"Tasa de exámenes médico legales por presunto delito sexual contra niños, niñas y adolescentes",2020,4,38,18566,204.675212754497,6,9473,63.3379077377811,32,9093,351.919058616518
30905,18,18001,121,Tasa de exámenes médico legales por presunto delito sexual cuando la víctima está entre 18 y 28 años,2020,5,9,36230,24.8412917471709,2,18679,10.7072113068151,7,17551,39.8837673067062
30906,18,18410,81,"Tasa de exámenes médico legales por presunto delito sexual contra niños, niñas y adolescentes",2020,3,2,2035,98.2800982800983,1,1051,95.1474785918173,1,984,101.626016260163
30907,18,18410,81,"Tasa de exámenes médico legales por presunto delito sexual contra niños, niñas y adolescentes",2020,4,2,1945,102.827763496144,0,1009,0,2,936,213.675213675214
30908,18,18460,81,"Tasa de exámenes médico legales por presunto delito sexual contra niños, niñas y adolescentes",2020,2,2,1246,160.513643659711,0,597,0,2,649,308.166409861325
30909,18,18460,81,"Tasa de exámenes médico legales por presunto delito sexual contra niños, niñas y adolescentes",2020,3,3,1545,194.174757281553,0,790,0,3,755,397.350993377483
30910,18,18460,81,"Tasa de exámenes médico legales por presunto delito sexual contra niños, niñas y adolescentes",2020,4,2,1414,141.442715700141,0,769,0,2,645,310.077519379845
30911,18,18592,81,"Tasa de exámenes médico legales por presunto delito sexual contra niños, niñas y adolescentes",2020,3,3,3400,88.2352941176471,0,1723,0,3,1677,178.890876565295
30912,18,18592,81,"Tasa de exámenes médico legales por presunto delito sexual contra niños, niñas y adolescentes",2020,4,15,3443,435.666569851873,1,1793,55.7724484104852,14,1650,848.484848484849
30913,18,18592,121,Tasa de exámenes médico legales por presunto delito sexual cuando la víctima está entre 18 y 28 años,2020,5,1,4795,20.8550573514077,0,2508,0,1,2287,43.7254044599913
30914,18,18610,81,"Tasa de exámenes médico legales por presunto delito sexual contra niños, niñas y adolescentes",2020,2,3,1338,224.215246636771,1,691,144.717800289436,2,647,309.119010819165
30915,18,18610,81,"Tasa de exámenes médico legales por presunto delito sexual contra niños, niñas y adolescentes",2020,3,4,1808,221.238938053097,0,915,0,4,893,447.928331466965
30916,18,18610,81,"Tasa de exámenes médico legales por presunto delito sexual contra niños, niñas y adolescentes",2020,4,3,1805,166.204986149584,0,912,0,3,893,335.946248600224
30917,18,18610,121,Tasa de exámenes médico legales por presunto delito sexual cuando la víctima está entre 18 y 28 años,2020,5,2,2351,85.0701829008932,0,1192,0,2,1159,172.562553925798
30918,18,18753,81,"Tasa de exámenes médico legales por presunto delito sexual contra niños, niñas y adolescentes",2020,2,3,6103,49.1561527117811,0,3137,0,3,2966,101.146325016858
30919,18,18753,81,"Tasa de exámenes médico legales por presunto delito sexual contra niños, niñas y adolescentes",2020,3,11,6936,158.592848904268,1,3546,28.2007896221094,10,3390,294.985250737463
30920,18,18753,81,"Tasa de exámenes médico legales por presunto delito sexual contra niños, niñas y adolescentes",2020,4,41,6370,643.642072213501,3,3324,90.2527075812274,38,3046,1247.53775443204
30921,18,18753,121,Tasa de exámenes médico legales por presunto delito sexual cuando la víctima está entre 18 y 28 años,2020,5,7,9902,70.6927893354878,1,5328,18.7687687687688,6,4574,131.176213379974
30922,18,18756,81,"Tasa de exámenes médico legales por presunto delito sexual contra niños, niñas y adolescentes",2020,3,1,1669,59.9161174355902,0,861,0,1,808,123.762376237624
30923,18,18756,81,"Tasa de exámenes médico legales por presunto delito sexual contra niños, niñas y adolescentes",2020,4,2,1545,129.449838187702,0,827,0,2,718,278.551532033426
30924,18,18785,81,"Tasa de exámenes médico legales por presunto delito sexual contra niños, niñas y adolescentes",2020,2,1,637,156.985871271586,0,320,0,1,317,315.457413249211
30925,18,18785,81,"Tasa de exámenes médico legales por presunto delito sexual contra niños, niñas y adolescentes",2020,3,2,838,238.663484486874,0,414,0,2,424,471.698113207547
30926,18,18785,81,"Tasa de exámenes médico legales por presunto delito sexual contra niños, niñas y adolescentes",2020,4,2,844,236.96682464455,0,427,0,2,417,479.616306954436
30927,18,18860,81,"Tasa de exámenes médico legales por presunto delito sexual contra niños, niñas y adolescentes",2020,2,1,578,173.010380622837,0,301,0,1,277,361.01083032491
30928,18,18860,81,"Tasa de exámenes médico legales por presunto delito sexual contra niños, niñas y adolescentes",2020,3,1,918,108.932461873638,0,488,0,1,430,232.558139534884
30929,18,18860,81,"Tasa de exámenes médico legales por presunto delito sexual contra niños, niñas y adolescentes",2020,4,3,1049,285.986653956149,1,546,183.150183150183,2,503,397.614314115308
30930,85,85010,81,"Tasa de exámenes médico legales por presunto delito sexual contra niños, niñas y adolescentes",2020,2,9,3332,270.108043217287,2,1746,114.54753722795,7,1586,441.361916771753
30931,85,85010,81,"Tasa de exámenes médico legales por presunto delito sexual contra niños, niñas y adolescentes",2020,3,13,3953,328.864153807235,1,2051,48.7567040468064,12,1902,630.914826498423
30932,85,85010,81,"Tasa de exámenes médico legales por presunto delito sexual contra niños, niñas y adolescentes",2020,4,7,4026,173.869846000994,0,2054,0,7,1972,354.969574036511
30933,85,85010,121,Tasa de exámenes médico legales por presunto delito sexual cuando la víctima está entre 18 y 28 años,2020,5,5,7360,67.9347826086957,0,3728,0,5,3632,137.665198237885
30934,85,85125,81,"Tasa de exámenes médico legales por presunto delito sexual contra niños, niñas y adolescentes",2020,3,3,1645,182.370820668693,1,836,119.617224880383,2,809,247.218788627936
30935,85,85125,81,"Tasa de exámenes médico legales por presunto delito sexual contra niños, niñas y adolescentes",2020,4,1,1574,63.5324015247776,0,821,0,1,753,132.802124833997
30936,85,85139,81,"Tasa de exámenes médico legales por presunto delito sexual contra niños, niñas y adolescentes",2020,2,2,1706,117.233294255569,0,877,0,2,829,241.254523522316
30937,85,85139,81,"Tasa de exámenes médico legales por presunto delito sexual contra niños, niñas y adolescentes",2020,3,3,1923,156.00624024961,0,1020,0,3,903,332.225913621262
30938,85,85139,81,"Tasa de exámenes médico legales por presunto delito sexual contra niños, niñas y adolescentes",2020,4,13,1825,712.328767123288,1,974,102.669404517454,12,851,1410.10575793184
30939,85,85139,121,Tasa de exámenes médico legales por presunto delito sexual cuando la víctima está entre 18 y 28 años,2020,5,2,3179,62.9128656810318,0,1616,0,2,1563,127.959053103007
30940,85,85162,81,"Tasa de exámenes médico legales por presunto delito sexual contra niños, niñas y adolescentes",2020,2,1,1615,61.9195046439629,0,813,0,1,802,124.688279301746
30941,85,85162,81,"Tasa de exámenes médico legales por presunto delito sexual contra niños, niñas y adolescentes",2020,3,13,1864,697.424892703863,2,938,213.219616204691,11,926,1187.90496760259
30942,85,85162,81,"Tasa de exámenes médico legales por presunto delito sexual contra niños, niñas y adolescentes",2020,4,8,1845,433.60433604336,0,922,0,8,923,866.738894907909
30943,85,85162,121,Tasa de exámenes médico legales por presunto delito sexual cuando la víctima está entre 18 y 28 años,2020,5,1,3373,29.6471983397569,0,1669,0,1,1704,58.6854460093897
30944,85,85225,81,"Tasa de exámenes médico legales por presunto delito sexual contra niños, niñas y adolescentes",2020,3,3,948,316.455696202532,1,492,203.252032520325,2,456,438.59649122807
30945,85,85230,81,"Tasa de exámenes médico legales por presunto delito sexual contra niños, niñas y adolescentes",2020,3,1,1702,58.7544065804935,0,863,0,1,839,119.189511323004
30946,85,85230,81,"Tasa de exámenes médico legales por presunto delito sexual contra niños, niñas y adolescentes",2020,4,1,1612,62.0347394540943,0,838,0,1,774,129.198966408269
30947,85,85230,121,Tasa de exámenes médico legales por presunto delito sexual cuando la víctima está entre 18 y 28 años,2020,5,1,2284,43.7828371278459,0,1144,0,1,1140,87.719298245614
30948,85,85250,81,"Tasa de exámenes médico legales por presunto delito sexual contra niños, niñas y adolescentes",2020,2,1,3948,25.3292806484296,0,1997,0,1,1951,51.2557662737058
30949,85,85250,81,"Tasa de exámenes médico legales por presunto delito sexual contra niños, niñas y adolescentes",2020,3,3,4461,67.2494956287828,1,2287,43.7254044599913,2,2174,91.9963201471941
30950,85,85250,81,"Tasa de exámenes médico legales por presunto delito sexual contra niños, niñas y adolescentes",2020,4,14,4169,335.811945310626,0,2142,0,14,2027,690.675875678342
30951,85,85250,121,Tasa de exámenes médico legales por presunto delito sexual cuando la víctima está entre 18 y 28 años,2020,5,4,6949,57.5622391711038,0,3527,0,4,3422,116.890707188778
30952,85,85263,81,"Tasa de exámenes médico legales por presunto delito sexual contra niños, niñas y adolescentes",2020,3,3,1467,204.498977505112,0,761,0,3,706,424.929178470255
30953,85,85263,81,"Tasa de exámenes médico legales por presunto delito sexual contra niños, niñas y adolescentes",2020,4,11,1409,780.69552874379,0,724,0,11,685,1605.83941605839
30954,85,85300,81,"Tasa de exámenes médico legales por presunto delito sexual contra niños, niñas y adolescentes",2020,4,3,372,806.451612903226,0,205,0,3,167,1796.40718562874
30955,85,85410,81,"Tasa de exámenes médico legales por presunto delito sexual contra niños, niñas y adolescentes",2020,2,5,2334,214.224507283633,1,1183,84.530853761623,4,1151,347.523892267593
30956,85,85410,81,"Tasa de exámenes médico legales por presunto delito sexual contra niños, niñas y adolescentes",2020,3,10,2820,354.609929078014,1,1437,69.589422407794,9,1383,650.759219088937
30957,85,85410,81,"Tasa de exámenes médico legales por presunto delito sexual contra niños, niñas y adolescentes",2020,4,9,2899,310.451879958606,0,1519,0,9,1380,652.173913043478
30958,85,85430,81,"Tasa de exámenes médico legales por presunto delito sexual contra niños, niñas y adolescentes",2020,2,1,1473,67.8886625933469,0,739,0,1,734,136.239782016349
30959,85,85430,81,"Tasa de exámenes médico legales por presunto delito sexual contra niños, niñas y adolescentes",2020,4,1,1504,66.4893617021277,0,779,0,1,725,137.931034482759
30960,85,85430,121,Tasa de exámenes médico legales por presunto delito sexual cuando la víctima está entre 18 y 28 años,2020,5,1,2475,40.4040404040404,0,1216,0,1,1259,79.428117553614
30961,85,85440,81,"Tasa de exámenes médico legales por presunto delito sexual contra niños, niñas y adolescentes",2020,2,7,3291,212.70130659374,1,1741,57.4382538770821,6,1550,387.096774193548
30962,85,85440,81,"Tasa de exámenes médico legales por presunto delito sexual contra niños, niñas y adolescentes",2020,3,12,3857,311.122634171636,2,1988,100.603621730382,10,1869,535.045478865704
30963,85,85440,81,"Tasa de exámenes médico legales por presunto delito sexual contra niños, niñas y adolescentes",2020,4,23,3876,593.395252837977,2,1918,104.275286757039,21,1958,1072.52298263534
30964,85,85440,121,Tasa de exámenes médico legales por presunto delito sexual cuando la víctima está entre 18 y 28 años,2020,5,3,7181,41.7769112936917,0,3554,0,3,3627,82.7129859387924
30965,85,85001,81,"Tasa de exámenes médico legales por presunto delito sexual contra niños, niñas y adolescentes",2020,2,19,15150,125.412541254125,5,7646,65.3936698927544,14,7504,186.567164179104
30966,85,85001,81,"Tasa de exámenes médico legales por presunto delito sexual contra niños, niñas y adolescentes",2020,3,43,17667,243.391634120111,5,8946,55.8909009613235,38,8721,435.729847494553
30967,85,85001,81,"Tasa de exámenes médico legales por presunto delito sexual contra niños, niñas y adolescentes",2020,4,68,18152,374.614367562803,4,9166,43.6395374209033,64,8986,712.219007344759
30968,85,85001,121,Tasa de exámenes médico legales por presunto delito sexual cuando la víctima está entre 18 y 28 años,2020,5,6,36313,16.5230082890425,0,18051,0,6,18262,32.8551089694447
30969,19,19022,81,"Tasa de exámenes médico legales por presunto delito sexual contra niños, niñas y adolescentes",2020,2,1,1170,85.4700854700855,0,581,0,1,589,169.779286926995
30970,19,19022,81,"Tasa de exámenes médico legales por presunto delito sexual contra niños, niñas y adolescentes",2020,3,2,1612,124.069478908189,0,800,0,2,812,246.305418719212
30971,19,19022,81,"Tasa de exámenes médico legales por presunto delito sexual contra niños, niñas y adolescentes",2020,4,4,1893,211.304807184363,0,962,0,4,931,429.645542427497
30972,19,19050,81,"Tasa de exámenes médico legales por presunto delito sexual contra niños, niñas y adolescentes",2020,3,1,2636,37.9362670713202,0,1347,0,1,1289,77.5795190069822
30973,19,19050,81,"Tasa de exámenes médico legales por presunto delito sexual contra niños, niñas y adolescentes",2020,4,1,2883,34.6860908775581,0,1516,0,1,1367,73.1528895391368
30974,19,19075,81,"Tasa de exámenes médico legales por presunto delito sexual contra niños, niñas y adolescentes",2020,3,3,2018,148.662041625372,1,1033,96.8054211035818,2,985,203.045685279188
30975,19,19075,81,"Tasa de exámenes médico legales por presunto delito sexual contra niños, niñas y adolescentes",2020,4,1,2294,43.59197907585,0,1199,0,1,1095,91.324200913242
30976,19,19100,81,"Tasa de exámenes médico legales por presunto delito sexual contra niños, niñas y adolescentes",2020,2,1,2270,44.0528634361234,0,1156,0,1,1114,89.7666068222621
30977,19,19100,81,"Tasa de exámenes médico legales por presunto delito sexual contra niños, niñas y adolescentes",2020,3,2,3015,66.334991708126,0,1565,0,2,1450,137.931034482759
30978,19,19100,81,"Tasa de exámenes médico legales por presunto delito sexual contra niños, niñas y adolescentes",2020,4,1,3491,28.6450873675165,0,1850,0,1,1641,60.9384521633151
30979,19,19100,121,Tasa de exámenes médico legales por presunto delito sexual cuando la víctima está entre 18 y 28 años,2020,5,1,6669,14.9947518368571,1,3560,28.0898876404494,0,3109,0
30980,19,19110,81,"Tasa de exámenes médico legales por presunto delito sexual contra niños, niñas y adolescentes",2020,4,1,3634,27.5178866263071,0,1855,0,1,1779,56.2113546936481
30981,19,19110,121,Tasa de exámenes médico legales por presunto delito sexual cuando la víctima está entre 18 y 28 años,2020,5,1,6602,15.1469251741896,0,3240,0,1,3362,29.7441998810232
30982,19,19130,81,"Tasa de exámenes médico legales por presunto delito sexual contra niños, niñas y adolescentes",2020,2,1,3387,29.5246530853262,0,1760,0,1,1627,61.4628149969269
30983,19,19130,81,"Tasa de exámenes médico legales por presunto delito sexual contra niños, niñas y adolescentes",2020,3,3,4370,68.649885583524,1,2262,44.2086648983201,2,2108,94.876660341556
30984,19,19130,81,"Tasa de exámenes médico legales por presunto delito sexual contra niños, niñas y adolescentes",2020,4,7,4772,146.689019279128,1,2469,40.5022276225192,6,2303,260.529743812419
30985,19,19137,121,Tasa de exámenes médico legales por presunto delito sexual cuando la víctima está entre 18 y 28 años,2020,5,1,8382,11.9303268909568,1,4337,23.0574129582661,0,4045,0
30986,19,19142,81,"Tasa de exámenes médico legales por presunto delito sexual contra niños, niñas y adolescentes",2020,4,1,3309,30.2206104563312,0,1675,0,1,1634,61.1995104039168
30987,19,19142,121,Tasa de exámenes médico legales por presunto delito sexual cuando la víctima está entre 18 y 28 años,2020,5,2,6307,31.7107975265578,0,3172,0,2,3135,63.7958532695375
30988,19,19212,81,"Tasa de exámenes médico legales por presunto delito sexual contra niños, niñas y adolescentes",2020,2,1,1812,55.1876379690949,0,901,0,1,911,109.769484083425
30989,19,19212,81,"Tasa de exámenes médico legales por presunto delito sexual contra niños, niñas y adolescentes",2020,3,3,2422,123.864574731627,0,1223,0,3,1199,250.208507089241
30990,19,19212,81,"Tasa de exámenes médico legales por presunto delito sexual contra niños, niñas y adolescentes",2020,4,1,2852,35.0631136044881,0,1493,0,1,1359,73.5835172921266
30991,19,19212,121,Tasa de exámenes médico legales por presunto delito sexual cuando la víctima está entre 18 y 28 años,2020,5,1,5337,18.737118231216,0,2867,0,1,2470,40.4858299595142
30992,19,19256,81,"Tasa de exámenes médico legales por presunto delito sexual contra niños, niñas y adolescentes",2020,2,4,3808,105.042016806723,0,1949,0,4,1859,215.169445938677
30993,19,19256,81,"Tasa de exámenes médico legales por presunto delito sexual contra niños, niñas y adolescentes",2020,3,4,4878,82.0008200082001,0,2485,0,4,2393,167.154199749269
30994,19,19256,81,"Tasa de exámenes médico legales por presunto delito sexual contra niños, niñas y adolescentes",2020,4,15,5326,281.637251220428,0,2730,0,15,2596,577.812018489985
30995,19,19256,121,Tasa de exámenes médico legales por presunto delito sexual cuando la víctima está entre 18 y 28 años,2020,5,1,9698,10.3114044132811,0,5043,0,1,4655,21.4822771213749
30996,19,19290,81,"Tasa de exámenes médico legales por presunto delito sexual contra niños, niñas y adolescentes",2020,3,1,465,215.05376344086,0,253,0,1,212,471.698113207547
30997,19,19290,81,"Tasa de exámenes médico legales por presunto delito sexual contra niños, niñas y adolescentes",2020,4,1,529,189.035916824197,0,282,0,1,247,404.858299595142
30998,19,19300,81,"Tasa de exámenes médico legales por presunto delito sexual contra niños, niñas y adolescentes",2020,3,1,1897,52.7148128624143,0,954,0,1,943,106.044538706257
30999,19,19300,81,"Tasa de exámenes médico legales por presunto delito sexual contra niños, niñas y adolescentes",2020,4,1,2159,46.3177396943029,0,1078,0,1,1081,92.5069380203515
31000,19,19300,121,Tasa de exámenes médico legales por presunto delito sexual cuando la víctima está entre 18 y 28 años,2020,5,2,4097,48.8162069807176,0,1912,0,2,2185,91.533180778032
31001,19,19355,81,"Tasa de exámenes médico legales por presunto delito sexual contra niños, niñas y adolescentes",2020,4,1,3518,28.4252416145537,0,1740,0,1,1778,56.2429696287964
31002,19,19392,81,"Tasa de exámenes médico legales por presunto delito sexual contra niños, niñas y adolescentes",2020,3,5,897,557.413600891862,1,449,222.71714922049,4,448,892.857142857143
31003,19,19392,81,"Tasa de exámenes médico legales por presunto delito sexual contra niños, niñas y adolescentes",2020,4,3,968,309.917355371901,1,497,201.207243460765,2,471,424.628450106157
31004,19,19392,121,Tasa de exámenes médico legales por presunto delito sexual cuando la víctima está entre 18 y 28 años,2020,5,1,1946,51.3874614594039,1,998,100.200400801603,0,948,0
31005,19,19397,81,"Tasa de exámenes médico legales por presunto delito sexual contra niños, niñas y adolescentes",2020,2,2,1733,115.406809001731,0,911,0,2,822,243.30900243309
31006,19,19397,81,"Tasa de exámenes médico legales por presunto delito sexual contra niños, niñas y adolescentes",2020,3,2,2171,92.1234454168586,0,1108,0,2,1063,188.146754468485
31007,19,19397,81,"Tasa de exámenes médico legales por presunto delito sexual contra niños, niñas y adolescentes",2020,4,1,2427,41.2031314379893,0,1215,0,1,1212,82.5082508250825
31008,19,19397,121,Tasa de exámenes médico legales por presunto delito sexual cuando la víctima está entre 18 y 28 años,2020,5,1,4763,20.9951711106446,0,2396,0,1,2367,42.247570764681
31009,19,19418,81,"Tasa de exámenes médico legales por presunto delito sexual contra niños, niñas y adolescentes",2020,4,1,2546,39.2772977219167,0,1320,0,1,1226,81.5660685154976
31010,19,19450,81,"Tasa de exámenes médico legales por presunto delito sexual contra niños, niñas y adolescentes",2020,3,2,1980,101.010101010101,0,1025,0,2,955,209.424083769634
31011,19,19450,81,"Tasa de exámenes médico legales por presunto delito sexual contra niños, niñas y adolescentes",2020,4,1,2244,44.5632798573975,0,1161,0,1,1083,92.3361034164358
31012,19,19455,81,"Tasa de exámenes médico legales por presunto delito sexual contra niños, niñas y adolescentes",2020,3,2,2912,68.6813186813187,0,1472,0,2,1440,138.888888888889
31013,19,19455,81,"Tasa de exámenes médico legales por presunto delito sexual contra niños, niñas y adolescentes",2020,4,3,3212,93.3997509339975,0,1622,0,3,1590,188.679245283019
31014,19,19455,121,Tasa de exámenes médico legales por presunto delito sexual cuando la víctima está entre 18 y 28 años,2020,5,2,6242,32.0410124959949,0,3124,0,2,3118,64.143681847338
31015,19,19473,81,"Tasa de exámenes médico legales por presunto delito sexual contra niños, niñas y adolescentes",2020,3,1,4542,22.0167327168648,0,2290,0,1,2252,44.404973357016
31016,19,19473,81,"Tasa de exámenes médico legales por presunto delito sexual contra niños, niñas y adolescentes",2020,4,3,4433,67.6742612226483,0,2224,0,3,2209,135.808057944771
31017,19,19513,81,"Tasa de exámenes médico legales por presunto delito sexual contra niños, niñas y adolescentes",2020,4,2,1032,193.798449612403,0,530,0,2,502,398.406374501992
31018,19,19517,81,"Tasa de exámenes médico legales por presunto delito sexual contra niños, niñas y adolescentes",2020,3,3,6518,46.0263884627186,0,3305,0,3,3213,93.3706816059757
31019,19,19517,81,"Tasa de exámenes médico legales por presunto delito sexual contra niños, niñas y adolescentes",2020,4,1,5877,17.0154840905224,0,2945,0,1,2932,34.106412005457
31020,19,19532,81,"Tasa de exámenes médico legales por presunto delito sexual contra niños, niñas y adolescentes",2020,2,2,2553,78.3392087739914,1,1236,80.9061488673139,1,1317,75.9301442672741
31021,19,19532,81,"Tasa de exámenes médico legales por presunto delito sexual contra niños, niñas y adolescentes",2020,3,5,3476,143.843498273878,1,1748,57.20823798627,4,1728,231.481481481481
31022,19,19532,81,"Tasa de exámenes médico legales por presunto delito sexual contra niños, niñas y adolescentes",2020,4,9,3969,226.757369614512,1,2057,48.6144871171609,8,1912,418.410041841004
31023,19,19532,121,Tasa de exámenes médico legales por presunto delito sexual cuando la víctima está entre 18 y 28 años,2020,5,3,6789,44.1891294741494,0,3407,0,3,3382,88.7049083382614
31024,19,19548,81,"Tasa de exámenes médico legales por presunto delito sexual contra niños, niñas y adolescentes",2020,4,1,4200,23.8095238095238,1,2121,47.1475719000471,0,2079,0
31025,19,19001,81,"Tasa de exámenes médico legales por presunto delito sexual contra niños, niñas y adolescentes",2020,2,11,20462,53.7581859055811,6,10516,57.0559147965006,5,9946,50.2714659159461
31026,19,19001,81,"Tasa de exámenes médico legales por presunto delito sexual contra niños, niñas y adolescentes",2020,3,51,25085,203.308750249153,7,12838,54.525627044711,44,12247,359.271658365314
31027,19,19001,81,"Tasa de exámenes médico legales por presunto delito sexual contra niños, niñas y adolescentes",2020,4,53,27605,191.99420394856,6,14054,42.6924718941227,47,13551,346.837871743783
31028,19,19001,121,Tasa de exámenes médico legales por presunto delito sexual cuando la víctima está entre 18 y 28 años,2020,5,18,61121,29.4497799446999,0,31136,0,18,29985,60.0300150075037
31029,19,19573,81,"Tasa de exámenes médico legales por presunto delito sexual contra niños, niñas y adolescentes",2020,2,1,3174,31.5059861373661,0,1653,0,1,1521,65.7462195923734
31030,19,19573,81,"Tasa de exámenes médico legales por presunto delito sexual contra niños, niñas y adolescentes",2020,3,3,3912,76.6871165644172,0,2008,0,3,1904,157.563025210084
31031,19,19573,81,"Tasa de exámenes médico legales por presunto delito sexual contra niños, niñas y adolescentes",2020,4,5,4101,121.921482565228,3,2050,146.341463414634,2,2051,97.5134080936129
31032,19,19573,121,Tasa de exámenes médico legales por presunto delito sexual cuando la víctima está entre 18 y 28 años,2020,5,1,8139,12.2865216857108,0,3870,0,1,4269,23.4246896228625
31033,19,19573,81,"Tasa de exámenes médico legales por presunto delito sexual contra niños, niñas y adolescentes",2020,1,1,616,162.337662337662,0,322,0,1,294,340.136054421769
31034,19,19585,81,"Tasa de exámenes médico legales por presunto delito sexual contra niños, niñas y adolescentes",2020,3,2,1810,110.497237569061,0,906,0,2,904,221.238938053097
31035,19,19585,121,Tasa de exámenes médico legales por presunto delito sexual cuando la víctima está entre 18 y 28 años,2020,5,1,3751,26.6595574513463,0,1909,0,1,1842,54.2888165038002
31036,19,19622,81,"Tasa de exámenes médico legales por presunto delito sexual contra niños, niñas y adolescentes",2020,2,2,689,290.275761973875,1,350,285.714285714286,1,339,294.985250737463
31037,19,19622,81,"Tasa de exámenes médico legales por presunto delito sexual contra niños, niñas y adolescentes",2020,3,3,871,344.43168771527,1,443,225.733634311512,2,428,467.289719626168
31038,19,19622,81,"Tasa de exámenes médico legales por presunto delito sexual contra niños, niñas y adolescentes",2020,4,1,1008,99.2063492063492,0,522,0,1,486,205.761316872428
31039,19,19693,81,"Tasa de exámenes médico legales por presunto delito sexual contra niños, niñas y adolescentes",2020,3,2,885,225.988700564972,0,434,0,2,451,443.458980044346
31040,19,19693,81,"Tasa de exámenes médico legales por presunto delito sexual contra niños, niñas y adolescentes",2020,4,2,1101,181.653042688465,0,549,0,2,552,362.31884057971
31041,19,19701,81,"Tasa de exámenes médico legales por presunto delito sexual contra niños, niñas y adolescentes",2020,3,1,562,177.935943060498,0,278,0,1,284,352.112676056338
31042,19,19698,81,"Tasa de exámenes médico legales por presunto delito sexual contra niños, niñas y adolescentes",2020,2,4,8827,45.315509233035,0,4581,0,4,4246,94.2063118228921
31043,19,19698,81,"Tasa de exámenes médico legales por presunto delito sexual contra niños, niñas y adolescentes",2020,3,9,10556,85.2595680181887,1,5458,18.3217295712715,8,5098,156.924284032954
31044,19,19698,81,"Tasa de exámenes médico legales por presunto delito sexual contra niños, niñas y adolescentes",2020,4,10,11061,90.40773890245,1,5676,17.6180408738548,9,5385,167.130919220056
31045,19,19698,121,Tasa de exámenes médico legales por presunto delito sexual cuando la víctima está entre 18 y 28 años,2020,5,2,22332,8.95575855274942,0,11189,0,2,11143,17.9484878398995
31046,19,19743,81,"Tasa de exámenes médico legales por presunto delito sexual contra niños, niñas y adolescentes",2020,3,2,4171,47.9501318628626,0,2120,0,2,2051,97.5134080936129
31047,19,19743,81,"Tasa de exámenes médico legales por presunto delito sexual contra niños, niñas y adolescentes",2020,4,8,4193,190.794180777486,2,2140,93.4579439252336,6,2053,292.255236239649
31048,19,19743,121,Tasa de exámenes médico legales por presunto delito sexual cuando la víctima está entre 18 y 28 años,2020,5,1,7987,12.5203455615375,0,4018,0,1,3969,25.1952632905014
31049,19,19780,81,"Tasa de exámenes médico legales por presunto delito sexual contra niños, niñas y adolescentes",2020,3,1,3530,28.328611898017,0,1789,0,1,1741,57.4382538770821
31050,19,19780,81,"Tasa de exámenes médico legales por presunto delito sexual contra niños, niñas y adolescentes",2020,4,1,3655,27.359781121751,0,1841,0,1,1814,55.1267916207277
31051,19,19785,81,"Tasa de exámenes médico legales por presunto delito sexual contra niños, niñas y adolescentes",2020,3,2,832,240.384615384615,0,455,0,2,377,530.503978779841
31052,19,19807,81,"Tasa de exámenes médico legales por presunto delito sexual contra niños, niñas y adolescentes",2020,2,2,2413,82.8843762950684,1,1250,80,1,1163,85.9845227858985
31053,19,19807,81,"Tasa de exámenes médico legales por presunto delito sexual contra niños, niñas y adolescentes",2020,3,5,3067,163.025758069775,0,1564,0,5,1503,332.667997338656
31054,19,19807,81,"Tasa de exámenes médico legales por presunto delito sexual contra niños, niñas y adolescentes",2020,4,4,3374,118.5536455246,0,1707,0,4,1667,239.95200959808
31055,19,19807,121,Tasa de exámenes médico legales por presunto delito sexual cuando la víctima está entre 18 y 28 años,2020,5,1,6500,15.3846153846154,0,3242,0,1,3258,30.6936771025169
31056,19,19821,81,"Tasa de exámenes médico legales por presunto delito sexual contra niños, niñas y adolescentes",2020,4,1,4528,22.0848056537102,0,2262,0,1,2266,44.1306266548985
31057,19,19824,81,"Tasa de exámenes médico legales por presunto delito sexual contra niños, niñas y adolescentes",2020,3,2,3009,66.4672648720505,0,1534,0,2,1475,135.593220338983
31058,19,19824,81,"Tasa de exámenes médico legales por presunto delito sexual contra niños, niñas y adolescentes",2020,4,3,2999,100.033344448149,0,1480,0,3,1519,197.498354180382
31059,19,19824,121,Tasa de exámenes médico legales por presunto delito sexual cuando la víctima está entre 18 y 28 años,2020,5,1,5419,18.4535892231039,0,2670,0,1,2749,36.3768643142961
31060,19,19845,81,"Tasa de exámenes médico legales por presunto delito sexual contra niños, niñas y adolescentes",2020,3,2,2002,99.9000999000999,0,1007,0,2,995,201.005025125628
31061,19,19845,81,"Tasa de exámenes médico legales por presunto delito sexual contra niños, niñas y adolescentes",2020,4,3,2091,143.472022955524,0,1017,0,3,1074,279.329608938547
31062,20,20011,81,"Tasa de exámenes médico legales por presunto delito sexual contra niños, niñas y adolescentes",2020,2,1,10925,9.1533180778032,1,5562,17.9791441927364,0,5363,0
31063,20,20011,81,"Tasa de exámenes médico legales por presunto delito sexual contra niños, niñas y adolescentes",2020,3,8,13093,61.1013518674101,0,6676,0,8,6417,124.668848371513
31064,20,20011,81,"Tasa de exámenes médico legales por presunto delito sexual contra niños, niñas y adolescentes",2020,4,15,12974,115.615847078773,1,6554,15.2578577967653,14,6420,218.068535825545
31065,20,20011,121,Tasa de exámenes médico legales por presunto delito sexual cuando la víctima está entre 18 y 28 años,2020,5,2,23192,8.62366333218351,1,11352,8.80902043692741,1,11840,8.44594594594595
31066,20,20013,81,"Tasa de exámenes médico legales por presunto delito sexual contra niños, niñas y adolescentes",2020,2,2,6626,30.1841231512225,1,3349,29.8596595998806,1,3277,30.5157155935307
31067,20,20013,81,"Tasa de exámenes médico legales por presunto delito sexual contra niños, niñas y adolescentes",2020,3,4,7782,51.4006682086867,0,3946,0,4,3836,104.275286757039
31068,20,20013,81,"Tasa de exámenes médico legales por presunto delito sexual contra niños, niñas y adolescentes",2020,4,13,7387,175.984838229322,0,3746,0,13,3641,357.044767920901
31069,20,20032,81,"Tasa de exámenes médico legales por presunto delito sexual contra niños, niñas y adolescentes",2020,4,1,2588,38.6398763523957,0,1339,0,1,1249,80.0640512409928
31070,20,20045,81,"Tasa de exámenes médico legales por presunto delito sexual contra niños, niñas y adolescentes",2020,3,1,3207,31.1817898347365,0,1642,0,1,1565,63.8977635782748
31071,20,20045,81,"Tasa de exámenes médico legales por presunto delito sexual contra niños, niñas y adolescentes",2020,4,1,2901,34.4708721130645,0,1475,0,1,1426,70.1262272089762
31072,20,20045,121,Tasa de exámenes médico legales por presunto delito sexual cuando la víctima está entre 18 y 28 años,2020,5,1,4522,22.1141088014153,0,2265,0,1,2257,44.3066016836509
31073,20,20060,81,"Tasa de exámenes médico legales por presunto delito sexual contra niños, niñas y adolescentes",2020,3,1,5508,18.1554103122731,0,2826,0,1,2682,37.2856077554064
31074,20,20060,81,"Tasa de exámenes médico legales por presunto delito sexual contra niños, niñas y adolescentes",2020,4,2,5425,36.8663594470046,0,2802,0,2,2623,76.2485703393061
31075,20,20060,121,Tasa de exámenes médico legales por presunto delito sexual cuando la víctima está entre 18 y 28 años,2020,5,1,8581,11.6536534203473,0,4298,0,1,4283,23.3481204763017
31076,20,20178,81,"Tasa de exámenes médico legales por presunto delito sexual contra niños, niñas y adolescentes",2020,2,2,3218,62.1504039776258,1,1666,60.0240096038415,1,1552,64.4329896907217
31077,20,20178,81,"Tasa de exámenes médico legales por presunto delito sexual contra niños, niñas y adolescentes",2020,3,5,3700,135.135135135135,1,1887,52.9941706412295,4,1813,220.628792057364
31078,20,20178,81,"Tasa de exámenes médico legales por presunto delito sexual contra niños, niñas y adolescentes",2020,4,6,3414,175.746924428822,0,1720,0,6,1694,354.191263282172
31079,20,20178,121,Tasa de exámenes médico legales por presunto delito sexual cuando la víctima está entre 18 y 28 años,2020,5,3,5428,55.2689756816507,0,2698,0,3,2730,109.89010989011
31080,20,20228,81,"Tasa de exámenes médico legales por presunto delito sexual contra niños, niñas y adolescentes",2020,2,2,3948,50.6585612968592,0,2034,0,2,1914,104.493207941484
31081,20,20228,81,"Tasa de exámenes médico legales por presunto delito sexual contra niños, niñas y adolescentes",2020,3,5,4904,101.957585644372,3,2518,119.142176330421,2,2386,83.8222967309304
31082,20,20228,81,"Tasa de exámenes médico legales por presunto delito sexual contra niños, niñas y adolescentes",2020,4,9,4838,186.027284001654,0,2462,0,9,2376,378.787878787879
31083,20,20228,121,Tasa de exámenes médico legales por presunto delito sexual cuando la víctima está entre 18 y 28 años,2020,5,2,7349,27.214587018642,0,3680,0,2,3669,54.5107658762606
31084,20,20238,81,"Tasa de exámenes médico legales por presunto delito sexual contra niños, niñas y adolescentes",2020,3,4,3950,101.26582278481,0,1998,0,4,1952,204.918032786885
31085,20,20238,81,"Tasa de exámenes médico legales por presunto delito sexual contra niños, niñas y adolescentes",2020,4,3,3787,79.21837866385,0,1930,0,3,1857,161.550888529887
31086,20,20250,81,"Tasa de exámenes médico legales por presunto delito sexual contra niños, niñas y adolescentes",2020,2,1,4966,20.1369311316955,0,2576,0,1,2390,41.8410041841004
31087,20,20250,81,"Tasa de exámenes médico legales por presunto delito sexual contra niños, niñas y adolescentes",2020,3,2,5564,35.9453630481668,0,2850,0,2,2714,73.6919675755343
31088,20,20250,81,"Tasa de exámenes médico legales por presunto delito sexual contra niños, niñas y adolescentes",2020,4,4,5049,79.2236086353733,0,2531,0,4,2518,158.856235107228
31089,20,20295,81,"Tasa de exámenes médico legales por presunto delito sexual contra niños, niñas y adolescentes",2020,2,1,1364,73.3137829912023,1,666,150.15015015015,0,698,0
31090,20,20295,81,"Tasa de exámenes médico legales por presunto delito sexual contra niños, niñas y adolescentes",2020,3,1,1689,59.206631142688,0,833,0,1,856,116.822429906542
31091,20,20295,81,"Tasa de exámenes médico legales por presunto delito sexual contra niños, niñas y adolescentes",2020,4,2,1706,117.233294255569,0,852,0,2,854,234.192037470726
31092,20,20310,81,"Tasa de exámenes médico legales por presunto delito sexual contra niños, niñas y adolescentes",2020,2,1,351,284.900284900285,0,178,0,1,173,578.034682080925
31093,20,20400,81,"Tasa de exámenes médico legales por presunto delito sexual contra niños, niñas y adolescentes",2020,2,4,5682,70.3977472720873,1,2868,34.8675034867503,3,2814,106.609808102345
31094,20,20400,81,"Tasa de exámenes médico legales por presunto delito sexual contra niños, niñas y adolescentes",2020,3,3,6579,45.5996352029184,0,3345,0,3,3234,92.7643784786642
31095,20,20400,81,"Tasa de exámenes médico legales por presunto delito sexual contra niños, niñas y adolescentes",2020,4,6,6164,97.3393900064893,0,3162,0,6,3002,199.866755496336
31096,20,20400,121,Tasa de exámenes médico legales por presunto delito sexual cuando la víctima está entre 18 y 28 años,2020,5,1,10517,9.5084149472283,0,5187,0,1,5330,18.7617260787992
31097,20,20621,81,"Tasa de exámenes médico legales por presunto delito sexual contra niños, niñas y adolescentes",2020,2,3,3075,97.5609756097561,0,1554,0,3,1521,197.23865877712
31098,20,20621,81,"Tasa de exámenes médico legales por presunto delito sexual contra niños, niñas y adolescentes",2020,3,2,3649,54.8095368594135,0,1868,0,2,1781,112.296462661426
31099,20,20621,81,"Tasa de exámenes médico legales por presunto delito sexual contra niños, niñas y adolescentes",2020,4,7,3488,200.688073394495,0,1799,0,7,1689,414.446417998816
31100,20,20621,121,Tasa de exámenes médico legales por presunto delito sexual cuando la víctima está entre 18 y 28 años,2020,5,1,5612,17.8189593727726,0,2792,0,1,2820,35.4609929078014
31101,20,20443,81,"Tasa de exámenes médico legales por presunto delito sexual contra niños, niñas y adolescentes",2020,3,1,1241,80.58017727639,0,628,0,1,613,163.132137030995
31102,20,20443,81,"Tasa de exámenes médico legales por presunto delito sexual contra niños, niñas y adolescentes",2020,4,2,1282,156.00624024961,1,657,152.20700152207,1,625,160
31103,20,20443,121,Tasa de exámenes médico legales por presunto delito sexual cuando la víctima está entre 18 y 28 años,2020,5,1,2099,47.6417341591234,0,1041,0,1,1058,94.5179584120983
31104,20,20517,81,"Tasa de exámenes médico legales por presunto delito sexual contra niños, niñas y adolescentes",2020,4,1,2345,42.6439232409382,0,1183,0,1,1162,86.0585197934596
31105,20,20570,81,"Tasa de exámenes médico legales por presunto delito sexual contra niños, niñas y adolescentes",2020,2,1,4452,22.4618149146451,1,2224,44.9640287769784,0,2228,0
31106,20,20570,81,"Tasa de exámenes médico legales por presunto delito sexual contra niños, niñas y adolescentes",2020,3,3,4754,63.1047538914598,1,2375,42.1052631578947,2,2379,84.0689365279529
31107,20,20570,81,"Tasa de exámenes médico legales por presunto delito sexual contra niños, niñas y adolescentes",2020,4,4,3991,100.225507391631,0,2010,0,4,1981,201.918223119637
31108,20,20570,121,Tasa de exámenes médico legales por presunto delito sexual cuando la víctima está entre 18 y 28 años,2020,5,1,5534,18.0701120346946,0,2804,0,1,2730,36.6300366300366
31109,20,20614,81,"Tasa de exámenes médico legales por presunto delito sexual contra niños, niñas y adolescentes",2020,2,1,1440,69.4444444444444,0,722,0,1,718,139.275766016713
31110,20,20614,81,"Tasa de exámenes médico legales por presunto delito sexual contra niños, niñas y adolescentes",2020,4,1,1818,55.005500550055,0,942,0,1,876,114.155251141553
31111,20,20710,81,"Tasa de exámenes médico legales por presunto delito sexual contra niños, niñas y adolescentes",2020,4,1,3063,32.6477309826967,0,1515,0,1,1548,64.5994832041344
31112,20,20750,81,"Tasa de exámenes médico legales por presunto delito sexual contra niños, niñas y adolescentes",2020,3,2,2435,82.135523613963,0,1258,0,2,1177,169.923534409516
31113,20,20750,81,"Tasa de exámenes médico legales por presunto delito sexual contra niños, niñas y adolescentes",2020,4,3,2269,132.216835610401,0,1159,0,3,1110,270.27027027027
31114,20,20787,121,Tasa de exámenes médico legales por presunto delito sexual cuando la víctima está entre 18 y 28 años,2020,5,1,2610,38.3141762452107,0,1300,0,1,1310,76.3358778625954
31115,20,20001,81,"Tasa de exámenes médico legales por presunto delito sexual contra niños, niñas y adolescentes",2020,2,17,50769,33.4850006893971,3,26049,11.5167568812622,14,24720,56.6343042071197
31116,20,20001,81,"Tasa de exámenes médico legales por presunto delito sexual contra niños, niñas y adolescentes",2020,3,62,59249,104.643116339516,9,30371,29.6335319877515,53,28878,183.530715423506
31117,20,20001,81,"Tasa de exámenes médico legales por presunto delito sexual contra niños, niñas y adolescentes",2020,4,94,57798,162.63538530745,5,29442,16.9825419468786,89,28356,313.866553815771
31118,20,20001,121,Tasa de exámenes médico legales por presunto delito sexual cuando la víctima está entre 18 y 28 años,2020,5,36,106116,33.925138527649,3,52736,5.68871359223301,33,53380,61.8209067066317
31119,20,20001,81,"Tasa de exámenes médico legales por presunto delito sexual contra niños, niñas y adolescentes",2020,1,2,9985,20.0300450676014,0,5139,0,2,4846,41.2711514651259
31120,27,27050,81,"Tasa de exámenes médico legales por presunto delito sexual contra niños, niñas y adolescentes",2020,3,3,743,403.768506056528,1,410,243.90243902439,2,333,600.600600600601
31121,27,27050,81,"Tasa de exámenes médico legales por presunto delito sexual contra niños, niñas y adolescentes",2020,4,1,786,127.226463104326,0,452,0,1,334,299.40119760479
31122,27,27073,81,"Tasa de exámenes médico legales por presunto delito sexual contra niños, niñas y adolescentes",2020,3,1,1839,54.3773790103317,0,904,0,1,935,106.951871657754
31123,27,27075,121,Tasa de exámenes médico legales por presunto delito sexual cuando la víctima está entre 18 y 28 años,2020,5,1,1994,50.1504513540622,0,1104,0,1,890,112.359550561798
31124,27,27077,121,Tasa de exámenes médico legales por presunto delito sexual cuando la víctima está entre 18 y 28 años,2020,5,3,5634,53.248136315229,1,3030,33.003300330033,2,2604,76.8049155145929
31125,27,27150,81,"Tasa de exámenes médico legales por presunto delito sexual contra niños, niñas y adolescentes",2020,2,1,2325,43.010752688172,0,1188,0,1,1137,87.9507475813544
31126,27,27160,81,"Tasa de exámenes médico legales por presunto delito sexual contra niños, niñas y adolescentes",2020,2,1,552,181.159420289855,0,252,0,1,300,333.333333333333
31127,27,27205,81,"Tasa de exámenes médico legales por presunto delito sexual contra niños, niñas y adolescentes",2020,2,1,1195,83.6820083682008,0,608,0,1,587,170.357751277683
31128,27,27205,81,"Tasa de exámenes médico legales por presunto delito sexual contra niños, niñas y adolescentes",2020,3,3,1564,191.815856777494,0,809,0,3,755,397.350993377483
31129,27,27205,121,Tasa de exámenes médico legales por presunto delito sexual cuando la víctima está entre 18 y 28 años,2020,5,1,2144,46.6417910447761,0,1077,0,1,1067,93.7207122774133
31130,27,27135,81,"Tasa de exámenes médico legales por presunto delito sexual contra niños, niñas y adolescentes",2020,4,1,751,133.155792276964,0,396,0,1,355,281.69014084507
31131,27,27135,121,Tasa de exámenes médico legales por presunto delito sexual cuando la víctima está entre 18 y 28 años,2020,5,1,1115,89.6860986547085,0,579,0,1,536,186.567164179104
31132,27,27245,81,"Tasa de exámenes médico legales por presunto delito sexual contra niños, niñas y adolescentes",2020,3,1,955,104.712041884817,0,487,0,1,468,213.675213675214
31133,27,27361,81,"Tasa de exámenes médico legales por presunto delito sexual contra niños, niñas y adolescentes",2020,3,2,3905,51.2163892445583,1,1969,50.7872016251904,1,1936,51.6528925619835
31134,27,27413,81,"Tasa de exámenes médico legales por presunto delito sexual contra niños, niñas y adolescentes",2020,3,1,1714,58.343057176196,0,818,0,1,896,111.607142857143
31135,27,27430,81,"Tasa de exámenes médico legales por presunto delito sexual contra niños, niñas y adolescentes",2020,4,1,2194,45.5788514129444,0,1159,0,1,1035,96.6183574879227
31136,27,27430,121,Tasa de exámenes médico legales por presunto delito sexual cuando la víctima está entre 18 y 28 años,2020,5,1,2733,36.5898280278083,0,1391,0,1,1342,74.5156482861401
31137,27,27495,81,"Tasa de exámenes médico legales por presunto delito sexual contra niños, niñas y adolescentes",2020,3,1,2511,39.8247710075667,0,1218,0,1,1293,77.3395204949729
31138,27,27495,81,"Tasa de exámenes médico legales por presunto delito sexual contra niños, niñas y adolescentes",2020,4,1,2308,43.3275563258232,0,1143,0,1,1165,85.8369098712446
31139,27,27001,81,"Tasa de exámenes médico legales por presunto delito sexual contra niños, niñas y adolescentes",2020,2,11,13965,78.7683494450412,4,7177,55.733593423436,7,6788,103.123158515027
31140,27,27001,81,"Tasa de exámenes médico legales por presunto delito sexual contra niños, niñas y adolescentes",2020,3,29,16377,177.077608841668,6,8166,73.4753857457752,23,8211,280.112044817927
31141,27,27001,81,"Tasa de exámenes médico legales por presunto delito sexual contra niños, niñas y adolescentes",2020,4,30,15415,194.615634122608,2,7458,26.816840976133,28,7957,351.891416362951
31142,27,27001,121,Tasa de exámenes médico legales por presunto delito sexual cuando la víctima está entre 18 y 28 años,2020,5,14,26290,53.2521871434005,1,12345,8.10044552450385,13,13945,93.2233775546791
31143,27,27001,81,"Tasa de exámenes médico legales por presunto delito sexual contra niños, niñas y adolescentes",2020,1,1,2741,36.4830353885443,0,1416,0,1,1325,75.4716981132075
31144,27,27580,81,"Tasa de exámenes médico legales por presunto delito sexual contra niños, niñas y adolescentes",2020,2,1,636,157.232704402516,0,316,0,1,320,312.5
31145,27,27615,81,"Tasa de exámenes médico legales por presunto delito sexual contra niños, niñas y adolescentes",2020,2,1,4582,21.8245307725884,0,2375,0,1,2207,45.3103760761214
31146,27,27615,121,Tasa de exámenes médico legales por presunto delito sexual cuando la víctima está entre 18 y 28 años,2020,5,1,10598,9.43574259294206,0,5599,0,1,4999,20.00400080016
31147,27,27660,81,"Tasa de exámenes médico legales por presunto delito sexual contra niños, niñas y adolescentes",2020,4,1,612,163.398692810458,0,307,0,1,305,327.868852459016
31148,27,27787,81,"Tasa de exámenes médico legales por presunto delito sexual contra niños, niñas y adolescentes",2020,2,1,1905,52.49343832021,0,962,0,1,943,106.044538706257
31149,27,27787,81,"Tasa de exámenes médico legales por presunto delito sexual contra niños, niñas y adolescentes",2020,3,7,2342,298.889837745517,0,1174,0,7,1168,599.315068493151
31150,27,27787,81,"Tasa de exámenes médico legales por presunto delito sexual contra niños, niñas y adolescentes",2020,4,8,2195,364.464692482916,0,1098,0,8,1097,729.26162260711
31151,27,27800,81,"Tasa de exámenes médico legales por presunto delito sexual contra niños, niñas y adolescentes",2020,3,1,1749,57.1755288736421,1,908,110.132158590308,0,841,0
31152,27,27810,81,"Tasa de exámenes médico legales por presunto delito sexual contra niños, niñas y adolescentes",2020,3,1,802,124.688279301746,0,405,0,1,397,251.889168765743
31153,23,23068,81,"Tasa de exámenes médico legales por presunto delito sexual contra niños, niñas y adolescentes",2020,2,1,4897,20.4206657137023,0,2471,0,1,2426,41.2201154163232
31154,23,23068,81,"Tasa de exámenes médico legales por presunto delito sexual contra niños, niñas y adolescentes",2020,3,3,5860,51.1945392491468,2,3005,66.5557404326123,1,2855,35.0262697022767
31155,23,23068,81,"Tasa de exámenes médico legales por presunto delito sexual contra niños, niñas y adolescentes",2020,4,2,5625,35.5555555555556,0,2934,0,2,2691,74.3218134522482
31156,23,23079,81,"Tasa de exámenes médico legales por presunto delito sexual contra niños, niñas y adolescentes",2020,4,1,2512,39.8089171974522,0,1321,0,1,1191,83.9630562552477
31157,23,23090,81,"Tasa de exámenes médico legales por presunto delito sexual contra niños, niñas y adolescentes",2020,3,1,1830,54.6448087431694,0,927,0,1,903,110.741971207087
31158,23,23090,81,"Tasa de exámenes médico legales por presunto delito sexual contra niños, niñas y adolescentes",2020,4,2,1812,110.37527593819,0,952,0,2,860,232.558139534884
31159,23,23162,81,"Tasa de exámenes médico legales por presunto delito sexual contra niños, niñas y adolescentes",2020,2,1,8525,11.7302052785924,0,4332,0,1,4193,23.8492725971858
31160,23,23162,81,"Tasa de exámenes médico legales por presunto delito sexual contra niños, niñas y adolescentes",2020,3,9,10073,89.3477613422019,1,5116,19.546520719312,8,4957,161.387936251765
31161,23,23162,81,"Tasa de exámenes médico legales por presunto delito sexual contra niños, niñas y adolescentes",2020,4,14,10204,137.201097608781,2,5162,38.7446726075165,12,5042,238.000793335978
31162,23,23162,121,Tasa de exámenes médico legales por presunto delito sexual cuando la víctima está entre 18 y 28 años,2020,5,4,19352,20.669698222406,0,9599,0,4,9753,41.0130216343689
31163,23,23168,81,"Tasa de exámenes médico legales por presunto delito sexual contra niños, niñas y adolescentes",2020,3,2,1701,117.577895355673,1,866,115.473441108545,1,835,119.760479041916
31164,23,23168,81,"Tasa de exámenes médico legales por presunto delito sexual contra niños, niñas y adolescentes",2020,4,3,1777,168.823860438942,0,895,0,3,882,340.136054421769
31165,23,23168,121,Tasa de exámenes médico legales por presunto delito sexual cuando la víctima está entre 18 y 28 años,2020,5,1,2948,33.921302578019,0,1533,0,1,1415,70.6713780918728
31166,23,23182,81,"Tasa de exámenes médico legales por presunto delito sexual contra niños, niñas y adolescentes",2020,3,5,4489,111.383381599465,1,2293,43.6109899694723,4,2196,182.149362477231
31167,23,23182,81,"Tasa de exámenes médico legales por presunto delito sexual contra niños, niñas y adolescentes",2020,4,5,4505,110.987791342952,1,2300,43.4782608695652,4,2205,181.40589569161
31168,23,23182,121,Tasa de exámenes médico legales por presunto delito sexual cuando la víctima está entre 18 y 28 años,2020,5,1,8420,11.8764845605701,0,4292,0,1,4128,24.2248062015504
31169,23,23189,81,"Tasa de exámenes médico legales por presunto delito sexual contra niños, niñas y adolescentes",2020,3,4,6027,66.3680106188817,3,3092,97.0245795601552,1,2935,34.0715502555366
31170,23,23189,81,"Tasa de exámenes médico legales por presunto delito sexual contra niños, niñas y adolescentes",2020,4,3,6159,48.7092060399415,0,3151,0,3,3008,99.7340425531915
31171,23,23189,121,Tasa de exámenes médico legales por presunto delito sexual cuando la víctima está entre 18 y 28 años,2020,5,1,10586,9.44643869261288,0,5376,0,1,5210,19.1938579654511
31172,23,23300,81,"Tasa de exámenes médico legales por presunto delito sexual contra niños, niñas y adolescentes",2020,2,1,1525,65.5737704918033,0,824,0,1,701,142.65335235378
31173,23,23300,81,"Tasa de exámenes médico legales por presunto delito sexual contra niños, niñas y adolescentes",2020,4,2,1910,104.712041884817,0,984,0,2,926,215.982721382289
31174,23,23300,121,Tasa de exámenes médico legales por presunto delito sexual cuando la víctima está entre 18 y 28 años,2020,5,1,3486,28.6861732644865,0,1707,0,1,1779,56.2113546936481
31175,23,23350,81,"Tasa de exámenes médico legales por presunto delito sexual contra niños, niñas y adolescentes",2020,2,2,1455,137.45704467354,1,746,134.048257372654,1,709,141.043723554302
31176,23,23350,81,"Tasa de exámenes médico legales por presunto delito sexual contra niños, niñas y adolescentes",2020,3,3,1725,173.913043478261,1,888,112.612612612613,2,837,238.9486260454
31177,23,23350,81,"Tasa de exámenes médico legales por presunto delito sexual contra niños, niñas y adolescentes",2020,4,2,1708,117.096018735363,0,881,0,2,827,241.837968561064
31178,23,23417,81,"Tasa de exámenes médico legales por presunto delito sexual contra niños, niñas y adolescentes",2020,3,6,11614,51.6617874978474,0,5890,0,6,5724,104.82180293501
31179,23,23417,81,"Tasa de exámenes médico legales por presunto delito sexual contra niños, niñas y adolescentes",2020,4,14,11550,121.212121212121,0,5835,0,14,5715,244.969378827647
31180,23,23419,81,"Tasa de exámenes médico legales por presunto delito sexual contra niños, niñas y adolescentes",2020,3,1,2256,44.3262411347518,0,1142,0,1,1114,89.7666068222621
31181,23,23419,81,"Tasa de exámenes médico legales por presunto delito sexual contra niños, niñas y adolescentes",2020,4,6,2240,267.857142857143,1,1156,86.5051903114187,5,1084,461.254612546125
31182,23,23464,81,"Tasa de exámenes médico legales por presunto delito sexual contra niños, niñas y adolescentes",2020,4,1,2121,47.1475719000471,0,1047,0,1,1074,93.1098696461825
31183,23,23466,81,"Tasa de exámenes médico legales por presunto delito sexual contra niños, niñas y adolescentes",2020,2,8,8468,94.4733112895607,3,4358,68.8389169343736,5,4110,121.654501216545
31184,23,23466,81,"Tasa de exámenes médico legales por presunto delito sexual contra niños, niñas y adolescentes",2020,3,17,10266,165.595168517436,4,5219,76.6430350641885,13,5047,257.578759659203
31185,23,23466,81,"Tasa de exámenes médico legales por presunto delito sexual contra niños, niñas y adolescentes",2020,4,17,10037,169.373318720733,1,5034,19.8649185538339,16,5003,319.808115130921
31186,23,23466,121,Tasa de exámenes médico legales por presunto delito sexual cuando la víctima está entre 18 y 28 años,2020,5,5,15417,32.4317312058118,1,7446,13.430029546065,4,7971,50.1819094216535
31187,23,23001,81,"Tasa de exámenes médico legales por presunto delito sexual contra niños, niñas y adolescentes",2020,2,16,42038,38.0608021314049,1,21630,4.62320850670365,15,20408,73.500588004704
31188,23,23001,81,"Tasa de exámenes médico legales por presunto delito sexual contra niños, niñas y adolescentes",2020,3,39,49366,79.0017420896974,7,25223,27.7524481623915,32,24143,132.543594416601
31189,23,23001,81,"Tasa de exámenes médico legales por presunto delito sexual contra niños, niñas y adolescentes",2020,4,76,49632,153.127014829142,3,25016,11.9923249120563,73,24616,296.555086122847
31190,23,23001,121,Tasa de exámenes médico legales por presunto delito sexual cuando la víctima está entre 18 y 28 años,2020,5,17,94777,17.9368412167509,2,46736,4.27935638479973,15,48041,31.22333007223
31191,23,23500,81,"Tasa de exámenes médico legales por presunto delito sexual contra niños, niñas y adolescentes",2020,3,1,3667,27.2702481592582,0,1912,0,1,1755,56.980056980057
31192,23,23500,81,"Tasa de exámenes médico legales por presunto delito sexual contra niños, niñas y adolescentes",2020,4,2,3656,54.7045951859956,0,1861,0,2,1795,111.42061281337
31193,23,23555,81,"Tasa de exámenes médico legales por presunto delito sexual contra niños, niñas y adolescentes",2020,2,2,5576,35.8680057388809,0,2852,0,2,2724,73.4214390602056
31194,23,23555,81,"Tasa de exámenes médico legales por presunto delito sexual contra niños, niñas y adolescentes",2020,3,5,6912,72.337962962963,0,3540,0,5,3372,148.279952550415
31195,23,23555,81,"Tasa de exámenes médico legales por presunto delito sexual contra niños, niñas y adolescentes",2020,4,11,6976,157.683486238532,0,3556,0,11,3420,321.637426900585
31196,23,23555,121,Tasa de exámenes médico legales por presunto delito sexual cuando la víctima está entre 18 y 28 años,2020,5,2,11157,17.9259657614054,0,5494,0,2,5663,35.3169698039908
31197,23,23570,81,"Tasa de exámenes médico legales por presunto delito sexual contra niños, niñas y adolescentes",2020,3,1,4001,24.9937515621095,0,2031,0,1,1970,50.761421319797
31198,23,23570,81,"Tasa de exámenes médico legales por presunto delito sexual contra niños, niñas y adolescentes",2020,4,3,4035,74.3494423791822,0,2058,0,3,1977,151.745068285281
31199,23,23574,81,"Tasa de exámenes médico legales por presunto delito sexual contra niños, niñas y adolescentes",2020,3,1,2834,35.2858151023289,0,1472,0,1,1362,73.4214390602056
31200,23,23574,81,"Tasa de exámenes médico legales por presunto delito sexual contra niños, niñas y adolescentes",2020,4,1,2858,34.9895031490553,0,1510,0,1,1348,74.1839762611276
31201,23,23586,81,"Tasa de exámenes médico legales por presunto delito sexual contra niños, niñas y adolescentes",2020,3,1,1831,54.6149645002731,0,961,0,1,870,114.942528735632
31202,23,23586,81,"Tasa de exámenes médico legales por presunto delito sexual contra niños, niñas y adolescentes",2020,4,3,1796,167.037861915368,0,933,0,3,863,347.624565469293
31203,23,23660,81,"Tasa de exámenes médico legales por presunto delito sexual contra niños, niñas y adolescentes",2020,2,9,8808,102.179836512262,1,4478,22.3313979455114,8,4330,184.757505773672
31204,23,23660,81,"Tasa de exámenes médico legales por presunto delito sexual contra niños, niñas y adolescentes",2020,3,18,10742,167.566561161795,2,5474,36.5363536719035,16,5268,303.720577069096
31205,23,23660,81,"Tasa de exámenes médico legales por presunto delito sexual contra niños, niñas y adolescentes",2020,4,32,10968,291.757840991977,1,5582,17.9147259046937,31,5386,575.566282955811
31206,23,23660,121,Tasa de exámenes médico legales por presunto delito sexual cuando la víctima está entre 18 y 28 años,2020,5,2,19034,10.5075128717033,0,9487,0,2,9547,20.9489892112706
31207,23,23660,81,"Tasa de exámenes médico legales por presunto delito sexual contra niños, niñas y adolescentes",2020,1,1,1726,57.9374275782155,0,874,0,1,852,117.370892018779
31208,23,23670,81,"Tasa de exámenes médico legales por presunto delito sexual contra niños, niñas y adolescentes",2020,2,1,5255,19.0294957183635,0,2713,0,1,2542,39.33910306845
31209,23,23670,81,"Tasa de exámenes médico legales por presunto delito sexual contra niños, niñas y adolescentes",2020,3,1,5762,17.3550850399167,1,2922,34.2231348391513,0,2840,0
31210,23,23670,81,"Tasa de exámenes médico legales por presunto delito sexual contra niños, niñas y adolescentes",2020,4,2,5454,36.6703337000367,0,2761,0,2,2693,74.2666171555886
31211,23,23672,81,"Tasa de exámenes médico legales por presunto delito sexual contra niños, niñas y adolescentes",2020,3,4,3917,102.118968598417,0,2020,0,4,1897,210.859251449657
31212,23,23672,81,"Tasa de exámenes médico legales por presunto delito sexual contra niños, niñas y adolescentes",2020,4,4,3694,108.283703302653,0,1851,0,4,1843,217.03743895822
31213,23,23675,81,"Tasa de exámenes médico legales por presunto delito sexual contra niños, niñas y adolescentes",2020,2,1,3399,29.4204177699323,0,1711,0,1,1688,59.2417061611374
31214,23,23675,81,"Tasa de exámenes médico legales por presunto delito sexual contra niños, niñas y adolescentes",2020,4,3,4102,73.1350560702097,0,2166,0,3,1936,154.95867768595
31215,23,23678,81,"Tasa de exámenes médico legales por presunto delito sexual contra niños, niñas y adolescentes",2020,4,1,2889,34.6140533056421,0,1464,0,1,1425,70.1754385964912
31216,23,23678,121,Tasa de exámenes médico legales por presunto delito sexual cuando la víctima está entre 18 y 28 años,2020,5,2,4526,44.1891294741494,0,2283,0,2,2243,89.1662951404369
31217,23,23682,81,"Tasa de exámenes médico legales por presunto delito sexual contra niños, niñas y adolescentes",2020,3,1,1906,52.4658971668416,0,995,0,1,911,109.769484083425
31218,23,23682,81,"Tasa de exámenes médico legales por presunto delito sexual contra niños, niñas y adolescentes",2020,4,5,1778,281.214848143982,0,921,0,5,857,583.43057176196
31219,23,23686,81,"Tasa de exámenes médico legales por presunto delito sexual contra niños, niñas y adolescentes",2020,4,3,5056,59.3354430379747,0,2627,0,3,2429,123.507616303005
31220,23,23807,81,"Tasa de exámenes médico legales por presunto delito sexual contra niños, niñas y adolescentes",2020,2,1,11524,8.67754251995835,1,5863,17.0561146170902,0,5661,0
31221,23,23807,81,"Tasa de exámenes médico legales por presunto delito sexual contra niños, niñas y adolescentes",2020,4,4,11253,35.5460766017951,0,5676,0,4,5577,71.7231486462256
31222,23,23807,121,Tasa de exámenes médico legales por presunto delito sexual cuando la víctima está entre 18 y 28 años,2020,5,2,17291,11.5667110057255,0,8727,0,2,8564,23.3535730966838
31223,23,23815,81,"Tasa de exámenes médico legales por presunto delito sexual contra niños, niñas y adolescentes",2020,2,1,7113,14.0587656403768,0,3738,0,1,3375,29.6296296296296
31224,23,23815,81,"Tasa de exámenes médico legales por presunto delito sexual contra niños, niñas y adolescentes",2020,3,1,7475,13.3779264214047,0,3861,0,1,3614,27.6701715550636
31225,23,23815,81,"Tasa de exámenes médico legales por presunto delito sexual contra niños, niñas y adolescentes",2020,4,4,6665,60.0150037509377,0,3394,0,4,3271,122.286762457964
31226,23,23815,121,Tasa de exámenes médico legales por presunto delito sexual cuando la víctima está entre 18 y 28 años,2020,5,1,11195,8.93255917820456,0,5706,0,1,5489,18.2182546912006
31227,23,23855,81,"Tasa de exámenes médico legales por presunto delito sexual contra niños, niñas y adolescentes",2020,4,1,4242,23.5737859500236,0,2207,0,1,2035,49.1400491400491
31228,25,25001,81,"Tasa de exámenes médico legales por presunto delito sexual contra niños, niñas y adolescentes",2020,4,1,990,101.010101010101,0,509,0,1,481,207.900207900208
31229,25,25001,121,Tasa de exámenes médico legales por presunto delito sexual cuando la víctima está entre 18 y 28 años,2020,5,1,1634,61.1995104039168,0,809,0,1,825,121.212121212121
31230,25,25019,81,"Tasa de exámenes médico legales por presunto delito sexual contra niños, niñas y adolescentes",2020,3,3,583,514.579759862779,1,299,334.448160535117,2,284,704.225352112676
31231,25,25019,81,"Tasa de exámenes médico legales por presunto delito sexual contra niños, niñas y adolescentes",2020,4,2,647,309.119010819165,2,336,595.238095238095,0,311,0
31232,25,25019,121,Tasa de exámenes médico legales por presunto delito sexual cuando la víctima está entre 18 y 28 años,2020,5,1,1223,81.7661488143908,0,648,0,1,575,173.913043478261
31233,25,25035,81,"Tasa de exámenes médico legales por presunto delito sexual contra niños, niñas y adolescentes",2020,2,2,1156,173.010380622837,0,578,0,2,578,346.020761245675
31234,25,25035,81,"Tasa de exámenes médico legales por presunto delito sexual contra niños, niñas y adolescentes",2020,3,2,1336,149.700598802395,0,677,0,2,659,303.490136570561
31235,25,25035,81,"Tasa de exámenes médico legales por presunto delito sexual contra niños, niñas y adolescentes",2020,4,5,1357,368.459837877671,0,697,0,5,660,757.575757575758
31236,25,25599,81,"Tasa de exámenes médico legales por presunto delito sexual contra niños, niñas y adolescentes",2020,2,1,687,145.560407569141,0,349,0,1,338,295.85798816568
31237,25,25599,81,"Tasa de exámenes médico legales por presunto delito sexual contra niños, niñas y adolescentes",2020,3,1,760,131.578947368421,0,397,0,1,363,275.482093663912
31238,25,25599,121,Tasa de exámenes médico legales por presunto delito sexual cuando la víctima está entre 18 y 28 años,2020,5,1,1346,74.2942050520059,0,691,0,1,655,152.671755725191
31239,25,25053,81,"Tasa de exámenes médico legales por presunto delito sexual contra niños, niñas y adolescentes",2020,4,2,974,205.338809034908,1,508,196.850393700787,1,466,214.592274678112
31240,25,25053,121,Tasa de exámenes médico legales por presunto delito sexual cuando la víctima está entre 18 y 28 años,2020,5,1,1563,63.9795265515035,0,826,0,1,737,135.685210312076
31241,25,25099,81,"Tasa de exámenes médico legales por presunto delito sexual contra niños, niñas y adolescentes",2020,3,1,1062,94.1619585687382,0,534,0,1,528,189.393939393939
31242,25,25099,81,"Tasa de exámenes médico legales por presunto delito sexual contra niños, niñas y adolescentes",2020,4,3,1184,253.378378378378,0,607,0,3,577,519.930675909879
31243,25,25120,81,"Tasa de exámenes médico legales por presunto delito sexual contra niños, niñas y adolescentes",2020,3,1,572,174.825174825175,1,301,332.225913621262,0,271,0
31244,25,25123,81,"Tasa de exámenes médico legales por presunto delito sexual contra niños, niñas y adolescentes",2020,2,2,766,261.096605744125,0,357,0,2,409,488.997555012225
31245,25,25123,81,"Tasa de exámenes médico legales por presunto delito sexual contra niños, niñas y adolescentes",2020,3,4,915,437.158469945355,1,450,222.222222222222,3,465,645.161290322581
31246,25,25123,81,"Tasa de exámenes médico legales por presunto delito sexual contra niños, niñas y adolescentes",2020,4,1,924,108.225108225108,0,491,0,1,433,230.94688221709
31247,25,25126,81,"Tasa de exámenes médico legales por presunto delito sexual contra niños, niñas y adolescentes",2020,2,5,7109,70.3333802222535,0,3590,0,5,3519,142.08581983518
31248,25,25126,81,"Tasa de exámenes médico legales por presunto delito sexual contra niños, niñas y adolescentes",2020,3,12,8207,146.216644328013,3,4237,70.8048147274015,9,3970,226.700251889169
31249,25,25126,81,"Tasa de exámenes médico legales por presunto delito sexual contra niños, niñas y adolescentes",2020,4,21,8420,249.406175771971,2,4368,45.7875457875458,19,4052,468.904244817374
31250,25,25126,121,Tasa de exámenes médico legales por presunto delito sexual cuando la víctima está entre 18 y 28 años,2020,5,1,16755,5.96836765144733,0,8218,0,1,8537,11.7137167623287
31251,25,25148,81,"Tasa de exámenes médico legales por presunto delito sexual contra niños, niñas y adolescentes",2020,2,5,799,625.782227784731,4,396,1010.10101010101,1,403,248.138957816377
31252,25,25148,81,"Tasa de exámenes médico legales por presunto delito sexual contra niños, niñas y adolescentes",2020,3,4,1103,362.647325475975,2,569,351.493848857645,2,534,374.531835205993
31253,25,25148,81,"Tasa de exámenes médico legales por presunto delito sexual contra niños, niñas y adolescentes",2020,4,5,1179,424.088210347752,0,626,0,5,553,904.159132007233
31254,25,25151,81,"Tasa de exámenes médico legales por presunto delito sexual contra niños, niñas y adolescentes",2020,2,1,1461,68.4462696783025,0,782,0,1,679,147.275405007364
31255,25,25151,81,"Tasa de exámenes médico legales por presunto delito sexual contra niños, niñas y adolescentes",2020,3,5,1683,297.08853238265,0,890,0,5,793,630.517023959647
31256,25,25151,81,"Tasa de exámenes médico legales por presunto delito sexual contra niños, niñas y adolescentes",2020,4,5,1653,302.480338777979,1,857,116.686114352392,4,796,502.51256281407
31257,25,25151,121,Tasa de exámenes médico legales por presunto delito sexual cuando la víctima está entre 18 y 28 años,2020,5,2,2853,70.1016473887136,0,1426,0,2,1427,140.154169586545
31258,25,25154,81,"Tasa de exámenes médico legales por presunto delito sexual contra niños, niñas y adolescentes",2020,3,1,786,127.226463104326,0,412,0,1,374,267.379679144385
31259,25,25154,81,"Tasa de exámenes médico legales por presunto delito sexual contra niños, niñas y adolescentes",2020,4,4,809,494.437577255871,0,427,0,4,382,1047.12041884817
31260,25,25168,81,"Tasa de exámenes médico legales por presunto delito sexual contra niños, niñas y adolescentes",2020,4,5,367,1362.39782016349,0,201,0,5,166,3012.04819277108
31261,25,25168,121,Tasa de exámenes médico legales por presunto delito sexual cuando la víctima está entre 18 y 28 años,2020,5,2,520,384.615384615385,0,299,0,2,221,904.977375565611
31262,25,25175,81,"Tasa de exámenes médico legales por presunto delito sexual contra niños, niñas y adolescentes",2020,2,11,9157,120.126679043355,3,4663,64.3362642075917,8,4494,178.015131286159
31263,25,25175,81,"Tasa de exámenes médico legales por presunto delito sexual contra niños, niñas y adolescentes",2020,3,11,11778,93.3944642553914,2,6042,33.101621979477,9,5736,156.903765690377
31264,25,25175,81,"Tasa de exámenes médico legales por presunto delito sexual contra niños, niñas y adolescentes",2020,4,32,13667,234.140630716324,5,7024,71.1845102505695,27,6643,406.442872196297
31265,25,25175,121,Tasa de exámenes médico legales por presunto delito sexual cuando la víctima está entre 18 y 28 años,2020,5,1,28284,3.53556781219064,0,14231,0,1,14053,7.11591830925781
31266,25,25178,81,"Tasa de exámenes médico legales por presunto delito sexual contra niños, niñas y adolescentes",2020,2,1,837,119.4743130227,0,434,0,1,403,248.138957816377
31267,25,25178,81,"Tasa de exámenes médico legales por presunto delito sexual contra niños, niñas y adolescentes",2020,4,4,959,417.101147028154,1,493,202.839756592292,3,466,643.776824034335
31268,25,25181,81,"Tasa de exámenes médico legales por presunto delito sexual contra niños, niñas y adolescentes",2020,2,1,763,131.061598951507,0,419,0,1,344,290.697674418605
31269,25,25181,81,"Tasa de exámenes médico legales por presunto delito sexual contra niños, niñas y adolescentes",2020,4,4,1091,366.636113657195,0,535,0,4,556,719.424460431655
31270,25,25181,121,Tasa de exámenes médico legales por presunto delito sexual cuando la víctima está entre 18 y 28 años,2020,5,2,1732,115.473441108545,0,854,0,2,878,227.790432801822
31271,25,25183,81,"Tasa de exámenes médico legales por presunto delito sexual contra niños, niñas y adolescentes",2020,3,2,2356,84.889643463497407,1,1210,82.6446280991735,1,1146,87.260034904014
31272,25,25183,81,"Tasa de exámenes médico legales por presunto delito sexual contra niños, niñas y adolescentes",2020,4,4,2393,167.154199749269,0,1220,0,4,1173,341.005967604433
31273,25,25183,121,Tasa de exámenes médico legales por presunto delito sexual cuando la víctima está entre 18 y 28 años,2020,5,1,4057,24.6487552378605,0,2037,0,1,2020,49.5049504950495
31274,25,25200,81,"Tasa de exámenes médico legales por presunto delito sexual contra niños, niñas y adolescentes",2020,4,1,2353,42.4989375265618,0,1190,0,1,1163,85.9845227858985
31275,25,25200,121,Tasa de exámenes médico legales por presunto delito sexual cuando la víctima está entre 18 y 28 años,2020,5,1,4400,22.7272727272727,0,2234,0,1,2166,46.1680517082179
31276,25,25214,81,"Tasa de exámenes médico legales por presunto delito sexual contra niños, niñas y adolescentes",2020,2,3,2607,115.074798619102,0,1355,0,3,1252,239.61661341853
31277,25,25214,81,"Tasa de exámenes médico legales por presunto delito sexual contra niños, niñas y adolescentes",2020,3,1,3365,29.7176820208024,1,1791,55.8347292015634,0,1574,0
31278,25,25214,81,"Tasa de exámenes médico legales por presunto delito sexual contra niños, niñas y adolescentes",2020,4,1,3702,27.0124257158293,0,1974,0,1,1728,57.8703703703704
31279,25,25214,121,Tasa de exámenes médico legales por presunto delito sexual cuando la víctima está entre 18 y 28 años,2020,5,1,6859,14.5793847499636,1,3417,29.2654375182909,0,3442,0
31280,25,25224,81,"Tasa de exámenes médico legales por presunto delito sexual contra niños, niñas y adolescentes",2020,4,1,792,126.262626262626,0,414,0,1,378,264.550264550265
31281,25,25224,121,Tasa de exámenes médico legales por presunto delito sexual cuando la víctima está entre 18 y 28 años,2020,5,1,1395,71.6845878136201,0,662,0,1,733,136.425648021828
31282,25,25224,81,"Tasa de exámenes médico legales por presunto delito sexual contra niños, niñas y adolescentes",2020,1,1,193,518.134715025907,0,101,0,1,92,1086.95652173913
31283,25,25245,81,"Tasa de exámenes médico legales por presunto delito sexual contra niños, niñas y adolescentes",2020,2,2,1646,121.506682867558,1,812,123.152709359606,1,834,119.904076738609
31284,25,25245,81,"Tasa de exámenes médico legales por presunto delito sexual contra niños, niñas y adolescentes",2020,3,7,2146,326.18825722274,5,1093,457.456541628545,2,1053,189.933523266857
31285,25,25245,81,"Tasa de exámenes médico legales por presunto delito sexual contra niños, niñas y adolescentes",2020,4,13,2247,578.549176680018,2,1178,169.779286926995,11,1069,1028.9990645463
31286,25,25245,121,Tasa de exámenes médico legales por presunto delito sexual cuando la víctima está entre 18 y 28 años,2020,5,1,3487,28.6779466590192,0,1763,0,1,1724,58.0046403712297
31287,25,25258,81,"Tasa de exámenes médico legales por presunto delito sexual contra niños, niñas y adolescentes",2020,4,1,435,229.885057471264,0,235,0,1,200,500
31288,25,25260,81,"Tasa de exámenes médico legales por presunto delito sexual contra niños, niñas y adolescentes",2020,2,1,2201,45.4338936846888,1,1170,85.4700854700855,0,1031,0
31289,25,25260,81,"Tasa de exámenes médico legales por presunto delito sexual contra niños, niñas y adolescentes",2020,3,5,2522,198.255352894528,0,1305,0,5,1217,410.846343467543
31290,25,25260,81,"Tasa de exámenes médico legales por presunto delito sexual contra niños, niñas y adolescentes",2020,4,2,2613,76.5403750478377,0,1308,0,2,1305,153.256704980843
31291,25,25260,121,Tasa de exámenes médico legales por presunto delito sexual cuando la víctima está entre 18 y 28 años,2020,5,1,5623,17.7841010136938,1,2823,35.4233085370174,0,2800,0
31292,25,25269,81,"Tasa de exámenes médico legales por presunto delito sexual contra niños, niñas y adolescentes",2020,2,18,11567,155.615111956428,4,5861,68.2477392936359,14,5706,245.355765860498
31293,25,25269,81,"Tasa de exámenes médico legales por presunto delito sexual contra niños, niñas y adolescentes",2020,3,13,13978,93.0032908856775,3,7066,42.4568355505236,10,6912,144.675925925926
31294,25,25269,81,"Tasa de exámenes médico legales por presunto delito sexual contra niños, niñas y adolescentes",2020,4,26,15160,171.503957783641,1,7701,12.9853265809635,25,7459,335.165571792465
31295,25,25269,121,Tasa de exámenes médico legales por presunto delito sexual cuando la víctima está entre 18 y 28 años,2020,5,8,32614,24.5293432268351,1,16500,6.06060606060606,7,16114,43.4404865334492
31296,25,25279,81,"Tasa de exámenes médico legales por presunto delito sexual contra niños, niñas y adolescentes",2020,3,1,1205,82.9875518672199,1,639,156.494522691706,0,566,0
31297,25,25279,81,"Tasa de exámenes médico legales por presunto delito sexual contra niños, niñas y adolescentes",2020,4,3,1163,257.953568357696,0,622,0,3,541,554.52865064695
31298,25,25281,81,"Tasa de exámenes médico legales por presunto delito sexual contra niños, niñas y adolescentes",2020,3,1,638,156.739811912226,0,317,0,1,321,311.526479750779
31299,25,25281,81,"Tasa de exámenes médico legales por presunto delito sexual contra niños, niñas y adolescentes",2020,4,2,652,306.748466257669,1,339,294.985250737463,1,313,319.488817891374
31300,25,25286,81,"Tasa de exámenes médico legales por presunto delito sexual contra niños, niñas y adolescentes",2020,2,3,7647,39.2310710082385,1,3787,26.4061262212833,2,3860,51.8134715025907
31301,25,25286,81,"Tasa de exámenes médico legales por presunto delito sexual contra niños, niñas y adolescentes",2020,3,10,9142,109.385254867644,3,4601,65.2032166920235,7,4541,154.151068046686
31302,25,25286,81,"Tasa de exámenes médico legales por presunto delito sexual contra niños, niñas y adolescentes",2020,4,11,9647,114.025085518814,2,4932,40.551500405515,9,4715,190.880169671262
31303,25,25288,81,"Tasa de exámenes médico legales por presunto delito sexual contra niños, niñas y adolescentes",2020,3,2,482,414.9377593361,0,249,0,2,233,858.369098712446
31304,25,25290,81,"Tasa de exámenes médico legales por presunto delito sexual contra niños, niñas y adolescentes",2020,2,8,9461,84.5576577528802,1,4810,20.7900207900208,7,4651,150.505267684369
31305,25,25290,81,"Tasa de exámenes médico legales por presunto delito sexual contra niños, niñas y adolescentes",2020,3,24,12104,198.281559814937,7,6228,112.395632626846,17,5876,289.31245745405
31306,25,25290,81,"Tasa de exámenes médico legales por presunto delito sexual contra niños, niñas y adolescentes",2020,4,27,13541,199.39443172587,1,7036,14.2126208072769,26,6505,399.692544196772
31307,25,25290,121,Tasa de exámenes médico legales por presunto delito sexual cuando la víctima está entre 18 y 28 años,2020,5,9,25588,35.1727372205721,2,12868,15.5424308361828,7,12720,55.0314465408805
31308,25,25290,81,"Tasa de exámenes médico legales por presunto delito sexual contra niños, niñas y adolescentes",2020,1,1,1808,55.3097345132743,1,918,108.932461873638,0,890,0
31309,25,25295,81,"Tasa de exámenes médico legales por presunto delito sexual contra niños, niñas y adolescentes",2020,2,3,1775,169.014084507042,1,901,110.987791342952,2,874,228.83295194508
31310,25,25295,81,"Tasa de exámenes médico legales por presunto delito sexual contra niños, niñas y adolescentes",2020,3,2,1933,103.466114847387,0,986,0,2,947,211.193241816262
31311,25,25295,81,"Tasa de exámenes médico legales por presunto delito sexual contra niños, niñas y adolescentes",2020,4,3,1904,157.563025210084,0,966,0,3,938,319.829424307036
31312,25,25297,81,"Tasa de exámenes médico legales por presunto delito sexual contra niños, niñas y adolescentes",2020,4,1,748,133.689839572193,0,376,0,1,372,268.817204301075
31313,25,25307,81,"Tasa de exámenes médico legales por presunto delito sexual contra niños, niñas y adolescentes",2020,2,4,7294,54.839594187003,1,3803,26.2950302392848,3,3491,85.9352621025494
31314,25,25307,81,"Tasa de exámenes médico legales por presunto delito sexual contra niños, niñas y adolescentes",2020,3,15,8625,173.913043478261,2,4431,45.1365380275333,13,4194,309.966618979495
31315,25,25307,81,"Tasa de exámenes médico legales por presunto delito sexual contra niños, niñas y adolescentes",2020,4,16,9005,177.679067184897,0,4539,0,16,4466,358.262427227944
31316,25,25307,121,Tasa de exámenes médico legales por presunto delito sexual cuando la víctima está entre 18 y 28 años,2020,5,3,18571,16.1542189435141,1,9419,10.6168383055526,2,9152,21.8531468531469
31317,25,25317,81,"Tasa de exámenes médico legales por presunto delito sexual contra niños, niñas y adolescentes",2020,2,2,1517,131.8391562294,1,759,131.752305665349,1,758,131.926121372032
31318,25,25317,81,"Tasa de exámenes médico legales por presunto delito sexual contra niños, niñas y adolescentes",2020,3,1,1610,62.111801242236,0,827,0,1,783,127.713920817369
31319,25,25317,81,"Tasa de exámenes médico legales por presunto delito sexual contra niños, niñas y adolescentes",2020,4,3,1424,210.674157303371,0,743,0,3,681,440.528634361234
31320,25,25320,81,"Tasa de exámenes médico legales por presunto delito sexual contra niños, niñas y adolescentes",2020,2,13,2038,637.880274779195,4,1044,383.141762452107,9,994,905.432595573441
31321,25,25320,81,"Tasa de exámenes médico legales por presunto delito sexual contra niños, niñas y adolescentes",2020,3,17,2508,677.830940988836,2,1295,154.440154440154,15,1213,1236.60346248969
31322,25,25320,81,"Tasa de exámenes médico legales por presunto delito sexual contra niños, niñas y adolescentes",2020,4,25,2593,964.134207481682,2,1351,148.038490007402,23,1242,1851.85185185185
31323,25,25320,121,Tasa de exámenes médico legales por presunto delito sexual cuando la víctima está entre 18 y 28 años,2020,5,1,5652,17.6928520877565,1,3437,29.0951411114344,0,2215,0
31324,25,25322,81,"Tasa de exámenes médico legales por presunto delito sexual contra niños, niñas y adolescentes",2020,3,2,1553,128.783000643915,0,754,0,2,799,250.312891113892
31325,25,25322,81,"Tasa de exámenes médico legales por presunto delito sexual contra niños, niñas y adolescentes",2020,4,5,1657,301.750150875075,0,826,0,5,831,601.684717208183
31326,25,25322,121,Tasa de exámenes médico legales por presunto delito sexual cuando la víctima está entre 18 y 28 años,2020,5,1,3176,31.4861460957179,0,1634,0,1,1542,64.8508430609598
31327,25,25324,81,"Tasa de exámenes médico legales por presunto delito sexual contra niños, niñas y adolescentes",2020,4,1,242,413.223140495868,1,132,757.575757575758,0,110,0
31328,25,25326,81,"Tasa de exámenes médico legales por presunto delito sexual contra niños, niñas y adolescentes",2020,2,1,543,184.162062615101,0,256,0,1,287,348.432055749129
31329,25,25326,81,"Tasa de exámenes médico legales por presunto delito sexual contra niños, niñas y adolescentes",2020,4,2,632,316.455696202532,0,342,0,2,290,689.655172413793
31330,25,25328,81,"Tasa de exámenes médico legales por presunto delito sexual contra niños, niñas y adolescentes",2020,3,1,407,245.700245700246,0,200,0,1,207,483.091787439613
31331,25,25328,81,"Tasa de exámenes médico legales por presunto delito sexual contra niños, niñas y adolescentes",2020,4,2,413,484.261501210654,0,211,0,2,202,990.09900990099
31332,25,25328,121,Tasa de exámenes médico legales por presunto delito sexual cuando la víctima está entre 18 y 28 años,2020,5,1,635,157.48031496063,0,319,0,1,316,316.455696202532
31333,25,25335,81,"Tasa de exámenes médico legales por presunto delito sexual contra niños, niñas y adolescentes",2020,3,2,724,276.243093922652,0,362,0,2,362,552.486187845304
31334,25,25335,81,"Tasa de exámenes médico legales por presunto delito sexual contra niños, niñas y adolescentes",2020,4,1,631,158.478605388273,0,314,0,1,317,315.457413249211
31335,25,25339,81,"Tasa de exámenes médico legales por presunto delito sexual contra niños, niñas y adolescentes",2020,3,1,358,279.329608938547,0,180,0,1,178,561.797752808989
31336,25,25339,81,"Tasa de exámenes médico legales por presunto delito sexual contra niños, niñas y adolescentes",2020,4,3,363,826.446280991736,0,190,0,3,173,1734.10404624277
31337,25,25377,81,"Tasa de exámenes médico legales por presunto delito sexual contra niños, niñas y adolescentes",2020,2,1,2201,45.4338936846888,0,1117,0,1,1084,92.2509225092251
31338,25,25377,81,"Tasa de exámenes médico legales por presunto delito sexual contra niños, niñas y adolescentes",2020,3,2,2681,74.5990302126072,0,1359,0,2,1322,151.285930408472
31339,25,25377,81,"Tasa de exámenes médico legales por presunto delito sexual contra niños, niñas y adolescentes",2020,4,3,2904,103.305785123967,0,1481,0,3,1423,210.822206605762
31340,25,25377,121,Tasa de exámenes médico legales por presunto delito sexual cuando la víctima está entre 18 y 28 años,2020,5,1,5693,17.5654312313367,0,2879,0,1,2814,35.5366027007818
31341,25,25386,81,"Tasa de exámenes médico legales por presunto delito sexual contra niños, niñas y adolescentes",2020,2,8,2404,332.778702163062,2,1228,162.866449511401,6,1176,510.204081632653
31342,25,25386,81,"Tasa de exámenes médico legales por presunto delito sexual contra niños, niñas y adolescentes",2020,3,6,2889,207.684319833853,0,1495,0,6,1394,430.416068866571
31343,25,25386,81,"Tasa de exámenes médico legales por presunto delito sexual contra niños, niñas y adolescentes",2020,4,18,2948,610.583446404342,2,1536,130.208333333333,16,1412,1133.14447592068
31344,25,25394,81,"Tasa de exámenes médico legales por presunto delito sexual contra niños, niñas y adolescentes",2020,3,2,768,260.416666666667,1,398,251.256281407035,1,370,270.27027027027
31345,25,25394,81,"Tasa de exámenes médico legales por presunto delito sexual contra niños, niñas y adolescentes",2020,4,2,798,250.62656641604,0,429,0,2,369,542.0054200542
31346,25,25398,81,"Tasa de exámenes médico legales por presunto delito sexual contra niños, niñas y adolescentes",2020,3,1,474,210.970464135021,0,252,0,1,222,450.45045045045
31347,25,25398,81,"Tasa de exámenes médico legales por presunto delito sexual contra niños, niñas y adolescentes",2020,4,2,515,388.349514563107,0,267,0,2,248,806.451612903226
31348,25,25402,81,"Tasa de exámenes médico legales por presunto delito sexual contra niños, niñas y adolescentes",2020,3,1,1661,60.2046959662854,0,836,0,1,825,121.212121212121
31349,25,25402,81,"Tasa de exámenes médico legales por presunto delito sexual contra niños, niñas y adolescentes",2020,4,2,1673,119.545726240287,0,859,0,2,814,245.700245700246
31350,25,25407,81,"Tasa de exámenes médico legales por presunto delito sexual contra niños, niñas y adolescentes",2020,2,1,1159,86.2812769628991,0,606,0,1,553,180.831826401447
31351,25,25407,81,"Tasa de exámenes médico legales por presunto delito sexual contra niños, niñas y adolescentes",2020,4,4,1059,377.714825306893,1,548,182.481751824818,3,511,587.084148727984
31352,25,25426,81,"Tasa de exámenes médico legales por presunto delito sexual contra niños, niñas y adolescentes",2020,2,1,340,294.117647058824,0,166,0,1,174,574.712643678161
31353,25,25426,81,"Tasa de exámenes médico legales por presunto delito sexual contra niños, niñas y adolescentes",2020,4,1,566,176.678445229682,1,298,335.570469798658,0,268,0
31354,25,25430,81,"Tasa de exámenes médico legales por presunto delito sexual contra niños, niñas y adolescentes",2020,3,4,11912,33.5795836131632,1,6029,16.5864985901476,3,5883,50.9943906170321
31355,25,25430,81,"Tasa de exámenes médico legales por presunto delito sexual contra niños, niñas y adolescentes",2020,4,15,11875,126.315789473684,1,5974,16.739203213927,14,5901,237.247924080664
31356,25,25430,121,Tasa de exámenes médico legales por presunto delito sexual cuando la víctima está entre 18 y 28 años,2020,5,3,26253,11.4272654553765,0,13142,0,3,13111,22.8815498436427
31357,25,25436,81,"Tasa de exámenes médico legales por presunto delito sexual contra niños, niñas y adolescentes",2020,3,1,263,380.228136882129,0,144,0,1,119,840.336134453781
31358,25,25438,81,"Tasa de exámenes médico legales por presunto delito sexual contra niños, niñas y adolescentes",2020,3,1,889,112.485939257593,0,475,0,1,414,241.545893719807
31359,25,25438,81,"Tasa de exámenes médico legales por presunto delito sexual contra niños, niñas y adolescentes",2020,4,6,874,686.49885583524,1,470,212.765957446809,5,404,1237.62376237624
31360,25,25473,81,"Tasa de exámenes médico legales por presunto delito sexual contra niños, niñas y adolescentes",2020,2,4,11680,34.2465753424658,1,5999,16.6694449074846,3,5681,52.8076042950185
31361,25,25473,81,"Tasa de exámenes médico legales por presunto delito sexual contra niños, niñas y adolescentes",2020,3,6,13720,43.731778425656,1,7027,14.2308239647076,5,6693,74.7049155834454
31362,25,25473,81,"Tasa de exámenes médico legales por presunto delito sexual contra niños, niñas y adolescentes",2020,4,6,14261,42.072785919641,1,7222,13.846579894766,5,7039,71.0328171615286
31363,25,25473,121,Tasa de exámenes médico legales por presunto delito sexual cuando la víctima está entre 18 y 28 años,2020,5,1,30681,3.25934617515726,0,15235,0,1,15446,6.47416806940308
31364,25,25486,81,"Tasa de exámenes médico legales por presunto delito sexual contra niños, niñas y adolescentes",2020,4,5,1483,337.154416722859,0,738,0,5,745,671.140939597315
31365,25,25486,121,Tasa de exámenes médico legales por presunto delito sexual cuando la víctima está entre 18 y 28 años,2020,5,1,2864,34.9162011173184,0,1403,0,1,1461,68.4462696783025
31366,25,25489,81,"Tasa de exámenes médico legales por presunto delito sexual contra niños, niñas y adolescentes",2020,2,1,227,440.528634361234,1,108,925.925925925926,0,119,0
31367,25,25489,81,"Tasa de exámenes médico legales por presunto delito sexual contra niños, niñas y adolescentes",2020,3,2,279,716.845878136201,1,149,671.140939597315,1,130,769.230769230769
31368,25,25489,81,"Tasa de exámenes médico legales por presunto delito sexual contra niños, niñas y adolescentes",2020,4,3,296,1013.51351351351,0,166,0,3,130,2307.69230769231
31369,25,25513,81,"Tasa de exámenes médico legales por presunto delito sexual contra niños, niñas y adolescentes",2020,3,2,2328,85.9106529209622,1,1189,84.1042893187552,1,1139,87.7963125548727
31370,25,25513,81,"Tasa de exámenes médico legales por presunto delito sexual contra niños, niñas y adolescentes",2020,4,8,2465,324.543610547667,0,1295,0,8,1170,683.760683760684
31371,25,25518,121,Tasa de exámenes médico legales por presunto delito sexual cuando la víctima está entre 18 y 28 años,2020,5,1,578,173.010380622837,0,307,0,1,271,369.0036900369
31372,25,25524,81,"Tasa de exámenes médico legales por presunto delito sexual contra niños, niñas y adolescentes",2020,4,1,484,206.611570247934,0,279,0,1,205,487.80487804878
31373,25,25530,81,"Tasa de exámenes médico legales por presunto delito sexual contra niños, niñas y adolescentes",2020,3,1,1067,93.7207122774133,1,539,185.528756957328,0,528,0
31374,25,25530,81,"Tasa de exámenes médico legales por presunto delito sexual contra niños, niñas y adolescentes",2020,4,3,1005,298.507462686567,0,490,0,3,515,582.52427184466
31375,25,25530,121,Tasa de exámenes médico legales por presunto delito sexual cuando la víctima está entre 18 y 28 años,2020,5,1,1668,59.9520383693046,0,830,0,1,838,119.331742243437
31376,25,25535,81,"Tasa de exámenes médico legales por presunto delito sexual contra niños, niñas y adolescentes",2020,2,1,721,138.69625520111,0,386,0,1,335,298.507462686567
31377,25,25535,81,"Tasa de exámenes médico legales por presunto delito sexual contra niños, niñas y adolescentes",2020,3,1,928,107.758620689655,1,485,206.185567010309,0,443,0
31378,25,25535,81,"Tasa de exámenes médico legales por presunto delito sexual contra niños, niñas y adolescentes",2020,4,1,1018,98.2318271119843,0,522,0,1,496,201.612903225806
31379,25,25535,121,Tasa de exámenes médico legales por presunto delito sexual cuando la víctima está entre 18 y 28 años,2020,5,1,1615,61.9195046439629,0,832,0,1,783,127.713920817369
31380,25,25572,81,"Tasa de exámenes médico legales por presunto delito sexual contra niños, niñas y adolescentes",2020,3,4,1506,265.604249667995,0,757,0,4,749,534.045393858478
31381,25,25572,81,"Tasa de exámenes médico legales por presunto delito sexual contra niños, niñas y adolescentes",2020,4,1,1528,65.4450261780105,0,799,0,1,729,137.174211248285
31382,25,25572,121,Tasa de exámenes médico legales por presunto delito sexual cuando la víctima está entre 18 y 28 años,2020,5,1,3071,32.5626831650928,0,1707,0,1,1364,73.3137829912023
31383,25,25592,81,"Tasa de exámenes médico legales por presunto delito sexual contra niños, niñas y adolescentes",2020,3,1,397,251.889168765743,0,201,0,1,196,510.204081632653
31384,25,25592,81,"Tasa de exámenes médico legales por presunto delito sexual contra niños, niñas y adolescentes",2020,4,2,410,487.80487804878,0,199,0,2,211,947.867298578199
31385,25,25594,81,"Tasa de exámenes médico legales por presunto delito sexual contra niños, niñas y adolescentes",2020,4,3,536,559.701492537313,0,285,0,3,251,1195.21912350598
31386,25,25596,81,"Tasa de exámenes médico legales por presunto delito sexual contra niños, niñas y adolescentes",2020,2,1,444,225.225225225225,1,227,440.528634361234,0,217,0
31387,25,25596,81,"Tasa de exámenes médico legales por presunto delito sexual contra niños, niñas y adolescentes",2020,4,1,541,184.842883548983,0,272,0,1,269,371.747211895911
31388,25,25612,81,"Tasa de exámenes médico legales por presunto delito sexual contra niños, niñas y adolescentes",2020,3,6,1272,471.698113207547,0,656,0,6,616,974.025974025974
31389,25,25612,81,"Tasa de exámenes médico legales por presunto delito sexual contra niños, niñas y adolescentes",2020,4,2,1229,162.73393002441,0,622,0,2,607,329.489291598023
31390,25,25645,81,"Tasa de exámenes médico legales por presunto delito sexual contra niños, niñas y adolescentes",2020,3,1,1052,95.0570342205323,1,535,186.915887850467,0,517,0
31391,25,25645,81,"Tasa de exámenes médico legales por presunto delito sexual contra niños, niñas y adolescentes",2020,4,1,1091,91.6590284142988,0,561,0,1,530,188.679245283019
31392,25,25649,81,"Tasa de exámenes médico legales por presunto delito sexual contra niños, niñas y adolescentes",2020,3,1,873,114.54753722795,1,463,215.982721382289,0,410,0
31393,25,25649,81,"Tasa de exámenes médico legales por presunto delito sexual contra niños, niñas y adolescentes",2020,4,3,842,356.294536817102,0,445,0,3,397,755.667506297229
31394,25,25653,81,"Tasa de exámenes médico legales por presunto delito sexual contra niños, niñas y adolescentes",2020,2,1,342,292.397660818713,1,173,578.034682080925,0,169,0
31395,25,25658,81,"Tasa de exámenes médico legales por presunto delito sexual contra niños, niñas y adolescentes",2020,2,1,886,112.866817155756,1,463,215.982721382289,0,423,0
31396,25,25658,81,"Tasa de exámenes médico legales por presunto delito sexual contra niños, niñas y adolescentes",2020,3,1,1032,96.8992248062015,0,532,0,1,500,200
31397,25,25658,81,"Tasa de exámenes médico legales por presunto delito sexual contra niños, niñas y adolescentes",2020,4,4,1026,389.863547758285,0,521,0,4,505,792.079207920792
31398,25,25658,121,Tasa de exámenes médico legales por presunto delito sexual cuando la víctima está entre 18 y 28 años,2020,5,2,1762,113.507377979569,1,857,116.686114352392,1,905,110.497237569061
31399,25,25662,81,"Tasa de exámenes médico legales por presunto delito sexual contra niños, niñas y adolescentes",2020,3,1,764,130.890052356021,1,403,248.138957816377,0,361,0
31400,25,25662,81,"Tasa de exámenes médico legales por presunto delito sexual contra niños, niñas y adolescentes",2020,4,2,758,263.852242744063,0,394,0,2,364,549.450549450549
31401,25,25718,81,"Tasa de exámenes médico legales por presunto delito sexual contra niños, niñas y adolescentes",2020,3,3,1060,283.018867924528,2,572,349.65034965035,1,488,204.918032786885
31402,25,25718,81,"Tasa de exámenes médico legales por presunto delito sexual contra niños, niñas y adolescentes",2020,4,4,1170,341.880341880342,2,668,299.40119760479,2,502,398.406374501992
31403,25,25718,121,Tasa de exámenes médico legales por presunto delito sexual cuando la víctima está entre 18 y 28 años,2020,5,1,1559,64.143681847338,0,823,0,1,736,135.869565217391
31404,25,25736,81,"Tasa de exámenes médico legales por presunto delito sexual contra niños, niñas y adolescentes",2020,2,2,1046,191.204588910134,1,540,185.185185185185,1,506,197.628458498024
31405,25,25736,81,"Tasa de exámenes médico legales por presunto delito sexual contra niños, niñas y adolescentes",2020,4,4,1285,311.284046692607,0,669,0,4,616,649.350649350649
31406,25,25736,121,Tasa de exámenes médico legales por presunto delito sexual cuando la víctima está entre 18 y 28 años,2020,5,1,2328,42.9553264604811,0,1169,0,1,1159,86.2812769628991
31407,25,25740,81,"Tasa de exámenes médico legales por presunto delito sexual contra niños, niñas y adolescentes",2020,2,2,2738,73.0460189919649,1,1380,72.463768115942,1,1358,73.6377025036819
31408,25,25740,81,"Tasa de exámenes médico legales por presunto delito sexual contra niños, niñas y adolescentes",2020,3,6,3319,180.777342573064,1,1674,59.7371565113501,5,1645,303.951367781155
31409,25,25740,81,"Tasa de exámenes médico legales por presunto delito sexual contra niños, niñas y adolescentes",2020,4,3,3505,85.5920114122682,0,1809,0,3,1696,176.88679245283
31410,25,25743,81,"Tasa de exámenes médico legales por presunto delito sexual contra niños, niñas y adolescentes",2020,2,2,1857,107.700592353258,1,997,100.300902708124,1,860,116.279069767442
31411,25,25743,81,"Tasa de exámenes médico legales por presunto delito sexual contra niños, niñas y adolescentes",2020,3,3,2164,138.632162661738,0,1133,0,3,1031,290.9796314258
31412,25,25743,81,"Tasa de exámenes médico legales por presunto delito sexual contra niños, niñas y adolescentes",2020,4,5,2166,230.84025854109,0,1126,0,5,1040,480.769230769231
31413,25,25743,121,Tasa de exámenes médico legales por presunto delito sexual cuando la víctima está entre 18 y 28 años,2020,5,1,3549,28.1769512538743,0,1796,0,1,1753,57.0450656018254
31414,25,25745,81,"Tasa de exámenes médico legales por presunto delito sexual contra niños, niñas y adolescentes",2020,2,1,1135,88.1057268722467,0,594,0,1,541,184.842883548983
31415,25,25745,81,"Tasa de exámenes médico legales por presunto delito sexual contra niños, niñas y adolescentes",2020,3,3,1490,201.342281879195,1,766,130.548302872063,2,724,276.243093922652
31416,25,25745,81,"Tasa de exámenes médico legales por presunto delito sexual contra niños, niñas y adolescentes",2020,4,1,1552,64.4329896907217,0,791,0,1,761,131.406044678055
31417,25,25754,81,"Tasa de exámenes médico legales por presunto delito sexual contra niños, niñas y adolescentes",2020,2,42,60160,69.813829787234,11,30782,35.7351699044896,31,29378,105.52113826673
31418,25,25754,81,"Tasa de exámenes médico legales por presunto delito sexual contra niños, niñas y adolescentes",2020,3,77,71114,108.276851252918,20,36334,55.0448615621732,57,34780,163.887291546866
31419,25,25754,81,"Tasa de exámenes médico legales por presunto delito sexual contra niños, niñas y adolescentes",2020,4,85,73636,115.432668803303,8,37182,21.5157872088645,77,36454,211.225105612553
31420,25,25754,121,Tasa de exámenes médico legales por presunto delito sexual cuando la víctima está entre 18 y 28 años,2020,5,16,154331,10.3673273678004,0,75885,0,16,78446,20.3961961094256
31421,25,25754,81,"Tasa de exámenes médico legales por presunto delito sexual contra niños, niñas y adolescentes",2020,1,1,11502,8.69414014953921,0,5892,0,1,5610,17.825311942959
31422,25,25758,81,"Tasa de exámenes médico legales por presunto delito sexual contra niños, niñas y adolescentes",2020,2,2,1874,106.723585912487,0,985,0,2,889,224.971878515186
31423,25,25758,81,"Tasa de exámenes médico legales por presunto delito sexual contra niños, niñas y adolescentes",2020,3,2,2416,82.7814569536424,0,1256,0,2,1160,172.413793103448
31424,25,25769,81,"Tasa de exámenes médico legales por presunto delito sexual contra niños, niñas y adolescentes",2020,4,2,1563,127.959053103007,0,775,0,2,788,253.807106598985
31425,25,25769,121,Tasa de exámenes médico legales por presunto delito sexual cuando la víctima está entre 18 y 28 años,2020,5,2,3089,64.7458724506313,0,1528,0,2,1561,128.122998078155
31426,25,25772,81,"Tasa de exámenes médico legales por presunto delito sexual contra niños, niñas y adolescentes",2020,3,1,1879,53.2197977647685,0,962,0,1,917,109.051254089422
31427,25,25772,81,"Tasa de exámenes médico legales por presunto delito sexual contra niños, niñas y adolescentes",2020,4,3,1953,153.609831029186,1,992,100.806451612903,2,961,208.116545265349
31428,25,25772,121,Tasa de exámenes médico legales por presunto delito sexual cuando la víctima está entre 18 y 28 años,2020,5,1,3694,27.0709258256632,0,1871,0,1,1823,54.8546352166758
31429,25,25777,81,"Tasa de exámenes médico legales por presunto delito sexual contra niños, niñas y adolescentes",2020,4,2,507,394.477317554241,0,257,0,2,250,800
31430,25,25777,121,Tasa de exámenes médico legales por presunto delito sexual cuando la víctima está entre 18 y 28 años,2020,5,1,738,135.50135501355,0,381,0,1,357,280.112044817927
31431,25,25779,81,"Tasa de exámenes médico legales por presunto delito sexual contra niños, niñas y adolescentes",2020,2,2,623,321.027287319422,1,355,281.69014084507,1,268,373.134328358209
31432,25,25785,81,"Tasa de exámenes médico legales por presunto delito sexual contra niños, niñas y adolescentes",2020,4,2,2204,90.7441016333938,0,1121,0,2,1083,184.672206832872
31433,25,25797,81,"Tasa de exámenes médico legales por presunto delito sexual contra niños, niñas y adolescentes",2020,2,1,793,126.103404791929,1,390,256.410256410256,0,403,0
31434,25,25797,81,"Tasa de exámenes médico legales por presunto delito sexual contra niños, niñas y adolescentes",2020,3,3,920,326.086956521739,0,474,0,3,446,672.645739910314
31435,25,25797,81,"Tasa de exámenes médico legales por presunto delito sexual contra niños, niñas y adolescentes",2020,4,5,936,534.188034188034,0,513,0,5,423,1182.03309692671
31436,25,25797,121,Tasa de exámenes médico legales por presunto delito sexual cuando la víctima está entre 18 y 28 años,2020,5,1,1526,65.5307994757536,0,812,0,1,714,140.056022408964
31437,25,25807,81,"Tasa de exámenes médico legales por presunto delito sexual contra niños, niñas y adolescentes",2020,4,1,249,401.606425702811,0,116,0,1,133,751.87969924812
31438,25,25815,81,"Tasa de exámenes médico legales por presunto delito sexual contra niños, niñas y adolescentes",2020,2,1,990,101.010101010101,1,506,197.628458498024,0,484,0
31439,25,25815,81,"Tasa de exámenes médico legales por presunto delito sexual contra niños, niñas y adolescentes",2020,4,1,1470,68.0272108843537,0,789,0,1,681,146.842878120411
31440,25,25817,81,"Tasa de exámenes médico legales por presunto delito sexual contra niños, niñas y adolescentes",2020,3,3,4601,65.2032166920235,0,2362,0,3,2239,133.988387673068
31441,25,25817,81,"Tasa de exámenes médico legales por presunto delito sexual contra niños, niñas y adolescentes",2020,4,4,4581,87.3171796550971,0,2342,0,4,2239,178.651183564091
31442,25,25817,121,Tasa de exámenes médico legales por presunto delito sexual cuando la víctima está entre 18 y 28 años,2020,5,1,10042,9.95817566221868,0,5054,0,1,4988,20.0481154771451
31443,25,25839,81,"Tasa de exámenes médico legales por presunto delito sexual contra niños, niñas y adolescentes",2020,3,2,700,285.714285714286,0,359,0,2,341,586.510263929619
31444,25,25839,81,"Tasa de exámenes médico legales por presunto delito sexual contra niños, niñas y adolescentes",2020,4,1,765,130.718954248366,1,398,251.256281407035,0,367,0
31445,25,25841,81,"Tasa de exámenes médico legales por presunto delito sexual contra niños, niñas y adolescentes",2020,2,1,527,189.753320683112,1,308,324.675324675325,0,219,0
31446,25,25841,81,"Tasa de exámenes médico legales por presunto delito sexual contra niños, niñas y adolescentes",2020,3,9,636,1415.09433962264,2,343,583.090379008746,7,293,2389.07849829352
31447,25,25841,81,"Tasa de exámenes médico legales por presunto delito sexual contra niños, niñas y adolescentes",2020,4,10,649,1540.83204930663,1,336,297.619047619048,9,313,2875.39936102236
31448,25,25841,121,Tasa de exámenes médico legales por presunto delito sexual cuando la víctima está entre 18 y 28 años,2020,5,2,1004,199.203187250996,1,540,185.185185185185,1,464,215.51724137931
31449,25,25845,81,"Tasa de exámenes médico legales por presunto delito sexual contra niños, niñas y adolescentes",2020,2,1,515,194.174757281553,0,268,0,1,247,404.858299595142
31450,25,25845,81,"Tasa de exámenes médico legales por presunto delito sexual contra niños, niñas y adolescentes",2020,4,1,731,136.798905608755,0,371,0,1,360,277.777777777778
31451,25,25851,81,"Tasa de exámenes médico legales por presunto delito sexual contra niños, niñas y adolescentes",2020,4,2,359,557.103064066852,0,180,0,2,179,1117.31843575419
31452,25,25506,81,"Tasa de exámenes médico legales por presunto delito sexual contra niños, niñas y adolescentes",2020,3,1,404,247.524752475248,0,214,0,1,190,526.315789473684
31453,25,25862,81,"Tasa de exámenes médico legales por presunto delito sexual contra niños, niñas y adolescentes",2020,3,3,591,507.614213197969,1,306,326.797385620915,2,285,701.754385964912
31454,25,25862,81,"Tasa de exámenes médico legales por presunto delito sexual contra niños, niñas y adolescentes",2020,4,4,595,672.268907563025,0,312,0,4,283,1413.42756183746
31455,25,25862,121,Tasa de exámenes médico legales por presunto delito sexual cuando la víctima está entre 18 y 28 años,2020,5,1,861,116.144018583043,0,454,0,1,407,245.700245700246
31456,25,25843,81,"Tasa de exámenes médico legales por presunto delito sexual contra niños, niñas y adolescentes",2020,2,6,3964,151.362260343088,2,2060,97.0873786407767,4,1904,210.084033613445
31457,25,25843,81,"Tasa de exámenes médico legales por presunto delito sexual contra niños, niñas y adolescentes",2020,3,5,4697,106.450926123057,2,2373,84.2815002107038,3,2324,129.087779690189
31458,25,25843,81,"Tasa de exámenes médico legales por presunto delito sexual contra niños, niñas y adolescentes",2020,4,8,4766,167.855644146034,0,2358,0,8,2408,332.225913621262
31459,25,25843,121,Tasa de exámenes médico legales por presunto delito sexual cuando la víctima está entre 18 y 28 años,2020,5,4,8906,44.913541432742,0,4367,0,4,4539,88.1251376955276
31460,25,25871,81,"Tasa de exámenes médico legales por presunto delito sexual contra niños, niñas y adolescentes",2020,3,2,169,1183.43195266272,1,89,1123.59550561798,1,80,1250
31461,25,25873,81,"Tasa de exámenes médico legales por presunto delito sexual contra niños, niñas y adolescentes",2020,2,1,1719,58.173356602676,1,859,116.414435389988,0,860,0
31462,25,25873,81,"Tasa de exámenes médico legales por presunto delito sexual contra niños, niñas y adolescentes",2020,3,3,2041,146.986771190593,1,1040,96.1538461538462,2,1001,199.8001998002
31463,25,25873,81,"Tasa de exámenes médico legales por presunto delito sexual contra niños, niñas y adolescentes",2020,4,2,2049,97.6085895558809,0,1079,0,2,970,206.185567010309
31464,25,25873,121,Tasa de exámenes médico legales por presunto delito sexual cuando la víctima está entre 18 y 28 años,2020,5,3,3266,91.8554807103491,0,1693,0,3,1573,190.718372536554
31465,25,25875,81,"Tasa de exámenes médico legales por presunto delito sexual contra niños, niñas y adolescentes",2020,2,3,2001,149.925037481259,0,1018,0,3,983,305.188199389624
31466,25,25875,81,"Tasa de exámenes médico legales por presunto delito sexual contra niños, niñas y adolescentes",2020,3,12,2463,487.21071863581,5,1264,395.569620253165,7,1199,583.819849874896
31467,25,25875,81,"Tasa de exámenes médico legales por presunto delito sexual contra niños, niñas y adolescentes",2020,4,7,2608,268.40490797546,0,1361,0,7,1247,561.347233360064
31468,25,25875,121,Tasa de exámenes médico legales por presunto delito sexual cuando la víctima está entre 18 y 28 años,2020,5,3,4732,63.3981403212172,1,2392,41.8060200668896,2,2340,85.4700854700855
31469,25,25878,81,"Tasa de exámenes médico legales por presunto delito sexual contra niños, niñas y adolescentes",2020,2,4,962,415.800415800416,3,463,647.948164146868,1,499,200.400801603206
31470,25,25878,81,"Tasa de exámenes médico legales por presunto delito sexual contra niños, niñas y adolescentes",2020,3,4,1249,320.256204963971,1,625,160,3,624,480.769230769231
31471,25,25878,81,"Tasa de exámenes médico legales por presunto delito sexual contra niños, niñas y adolescentes",2020,4,1,1305,76.6283524904215,0,685,0,1,620,161.290322580645
31472,25,25885,81,"Tasa de exámenes médico legales por presunto delito sexual contra niños, niñas y adolescentes",2020,3,1,1143,87.4890638670166,0,610,0,1,533,187.617260787993
31473,25,25885,81,"Tasa de exámenes médico legales por presunto delito sexual contra niños, niñas y adolescentes",2020,4,3,1157,259.291270527226,0,634,0,3,523,573.613766730402
31474,25,25898,81,"Tasa de exámenes médico legales por presunto delito sexual contra niños, niñas y adolescentes",2020,3,1,452,221.238938053097,1,248,403.225806451613,0,204,0
31475,25,25898,81,"Tasa de exámenes médico legales por presunto delito sexual contra niños, niñas y adolescentes",2020,4,3,478,627.615062761506,0,266,0,3,212,1415.09433962264
31476,25,25899,81,"Tasa de exámenes médico legales por presunto delito sexual contra niños, niñas y adolescentes",2020,2,7,11496,60.8907446068198,1,5918,16.8976005407232,6,5578,107.565435640014
31477,25,25899,81,"Tasa de exámenes médico legales por presunto delito sexual contra niños, niñas y adolescentes",2020,3,16,12938,123.666718194466,5,6601,75.7460990758976,11,6337,173.583714691494
31478,25,25899,81,"Tasa de exámenes médico legales por presunto delito sexual contra niños, niñas y adolescentes",2020,4,20,13212,151.377535573721,4,6653,60.1232526679693,16,6559,243.939624942827
31479,25,25899,121,Tasa de exámenes médico legales por presunto delito sexual cuando la víctima está entre 18 y 28 años,2020,5,5,28684,17.4313205968484,0,14274,0,5,14410,34.6981263011797
31480,94,94343,81,"Tasa de exámenes médico legales por presunto delito sexual contra niños, niñas y adolescentes",2020,3,1,1679,59.5592614651578,1,859,116.414435389988,0,820,0
31481,94,94343,81,"Tasa de exámenes médico legales por presunto delito sexual contra niños, niñas y adolescentes",2020,4,2,1504,132.978723404255,0,812,0,2,692,289.017341040462
31482,94,94886,81,"Tasa de exámenes médico legales por presunto delito sexual contra niños, niñas y adolescentes",2020,4,1,161,621.11801242236,0,87,0,1,74,1351.35135135135
31483,94,94001,81,"Tasa de exámenes médico legales por presunto delito sexual contra niños, niñas y adolescentes",2020,2,3,3827,78.3903841128821,0,1960,0,3,1867,160.685591858597
31484,94,94001,81,"Tasa de exámenes médico legales por presunto delito sexual contra niños, niñas y adolescentes",2020,3,12,4744,252.951096121417,4,2405,166.320166320166,8,2339,342.026507054297
31485,94,94001,81,"Tasa de exámenes médico legales por presunto delito sexual contra niños, niñas y adolescentes",2020,4,12,4579,262.065953264905,1,2349,42.571306939123,11,2230,493.273542600897
31486,94,94001,121,Tasa de exámenes médico legales por presunto delito sexual cuando la víctima está entre 18 y 28 años,2020,5,7,7110,98.4528832630099,0,3754,0,7,3356,208.581644815256
31487,95,95025,81,"Tasa de exámenes médico legales por presunto delito sexual contra niños, niñas y adolescentes",2020,3,2,1899,105.318588730911,0,965,0,2,934,214.132762312634
31488,95,95200,81,"Tasa de exámenes médico legales por presunto delito sexual contra niños, niñas y adolescentes",2020,3,1,1027,97.3709834469328,0,529,0,1,498,200.803212851406
31489,95,95200,81,"Tasa de exámenes médico legales por presunto delito sexual contra niños, niñas y adolescentes",2020,4,3,837,358.4229390681,0,430,0,3,407,737.100737100737
31490,95,95001,81,"Tasa de exámenes médico legales por presunto delito sexual contra niños, niñas y adolescentes",2020,2,7,5966,117.33154542407,0,3057,0,7,2909,240.632519766243
31491,95,95001,81,"Tasa de exámenes médico legales por presunto delito sexual contra niños, niñas y adolescentes",2020,3,21,6734,311.850311850312,5,3392,147.405660377359,16,3342,478.755236385398
31492,95,95001,81,"Tasa de exámenes médico legales por presunto delito sexual contra niños, niñas y adolescentes",2020,4,20,6614,302.388872089507,3,3402,88.1834215167548,17,3212,529.265255292653
31493,95,95001,121,Tasa de exámenes médico legales por presunto delito sexual cuando la víctima está entre 18 y 28 años,2020,5,3,11405,26.3042525208242,0,6062,0,3,5343,56.1482313307131
31494,41,41006,81,"Tasa de exámenes médico legales por presunto delito sexual contra niños, niñas y adolescentes",2020,2,5,2775,180.18018018018,3,1390,215.827338129496,2,1385,144.404332129964
31495,41,41006,81,"Tasa de exámenes médico legales por presunto delito sexual contra niños, niñas y adolescentes",2020,3,4,3335,119.940029985007,0,1687,0,4,1648,242.718446601942
31496,41,41006,81,"Tasa de exámenes médico legales por presunto delito sexual contra niños, niñas y adolescentes",2020,4,11,3212,342.465753424658,2,1645,121.580547112462,9,1567,574.345883854499
31497,41,41006,121,Tasa de exámenes médico legales por presunto delito sexual cuando la víctima está entre 18 y 28 años,2020,5,4,4743,84.3348091924942,0,2425,0,4,2318,172.562553925798
31498,41,41016,81,"Tasa de exámenes médico legales por presunto delito sexual contra niños, niñas y adolescentes",2020,3,2,1902,105.15247108307,0,951,0,2,951,210.304942166141
31499,41,41016,81,"Tasa de exámenes médico legales por presunto delito sexual contra niños, niñas y adolescentes",2020,4,3,1807,166.021029330382,0,912,0,3,895,335.195530726257
31500,41,41016,121,Tasa de exámenes médico legales por presunto delito sexual cuando la víctima está entre 18 y 28 años,2020,5,1,2874,34.794711203897,0,1407,0,1,1467,68.1663258350375
31501,41,41020,81,"Tasa de exámenes médico legales por presunto delito sexual contra niños, niñas y adolescentes",2020,2,1,1981,50.4795557799091,1,983,101.729399796541,0,998,0
31502,41,41020,81,"Tasa de exámenes médico legales por presunto delito sexual contra niños, niñas y adolescentes",2020,3,5,2604,192.012288786482,1,1326,75.4147812971342,4,1278,312.989045383412
31503,41,41020,81,"Tasa de exámenes médico legales por presunto delito sexual contra niños, niñas y adolescentes",2020,4,4,2743,145.82573824280001,2,1458,137.174211248285,2,1285,155.642023346304
31504,41,41026,81,"Tasa de exámenes médico legales por presunto delito sexual contra niños, niñas y adolescentes",2020,4,2,441,453.514739229025,0,237,0,2,204,980.392156862745
31505,41,41078,81,"Tasa de exámenes médico legales por presunto delito sexual contra niños, niñas y adolescentes",2020,2,1,559,178.890876565295,1,299,334.448160535117,0,260,0
31506,41,41078,81,"Tasa de exámenes médico legales por presunto delito sexual contra niños, niñas y adolescentes",2020,3,3,832,360.576923076923,2,429,466.200466200466,1,403,248.138957816377
31507,41,41078,81,"Tasa de exámenes médico legales por presunto delito sexual contra niños, niñas y adolescentes",2020,4,2,981,203.873598369011,0,522,0,2,459,435.729847494553
31508,41,41132,81,"Tasa de exámenes médico legales por presunto delito sexual contra niños, niñas y adolescentes",2020,2,2,2708,73.8552437223043,0,1391,0,2,1317,151.860288534548
31509,41,41132,81,"Tasa de exámenes médico legales por presunto delito sexual contra niños, niñas y adolescentes",2020,3,7,3245,215.716486902928,1,1685,59.3471810089021,6,1560,384.615384615385
31510,41,41132,81,"Tasa de exámenes médico legales por presunto delito sexual contra niños, niñas y adolescentes",2020,4,6,3222,186.219739292365,1,1658,60.313630880579,5,1564,319.693094629156
31511,41,41132,121,Tasa de exámenes médico legales por presunto delito sexual cuando la víctima está entre 18 y 28 años,2020,5,4,5398,74.1015190811412,1,2709,36.9139904023625,3,2689,111.565637783563
31512,41,41206,81,"Tasa de exámenes médico legales por presunto delito sexual contra niños, niñas y adolescentes",2020,4,4,726,550.964187327824,0,401,0,4,325,1230.76923076923
31513,41,41298,81,"Tasa de exámenes médico legales por presunto delito sexual contra niños, niñas y adolescentes",2020,2,1,6951,14.3864192202561,0,3555,0,1,3396,29.4464075382803
31514,41,41298,81,"Tasa de exámenes médico legales por presunto delito sexual contra niños, niñas y adolescentes",2020,3,1,8349,11.9774823332136,0,4308,0,1,4041,24.7463499133878
31515,41,41298,81,"Tasa de exámenes médico legales por presunto delito sexual contra niños, niñas y adolescentes",2020,4,5,8318,60.1106035104592,0,4343,0,5,3975,125.786163522013
31516,41,41306,81,"Tasa de exámenes médico legales por presunto delito sexual contra niños, niñas y adolescentes",2020,3,1,2678,37.3412994772218,1,1311,76.27765064836,0,1367,0
31517,41,41306,121,Tasa de exámenes médico legales por presunto delito sexual cuando la víctima está entre 18 y 28 años,2020,5,1,4227,23.6574402649633,0,2117,0,1,2110,47.39336492891
31518,41,41319,81,"Tasa de exámenes médico legales por presunto delito sexual contra niños, niñas y adolescentes",2020,3,1,2196,45.5373406193078,0,1114,0,1,1082,92.4214417744917
31519,41,41319,81,"Tasa de exámenes médico legales por presunto delito sexual contra niños, niñas y adolescentes",2020,4,1,2144,46.6417910447761,0,1114,0,1,1030,97.0873786407767
31520,41,41349,81,"Tasa de exámenes médico legales por presunto delito sexual contra niños, niñas y adolescentes",2020,3,1,853,117.233294255569,0,448,0,1,405,246.913580246914
31521,41,41349,81,"Tasa de exámenes médico legales por presunto delito sexual contra niños, niñas y adolescentes",2020,4,1,803,124.53300124533,0,420,0,1,383,261.096605744125
31522,41,41349,121,Tasa de exámenes médico legales por presunto delito sexual cuando la víctima está entre 18 y 28 años,2020,5,1,1297,77.1010023130301,0,652,0,1,645,155.038759689922
31523,41,41357,81,"Tasa de exámenes médico legales por presunto delito sexual contra niños, niñas y adolescentes",2020,3,1,1138,87.8734622144112,1,581,172.117039586919,0,557,0
31524,41,41357,81,"Tasa de exámenes médico legales por presunto delito sexual contra niños, niñas y adolescentes",2020,4,2,1067,187.441424554827,0,556,0,2,511,391.389432485323
31525,41,41359,81,"Tasa de exámenes médico legales por presunto delito sexual contra niños, niñas y adolescentes",2020,2,1,2320,43.1034482758621,0,1137,0,1,1183,84.530853761623
31526,41,41359,81,"Tasa de exámenes médico legales por presunto delito sexual contra niños, niñas y adolescentes",2020,3,3,2819,106.420716566158,1,1422,70.323488045007,2,1397,143.163922691482
31527,41,41359,81,"Tasa de exámenes médico legales por presunto delito sexual contra niños, niñas y adolescentes",2020,4,9,2870,313.588850174216,1,1480,67.5675675675676,8,1390,575.539568345324
31528,41,41359,121,Tasa de exámenes médico legales por presunto delito sexual cuando la víctima está entre 18 y 28 años,2020,5,1,4863,20.5634382068682,0,2485,0,1,2378,42.0521446593776
31529,41,41378,81,"Tasa de exámenes médico legales por presunto delito sexual contra niños, niñas y adolescentes",2020,3,1,1620,61.7283950617284,0,837,0,1,783,127.713920817369
31530,41,41396,81,"Tasa de exámenes médico legales por presunto delito sexual contra niños, niñas y adolescentes",2020,2,4,6745,59.3031875463306,0,3461,0,4,3284,121.802679658952
31531,41,41396,81,"Tasa de exámenes médico legales por presunto delito sexual contra niños, niñas y adolescentes",2020,3,12,7717,155.500842296229,1,3972,25.1762336354481,11,3745,293.724966622163
31532,41,41396,81,"Tasa de exámenes médico legales por presunto delito sexual contra niños, niñas y adolescentes",2020,4,15,7249,206.925093116292,1,3733,26.7881060809001,14,3516,398.179749715586
31533,41,41396,121,Tasa de exámenes médico legales por presunto delito sexual cuando la víctima está entre 18 y 28 años,2020,5,6,11377,52.7379801353608,0,5802,0,6,5575,107.62331838565
31534,41,41483,81,"Tasa de exámenes médico legales por presunto delito sexual contra niños, niñas y adolescentes",2020,2,1,771,129.70168612192,1,385,259.74025974026,0,386,0
31535,41,41001,81,"Tasa de exámenes médico legales por presunto delito sexual contra niños, niñas y adolescentes",2020,2,43,31252,137.591194163574,5,15996,31.2578144536134,38,15256,249.082328264289
31536,41,41001,81,"Tasa de exámenes médico legales por presunto delito sexual contra niños, niñas y adolescentes",2020,3,70,35809,195.481582842302,9,18367,49.0009255730386,61,17442,349.730535489049
31537,41,41001,81,"Tasa de exámenes médico legales por presunto delito sexual contra niños, niñas y adolescentes",2020,4,103,34897,295.154311258847,16,17727,90.2577988379308,87,17170,506.697728596389
31538,41,41001,121,Tasa de exámenes médico legales por presunto delito sexual cuando la víctima está entre 18 y 28 años,2020,5,31,65452,47.3629530037279,0,32352,0,31,33100,93.6555891238671
31539,41,41524,81,"Tasa de exámenes médico legales por presunto delito sexual contra niños, niñas y adolescentes",2020,3,3,2792,107.449856733524,1,1444,69.2520775623269,2,1348,148.367952522255
31540,41,41524,81,"Tasa de exámenes médico legales por presunto delito sexual contra niños, niñas y adolescentes",2020,4,5,2696,185.459940652819,0,1382,0,5,1314,380.517503805175
31541,41,41524,121,Tasa de exámenes médico legales por presunto delito sexual cuando la víctima está entre 18 y 28 años,2020,5,2,4723,42.3459665466864,0,2405,0,2,2318,86.2812769628991
31542,41,41530,81,"Tasa de exámenes médico legales por presunto delito sexual contra niños, niñas y adolescentes",2020,4,3,1228,244.299674267101,0,626,0,3,602,498.338870431894
31543,41,41548,81,"Tasa de exámenes médico legales por presunto delito sexual contra niños, niñas y adolescentes",2020,2,1,1604,62.3441396508728,0,811,0,1,793,126.103404791929
31544,41,41548,81,"Tasa de exámenes médico legales por presunto delito sexual contra niños, niñas y adolescentes",2020,4,1,1578,63.3713561470215,0,815,0,1,763,131.061598951507
31545,41,41551,81,"Tasa de exámenes médico legales por presunto delito sexual contra niños, niñas y adolescentes",2020,2,4,11902,33.6077970089061,1,6128,16.3185378590078,3,5774,51.9570488396259
31546,41,41551,81,"Tasa de exámenes médico legales por presunto delito sexual contra niños, niñas y adolescentes",2020,3,13,14200,91.5492957746479,2,7269,27.5141009767506,11,6931,158.707257250036
31547,41,41551,81,"Tasa de exámenes médico legales por presunto delito sexual contra niños, niñas y adolescentes",2020,4,29,14326,202.429149797571,3,7255,41.3507925568573,26,7071,367.699052467826
31548,41,41551,121,Tasa de exámenes médico legales por presunto delito sexual cuando la víctima está entre 18 y 28 años,2020,5,4,25036,15.976993129893,1,12591,7.94218092288142,3,12445,24.1060666934512
31549,41,41615,81,"Tasa de exámenes médico legales por presunto delito sexual contra niños, niñas y adolescentes",2020,2,2,2011,99.4530084535057,1,1042,95.9692898272553,1,969,103.199174406605
31550,41,41615,81,"Tasa de exámenes médico legales por presunto delito sexual contra niños, niñas y adolescentes",2020,3,7,2397,292.031706299541,2,1252,159.744408945687,5,1145,436.681222707424
31551,41,41615,81,"Tasa de exámenes médico legales por presunto delito sexual contra niños, niñas y adolescentes",2020,4,7,2478,282.485875706215,2,1329,150.489089541008,5,1149,435.161009573542
31552,41,41615,121,Tasa de exámenes médico legales por presunto delito sexual cuando la víctima está entre 18 y 28 años,2020,5,2,4865,41.1099691675231,1,2773,36.0620266858998,1,2092,47.8011472275335
31553,41,41660,81,"Tasa de exámenes médico legales por presunto delito sexual contra niños, niñas y adolescentes",2020,2,1,1223,81.7661488143908,0,640,0,1,583,171.526586620926
31554,41,41660,81,"Tasa de exámenes médico legales por presunto delito sexual contra niños, niñas y adolescentes",2020,3,1,1399,71.4796283059328,1,747,133.868808567604,0,652,0
31555,41,41660,121,Tasa de exámenes médico legales por presunto delito sexual cuando la víctima está entre 18 y 28 años,2020,5,1,1892,52.8541226215645,0,921,0,1,971,102.986611740474
31556,41,41668,81,"Tasa de exámenes médico legales por presunto delito sexual contra niños, niñas y adolescentes",2020,3,4,3535,113.154172560113,1,1852,53.9956803455724,3,1683,178.25311942959
31557,41,41668,81,"Tasa de exámenes médico legales por presunto delito sexual contra niños, niñas y adolescentes",2020,4,11,3463,317.643661565117,2,1792,111.607142857143,9,1671,538.599640933573
31558,41,41668,121,Tasa de exámenes médico legales por presunto delito sexual cuando la víctima está entre 18 y 28 años,2020,5,2,6322,31.6355583676052,0,3249,0,2,3073,65.0829808005207
31559,41,41676,81,"Tasa de exámenes médico legales por presunto delito sexual contra niños, niñas y adolescentes",2020,3,1,1257,79.5544948289578,1,638,156.739811912226,0,619,0
31560,41,41676,81,"Tasa de exámenes médico legales por presunto delito sexual contra niños, niñas y adolescentes",2020,4,1,1132,88.339222614841,1,595,168.067226890756,0,537,0
31561,41,41770,81,"Tasa de exámenes médico legales por presunto delito sexual contra niños, niñas y adolescentes",2020,3,1,2758,36.2581580855693,0,1423,0,1,1335,74.9063670411985
31562,41,41770,81,"Tasa de exámenes médico legales por presunto delito sexual contra niños, niñas y adolescentes",2020,4,1,2543,39.3236335037357,0,1300,0,1,1243,80.450522928399
31563,41,41799,81,"Tasa de exámenes médico legales por presunto delito sexual contra niños, niñas y adolescentes",2020,2,1,1091,91.6590284142988,1,593,168.634064080944,0,498,0
31564,41,41799,81,"Tasa de exámenes médico legales por presunto delito sexual contra niños, niñas y adolescentes",2020,3,3,1338,224.215246636771,0,717,0,3,621,483.091787439613
31565,41,41799,81,"Tasa de exámenes médico legales por presunto delito sexual contra niños, niñas y adolescentes",2020,4,3,1326,226.244343891403,0,705,0,3,621,483.091787439613
31566,41,41799,121,Tasa de exámenes médico legales por presunto delito sexual cuando la víctima está entre 18 y 28 años,2020,5,1,1979,50.5305709954523,0,1043,0,1,936,106.837606837607
31567,41,41801,81,"Tasa de exámenes médico legales por presunto delito sexual contra niños, niñas y adolescentes",2020,3,1,896,111.607142857143,0,472,0,1,424,235.849056603774
31568,41,41797,121,Tasa de exámenes médico legales por presunto delito sexual cuando la víctima está entre 18 y 28 años,2020,5,1,1853,53.9665407447383,0,952,0,1,901,110.987791342952
31569,41,41807,81,"Tasa de exámenes médico legales por presunto delito sexual contra niños, niñas y adolescentes",2020,3,3,2383,125.891733109526,2,1260,158.730158730159,1,1123,89.0471950133571
31570,41,41807,81,"Tasa de exámenes médico legales por presunto delito sexual contra niños, niñas y adolescentes",2020,4,2,2439,82.0008200082001,0,1282,0,2,1157,172.86084701815
31571,41,41807,121,Tasa de exámenes médico legales por presunto delito sexual cuando la víctima está entre 18 y 28 años,2020,5,2,3857,51.8537723619393,0,1961,0,2,1896,105.485232067511
31572,41,41872,81,"Tasa de exámenes médico legales por presunto delito sexual contra niños, niñas y adolescentes",2020,4,1,623,160.513643659711,1,330,303.030303030303,0,293,0
31573,41,41885,81,"Tasa de exámenes médico legales por presunto delito sexual contra niños, niñas y adolescentes",2020,2,1,633,157.977883096366,0,311,0,1,322,310.55900621118
31574,41,41885,81,"Tasa de exámenes médico legales por presunto delito sexual contra niños, niñas y adolescentes",2020,4,1,731,136.798905608755,0,386,0,1,345,289.855072463768
31575,44,44035,81,"Tasa de exámenes médico legales por presunto delito sexual contra niños, niñas y adolescentes",2020,2,1,3768,26.5392781316348,0,1887,0,1,1881,53.1632110579479
31576,44,44035,81,"Tasa de exámenes médico legales por presunto delito sexual contra niños, niñas y adolescentes",2020,4,4,4132,96.805421103581807,1,2073,48.2392667631452,3,2059,145.70179698883
31577,44,44078,81,"Tasa de exámenes médico legales por presunto delito sexual contra niños, niñas y adolescentes",2020,2,3,4102,73.1350560702097,0,2090,0,3,2012,149.105367793241
31578,44,44078,81,"Tasa de exámenes médico legales por presunto delito sexual contra niños, niñas y adolescentes",2020,3,4,4856,82.3723228995058,2,2505,79.8403193612774,2,2351,85.0701829008932
31579,44,44078,81,"Tasa de exámenes médico legales por presunto delito sexual contra niños, niñas y adolescentes",2020,4,7,4614,151.712180320763,1,2385,41.9287211740042,6,2229,269.179004037685
31580,44,44090,81,"Tasa de exámenes médico legales por presunto delito sexual contra niños, niñas y adolescentes",2020,2,1,4931,20.2798620969377,0,2476,0,1,2455,40.7331975560082
31581,44,44090,81,"Tasa de exámenes médico legales por presunto delito sexual contra niños, niñas y adolescentes",2020,3,5,5994,83.4167500834167,0,3128,0,5,2866,174.459176552687
31582,44,44090,81,"Tasa de exámenes médico legales por presunto delito sexual contra niños, niñas y adolescentes",2020,4,9,5532,162.689804772234,0,2982,0,9,2550,352.941176470588
31583,44,44090,121,Tasa de exámenes médico legales por presunto delito sexual cuando la víctima está entre 18 y 28 años,2020,5,4,8536,46.8603561387067,0,4388,0,4,4148,96.4320154291225
31584,44,44098,81,"Tasa de exámenes médico legales por presunto delito sexual contra niños, niñas y adolescentes",2020,3,2,1716,116.550116550117,1,857,116.686114352392,1,859,116.414435389988
31585,44,44098,81,"Tasa de exámenes médico legales por presunto delito sexual contra niños, niñas y adolescentes",2020,4,1,1575,63.4920634920635,1,817,122.399020807834,0,758,0
31586,44,44110,81,"Tasa de exámenes médico legales por presunto delito sexual contra niños, niñas y adolescentes",2020,3,1,831,120.336943441637,0,427,0,1,404,247.524752475248
31587,44,44110,81,"Tasa de exámenes médico legales por presunto delito sexual contra niños, niñas y adolescentes",2020,4,2,791,252.844500632111,0,415,0,2,376,531.914893617021
31588,44,44279,81,"Tasa de exámenes médico legales por presunto delito sexual contra niños, niñas y adolescentes",2020,2,3,5125,58.5365853658537,1,2610,38.3141762452107,2,2515,79.5228628230616
31589,44,44279,81,"Tasa de exámenes médico legales por presunto delito sexual contra niños, niñas y adolescentes",2020,3,6,5691,105.429625724829,0,2923,0,6,2768,216.763005780347
31590,44,44279,81,"Tasa de exámenes médico legales por presunto delito sexual contra niños, niñas y adolescentes",2020,4,16,4813,332.432993974652,2,2474,80.8407437348424,14,2339,598.546387345019
31591,44,44279,121,Tasa de exámenes médico legales por presunto delito sexual cuando la víctima está entre 18 y 28 años,2020,5,2,8680,23.0414746543779,0,4245,0,2,4435,45.0958286358512
31592,44,44378,81,"Tasa de exámenes médico legales por presunto delito sexual contra niños, niñas y adolescentes",2020,2,1,2471,40.4694455685957,0,1285,0,1,1186,84.3170320404722
31593,44,44378,81,"Tasa de exámenes médico legales por presunto delito sexual contra niños, niñas y adolescentes",2020,3,1,2928,34.1530054644809,0,1497,0,1,1431,69.8812019566736
31594,44,44378,81,"Tasa de exámenes médico legales por presunto delito sexual contra niños, niñas y adolescentes",2020,4,1,2738,36.5230094959825,0,1375,0,1,1363,73.3675715333822
31595,44,44420,81,"Tasa de exámenes médico legales por presunto delito sexual contra niños, niñas y adolescentes",2020,4,2,482,414.9377593361,0,251,0,2,231,865.800865800866
31596,44,44430,81,"Tasa de exámenes médico legales por presunto delito sexual contra niños, niñas y adolescentes",2020,2,12,22293,53.828556048984,1,11402,8.77039115944571,11,10891,101.000826370398
31597,44,44430,81,"Tasa de exámenes médico legales por presunto delito sexual contra niños, niñas y adolescentes",2020,3,23,25414,90.5012984968915,4,12983,30.8095201417238,19,12431,152.843697208591
31598,44,44430,81,"Tasa de exámenes médico legales por presunto delito sexual contra niños, niñas y adolescentes",2020,4,33,22380,147.45308310992,1,11297,8.8519075860848,32,11083,288.730488134981
31599,44,44430,121,Tasa de exámenes médico legales por presunto delito sexual cuando la víctima está entre 18 y 28 años,2020,5,8,38114,20.9896625911738,0,18476,0,8,19638,40.7373459619106
31600,44,44430,81,"Tasa de exámenes médico legales por presunto delito sexual contra niños, niñas y adolescentes",2020,1,1,4488,22.2816399286988,0,2305,0,1,2183,45.8085203847916
31601,44,44560,81,"Tasa de exámenes médico legales por presunto delito sexual contra niños, niñas y adolescentes",2020,3,2,15194,13.1630906936949,0,7696,0,2,7498,26.6737796745799
31602,44,44560,81,"Tasa de exámenes médico legales por presunto delito sexual contra niños, niñas y adolescentes",2020,4,3,13001,23.0751480655334,0,6456,0,3,6545,45.8365164247517
31603,44,44560,121,Tasa de exámenes médico legales por presunto delito sexual cuando la víctima está entre 18 y 28 años,2020,5,1,18637,5.36567044052154,0,9089,0,1,9548,10.4733975701718
31604,44,44001,81,"Tasa de exámenes médico legales por presunto delito sexual contra niños, niñas y adolescentes",2020,2,7,23769,29.4501241112373,3,11979,25.0438266967193,4,11790,33.9270568278202
31605,44,44001,81,"Tasa de exámenes médico legales por presunto delito sexual contra niños, niñas y adolescentes",2020,3,35,26776,130.714072303555,7,13502,51.8441712338913,28,13274,210.938677113154
31606,44,44001,81,"Tasa de exámenes médico legales por presunto delito sexual contra niños, niñas y adolescentes",2020,4,54,23287,231.889036801649,3,11680,25.6849315068493,51,11607,439.390023261825
31607,44,44001,121,Tasa de exámenes médico legales por presunto delito sexual cuando la víctima está entre 18 y 28 años,2020,5,19,41109,46.2185896032499,3,20018,14.9865121390748,16,21091,75.8617419752501
31608,44,44650,81,"Tasa de exámenes médico legales por presunto delito sexual contra niños, niñas y adolescentes",2020,2,1,4564,21.9106047326906,0,2300,0,1,2264,44.1696113074205
31609,44,44650,81,"Tasa de exámenes médico legales por presunto delito sexual contra niños, niñas y adolescentes",2020,3,2,5550,36.036036036036,1,2810,35.5871886120996,1,2740,36.4963503649635
31610,44,44650,81,"Tasa de exámenes médico legales por presunto delito sexual contra niños, niñas y adolescentes",2020,4,10,5334,187.476565429321,2,2712,73.7463126843658,8,2622,305.11060259344
31611,44,44650,121,Tasa de exámenes médico legales por presunto delito sexual cuando la víctima está entre 18 y 28 años,2020,5,2,9594,20.8463623097769,0,4785,0,2,4809,41.5886878768975
31612,44,44847,81,"Tasa de exámenes médico legales por presunto delito sexual contra niños, niñas y adolescentes",2020,2,2,21492,9.30578820026056,1,11133,8.98230485942693,1,10359,9.65344145187759
31613,44,44847,81,"Tasa de exámenes médico legales por presunto delito sexual contra niños, niñas y adolescentes",2020,3,5,26125,19.138755980861198,1,13291,7.52388834549695,4,12834,31.1672120928783
31614,44,44847,81,"Tasa de exámenes médico legales por presunto delito sexual contra niños, niñas y adolescentes",2020,4,4,25406,15.7443123671574,0,12479,0,4,12927,30.9429875454475
31615,44,44874,81,"Tasa de exámenes médico legales por presunto delito sexual contra niños, niñas y adolescentes",2020,2,2,2946,67.8886625933469,1,1455,68.7285223367698,1,1491,67.0690811535882
31616,44,44874,81,"Tasa de exámenes médico legales por presunto delito sexual contra niños, niñas y adolescentes",2020,3,4,3529,113.346557098328,0,1753,0,4,1776,225.225225225225
31617,44,44874,81,"Tasa de exámenes médico legales por presunto delito sexual contra niños, niñas y adolescentes",2020,4,10,3173,315.159155373464,1,1593,62.7746390458255,9,1580,569.620253164557
31618,47,47053,81,"Tasa de exámenes médico legales por presunto delito sexual contra niños, niñas y adolescentes",2020,4,2,5241,38.1606563632894,0,2719,0,2,2522,79.3021411578113
31619,47,47058,81,"Tasa de exámenes médico legales por presunto delito sexual contra niños, niñas y adolescentes",2020,3,5,3950,126.582278481013,2,2036,98.2318271119843,3,1914,156.739811912226
31620,47,47058,81,"Tasa de exámenes médico legales por presunto delito sexual contra niños, niñas y adolescentes",2020,4,5,3789,131.96093956189,2,1967,101.677681748856,3,1822,164.654226125137
31621,47,47161,81,"Tasa de exámenes médico legales por presunto delito sexual contra niños, niñas y adolescentes",2020,4,1,1061,94.2507068803016,0,568,0,1,493,202.839756592292
31622,47,47170,81,"Tasa de exámenes médico legales por presunto delito sexual contra niños, niñas y adolescentes",2020,4,1,2792,35.8166189111748,1,1485,67.3400673400673,0,1307,0
31623,47,47189,81,"Tasa de exámenes médico legales por presunto delito sexual contra niños, niñas y adolescentes",2020,2,2,11545,17.3235166738848,0,5840,0,2,5705,35.056967572305
31624,47,47189,81,"Tasa de exámenes médico legales por presunto delito sexual contra niños, niñas y adolescentes",2020,3,5,14281,35.0115538127582,1,7292,13.713658804169,4,6989,57.2327943911862
31625,47,47189,81,"Tasa de exámenes médico legales por presunto delito sexual contra niños, niñas y adolescentes",2020,4,3,14452,20.7583725435926,0,7466,0,3,6986,42.9430289149728
31626,47,47189,121,Tasa de exámenes médico legales por presunto delito sexual cuando la víctima está entre 18 y 28 años,2020,5,1,24462,4.08797318289592,0,12481,0,1,11981,8.34654870211168
31627,47,47245,81,"Tasa de exámenes médico legales por presunto delito sexual contra niños, niñas y adolescentes",2020,2,3,7214,41.5858053784308,0,3716,0,3,3498,85.7632933104631
31628,47,47245,81,"Tasa de exámenes médico legales por presunto delito sexual contra niños, niñas y adolescentes",2020,3,5,8730,57.2737686139748,1,4473,22.3563603845294,4,4257,93.9628846605591
31629,47,47245,81,"Tasa de exámenes médico legales por presunto delito sexual contra niños, niñas y adolescentes",2020,4,15,8348,179.683756588404,1,4279,23.3699462491236,14,4069,344.064880806095
31630,47,47245,121,Tasa de exámenes médico legales por presunto delito sexual cuando la víctima está entre 18 y 28 años,2020,5,3,12685,23.6499802916831,0,6544,0,3,6141,48.8519785051295
31631,47,47268,81,"Tasa de exámenes médico legales por presunto delito sexual contra niños, niñas y adolescentes",2020,4,3,2772,108.225108225108,0,1454,0,3,1318,227.617602427921
31632,47,47288,81,"Tasa de exámenes médico legales por presunto delito sexual contra niños, niñas y adolescentes",2020,4,3,8790,34.1296928327645,0,4493,0,3,4297,69.8161508028857
31633,47,47288,121,Tasa de exámenes médico legales por presunto delito sexual cuando la víctima está entre 18 y 28 años,2020,5,1,13325,7.5046904315197,0,6720,0,1,6605,15.1400454201363
31634,47,47318,81,"Tasa de exámenes médico legales por presunto delito sexual contra niños, niñas y adolescentes",2020,3,1,3421,29.2312189418299,0,1817,0,1,1604,62.3441396508728
31635,47,47318,81,"Tasa de exámenes médico legales por presunto delito sexual contra niños, niñas y adolescentes",2020,4,1,3250,30.7692307692308,0,1748,0,1,1502,66.577896138482
31636,47,47460,81,"Tasa de exámenes médico legales por presunto delito sexual contra niños, niñas y adolescentes",2020,3,1,2835,35.2733686067019,0,1471,0,1,1364,73.3137829912023
31637,47,47460,81,"Tasa de exámenes médico legales por presunto delito sexual contra niños, niñas y adolescentes",2020,4,4,2681,149.198060425214,0,1394,0,4,1287,310.800310800311
31638,47,47545,81,"Tasa de exámenes médico legales por presunto delito sexual contra niños, niñas y adolescentes",2020,3,1,1795,55.7103064066852,0,929,0,1,866,115.473441108545
31639,47,47545,81,"Tasa de exámenes médico legales por presunto delito sexual contra niños, niñas y adolescentes",2020,4,2,1608,124.378109452736,0,845,0,2,763,262.123197903014
31640,47,47551,81,"Tasa de exámenes médico legales por presunto delito sexual contra niños, niñas y adolescentes",2020,3,1,4407,22.691173133651,1,2260,44.2477876106195,0,2147,0
31641,47,47551,81,"Tasa de exámenes médico legales por presunto delito sexual contra niños, niñas y adolescentes",2020,4,1,4233,23.623907394283,0,2180,0,1,2053,48.7092060399415
31642,47,47555,81,"Tasa de exámenes médico legales por presunto delito sexual contra niños, niñas y adolescentes",2020,2,4,6399,62.5097671511174,0,3200,0,4,3199,125.039074710847
31643,47,47555,81,"Tasa de exámenes médico legales por presunto delito sexual contra niños, niñas y adolescentes",2020,3,6,7838,76.5501403419239,1,3972,25.1762336354481,5,3866,129.332643559234
31644,47,47555,81,"Tasa de exámenes médico legales por presunto delito sexual contra niños, niñas y adolescentes",2020,4,20,7618,262.536098713573,1,3928,25.4582484725051,19,3690,514.905149051491
31645,47,47555,121,Tasa de exámenes médico legales por presunto delito sexual cuando la víctima está entre 18 y 28 años,2020,5,4,11738,34.0773555972057,0,6026,0,4,5712,70.0280112044818
31646,47,47570,81,"Tasa de exámenes médico legales por presunto delito sexual contra niños, niñas y adolescentes",2020,2,1,3472,28.8018433179723,0,1733,0,1,1739,57.5043128234618
31647,47,47605,81,"Tasa de exámenes médico legales por presunto delito sexual contra niños, niñas y adolescentes",2020,4,2,1246,160.513643659711,0,662,0,2,584,342.465753424658
31648,47,47692,81,"Tasa de exámenes médico legales por presunto delito sexual contra niños, niñas y adolescentes",2020,3,3,2620,114.503816793893,3,1371,218.818380743982,0,1249,0
31649,47,47707,81,"Tasa de exámenes médico legales por presunto delito sexual contra niños, niñas y adolescentes",2020,3,1,3295,30.3490136570561,0,1730,0,1,1565,63.8977635782748
31650,47,47707,81,"Tasa de exámenes médico legales por presunto delito sexual contra niños, niñas y adolescentes",2020,4,1,3129,31.9590923617769,0,1652,0,1,1477,67.7048070412999
31651,47,47720,81,"Tasa de exámenes médico legales por presunto delito sexual contra niños, niñas y adolescentes",2020,4,2,1354,147.710487444609,0,703,0,2,651,307.219662058372
31652,47,47001,81,"Tasa de exámenes médico legales por presunto delito sexual contra niños, niñas y adolescentes",2020,2,22,44512,49.4248741912293,10,22870,43.7254044599913,12,21642,55.4477405045744
31653,47,47001,81,"Tasa de exámenes médico legales por presunto delito sexual contra niños, niñas y adolescentes",2020,3,68,55053,123.517337838083,10,28242,35.4082572055803,58,26811,216.329118645332
31654,47,47001,81,"Tasa de exámenes médico legales por presunto delito sexual contra niños, niñas y adolescentes",2020,4,95,56640,167.725988700565,13,28772,45.1828166272765,82,27868,294.244294531362
31655,47,47001,121,Tasa de exámenes médico legales por presunto delito sexual cuando la víctima está entre 18 y 28 años,2020,5,24,105859,22.6716670287836,2,52543,3.80640618160364,22,53316,41.2634106084477
31656,47,47745,81,"Tasa de exámenes médico legales por presunto delito sexual contra niños, niñas y adolescentes",2020,3,2,3556,56.2429696287964,1,1816,55.0660792951542,1,1740,57.4712643678161
31657,47,47745,81,"Tasa de exámenes médico legales por presunto delito sexual contra niños, niñas y adolescentes",2020,4,1,3479,28.7438919229664,0,1777,0,1,1702,58.7544065804935
31658,47,47798,81,"Tasa de exámenes médico legales por presunto delito sexual contra niños, niñas y adolescentes",2020,2,1,1301,76.8639508070715,0,693,0,1,608,164.473684210526
31659,47,47798,121,Tasa de exámenes médico legales por presunto delito sexual cuando la víctima está entre 18 y 28 años,2020,5,2,2287,87.4508089199825,0,1219,0,2,1068,187.265917602996
31660,47,47980,81,"Tasa de exámenes médico legales por presunto delito sexual contra niños, niñas y adolescentes",2020,3,2,9589,20.8572322452811,0,4873,0,2,4716,42.4088210347752
31661,47,47980,81,"Tasa de exámenes médico legales por presunto delito sexual contra niños, niñas y adolescentes",2020,4,2,9189,21.7651539884645,0,4676,0,2,4513,44.3164192333259
31662,47,47980,121,Tasa de exámenes médico legales por presunto delito sexual cuando la víctima está entre 18 y 28 años,2020,5,1,14897,6.71276095858227,0,7581,0,1,7316,13.6686714051394
31663,50,50006,81,"Tasa de exámenes médico legales por presunto delito sexual contra niños, niñas y adolescentes",2020,2,5,7240,69.060773480663,3,3747,80.0640512409928,2,3493,57.2573718866304
31664,50,50006,81,"Tasa de exámenes médico legales por presunto delito sexual contra niños, niñas y adolescentes",2020,3,15,8751,171.408981830648,5,4485,111.482720178372,10,4266,234.41162681669
31665,50,50006,81,"Tasa de exámenes médico legales por presunto delito sexual contra niños, niñas y adolescentes",2020,4,25,8824,283.318223028105,3,4447,67.4612098043625,22,4377,502.627370344985
31666,50,50006,121,Tasa de exámenes médico legales por presunto delito sexual cuando la víctima está entre 18 y 28 años,2020,5,9,17250,52.1739130434783,3,9072,33.0687830687831,6,8178,73.3675715333822
31667,50,50110,81,"Tasa de exámenes médico legales por presunto delito sexual contra niños, niñas y adolescentes",2020,3,2,828,241.545893719807,1,410,243.90243902439,1,418,239.234449760766
31668,50,50110,81,"Tasa de exámenes médico legales por presunto delito sexual contra niños, niñas y adolescentes",2020,4,5,830,602.409638554217,0,413,0,5,417,1199.04076738609
31669,50,50124,81,"Tasa de exámenes médico legales por presunto delito sexual contra niños, niñas y adolescentes",2020,2,1,602,166.112956810631,0,310,0,1,292,342.465753424658
31670,50,50124,81,"Tasa de exámenes médico legales por presunto delito sexual contra niños, niñas y adolescentes",2020,3,1,711,140.646976090014,0,383,0,1,328,304.878048780488
31671,50,50124,81,"Tasa de exámenes médico legales por presunto delito sexual contra niños, niñas y adolescentes",2020,4,2,652,306.748466257669,0,356,0,2,296,675.675675675676
31672,50,50150,81,"Tasa de exámenes médico legales por presunto delito sexual contra niños, niñas y adolescentes",2020,2,2,1486,134.589502018843,1,755,132.450331125828,1,731,136.798905608755
31673,50,50150,81,"Tasa de exámenes médico legales por presunto delito sexual contra niños, niñas y adolescentes",2020,3,4,1750,228.571428571429,1,879,113.765642775882,3,871,344.43168771527
31674,50,50150,81,"Tasa de exámenes médico legales por presunto delito sexual contra niños, niñas y adolescentes",2020,4,3,1735,172.910662824207,1,867,115.340253748558,2,868,230.414746543779
31675,50,50226,81,"Tasa de exámenes médico legales por presunto delito sexual contra niños, niñas y adolescentes",2020,2,1,1917,52.1648408972353,0,985,0,1,932,107.296137339056
31676,50,50226,81,"Tasa de exámenes médico legales por presunto delito sexual contra niños, niñas y adolescentes",2020,3,8,2432,328.947368421053,4,1231,324.939073923639,4,1201,333.055786844296
31677,50,50226,81,"Tasa de exámenes médico legales por presunto delito sexual contra niños, niñas y adolescentes",2020,4,4,2516,158.982511923688,1,1266,78.9889415481832,3,1250,240
31678,50,50226,121,Tasa de exámenes médico legales por presunto delito sexual cuando la víctima está entre 18 y 28 años,2020,5,3,4304,69.7026022304833,0,2101,0,3,2203,136.177939173854
31679,50,50226,81,"Tasa de exámenes médico legales por presunto delito sexual contra niños, niñas y adolescentes",2020,1,1,370,270.27027027027,0,190,0,1,180,555.555555555556
31680,50,50251,81,"Tasa de exámenes médico legales por presunto delito sexual contra niños, niñas y adolescentes",2020,2,1,646,154.798761609907,0,323,0,1,323,309.597523219814
31681,50,50251,81,"Tasa de exámenes médico legales por presunto delito sexual contra niños, niñas y adolescentes",2020,4,7,860,813.953488372093,0,455,0,7,405,1728.39506172839
31682,50,50251,121,Tasa de exámenes médico legales por presunto delito sexual cuando la víctima está entre 18 y 28 años,2020,5,1,1197,83.5421888053467,0,614,0,1,583,171.526586620926
31683,50,50287,81,"Tasa de exámenes médico legales por presunto delito sexual contra niños, niñas y adolescentes",2020,2,3,1040,288.461538461538,1,530,188.679245283019,2,510,392.156862745098
31684,50,50287,81,"Tasa de exámenes médico legales por presunto delito sexual contra niños, niñas y adolescentes",2020,3,2,1354,147.710487444609,0,686,0,2,668,299.40119760479
31685,50,50287,81,"Tasa de exámenes médico legales por presunto delito sexual contra niños, niñas y adolescentes",2020,4,1,1382,72.3589001447178,0,705,0,1,677,147.710487444609
31686,50,50287,121,Tasa de exámenes médico legales por presunto delito sexual cuando la víctima está entre 18 y 28 años,2020,5,1,2122,47.1253534401508,0,1073,0,1,1049,95.3288846520496
31687,50,50313,81,"Tasa de exámenes médico legales por presunto delito sexual contra niños, niñas y adolescentes",2020,2,1,6104,16.3826998689384,0,3072,0,1,3032,32.9815303430079
31688,50,50313,81,"Tasa de exámenes médico legales por presunto delito sexual contra niños, niñas y adolescentes",2020,3,8,7574,105.624504885133,0,3818,0,8,3756,212.992545260916
31689,50,50313,81,"Tasa de exámenes médico legales por presunto delito sexual contra niños, niñas y adolescentes",2020,4,14,7732,181.065700982928,1,3899,25.6476019492177,13,3833,339.15992695017
31690,50,50313,121,Tasa de exámenes médico legales por presunto delito sexual cuando la víctima está entre 18 y 28 años,2020,5,7,12925,54.1586073500967,0,6283,0,7,6642,105.389942788317
31691,50,50318,81,"Tasa de exámenes médico legales por presunto delito sexual contra niños, niñas y adolescentes",2020,2,1,1229,81.366965012205,0,627,0,1,602,166.112956810631
31692,50,50318,81,"Tasa de exámenes médico legales por presunto delito sexual contra niños, niñas y adolescentes",2020,3,1,1448,69.060773480663,0,738,0,1,710,140.845070422535
31693,50,50318,81,"Tasa de exámenes médico legales por presunto delito sexual contra niños, niñas y adolescentes",2020,4,1,1432,69.8324022346369,0,728,0,1,704,142.045454545455
31694,50,50318,121,Tasa de exámenes médico legales por presunto delito sexual cuando la víctima está entre 18 y 28 años,2020,5,1,2523,39.6353547364249,0,1242,0,1,1281,78.064012490242
31695,50,50350,81,"Tasa de exámenes médico legales por presunto delito sexual contra niños, niñas y adolescentes",2020,2,1,3275,30.5343511450382,0,1622,0,1,1653,60.4960677555959
31696,50,50350,81,"Tasa de exámenes médico legales por presunto delito sexual contra niños, niñas y adolescentes",2020,3,2,3858,51.8403317781234,0,1965,0,2,1893,105.652403592182
31697,50,50350,81,"Tasa de exámenes médico legales por presunto delito sexual contra niños, niñas y adolescentes",2020,4,4,3571,112.013441612994,0,1882,0,4,1689,236.826524570752
31698,50,50400,81,"Tasa de exámenes médico legales por presunto delito sexual contra niños, niñas y adolescentes",2020,2,1,984,101.626016260163,0,492,0,1,492,203.252032520325
31699,50,50400,81,"Tasa de exámenes médico legales por presunto delito sexual contra niños, niñas y adolescentes",2020,4,2,1251,159.872102318145,0,671,0,2,580,344.827586206897
31700,50,50325,81,"Tasa de exámenes médico legales por presunto delito sexual contra niños, niñas y adolescentes",2020,3,4,1091,366.636113657195,2,549,364.298724954463,2,542,369.0036900369
31701,50,50325,81,"Tasa de exámenes médico legales por presunto delito sexual contra niños, niñas y adolescentes",2020,4,4,823,486.026731470231,0,429,0,4,394,1015.22842639594
31702,50,50330,81,"Tasa de exámenes médico legales por presunto delito sexual contra niños, niñas y adolescentes",2020,2,1,964,103.734439834025,0,476,0,1,488,204.918032786885
31703,50,50330,81,"Tasa de exámenes médico legales por presunto delito sexual contra niños, niñas y adolescentes",2020,3,1,1189,84.1042893187552,0,612,0,1,577,173.310225303293
31704,50,50330,81,"Tasa de exámenes médico legales por presunto delito sexual contra niños, niñas y adolescentes",2020,4,2,1169,171.086398631309,0,621,0,2,548,364.963503649635
31705,50,50450,81,"Tasa de exámenes médico legales por presunto delito sexual contra niños, niñas y adolescentes",2020,2,1,906,110.37527593819,1,490,204.081632653061,0,416,0
31706,50,50450,81,"Tasa de exámenes médico legales por presunto delito sexual contra niños, niñas y adolescentes",2020,4,3,1075,279.06976744186,0,551,0,3,524,572.519083969466
31707,50,50568,81,"Tasa de exámenes médico legales por presunto delito sexual contra niños, niñas y adolescentes",2020,3,5,5984,83.5561497326203,1,3009,33.2336324360253,4,2975,134.453781512605
31708,50,50568,81,"Tasa de exámenes médico legales por presunto delito sexual contra niños, niñas y adolescentes",2020,4,9,5147,174.859141247329,2,2641,75.7288905717531,7,2506,279.329608938547
31709,50,50568,121,Tasa de exámenes médico legales por presunto delito sexual cuando la víctima está entre 18 y 28 años,2020,5,4,8882,45.034902049088,0,4789,0,4,4093,97.7278279990227
31710,50,50577,81,"Tasa de exámenes médico legales por presunto delito sexual contra niños, niñas y adolescentes",2020,3,3,1231,243.704305442729,1,645,155.038759689922,2,586,341.296928327645
31711,50,50573,81,"Tasa de exámenes médico legales por presunto delito sexual contra niños, niñas y adolescentes",2020,2,5,2917,171.408981830648,0,1513,0,5,1404,356.125356125356
31712,50,50573,81,"Tasa de exámenes médico legales por presunto delito sexual contra niños, niñas y adolescentes",2020,3,15,3505,427.960057061341,4,1826,219.058050383352,11,1679,655.151876116736
31713,50,50573,81,"Tasa de exámenes médico legales por presunto delito sexual contra niños, niñas y adolescentes",2020,4,17,3359,506.103006847276,0,1754,0,17,1605,1059.19003115265
31714,50,50573,121,Tasa de exámenes médico legales por presunto delito sexual cuando la víctima está entre 18 y 28 años,2020,5,3,5353,56.0433401830749,0,2666,0,3,2687,111.648678823967
31715,50,50590,81,"Tasa de exámenes médico legales por presunto delito sexual contra niños, niñas y adolescentes",2020,3,2,1472,135.869565217391,0,744,0,2,728,274.725274725275
31716,50,50590,81,"Tasa de exámenes médico legales por presunto delito sexual contra niños, niñas y adolescentes",2020,4,10,1402,713.266761768902,0,714,0,10,688,1453.48837209302
31717,50,50590,121,Tasa de exámenes médico legales por presunto delito sexual cuando la víctima está entre 18 y 28 años,2020,5,1,2219,45.0653447498873,0,1158,0,1,1061,94.2507068803016
31718,50,50606,81,"Tasa de exámenes médico legales por presunto delito sexual contra niños, niñas y adolescentes",2020,2,2,1473,135.777325186694,0,743,0,2,730,273.972602739726
31719,50,50606,81,"Tasa de exámenes médico legales por presunto delito sexual contra niños, niñas y adolescentes",2020,3,5,1818,275.027502750275,1,934,107.066381156317,4,884,452.488687782805
31720,50,50606,81,"Tasa de exámenes médico legales por presunto delito sexual contra niños, niñas y adolescentes",2020,4,3,1858,161.463939720129,0,974,0,3,884,339.366515837104
31721,50,50606,121,Tasa de exámenes médico legales por presunto delito sexual cuando la víctima está entre 18 y 28 años,2020,5,1,3255,30.7219662058372,0,1655,0,1,1600,62.5
31722,50,50680,81,"Tasa de exámenes médico legales por presunto delito sexual contra niños, niñas y adolescentes",2020,2,2,1360,147.058823529412,1,696,143.67816091954,1,664,150.602409638554
31723,50,50680,81,"Tasa de exámenes médico legales por presunto delito sexual contra niños, niñas y adolescentes",2020,3,2,1551,128.949065119278,1,791,126.422250316056,1,760,131.578947368421
31724,50,50680,81,"Tasa de exámenes médico legales por presunto delito sexual contra niños, niñas y adolescentes",2020,4,6,1449,414.07867494824,1,738,135.50135501355,5,711,703.23488045007
31725,50,50680,121,Tasa de exámenes médico legales por presunto delito sexual cuando la víctima está entre 18 y 28 años,2020,5,1,2410,41.49377593361,0,1230,0,1,1180,84.7457627118644
31726,50,50683,81,"Tasa de exámenes médico legales por presunto delito sexual contra niños, niñas y adolescentes",2020,3,4,894,447.427293064877,2,449,445.43429844098,2,445,449.438202247191
31727,50,50683,81,"Tasa de exámenes médico legales por presunto delito sexual contra niños, niñas y adolescentes",2020,4,2,1066,187.617260787993,0,587,0,2,479,417.536534446764
31728,50,50683,121,Tasa de exámenes médico legales por presunto delito sexual cuando la víctima está entre 18 y 28 años,2020,5,2,1618,123.609394313968,0,896,0,2,722,277.008310249307
31729,50,50223,81,"Tasa de exámenes médico legales por presunto delito sexual contra niños, niñas y adolescentes",2020,2,1,507,197.23865877712,0,256,0,1,251,398.406374501992
31730,50,50223,121,Tasa de exámenes médico legales por presunto delito sexual cuando la víctima está entre 18 y 28 años,2020,5,1,1168,85.6164383561644,0,583,0,1,585,170.940170940171
31731,50,50689,81,"Tasa de exámenes médico legales por presunto delito sexual contra niños, niñas y adolescentes",2020,2,2,2182,91.6590284142988,0,1078,0,2,1104,181.159420289855
31732,50,50689,81,"Tasa de exámenes médico legales por presunto delito sexual contra niños, niñas y adolescentes",2020,3,2,2871,69.6621386276559,1,1452,68.870523415978,1,1419,70.4721634954193
31733,50,50689,81,"Tasa de exámenes médico legales por presunto delito sexual contra niños, niñas y adolescentes",2020,4,7,2967,235.92854735423,1,1524,65.6167979002625,6,1443,415.800415800416
31734,50,50689,121,Tasa de exámenes médico legales por presunto delito sexual cuando la víctima está entre 18 y 28 años,2020,5,3,4448,67.4460431654676,0,2198,0,3,2250,133.333333333333
31735,50,50370,81,"Tasa de exámenes médico legales por presunto delito sexual contra niños, niñas y adolescentes",2020,3,1,1125,88.8888888888889,0,580,0,1,545,183.48623853211
31736,50,50370,81,"Tasa de exámenes médico legales por presunto delito sexual contra niños, niñas y adolescentes",2020,4,2,1347,148.478099480327,1,725,137.931034482759,1,622,160.771704180064
31737,50,50370,121,Tasa de exámenes médico legales por presunto delito sexual cuando la víctima está entre 18 y 28 años,2020,5,1,1934,51.7063081695967,1,1164,85.9106529209622,0,770,0
31738,50,50001,81,"Tasa de exámenes médico legales por presunto delito sexual contra niños, niñas y adolescentes",2020,2,46,40487,113.616716476894,14,20975,66.746126340882,32,19512,164.0016400164
31739,50,50001,81,"Tasa de exámenes médico legales por presunto delito sexual contra niños, niñas y adolescentes",2020,3,97,49919,194.314789959735,20,25790,77.5494377665762,77,24129,319.118073687264
31740,50,50001,81,"Tasa de exámenes médico legales por presunto delito sexual contra niños, niñas y adolescentes",2020,4,124,52934,234.253976650168,16,27286,58.6381294436707,108,25648,421.085464753587
31741,50,50001,121,Tasa de exámenes médico legales por presunto delito sexual cuando la víctima está entre 18 y 28 años,2020,5,27,104444,25.8511738347823,1,53510,1.86880956830499,26,50934,51.0464522715671
31742,50,50001,81,"Tasa de exámenes médico legales por presunto delito sexual contra niños, niñas y adolescentes",2020,1,2,7857,25.4550082728777,1,4066,24.5941957697983,1,3791,26.3782643102084
31743,50,50711,81,"Tasa de exámenes médico legales por presunto delito sexual contra niños, niñas y adolescentes",2020,3,2,1943,102.933607822954,0,987,0,2,956,209.205020920502
31744,50,50711,81,"Tasa de exámenes médico legales por presunto delito sexual contra niños, niñas y adolescentes",2020,4,2,1996,100.200400801603,0,1010,0,2,986,202.839756592292
31745,52,52079,81,"Tasa de exámenes médico legales por presunto delito sexual contra niños, niñas y adolescentes",2020,4,1,7315,13.6705399863295,0,3772,0,1,3543,28.2246683601468
31746,52,52110,81,"Tasa de exámenes médico legales por presunto delito sexual contra niños, niñas y adolescentes",2020,4,1,2225,44.9438202247191,0,1139,0,1,1086,92.0810313075506
31747,52,52240,121,Tasa de exámenes médico legales por presunto delito sexual cuando la víctima está entre 18 y 28 años,2020,5,1,2751,36.3504180298073,0,1393,0,1,1358,73.6377025036819
31748,52,52233,81,"Tasa de exámenes médico legales por presunto delito sexual contra niños, niñas y adolescentes",2020,3,1,505,198.019801980198,0,278,0,1,227,440.528634361234
31749,52,52250,81,"Tasa de exámenes médico legales por presunto delito sexual contra niños, niñas y adolescentes",2020,3,1,3252,30.750307503075,0,1652,0,1,1600,62.5
31750,52,52320,81,"Tasa de exámenes médico legales por presunto delito sexual contra niños, niñas y adolescentes",2020,4,1,991,100.908173562059,0,506,0,1,485,206.185567010309
31751,52,52354,81,"Tasa de exámenes médico legales por presunto delito sexual contra niños, niñas y adolescentes",2020,3,1,497,201.207243460765,0,245,0,1,252,396.825396825397
31752,52,52356,81,"Tasa de exámenes médico legales por presunto delito sexual contra niños, niñas y adolescentes",2020,4,2,10696,18.698578908003,0,5459,0,2,5237,38.1898033225129
31753,52,52356,121,Tasa de exámenes médico legales por presunto delito sexual cuando la víctima está entre 18 y 28 años,2020,5,1,21171,4.72344244485381,0,10739,0,1,10432,9.58588957055215
31754,52,52390,81,"Tasa de exámenes médico legales por presunto delito sexual contra niños, niñas y adolescentes",2020,4,2,974,205.338809034908,0,509,0,2,465,430.10752688172
31755,52,52405,81,"Tasa de exámenes médico legales por presunto delito sexual contra niños, niñas y adolescentes",2020,2,2,639,312.989045383412,0,318,0,2,321,623.052959501558
31756,52,52001,81,"Tasa de exámenes médico legales por presunto delito sexual contra niños, niñas y adolescentes",2020,2,2,23795,8.4051271275478,1,12150,8.23045267489712,1,11645,8.587376556462
31757,52,52001,81,"Tasa de exámenes médico legales por presunto delito sexual contra niños, niñas y adolescentes",2020,3,4,28770,13.9033715676051,1,14628,6.83620453923981,3,14142,21.2134068731438
31758,52,52001,81,"Tasa de exámenes médico legales por presunto delito sexual contra niños, niñas y adolescentes",2020,4,9,32048,28.0828756864703,0,16228,0,9,15820,56.890012642225
31759,52,52001,121,Tasa de exámenes médico legales por presunto delito sexual cuando la víctima está entre 18 y 28 años,2020,5,7,72121,9.70591089973794,0,36143,0,7,35978,19.456334426594
31760,52,52835,81,"Tasa de exámenes médico legales por presunto delito sexual contra niños, niñas y adolescentes",2020,3,1,30317,3.29847940099614,0,15376,0,1,14941,6.69299243691855
31761,52,52835,81,"Tasa de exámenes médico legales por presunto delito sexual contra niños, niñas y adolescentes",2020,4,2,30129,6.63812273888944,0,15304,0,2,14825,13.4907251264755
31762,52,52835,121,Tasa de exámenes médico legales por presunto delito sexual cuando la víctima está entre 18 y 28 años,2020,5,2,50564,3.95538327663951,1,25477,3.92510892177258,1,25087,3.98612827360785
31763,52,52683,81,"Tasa de exámenes médico legales por presunto delito sexual contra niños, niñas y adolescentes",2020,3,1,1411,70.871722182849,0,755,0,1,656,152.439024390244
31764,52,52786,81,"Tasa de exámenes médico legales por presunto delito sexual contra niños, niñas y adolescentes",2020,4,1,1539,64.9772579597141,0,802,0,1,737,135.685210312076
31765,52,52788,121,Tasa de exámenes médico legales por presunto delito sexual cuando la víctima está entre 18 y 28 años,2020,5,1,2387,41.8935902806871,0,1201,0,1,1186,84.3170320404722
31766,52,52838,81,"Tasa de exámenes médico legales por presunto delito sexual contra niños, niñas y adolescentes",2020,3,1,3519,28.4171639670361,0,1791,0,1,1728,57.8703703703704
31767,52,52838,81,"Tasa de exámenes médico legales por presunto delito sexual contra niños, niñas y adolescentes",2020,4,1,4052,24.6791707798618,1,2100,47.6190476190476,0,1952,0
31768,52,52838,121,Tasa de exámenes médico legales por presunto delito sexual cuando la víctima está entre 18 y 28 años,2020,5,2,8676,23.0520977408944,0,4557,0,2,4119,48.5554746297645
31769,54,54003,81,"Tasa de exámenes médico legales por presunto delito sexual contra niños, niñas y adolescentes",2020,2,2,3423,58.428279287175,1,1756,56.9476082004556,1,1667,59.9880023995201
31770,54,54003,81,"Tasa de exámenes médico legales por presunto delito sexual contra niños, niñas y adolescentes",2020,3,5,3952,126.518218623482,1,2011,49.7265042267529,4,1941,206.07934054611
31771,54,54003,81,"Tasa de exámenes médico legales por presunto delito sexual contra niños, niñas y adolescentes",2020,4,7,3768,185.774946921444,0,1905,0,7,1863,375.738056897477
31772,54,54003,121,Tasa de exámenes médico legales por presunto delito sexual cuando la víctima está entre 18 y 28 años,2020,5,3,6241,48.0692196763339,0,3162,0,3,3079,97.4342318934719
31773,54,54099,81,"Tasa de exámenes médico legales por presunto delito sexual contra niños, niñas y adolescentes",2020,2,1,699,143.061516452074,0,357,0,1,342,292.397660818713
31774,54,54099,81,"Tasa de exámenes médico legales por presunto delito sexual contra niños, niñas y adolescentes",2020,3,1,854,117.096018735363,0,467,0,1,387,258.397932816537
31775,54,54099,81,"Tasa de exámenes médico legales por presunto delito sexual contra niños, niñas y adolescentes",2020,4,2,879,227.531285551763,2,502,398.406374501992,0,377,0
31776,54,54099,121,Tasa de exámenes médico legales por presunto delito sexual cuando la víctima está entre 18 y 28 años,2020,5,1,1529,65.402223675605,0,828,0,1,701,142.65335235378
31777,54,54128,81,"Tasa de exámenes médico legales por presunto delito sexual contra niños, niñas y adolescentes",2020,3,2,1293,154.679040989946,0,673,0,2,620,322.58064516129
31778,54,54128,81,"Tasa de exámenes médico legales por presunto delito sexual contra niños, niñas y adolescentes",2020,4,7,1304,536.80981595092,1,695,143.884892086331,6,609,985.221674876847
31779,54,54172,81,"Tasa de exámenes médico legales por presunto delito sexual contra niños, niñas y adolescentes",2020,2,2,1467,136.332651670075,1,733,136.425648021828,1,734,136.239782016349
31780,54,54172,81,"Tasa de exámenes médico legales por presunto delito sexual contra niños, niñas y adolescentes",2020,4,3,1835,163.487738419619,0,918,0,3,917,327.153762268266
31781,54,54172,121,Tasa de exámenes médico legales por presunto delito sexual cuando la víctima está entre 18 y 28 años,2020,5,2,3251,61.5195324515534,0,1634,0,2,1617,123.685837971552
31782,54,54174,81,"Tasa de exámenes médico legales por presunto delito sexual contra niños, niñas y adolescentes",2020,4,2,1349,148.257968865827,0,719,0,2,630,317.460317460317
31783,54,54206,81,"Tasa de exámenes médico legales por presunto delito sexual contra niños, niñas y adolescentes",2020,3,1,2482,40.290088638195,1,1244,80.3858520900322,0,1238,0
31784,54,54206,81,"Tasa de exámenes médico legales por presunto delito sexual contra niños, niñas y adolescentes",2020,4,1,2355,42.4628450106157,0,1215,0,1,1140,87.719298245614
31785,54,54001,81,"Tasa de exámenes médico legales por presunto delito sexual contra niños, niñas y adolescentes",2020,2,34,62085,54.7636305065636,12,31907,37.6093020340364,22,30178,72.9007886539864
31786,54,54001,81,"Tasa de exámenes médico legales por presunto delito sexual contra niños, niñas y adolescentes",2020,3,52,73034,71.1997152011392,14,37453,37.3801831628975,38,35581,106.798572271718
31787,54,54001,81,"Tasa de exámenes médico legales por presunto delito sexual contra niños, niñas y adolescentes",2020,4,93,73986,125.699456653962,10,37595,26.5992818193909,83,36391,228.078371025803
31788,54,54001,121,Tasa de exámenes médico legales por presunto delito sexual cuando la víctima está entre 18 y 28 años,2020,5,12,152462,7.87081371095748,1,76804,1.302015520025,11,75658,14.5391102064554
31789,54,54239,81,"Tasa de exámenes médico legales por presunto delito sexual contra niños, niñas y adolescentes",2020,2,1,369,271.0027100271,1,182,549.450549450549,0,187,0
31790,54,54245,81,"Tasa de exámenes médico legales por presunto delito sexual contra niños, niñas y adolescentes",2020,4,2,1620,123.456790123457,0,850,0,2,770,259.74025974026
31791,54,54261,81,"Tasa de exámenes médico legales por presunto delito sexual contra niños, niñas y adolescentes",2020,2,1,2869,34.8553502962705,0,1501,0,1,1368,73.0994152046784
31792,54,54261,81,"Tasa de exámenes médico legales por presunto delito sexual contra niños, niñas y adolescentes",2020,3,2,3267,61.2182430364249,1,1709,58.5137507314219,1,1558,64.1848523748395
31793,54,54261,81,"Tasa de exámenes médico legales por presunto delito sexual contra niños, niñas y adolescentes",2020,4,3,3150,95.2380952380952,0,1633,0,3,1517,197.7587343441
31794,54,54313,121,Tasa de exámenes médico legales por presunto delito sexual cuando la víctima está entre 18 y 28 años,2020,5,1,1480,67.5675675675676,0,872,0,1,608,164.473684210526
31795,54,54344,81,"Tasa de exámenes médico legales por presunto delito sexual contra niños, niñas y adolescentes",2020,2,1,1396,71.6332378223496,0,707,0,1,689,145.137880986938
31796,54,54344,81,"Tasa de exámenes médico legales por presunto delito sexual contra niños, niñas y adolescentes",2020,4,1,1357,73.6919675755343,0,702,0,1,655,152.671755725191
31797,54,54385,81,"Tasa de exámenes médico legales por presunto delito sexual contra niños, niñas y adolescentes",2020,4,1,1475,67.7966101694915,0,748,0,1,727,137.551581843191
31798,54,54398,81,"Tasa de exámenes médico legales por presunto delito sexual contra niños, niñas y adolescentes",2020,3,1,946,105.708245243129,1,485,206.185567010309,0,461,0
31799,54,54405,81,"Tasa de exámenes médico legales por presunto delito sexual contra niños, niñas y adolescentes",2020,2,4,7562,52.8960592435864,2,3790,52.7704485488127,2,3772,53.0222693531283
31800,54,54405,81,"Tasa de exámenes médico legales por presunto delito sexual contra niños, niñas y adolescentes",2020,3,4,9106,43.9270810454645,0,4642,0,4,4464,89.6057347670251
31801,54,54405,81,"Tasa de exámenes médico legales por presunto delito sexual contra niños, niñas y adolescentes",2020,4,4,9241,43.2853587274105,2,4750,42.1052631578947,2,4491,44.5335114673792
31802,54,54405,121,Tasa de exámenes médico legales por presunto delito sexual cuando la víctima está entre 18 y 28 años,2020,5,1,18182,5.49994500054999,0,9021,0,1,9161,10.9158388822181
31803,54,54418,81,"Tasa de exámenes médico legales por presunto delito sexual contra niños, niñas y adolescentes",2020,4,1,449,222.71714922049,0,240,0,1,209,478.468899521531
31804,54,54498,81,"Tasa de exámenes médico legales por presunto delito sexual contra niños, niñas y adolescentes",2020,2,4,10374,38.5579332947754,0,5189,0,4,5185,77.145612343298
31805,54,54498,81,"Tasa de exámenes médico legales por presunto delito sexual contra niños, niñas y adolescentes",2020,3,12,12492,96.0614793467819,1,6277,15.9311773140035,11,6215,176.991150442478
31806,54,54498,81,"Tasa de exámenes médico legales por presunto delito sexual contra niños, niñas y adolescentes",2020,4,12,12923,92.8576955815213,0,6480,0,12,6443,186.248641936986
31807,54,54498,121,Tasa de exámenes médico legales por presunto delito sexual cuando la víctima está entre 18 y 28 años,2020,5,6,25073,23.9301240378096,0,12392,0,6,12681,47.3148805299267
31808,54,54518,81,"Tasa de exámenes médico legales por presunto delito sexual contra niños, niñas y adolescentes",2020,2,1,3462,28.8850375505488,0,1745,0,1,1717,58.24111822947
31809,54,54518,81,"Tasa de exámenes médico legales por presunto delito sexual contra niños, niñas y adolescentes",2020,3,2,4489,44.5533526397861,0,2251,0,2,2238,89.3655049151028
31810,54,54518,81,"Tasa de exámenes médico legales por presunto delito sexual contra niños, niñas y adolescentes",2020,4,12,5371,223.42208154906,1,2719,36.7782272894447,11,2652,414.781297134238
31811,54,54518,121,Tasa de exámenes médico legales por presunto delito sexual cuando la víctima está entre 18 y 28 años,2020,5,4,11573,34.5632074656528,1,5985,16.7084377610693,3,5588,53.6864710093057
31812,54,54520,81,"Tasa de exámenes médico legales por presunto delito sexual contra niños, niñas y adolescentes",2020,3,1,600,166.666666666667,0,325,0,1,275,363.636363636364
31813,54,54520,81,"Tasa de exámenes médico legales por presunto delito sexual contra niños, niñas y adolescentes",2020,4,2,576,347.222222222222,0,303,0,2,273,732.600732600733
31814,54,54553,81,"Tasa de exámenes médico legales por presunto delito sexual contra niños, niñas y adolescentes",2020,2,1,988,101.214574898785,0,521,0,1,467,214.132762312634
31815,54,54553,81,"Tasa de exámenes médico legales por presunto delito sexual contra niños, niñas y adolescentes",2020,4,3,1034,290.135396518375,0,530,0,3,504,595.238095238095
31816,54,54599,81,"Tasa de exámenes médico legales por presunto delito sexual contra niños, niñas y adolescentes",2020,4,3,603,497.512437810945,1,327,305.810397553517,2,276,724.63768115942
31817,54,54660,81,"Tasa de exámenes médico legales por presunto delito sexual contra niños, niñas y adolescentes",2020,3,3,1147,261.5518744551,0,590,0,3,557,538.599640933573
31818,54,54660,81,"Tasa de exámenes médico legales por presunto delito sexual contra niños, niñas y adolescentes",2020,4,2,1230,162.60162601626,1,644,155.27950310559,1,586,170.648464163823
31819,54,54673,81,"Tasa de exámenes médico legales por presunto delito sexual contra niños, niñas y adolescentes",2020,2,1,758,131.926121372032,1,368,271.739130434783,0,390,0
31820,54,54673,81,"Tasa de exámenes médico legales por presunto delito sexual contra niños, niñas y adolescentes",2020,3,1,848,117.924528301887,0,433,0,1,415,240.963855421687
31821,54,54680,81,"Tasa de exámenes médico legales por presunto delito sexual contra niños, niñas y adolescentes",2020,2,1,292,342.465753424658,0,150,0,1,142,704.225352112676
31822,54,54680,81,"Tasa de exámenes médico legales por presunto delito sexual contra niños, niñas y adolescentes",2020,4,1,400,250,0,197,0,1,203,492.610837438424
31823,54,54720,81,"Tasa de exámenes médico legales por presunto delito sexual contra niños, niñas y adolescentes",2020,2,1,2914,34.3170899107756,0,1500,0,1,1414,70.7213578500707
31824,54,54720,121,Tasa de exámenes médico legales por presunto delito sexual cuando la víctima está entre 18 y 28 años,2020,5,1,5356,18.6706497386109,0,2927,0,1,2429,41.1692054343351
31825,54,54743,81,"Tasa de exámenes médico legales por presunto delito sexual contra niños, niñas y adolescentes",2020,3,3,700,428.571428571429,1,366,273.224043715847,2,334,598.802395209581
31826,54,54800,81,"Tasa de exámenes médico legales por presunto delito sexual contra niños, niñas y adolescentes",2020,4,1,2119,47.192071731949,0,1087,0,1,1032,96.8992248062015
31827,54,54800,121,Tasa de exámenes médico legales por presunto delito sexual cuando la víctima está entre 18 y 28 años,2020,5,2,3431,58.2920431361119,0,1721,0,2,1710,116.959064327485
31828,54,54810,81,"Tasa de exámenes médico legales por presunto delito sexual contra niños, niñas y adolescentes",2020,3,1,7766,12.8766417718259,0,4104,0,1,3662,27.3074822501365
31829,54,54810,81,"Tasa de exámenes médico legales por presunto delito sexual contra niños, niñas y adolescentes",2020,4,2,6870,29.1120815138282,0,3631,0,2,3239,61.7474529175672
31830,54,54820,81,"Tasa de exámenes médico legales por presunto delito sexual contra niños, niñas y adolescentes",2020,3,1,1737,57.5705238917674,0,890,0,1,847,118.063754427391
31831,54,54820,81,"Tasa de exámenes médico legales por presunto delito sexual contra niños, niñas y adolescentes",2020,4,1,1759,56.8504832291074,0,942,0,1,817,122.399020807834
31832,54,54871,81,"Tasa de exámenes médico legales por presunto delito sexual contra niños, niñas y adolescentes",2020,3,1,658,151.975683890577,0,339,0,1,319,313.479623824451
31833,54,54874,81,"Tasa de exámenes médico legales por presunto delito sexual contra niños, niñas y adolescentes",2020,2,3,9281,32.3241030061416,1,4786,20.8942749686586,2,4495,44.4938820912125
31834,54,54874,81,"Tasa de exámenes médico legales por presunto delito sexual contra niños, niñas y adolescentes",2020,3,12,10793,111.183174279626,4,5583,71.6460684219953,8,5210,153.550863723608
31835,54,54874,81,"Tasa de exámenes médico legales por presunto delito sexual contra niños, niñas y adolescentes",2020,4,6,10573,56.748321195498,0,5390,0,6,5183,115.763071580166
31836,54,54874,121,Tasa de exámenes médico legales por presunto delito sexual cuando la víctima está entre 18 y 28 años,2020,5,2,21161,9.45134918009546,0,10300,0,2,10861,18.4145106343799
31837,86,86219,81,"Tasa de exámenes médico legales por presunto delito sexual contra niños, niñas y adolescentes",2020,3,1,512,195.3125,0,259,0,1,253,395.256916996047
31838,86,86219,81,"Tasa de exámenes médico legales por presunto delito sexual contra niños, niñas y adolescentes",2020,4,1,501,199.600798403194,0,247,0,1,254,393.700787401575
31839,86,86001,81,"Tasa de exámenes médico legales por presunto delito sexual contra niños, niñas y adolescentes",2020,2,4,4714,84.8536274925753,0,2375,0,4,2339,171.013253527148
31840,86,86001,81,"Tasa de exámenes médico legales por presunto delito sexual contra niños, niñas y adolescentes",2020,3,7,5594,125.134072220236,0,2809,0,7,2785,251.346499102334
31841,86,86001,81,"Tasa de exámenes médico legales por presunto delito sexual contra niños, niñas y adolescentes",2020,4,7,5940,117.845117845118,1,3009,33.2336324360253,6,2931,204.708290685773
31842,86,86001,121,Tasa de exámenes médico legales por presunto delito sexual cuando la víctima está entre 18 y 28 años,2020,5,4,12201,32.784198016556,1,6198,16.134236850597,3,6003,49.9750124937531
31843,86,86320,81,"Tasa de exámenes médico legales por presunto delito sexual contra niños, niñas y adolescentes",2020,2,1,3639,27.4800769442154,0,1843,0,1,1796,55.6792873051225
31844,86,86320,81,"Tasa de exámenes médico legales por presunto delito sexual contra niños, niñas y adolescentes",2020,3,7,4489,155.936734239252,1,2282,43.8212094653812,6,2207,271.862256456729
31845,86,86320,81,"Tasa de exámenes médico legales por presunto delito sexual contra niños, niñas y adolescentes",2020,4,12,4601,260.812866768094,0,2365,0,12,2236,536.672629695885
31846,86,86320,121,Tasa de exámenes médico legales por presunto delito sexual cuando la víctima está entre 18 y 28 años,2020,5,4,7657,52.2397805929215,0,3850,0,4,3807,105.069608615708
31847,86,86568,81,"Tasa de exámenes médico legales por presunto delito sexual contra niños, niñas y adolescentes",2020,2,6,5718,104.931794333683,1,2914,34.3170899107756,5,2804,178.316690442225
31848,86,86568,81,"Tasa de exámenes médico legales por presunto delito sexual contra niños, niñas y adolescentes",2020,3,10,7205,138.792505204719,0,3641,0,10,3564,280.583613916947
31849,86,86568,81,"Tasa de exámenes médico legales por presunto delito sexual contra niños, niñas y adolescentes",2020,4,16,7784,205.549845837616,2,3976,50.3018108651912,14,3808,367.647058823529
31850,86,86568,121,Tasa de exámenes médico legales por presunto delito sexual cuando la víctima está entre 18 y 28 años,2020,5,3,14131,21.2299200339679,0,7313,0,3,6818,44.0011733646231
31851,86,86569,81,"Tasa de exámenes médico legales por presunto delito sexual contra niños, niñas y adolescentes",2020,2,1,1495,66.8896321070234,0,742,0,1,753,132.802124833997
31852,86,86569,81,"Tasa de exámenes médico legales por presunto delito sexual contra niños, niñas y adolescentes",2020,3,7,1688,414.691943127962,1,854,117.096018735363,6,834,719.424460431655
31853,86,86569,81,"Tasa de exámenes médico legales por presunto delito sexual contra niños, niñas y adolescentes",2020,4,2,1670,119.760479041916,1,878,113.895216400911,1,792,126.262626262626
31854,86,86571,81,"Tasa de exámenes médico legales por presunto delito sexual contra niños, niñas y adolescentes",2020,2,1,4103,24.3724104313917,0,2173,0,1,1930,51.8134715025907
31855,86,86571,81,"Tasa de exámenes médico legales por presunto delito sexual contra niños, niñas y adolescentes",2020,3,2,4996,40.0320256204964,0,2537,0,2,2459,81.3338755591704
31856,86,86573,81,"Tasa de exámenes médico legales por presunto delito sexual contra niños, niñas y adolescentes",2020,2,2,3417,58.5308750365818,0,1694,0,2,1723,116.076610562972
31857,86,86573,81,"Tasa de exámenes médico legales por presunto delito sexual contra niños, niñas y adolescentes",2020,3,9,4022,223.769269020388,0,2025,0,9,1997,450.676014021032
31858,86,86573,81,"Tasa de exámenes médico legales por presunto delito sexual contra niños, niñas y adolescentes",2020,4,10,3776,264.830508474576,3,1962,152.905198776758,7,1814,385.887541345094
31859,86,86755,81,"Tasa de exámenes médico legales por presunto delito sexual contra niños, niñas y adolescentes",2020,3,1,539,185.528756957328,1,259,386.100386100386,0,280,0
31860,86,86757,81,"Tasa de exámenes médico legales por presunto delito sexual contra niños, niñas y adolescentes",2020,2,1,1907,52.4383848977452,1,971,102.986611740474,0,936,0
31861,86,86757,81,"Tasa de exámenes médico legales por presunto delito sexual contra niños, niñas y adolescentes",2020,3,4,2274,175.901495162709,1,1146,87.260034904014,3,1128,265.957446808511
31862,86,86757,81,"Tasa de exámenes médico legales por presunto delito sexual contra niños, niñas y adolescentes",2020,4,5,2312,216.262975778547,1,1154,86.6551126516464,4,1158,345.423143350604
31863,86,86757,121,Tasa de exámenes médico legales por presunto delito sexual cuando la víctima está entre 18 y 28 años,2020,5,2,3944,50.709939148073,1,1987,50.3271263210871,1,1957,51.0986203372509
31864,86,86749,81,"Tasa de exámenes médico legales por presunto delito sexual contra niños, niñas y adolescentes",2020,4,2,1522,131.406044678055,0,785,0,2,737,271.370420624152
31865,86,86749,121,Tasa de exámenes médico legales por presunto delito sexual cuando la víctima está entre 18 y 28 años,2020,5,1,2962,33.7609723160027,1,1464,68.3060109289618,0,1498,0
31866,86,86865,81,"Tasa de exámenes médico legales por presunto delito sexual contra niños, niñas y adolescentes",2020,2,5,2751,181.752090149037,2,1434,139.470013947001,3,1317,227.790432801822
31867,86,86865,81,"Tasa de exámenes médico legales por presunto delito sexual contra niños, niñas y adolescentes",2020,3,9,3694,243.638332430969,2,1924,103.950103950104,7,1770,395.480225988701
31868,86,86865,81,"Tasa de exámenes médico legales por presunto delito sexual contra niños, niñas y adolescentes",2020,4,19,4156,457.170356111646,2,2165,92.378752886836,17,1991,853.842290306379
31869,86,86865,121,Tasa de exámenes médico legales por presunto delito sexual cuando la víctima está entre 18 y 28 años,2020,5,3,7145,41.9874037788663,0,3630,0,3,3515,85.348506401138
31870,86,86885,81,"Tasa de exámenes médico legales por presunto delito sexual contra niños, niñas y adolescentes",2020,2,1,2321,43.084877208100004,1,1172,85.3242320819113,0,1149,0
31871,86,86885,81,"Tasa de exámenes médico legales por presunto delito sexual contra niños, niñas y adolescentes",2020,3,5,2758,181.290790427846,0,1389,0,5,1369,365.230094959825
31872,86,86885,81,"Tasa de exámenes médico legales por presunto delito sexual contra niños, niñas y adolescentes",2020,4,10,2816,355.113636363636,1,1445,69.2041522491349,9,1371,656.455142231947
31873,86,86885,121,Tasa de exámenes médico legales por presunto delito sexual cuando la víctima está entre 18 y 28 años,2020,5,1,5028,19.8886237072395,0,2581,0,1,2447,40.8663669799755
31874,63,63001,81,"Tasa de exámenes médico legales por presunto delito sexual contra niños, niñas y adolescentes",2020,2,28,17492,160.07317630917,7,8903,78.6251825227451,21,8589,244.498777506112
31875,63,63001,81,"Tasa de exámenes médico legales por presunto delito sexual contra niños, niñas y adolescentes",2020,3,38,20668,183.859105864138,8,10541,75.8941276918698,30,10127,296.237780191567
31876,63,63001,81,"Tasa de exámenes médico legales por presunto delito sexual contra niños, niñas y adolescentes",2020,4,56,23323,240.106332804528,6,11850,50.6329113924051,50,11473,435.805804933322
31877,63,63001,121,Tasa de exámenes médico legales por presunto delito sexual cuando la víctima está entre 18 y 28 años,2020,5,20,52770,37.9003221527383,1,26058,3.83759306163174,19,26712,71.1290805630428
31878,63,63001,81,"Tasa de exámenes médico legales por presunto delito sexual contra niños, niñas y adolescentes",2020,1,1,3366,29.708853238265,0,1719,0,1,1647,60.7164541590771
31879,63,63111,81,"Tasa de exámenes médico legales por presunto delito sexual contra niños, niñas y adolescentes",2020,3,3,280,1071.42857142857,0,145,0,3,135,2222.22222222222
31880,63,63111,81,"Tasa de exámenes médico legales por presunto delito sexual contra niños, niñas y adolescentes",2020,4,4,301,1328.90365448505,0,166,0,4,135,2962.96296296296
31881,63,63130,81,"Tasa de exámenes médico legales por presunto delito sexual contra niños, niñas y adolescentes",2020,2,7,4626,151.318633808906,2,2388,83.7520938023451,5,2238,223.413762287757
31882,63,63130,81,"Tasa de exámenes médico legales por presunto delito sexual contra niños, niñas y adolescentes",2020,3,20,5553,360.165676211057,6,2827,212.239122744959,14,2726,513.573000733676
31883,63,63130,81,"Tasa de exámenes médico legales por presunto delito sexual contra niños, niñas y adolescentes",2020,4,23,6210,370.37037037037,4,3136,127.551020408163,19,3074,618.087182823682
31884,63,63130,121,Tasa de exámenes médico legales por presunto delito sexual cuando la víctima está entre 18 y 28 años,2020,5,3,12978,23.1160425335183,0,6682,0,3,6296,47.6493011435832
31885,63,63190,81,"Tasa de exámenes médico legales por presunto delito sexual contra niños, niñas y adolescentes",2020,2,4,1820,219.78021978022,0,904,0,4,916,436.681222707424
31886,63,63190,81,"Tasa de exámenes médico legales por presunto delito sexual contra niños, niñas y adolescentes",2020,3,1,2142,46.6853408029879,0,1093,0,1,1049,95.3288846520496
31887,63,63190,81,"Tasa de exámenes médico legales por presunto delito sexual contra niños, niñas y adolescentes",2020,4,2,2341,85.4335753951303,0,1198,0,2,1143,174.978127734033
31888,63,63212,81,"Tasa de exámenes médico legales por presunto delito sexual contra niños, niñas y adolescentes",2020,4,1,503,198.807157057654,0,267,0,1,236,423.728813559322
31889,63,63272,81,"Tasa de exámenes médico legales por presunto delito sexual contra niños, niñas y adolescentes",2020,2,1,701,142.65335235378,0,369,0,1,332,301.204819277108
31890,63,63272,81,"Tasa de exámenes médico legales por presunto delito sexual contra niños, niñas y adolescentes",2020,3,3,917,327.153762268266,1,480,208.333333333333,2,437,457.66590389016
31891,63,63272,81,"Tasa de exámenes médico legales por presunto delito sexual contra niños, niñas y adolescentes",2020,4,1,1037,96.4320154291225,0,532,0,1,505,198.019801980198
31892,63,63302,81,"Tasa de exámenes médico legales por presunto delito sexual contra niños, niñas y adolescentes",2020,2,2,488,409.83606557377,0,255,0,2,233,858.369098712446
31893,63,63302,81,"Tasa de exámenes médico legales por presunto delito sexual contra niños, niñas y adolescentes",2020,3,4,592,675.675675675676,0,324,0,4,268,1492.53731343284
31894,63,63302,81,"Tasa de exámenes médico legales por presunto delito sexual contra niños, niñas y adolescentes",2020,4,4,643,622.083981337481,0,362,0,4,281,1423.48754448399
31895,63,63401,81,"Tasa de exámenes médico legales por presunto delito sexual contra niños, niñas y adolescentes",2020,2,10,2339,427.533133817871,3,1191,251.889168765743,7,1148,609.756097560976
31896,63,63401,81,"Tasa de exámenes médico legales por presunto delito sexual contra niños, niñas y adolescentes",2020,3,18,2835,634.920634920635,2,1469,136.147038801906,16,1366,1171.30307467057
31897,63,63401,81,"Tasa de exámenes médico legales por presunto delito sexual contra niños, niñas y adolescentes",2020,4,12,3223,372.323921811976,2,1658,120.627261761158,10,1565,638.977635782748
31898,63,63401,121,Tasa de exámenes médico legales por presunto delito sexual cuando la víctima está entre 18 y 28 años,2020,5,5,6467,77.3156022885418,2,3226,61.9962802231866,3,3241,92.5640234495526
31899,63,63470,81,"Tasa de exámenes médico legales por presunto delito sexual contra niños, niñas y adolescentes",2020,2,3,2541,118.063754427391,0,1307,0,3,1234,243.111831442464
31900,63,63470,81,"Tasa de exámenes médico legales por presunto delito sexual contra niños, niñas y adolescentes",2020,3,11,2980,369.127516778523,4,1528,261.780104712042,7,1452,482.093663911846
31901,63,63470,81,"Tasa de exámenes médico legales por presunto delito sexual contra niños, niñas y adolescentes",2020,4,7,3240,216.049382716049,0,1652,0,7,1588,440.80604534005
31902,63,63470,121,Tasa de exámenes médico legales por presunto delito sexual cuando la víctima está entre 18 y 28 años,2020,5,1,6649,15.0398556173861,1,3322,30.1023479831427,0,3327,0
31903,63,63548,81,"Tasa de exámenes médico legales por presunto delito sexual contra niños, niñas y adolescentes",2020,2,1,357,280.11204481792703,0,196,0,1,161,621.11801242236
31904,63,63548,81,"Tasa de exámenes médico legales por presunto delito sexual contra niños, niñas y adolescentes",2020,3,2,431,464.037122969838,0,236,0,2,195,1025.64102564103
31905,63,63548,81,"Tasa de exámenes médico legales por presunto delito sexual contra niños, niñas y adolescentes",2020,4,2,452,442.477876106195,1,240,416.666666666667,1,212,471.698113207547
31906,63,63548,121,Tasa de exámenes médico legales por presunto delito sexual cuando la víctima está entre 18 y 28 años,2020,5,1,762,131.233595800525,0,390,0,1,372,268.817204301075
31907,63,63594,81,"Tasa de exámenes médico legales por presunto delito sexual contra niños, niñas y adolescentes",2020,2,6,1993,301.053687907677,1,1023,97.7517106549365,5,970,515.463917525773
31908,63,63594,81,"Tasa de exámenes médico legales por presunto delito sexual contra niños, niñas y adolescentes",2020,3,8,2322,344.530577088717,2,1204,166.112956810631,6,1118,536.672629695885
31909,63,63594,81,"Tasa de exámenes médico legales por presunto delito sexual contra niños, niñas y adolescentes",2020,4,5,2520,198.412698412698,0,1294,0,5,1226,407.830342577488
31910,63,63690,81,"Tasa de exámenes médico legales por presunto delito sexual contra niños, niñas y adolescentes",2020,2,1,603,165.837479270315,0,316,0,1,287,348.432055749129
31911,63,63690,81,"Tasa de exámenes médico legales por presunto delito sexual contra niños, niñas y adolescentes",2020,3,2,716,279.329608938547,1,386,259.067357512953,1,330,303.030303030303
31912,63,63690,81,"Tasa de exámenes médico legales por presunto delito sexual contra niños, niñas y adolescentes",2020,4,3,774,387.596899224806,1,418,239.234449760766,2,356,561.797752808989
31913,66,66045,81,"Tasa de exámenes médico legales por presunto delito sexual contra niños, niñas y adolescentes",2020,2,8,785,1019.10828025478,4,402,995.02487562189,4,383,1044.3864229765
31914,66,66045,81,"Tasa de exámenes médico legales por presunto delito sexual contra niños, niñas y adolescentes",2020,3,15,1050,1428.57142857143,1,563,177.619893428064,14,487,2874.74332648871
31915,66,66045,81,"Tasa de exámenes médico legales por presunto delito sexual contra niños, niñas y adolescentes",2020,4,10,1145,873.362445414847,1,625,160,9,520,1730.76923076923
31916,66,66045,121,Tasa de exámenes médico legales por presunto delito sexual cuando la víctima está entre 18 y 28 años,2020,5,1,1899,52.6592943654555,0,996,0,1,903,110.741971207087
31917,66,66088,81,"Tasa de exámenes médico legales por presunto delito sexual contra niños, niñas y adolescentes",2020,2,3,1725,173.913043478261,1,918,108.932461873638,2,807,247.831474597274
31918,66,66088,81,"Tasa de exámenes médico legales por presunto delito sexual contra niños, niñas y adolescentes",2020,3,6,2241,267.737617135207,2,1172,170.648464163823,4,1069,374.181478016838
31919,66,66088,81,"Tasa de exámenes médico legales por presunto delito sexual contra niños, niñas y adolescentes",2020,4,6,2351,255.21054870268,2,1207,165.700082850041,4,1144,349.65034965035
31920,66,66170,81,"Tasa de exámenes médico legales por presunto delito sexual contra niños, niñas y adolescentes",2020,2,18,13966,128.884433624517,6,7021,85.4579119783507,12,6945,172.786177105832
31921,66,66170,81,"Tasa de exámenes médico legales por presunto delito sexual contra niños, niñas y adolescentes",2020,3,41,16659,246.113212077556,6,8470,70.8382526564345,35,8189,427.402613261693
31922,66,66170,81,"Tasa de exámenes médico legales por presunto delito sexual contra niños, niñas y adolescentes",2020,4,48,18096,265.25198938992,4,9144,43.7445319335083,44,8952,491.510277033065
31923,66,66170,121,Tasa de exámenes médico legales por presunto delito sexual cuando la víctima está entre 18 y 28 años,2020,5,5,39141,12.7743287090263,0,18932,0,5,20209,24.7414518283933
31924,66,66318,81,"Tasa de exámenes médico legales por presunto delito sexual contra niños, niñas y adolescentes",2020,2,2,781,256.081946222791,1,395,253.164556962025,1,386,259.067357512953
31925,66,66318,81,"Tasa de exámenes médico legales por presunto delito sexual contra niños, niñas y adolescentes",2020,3,1,1063,94.0733772342427,0,546,0,1,517,193.423597678917
31926,66,66318,81,"Tasa de exámenes médico legales por presunto delito sexual contra niños, niñas y adolescentes",2020,4,2,1164,171.821305841924,0,597,0,2,567,352.733686067019
31927,66,66400,81,"Tasa de exámenes médico legales por presunto delito sexual contra niños, niñas y adolescentes",2020,2,2,1801,111.049416990561,1,890,112.359550561798,1,911,109.769484083425
31928,66,66400,81,"Tasa de exámenes médico legales por presunto delito sexual contra niños, niñas y adolescentes",2020,3,6,2278,263.388937664618,1,1148,87.1080139372822,5,1130,442.477876106195
31929,66,66400,81,"Tasa de exámenes médico legales por presunto delito sexual contra niños, niñas y adolescentes",2020,4,6,2555,234.833659491194,0,1288,0,6,1267,473.559589581689
31930,66,66440,81,"Tasa de exámenes médico legales por presunto delito sexual contra niños, niñas y adolescentes",2020,2,3,1176,255.102040816327,1,595,168.067226890756,2,581,344.234079173838
31931,66,66440,81,"Tasa de exámenes médico legales por presunto delito sexual contra niños, niñas y adolescentes",2020,3,10,1496,668.449197860962,6,756,793.650793650794,4,740,540.540540540541
31932,66,66440,81,"Tasa de exámenes médico legales por presunto delito sexual contra niños, niñas y adolescentes",2020,4,6,1557,385.356454720617,2,791,252.844500632111,4,766,522.193211488251
31933,66,66440,121,Tasa de exámenes médico legales por presunto delito sexual cuando la víctima está entre 18 y 28 años,2020,5,1,2540,39.3700787401575,0,1284,0,1,1256,79.6178343949045
31934,66,66456,81,"Tasa de exámenes médico legales por presunto delito sexual contra niños, niñas y adolescentes",2020,2,1,2433,41.101520756268,0,1265,0,1,1168,85.6164383561644
31935,66,66456,81,"Tasa de exámenes médico legales por presunto delito sexual contra niños, niñas y adolescentes",2020,3,2,2513,79.5861520095503,0,1284,0,2,1229,162.73393002441
31936,66,66456,81,"Tasa de exámenes médico legales por presunto delito sexual contra niños, niñas y adolescentes",2020,4,2,2101,95.1927653498334,0,1055,0,2,1046,191.204588910134
31937,66,66001,81,"Tasa de exámenes médico legales por presunto delito sexual contra niños, niñas y adolescentes",2020,2,52,28830,180.367672563302,11,14824,74.2039935240151,41,14006,292.731686420106
31938,66,66001,81,"Tasa de exámenes médico legales por presunto delito sexual contra niños, niñas y adolescentes",2020,3,114,34620,329.289428076257,25,17772,140.670717983345,89,16848,528.252611585945
31939,66,66001,81,"Tasa de exámenes médico legales por presunto delito sexual contra niños, niñas y adolescentes",2020,4,129,38270,337.078651685393,17,19441,87.4440615194692,112,18829,594.827128365819
31940,66,66001,121,Tasa de exámenes médico legales por presunto delito sexual cuando la víctima está entre 18 y 28 años,2020,5,31,84211,36.8122929308523,3,41627,7.20686093160689,28,42584,65.7523952658275
31941,66,66001,81,"Tasa de exámenes médico legales por presunto delito sexual contra niños, niñas y adolescentes",2020,1,1,5638,17.7367860943597,0,2896,0,1,2742,36.4697301239971
31942,66,66572,81,"Tasa de exámenes médico legales por presunto delito sexual contra niños, niñas y adolescentes",2020,3,2,2711,73.7735153080044,1,1415,70.6713780918728,1,1296,77.1604938271605
31943,66,66572,81,"Tasa de exámenes médico legales por presunto delito sexual contra niños, niñas y adolescentes",2020,4,3,1973,152.05271160669,1,1041,96.0614793467819,2,932,214.592274678112
31944,66,66594,81,"Tasa de exámenes médico legales por presunto delito sexual contra niños, niñas y adolescentes",2020,3,2,2673,74.8222970445193,0,1390,0,2,1283,155.884645362432
31945,66,66594,81,"Tasa de exámenes médico legales por presunto delito sexual contra niños, niñas y adolescentes",2020,4,3,2728,109.970674486804,0,1409,0,3,1319,227.445034116755
31946,66,66594,121,Tasa de exámenes médico legales por presunto delito sexual cuando la víctima está entre 18 y 28 años,2020,5,1,4307,23.2180171813327,0,2198,0,1,2109,47.4158368895211
31947,66,66682,81,"Tasa de exámenes médico legales por presunto delito sexual contra niños, niñas y adolescentes",2020,2,7,4764,146.935348446683,1,2459,40.6669377795852,6,2305,260.303687635575
31948,66,66682,81,"Tasa de exámenes médico legales por presunto delito sexual contra niños, niñas y adolescentes",2020,3,5,6071,82.3587547356284,1,3128,31.9693094629156,4,2943,135.915732246007
31949,66,66682,81,"Tasa de exámenes médico legales por presunto delito sexual contra niños, niñas y adolescentes",2020,4,7,6790,103.092783505155,0,3471,0,7,3319,210.906899668575
31950,66,66682,121,Tasa de exámenes médico legales por presunto delito sexual cuando la víctima está entre 18 y 28 años,2020,5,1,13447,7.43660295976798,0,6733,0,1,6714,14.8942508191838
31951,66,66687,81,"Tasa de exámenes médico legales por presunto delito sexual contra niños, niñas y adolescentes",2020,2,2,777,257.400257400257,0,398,0,2,379,527.704485488127
31952,66,66687,81,"Tasa de exámenes médico legales por presunto delito sexual contra niños, niñas y adolescentes",2020,3,5,1093,457.456541628545,0,566,0,5,527,948.76660341556
31953,66,66687,81,"Tasa de exámenes médico legales por presunto delito sexual contra niños, niñas y adolescentes",2020,4,3,1216,246.710526315789,1,635,157.48031496063,2,581,344.234079173838
31954,66,66687,121,Tasa de exámenes médico legales por presunto delito sexual cuando la víctima está entre 18 y 28 años,2020,5,2,1826,109.529025191676,0,920,0,2,906,220.75055187638
31955,68,68051,81,"Tasa de exámenes médico legales por presunto delito sexual contra niños, niñas y adolescentes",2020,2,3,616,487.012987012987,2,302,662.251655629139,1,314,318.471337579618
31956,68,68051,81,"Tasa de exámenes médico legales por presunto delito sexual contra niños, niñas y adolescentes",2020,3,2,796,251.256281407035,1,398,251.256281407035,1,398,251.256281407035
31957,68,68077,81,"Tasa de exámenes médico legales por presunto delito sexual contra niños, niñas y adolescentes",2020,3,5,3038,164.581961816985,0,1586,0,5,1452,344.35261707989
31958,68,68077,81,"Tasa de exámenes médico legales por presunto delito sexual contra niños, niñas y adolescentes",2020,4,9,3205,280.811232449298,0,1644,0,9,1561,576.553491351698
31959,68,68077,121,Tasa de exámenes médico legales por presunto delito sexual cuando la víctima está entre 18 y 28 años,2020,5,2,5705,35.056967572305,0,2810,0,2,2895,69.0846286701209
31960,68,68079,81,"Tasa de exámenes médico legales por presunto delito sexual contra niños, niñas y adolescentes",2020,2,1,794,125.944584382872,0,399,0,1,395,253.164556962025
31961,68,68079,81,"Tasa de exámenes médico legales por presunto delito sexual contra niños, niñas y adolescentes",2020,3,1,958,104.384133611691,0,472,0,1,486,205.761316872428
31962,68,68079,81,"Tasa de exámenes médico legales por presunto delito sexual contra niños, niñas y adolescentes",2020,4,2,951,210.304942166141,0,474,0,2,477,419.287211740042
31963,68,68081,81,"Tasa de exámenes médico legales por presunto delito sexual contra niños, niñas y adolescentes",2020,2,6,18332,32.7296530656775,3,9315,32.2061191626409,3,9017,33.2704890761894
31964,68,68081,81,"Tasa de exámenes médico legales por presunto delito sexual contra niños, niñas y adolescentes",2020,3,25,21087,118.556456584626,4,10780,37.1057513914657,21,10307,203.745027651111
31965,68,68081,81,"Tasa de exámenes médico legales por presunto delito sexual contra niños, niñas y adolescentes",2020,4,52,20179,257.693641904951,0,10391,0,52,9788,531.262770739681
31966,68,68081,121,Tasa de exámenes médico legales por presunto delito sexual cuando la víctima está entre 18 y 28 años,2020,5,20,38353,52.147159283498,3,19245,15.5884645362432,17,19108,88.9679715302491
31967,68,68092,81,"Tasa de exámenes médico legales por presunto delito sexual contra niños, niñas y adolescentes",2020,2,1,548,182.481751824818,1,293,341.296928327645,0,255,0
31968,68,68092,81,"Tasa de exámenes médico legales por presunto delito sexual contra niños, niñas y adolescentes",2020,3,2,658,303.951367781155,0,343,0,2,315,634.920634920635
31969,68,68092,81,"Tasa de exámenes médico legales por presunto delito sexual contra niños, niñas y adolescentes",2020,4,3,631,475.435816164818,0,333,0,3,298,1006.71140939597
31970,68,68092,121,Tasa de exámenes médico legales por presunto delito sexual cuando la víctima está entre 18 y 28 años,2020,5,2,1008,198.412698412698,0,542,0,2,466,429.184549356223
31971,68,68101,81,"Tasa de exámenes médico legales por presunto delito sexual contra niños, niñas y adolescentes",2020,2,1,758,131.926121372032,0,398,0,1,360,277.777777777778
31972,68,68101,81,"Tasa de exámenes médico legales por presunto delito sexual contra niños, niñas y adolescentes",2020,3,1,1098,91.0746812386157,0,572,0,1,526,190.114068441065
31973,68,68001,81,"Tasa de exámenes médico legales por presunto delito sexual contra niños, niñas y adolescentes",2020,2,22,38970,56.4536823197331,6,19860,30.2114803625378,16,19110,83.7257980115123
31974,68,68001,81,"Tasa de exámenes médico legales por presunto delito sexual contra niños, niñas y adolescentes",2020,3,53,46601,113.731464990022,10,23733,42.1354232503265,43,22868,188.035683050551
31975,68,68001,81,"Tasa de exámenes médico legales por presunto delito sexual contra niños, niñas y adolescentes",2020,4,80,50368,158.831003811944,4,25613,15.6170694569164,76,24755,307.008685114118
31976,68,68001,121,Tasa de exámenes médico legales por presunto delito sexual cuando la víctima está entre 18 y 28 años,2020,5,21,117109,17.9320120571433,1,58901,1.69776404475306,20,58208,34.3595382078065
31977,68,68147,81,"Tasa de exámenes médico legales por presunto delito sexual contra niños, niñas y adolescentes",2020,4,2,519,385.356454720617,0,281,0,2,238,840.336134453781
31978,68,68160,81,"Tasa de exámenes médico legales por presunto delito sexual contra niños, niñas y adolescentes",2020,3,1,197,507.614213197969,0,95,0,1,102,980.392156862745
31979,68,68160,81,"Tasa de exámenes médico legales por presunto delito sexual contra niños, niñas y adolescentes",2020,4,1,209,478.468899521531,0,102,0,1,107,934.579439252336
31980,68,68162,81,"Tasa de exámenes médico legales por presunto delito sexual contra niños, niñas y adolescentes",2020,3,1,690,144.927536231884,0,354,0,1,336,297.619047619048
31981,68,68162,81,"Tasa de exámenes médico legales por presunto delito sexual contra niños, niñas y adolescentes",2020,4,3,680,441.176470588235,0,362,0,3,318,943.396226415094
31982,68,68167,81,"Tasa de exámenes médico legales por presunto delito sexual contra niños, niñas y adolescentes",2020,3,1,1153,86.7302688638335,0,599,0,1,554,180.505415162455
31983,68,68167,81,"Tasa de exámenes médico legales por presunto delito sexual contra niños, niñas y adolescentes",2020,4,1,1150,86.9565217391304,0,610,0,1,540,185.185185185185
31984,68,68169,81,"Tasa de exámenes médico legales por presunto delito sexual contra niños, niñas y adolescentes",2020,2,1,222,450.45045045045,0,112,0,1,110,909.090909090909
31985,68,68169,81,"Tasa de exámenes médico legales por presunto delito sexual contra niños, niñas y adolescentes",2020,3,1,237,421.940928270042,0,117,0,1,120,833.333333333333
31986,68,68169,121,Tasa de exámenes médico legales por presunto delito sexual cuando la víctima está entre 18 y 28 años,2020,5,1,436,229.357798165138,0,229,0,1,207,483.091787439613
31987,68,68176,81,"Tasa de exámenes médico legales por presunto delito sexual contra niños, niñas y adolescentes",2020,4,1,282,354.609929078014,1,138,724.63768115942,0,144,0
31988,68,68190,81,"Tasa de exámenes médico legales por presunto delito sexual contra niños, niñas y adolescentes",2020,2,1,2840,35.2112676056338,1,1447,69.1085003455425,0,1393,0
31989,68,68190,81,"Tasa de exámenes médico legales por presunto delito sexual contra niños, niñas y adolescentes",2020,3,14,3635,385.144429160935,3,1830,163.934426229508,11,1805,609.418282548476
31990,68,68190,81,"Tasa de exámenes médico legales por presunto delito sexual contra niños, niñas y adolescentes",2020,4,15,3715,403.768506056528,0,1847,0,15,1868,802.997858672377
31991,68,68190,121,Tasa de exámenes médico legales por presunto delito sexual cuando la víctima está entre 18 y 28 años,2020,5,3,7137,42.0344682639765,0,4046,0,3,3091,97.0559689420899
31992,68,68207,81,"Tasa de exámenes médico legales por presunto delito sexual contra niños, niñas y adolescentes",2020,4,1,559,178.890876565295,0,276,0,1,283,353.356890459364
31993,68,68217,81,"Tasa de exámenes médico legales por presunto delito sexual contra niños, niñas y adolescentes",2020,2,1,433,230.94688221709,0,235,0,1,198,505.050505050505
31994,68,68217,81,"Tasa de exámenes médico legales por presunto delito sexual contra niños, niñas y adolescentes",2020,3,2,511,391.389432485323,0,276,0,2,235,851.063829787234
31995,68,68229,81,"Tasa de exámenes médico legales por presunto delito sexual contra niños, niñas y adolescentes",2020,3,3,1269,236.406619385343,0,633,0,3,636,471.698113207547
31996,68,68229,81,"Tasa de exámenes médico legales por presunto delito sexual contra niños, niñas y adolescentes",2020,4,4,1274,313.971742543171,2,636,314.465408805031,2,638,313.479623824451
31997,68,68235,81,"Tasa de exámenes médico legales por presunto delito sexual contra niños, niñas y adolescentes",2020,2,1,1870,53.475935828877,0,934,0,1,936,106.837606837607
31998,68,68235,81,"Tasa de exámenes médico legales por presunto delito sexual contra niños, niñas y adolescentes",2020,3,3,2399,125.052105043768,0,1206,0,3,1193,251.466890192791
31999,68,68235,81,"Tasa de exámenes médico legales por presunto delito sexual contra niños, niñas y adolescentes",2020,4,8,2466,324.41200324412,0,1267,0,8,1199,667.222685571309
32000,68,68235,121,Tasa de exámenes médico legales por presunto delito sexual cuando la víctima está entre 18 y 28 años,2020,5,3,3784,79.2811839323467,0,1971,0,3,1813,165.471594043023
32001,68,68250,121,Tasa de exámenes médico legales por presunto delito sexual cuando la víctima está entre 18 y 28 años,2020,5,2,974,205.338809034908,0,542,0,2,432,462.962962962963
32002,68,68255,81,"Tasa de exámenes médico legales por presunto delito sexual contra niños, niñas y adolescentes",2020,2,2,1212,165.016501650165,0,620,0,2,592,337.837837837838
32003,68,68255,81,"Tasa de exámenes médico legales por presunto delito sexual contra niños, niñas y adolescentes",2020,3,4,1518,263.504611330698,1,795,125.786163522013,3,723,414.9377593361
32004,68,68255,81,"Tasa de exámenes médico legales por presunto delito sexual contra niños, niñas y adolescentes",2020,4,3,1563,191.938579654511,1,824,121.359223300971,2,739,270.63599458728
32005,68,68255,121,Tasa de exámenes médico legales por presunto delito sexual cuando la víctima está entre 18 y 28 años,2020,5,1,2462,40.6173842404549,0,1273,0,1,1189,84.1042893187552
32006,68,68264,81,"Tasa de exámenes médico legales por presunto delito sexual contra niños, niñas y adolescentes",2020,2,3,235,1276.59574468085,0,128,0,3,107,2803.73831775701
32007,68,68271,81,"Tasa de exámenes médico legales por presunto delito sexual contra niños, niñas y adolescentes",2020,3,1,589,169.779286926995,0,305,0,1,284,352.112676056338
32008,68,68276,81,"Tasa de exámenes médico legales por presunto delito sexual contra niños, niñas y adolescentes",2020,2,16,20447,78.251088179195,3,10500,28.5714285714286,13,9947,130.692671157133
32009,68,68276,81,"Tasa de exámenes médico legales por presunto delito sexual contra niños, niñas y adolescentes",2020,3,19,24528,77.4624918460535,4,12556,31.8572793883402,15,11972,125.292348813899
32010,68,68276,81,"Tasa de exámenes médico legales por presunto delito sexual contra niños, niñas y adolescentes",2020,4,24,26089,91.9927938978113,1,13159,7.5993616536211,23,12930,177.880897138438
32011,68,68296,81,"Tasa de exámenes médico legales por presunto delito sexual contra niños, niñas y adolescentes",2020,4,1,257,389.105058365759,0,142,0,1,115,869.565217391304
32012,68,68298,81,"Tasa de exámenes médico legales por presunto delito sexual contra niños, niñas y adolescentes",2020,3,4,436,917.431192660551,0,227,0,4,209,1913.87559808612
32013,68,68298,81,"Tasa de exámenes médico legales por presunto delito sexual contra niños, niñas y adolescentes",2020,4,1,416,240.384615384615,0,227,0,1,189,529.100529100529
32014,68,68307,81,"Tasa de exámenes médico legales por presunto delito sexual contra niños, niñas y adolescentes",2020,2,3,13069,22.9550845512281,0,6699,0,3,6370,47.0957613814757
32015,68,68307,81,"Tasa de exámenes médico legales por presunto delito sexual contra niños, niñas y adolescentes",2020,3,20,15419,129.710097931124,4,7874,50.8001016002032,16,7545,212.060967528164
32016,68,68307,81,"Tasa de exámenes médico legales por presunto delito sexual contra niños, niñas y adolescentes",2020,4,24,15755,152.332592827674,2,7964,25.1130085384229,22,7791,282.37710178411
32017,68,68307,121,Tasa de exámenes médico legales por presunto delito sexual cuando la víctima está entre 18 y 28 años,2020,5,2,33666,5.94071169726133,1,16851,5.9343659130022,1,16815,5.94707106749926
32018,68,68318,81,"Tasa de exámenes médico legales por presunto delito sexual contra niños, niñas y adolescentes",2020,3,1,584,171.232876712329,0,287,0,1,297,336.700336700337
32019,68,68318,81,"Tasa de exámenes médico legales por presunto delito sexual contra niños, niñas y adolescentes",2020,4,1,606,165.016501650165,0,316,0,1,290,344.827586206897
32020,68,68320,81,"Tasa de exámenes médico legales por presunto delito sexual contra niños, niñas y adolescentes",2020,2,1,269,371.747211895911,0,140,0,1,129,775.193798449612
32021,68,68320,81,"Tasa de exámenes médico legales por presunto delito sexual contra niños, niñas y adolescentes",2020,4,2,451,443.458980044346,0,229,0,2,222,900.900900900901
32022,68,68322,81,"Tasa de exámenes médico legales por presunto delito sexual contra niños, niñas y adolescentes",2020,4,1,238,420.168067226891,0,103,0,1,135,740.740740740741
32023,68,68324,81,"Tasa de exámenes médico legales por presunto delito sexual contra niños, niñas y adolescentes",2020,4,2,368,543.478260869565,0,174,0,2,194,1030.92783505155
32024,68,68327,81,"Tasa de exámenes médico legales por presunto delito sexual contra niños, niñas y adolescentes",2020,3,6,460,1304.34782608696,3,242,1239.6694214876,3,218,1376.14678899083
32025,68,68327,81,"Tasa de exámenes médico legales por presunto delito sexual contra niños, niñas y adolescentes",2020,4,3,506,592.885375494071,0,256,0,3,250,1200
32026,68,68368,121,Tasa de exámenes médico legales por presunto delito sexual cuando la víctima está entre 18 y 28 años,2020,5,1,437,228.83295194508,0,242,0,1,195,512.820512820513
32027,68,68377,81,"Tasa de exámenes médico legales por presunto delito sexual contra niños, niñas y adolescentes",2020,3,1,611,163.66612111293,0,309,0,1,302,331.12582781457
32028,68,68377,81,"Tasa de exámenes médico legales por presunto delito sexual contra niños, niñas y adolescentes",2020,4,1,660,151.515151515152,0,342,0,1,318,314.465408805031
32029,68,68397,81,"Tasa de exámenes médico legales por presunto delito sexual contra niños, niñas y adolescentes",2020,2,1,279,358.4229390681,0,144,0,1,135,740.740740740741
32030,68,68397,81,"Tasa de exámenes médico legales por presunto delito sexual contra niños, niñas y adolescentes",2020,4,1,475,210.526315789474,0,255,0,1,220,454.545454545455
32031,68,68385,81,"Tasa de exámenes médico legales por presunto delito sexual contra niños, niñas y adolescentes",2020,3,5,1088,459.558823529412,0,568,0,5,520,961.538461538462
32032,68,68385,81,"Tasa de exámenes médico legales por presunto delito sexual contra niños, niñas y adolescentes",2020,4,2,1137,175.901495162709,0,589,0,2,548,364.963503649635
32033,68,68385,121,Tasa de exámenes médico legales por presunto delito sexual cuando la víctima está entre 18 y 28 años,2020,5,2,1621,123.380629241209,0,859,0,2,762,262.46719160105
32034,68,68406,81,"Tasa de exámenes médico legales por presunto delito sexual contra niños, niñas y adolescentes",2020,2,2,3571,56.0067208064968,0,1815,0,2,1756,113.895216400911
32035,68,68406,81,"Tasa de exámenes médico legales por presunto delito sexual contra niños, niñas y adolescentes",2020,3,5,4308,116.063138347261,0,2183,0,5,2125,235.294117647059
32036,68,68406,81,"Tasa de exámenes médico legales por presunto delito sexual contra niños, niñas y adolescentes",2020,4,2,4387,45.5892409391384,0,2236,0,2,2151,92.9800092980009
32037,68,68406,121,Tasa de exámenes médico legales por presunto delito sexual cuando la víctima está entre 18 y 28 años,2020,5,1,8557,11.6863386700947,0,4408,0,1,4149,24.1021932995903
32038,68,68418,81,"Tasa de exámenes médico legales por presunto delito sexual contra niños, niñas y adolescentes",2020,3,2,1544,129.533678756477,0,794,0,2,750,266.666666666667
32039,68,68418,81,"Tasa de exámenes médico legales por presunto delito sexual contra niños, niñas y adolescentes",2020,4,2,1540,129.87012987013,0,784,0,2,756,264.550264550265
32040,68,68425,81,"Tasa de exámenes médico legales por presunto delito sexual contra niños, niñas y adolescentes",2020,4,1,219,456.62100456621,0,116,0,1,103,970.873786407767
32041,68,68432,81,"Tasa de exámenes médico legales por presunto delito sexual contra niños, niñas y adolescentes",2020,2,2,1496,133.689839572193,1,779,128.369704749679,1,717,139.470013947001
32042,68,68432,81,"Tasa de exámenes médico legales por presunto delito sexual contra niños, niñas y adolescentes",2020,3,2,2021,98.9609104403761,2,1040,192.307692307692,0,981,0
32043,68,68432,81,"Tasa de exámenes médico legales por presunto delito sexual contra niños, niñas y adolescentes",2020,4,3,2222,135.013501350135,1,1138,87.8734622144112,2,1084,184.50184501845
32044,68,68444,121,Tasa de exámenes médico legales por presunto delito sexual cuando la víctima está entre 18 y 28 años,2020,5,1,737,135.685210312076,1,377,265.25198938992,0,360,0
32045,68,68464,81,"Tasa de exámenes médico legales por presunto delito sexual contra niños, niñas y adolescentes",2020,3,2,1163,171.969045571797,1,586,170.648464163823,1,577,173.310225303293
32046,68,68464,81,"Tasa de exámenes médico legales por presunto delito sexual contra niños, niñas y adolescentes",2020,4,3,1125,266.666666666667,0,576,0,3,549,546.448087431694
32047,68,68498,81,"Tasa de exámenes médico legales por presunto delito sexual contra niños, niñas y adolescentes",2020,4,1,587,170.357751277683,0,309,0,1,278,359.712230215827
32048,68,68500,81,"Tasa de exámenes médico legales por presunto delito sexual contra niños, niñas y adolescentes",2020,2,1,800,125,0,411,0,1,389,257.06940874036
32049,68,68500,81,"Tasa de exámenes médico legales por presunto delito sexual contra niños, niñas y adolescentes",2020,3,5,1051,475.737392959087,0,545,0,5,506,988.142292490119
32050,68,68500,81,"Tasa de exámenes médico legales por presunto delito sexual contra niños, niñas y adolescentes",2020,4,1,1102,90.7441016333938,0,569,0,1,533,187.617260787993
32051,68,68502,81,"Tasa de exámenes médico legales por presunto delito sexual contra niños, niñas y adolescentes",2020,3,1,370,270.27027027027,0,202,0,1,168,595.238095238095
32052,68,68502,121,Tasa de exámenes médico legales por presunto delito sexual cuando la víctima está entre 18 y 28 años,2020,5,1,539,185.528756957328,0,295,0,1,244,409.83606557377
32053,68,68524,81,"Tasa de exámenes médico legales por presunto delito sexual contra niños, niñas y adolescentes",2020,4,1,249,401.606425702811,0,132,0,1,117,854.700854700855
32054,68,68533,81,"Tasa de exámenes médico legales por presunto delito sexual contra niños, niñas y adolescentes",2020,3,1,494,202.429149797571,0,259,0,1,235,425.531914893617
32055,68,68533,121,Tasa de exámenes médico legales por presunto delito sexual cuando la víctima está entre 18 y 28 años,2020,5,1,839,119.189511323004,0,435,0,1,404,247.524752475248
32056,68,68547,81,"Tasa de exámenes médico legales por presunto delito sexual contra niños, niñas y adolescentes",2020,2,3,13699,21.8994087159647,1,7053,14.1783638168155,2,6646,30.0932891965092
32057,68,68547,81,"Tasa de exámenes médico legales por presunto delito sexual contra niños, niñas y adolescentes",2020,3,20,16370,122.174709835064,3,8426,35.6040826014716,17,7944,213.997985901309
32058,68,68547,81,"Tasa de exámenes médico legales por presunto delito sexual contra niños, niñas y adolescentes",2020,4,19,16827,112.913769537054,1,8618,11.6036203295428,18,8209,219.271531246193
32059,68,68547,121,Tasa de exámenes médico legales por presunto delito sexual cuando la víctima está entre 18 y 28 años,2020,5,5,34601,14.4504494089766,2,17275,11.5774240231548,3,17326,17.3150178921852
32060,68,68549,81,"Tasa de exámenes médico legales por presunto delito sexual contra niños, niñas y adolescentes",2020,2,1,359,278.551532033426,0,200,0,1,159,628.930817610063
32061,68,68549,81,"Tasa de exámenes médico legales por presunto delito sexual contra niños, niñas y adolescentes",2020,3,1,466,214.592274678112,1,257,389.105058365759,0,209,0
32062,68,68549,81,"Tasa de exámenes médico legales por presunto delito sexual contra niños, niñas y adolescentes",2020,4,1,501,199.600798403194,0,269,0,1,232,431.034482758621
32063,68,68572,81,"Tasa de exámenes médico legales por presunto delito sexual contra niños, niñas y adolescentes",2020,3,2,1264,158.227848101266,0,640,0,2,624,320.51282051282
32064,68,68572,81,"Tasa de exámenes médico legales por presunto delito sexual contra niños, niñas y adolescentes",2020,4,1,1431,69.8812019566736,0,747,0,1,684,146.198830409357
32065,68,68573,81,"Tasa de exámenes médico legales por presunto delito sexual contra niños, niñas y adolescentes",2020,3,2,978,204.498977505112,0,487,0,2,491,407.331975560081
32066,68,68573,81,"Tasa de exámenes médico legales por presunto delito sexual contra niños, niñas y adolescentes",2020,4,5,852,586.854460093897,0,422,0,5,430,1162.79069767442
32067,68,68575,81,"Tasa de exámenes médico legales por presunto delito sexual contra niños, niñas y adolescentes",2020,2,4,3507,114.057599087539,0,1814,0,4,1693,236.266981689309
32068,68,68575,81,"Tasa de exámenes médico legales por presunto delito sexual contra niños, niñas y adolescentes",2020,3,4,4090,97.799511002445,1,2121,47.1475719000471,3,1969,152.361604875571
32069,68,68575,81,"Tasa de exámenes médico legales por presunto delito sexual contra niños, niñas y adolescentes",2020,4,11,3779,291.082296903943,1,1969,50.7872016251904,10,1810,552.486187845304
32070,68,68575,121,Tasa de exámenes médico legales por presunto delito sexual cuando la víctima está entre 18 y 28 años,2020,5,6,5969,100.51934997487,2,3012,66.4010624169987,4,2957,135.27223537369
32071,68,68615,81,"Tasa de exámenes médico legales por presunto delito sexual contra niños, niñas y adolescentes",2020,2,1,2289,43.6871996505024,0,1195,0,1,1094,91.4076782449726
32072,68,68615,81,"Tasa de exámenes médico legales por presunto delito sexual contra niños, niñas y adolescentes",2020,3,1,2752,36.3372093023256,0,1430,0,1,1322,75.642965204236
32073,68,68615,81,"Tasa de exámenes médico legales por presunto delito sexual contra niños, niñas y adolescentes",2020,4,3,2685,111.731843575419,0,1414,0,3,1271,236.0346184107
32074,68,68615,121,Tasa de exámenes médico legales por presunto delito sexual cuando la víctima está entre 18 y 28 años,2020,5,1,4449,22.4769611148573,0,2343,0,1,2106,47.4833808167142
32075,68,68655,81,"Tasa de exámenes médico legales por presunto delito sexual contra niños, niñas y adolescentes",2020,2,1,3594,27.8241513633834,1,1851,54.0248514316586,0,1743,0
32076,68,68655,81,"Tasa de exámenes médico legales por presunto delito sexual contra niños, niñas y adolescentes",2020,3,10,4054,246.669955599408,3,2075,144.578313253012,7,1979,353.713996968166
32077,68,68655,81,"Tasa de exámenes médico legales por presunto delito sexual contra niños, niñas y adolescentes",2020,4,15,3659,409.948073244056,1,1855,53.9083557951483,14,1804,776.053215077605
32078,68,68655,121,Tasa de exámenes médico legales por presunto delito sexual cuando la víctima está entre 18 y 28 años,2020,5,3,6307,47.5661962898367,0,3161,0,3,3146,95.3591862682772
32079,68,68669,81,"Tasa de exámenes médico legales por presunto delito sexual contra niños, niñas y adolescentes",2020,3,3,762,393.700787401575,0,407,0,3,355,845.070422535211
32080,68,68669,121,Tasa de exámenes médico legales por presunto delito sexual cuando la víctima está entre 18 y 28 años,2020,5,1,1182,84.6023688663282,0,635,0,1,547,182.815356489945
32081,68,68679,81,"Tasa de exámenes médico legales por presunto delito sexual contra niños, niñas y adolescentes",2020,2,3,4298,69.7999069334574,2,2183,91.6170407695831,1,2115,47.2813238770686
32082,68,68679,81,"Tasa de exámenes médico legales por presunto delito sexual contra niños, niñas y adolescentes",2020,3,9,5165,174.249757986447,3,2621,114.46012972148,6,2544,235.849056603774
32083,68,68679,81,"Tasa de exámenes médico legales por presunto delito sexual contra niños, niñas y adolescentes",2020,4,10,5256,190.258751902588,0,2641,0,10,2615,382.409177820268
32084,68,68679,121,Tasa de exámenes médico legales por presunto delito sexual cuando la víctima está entre 18 y 28 años,2020,5,1,10633,9.40468353239913,0,5212,0,1,5421,18.4467810367091
32085,68,68684,81,"Tasa de exámenes médico legales por presunto delito sexual contra niños, niñas y adolescentes",2020,3,1,374,267.379679144385,1,193,518.134715025907,0,181,0
32086,68,68689,81,"Tasa de exámenes médico legales por presunto delito sexual contra niños, niñas y adolescentes",2020,2,3,2619,114.54753722795,1,1353,73.909830007391,2,1266,157.977883096366
32087,68,68689,81,"Tasa de exámenes médico legales por presunto delito sexual contra niños, niñas y adolescentes",2020,3,10,3387,295.246530853262,4,1759,227.40193291643,6,1628,368.550368550369
32088,68,68689,81,"Tasa de exámenes médico legales por presunto delito sexual contra niños, niñas y adolescentes",2020,4,7,3575,195.804195804196,0,1904,0,7,1671,418.910831837223
32089,68,68689,121,Tasa de exámenes médico legales por presunto delito sexual cuando la víctima está entre 18 y 28 años,2020,5,1,5794,17.2592336900242,1,3116,32.0924261874198,0,2678,0
32090,68,68705,121,Tasa de exámenes médico legales por presunto delito sexual cuando la víctima está entre 18 y 28 años,2020,5,1,402,248.756218905473,0,223,0,1,179,558.659217877095
32091,68,68720,81,"Tasa de exámenes médico legales por presunto delito sexual contra niños, niñas y adolescentes",2020,3,3,386,777.20207253886,0,195,0,3,191,1570.68062827225
32092,68,68755,81,"Tasa de exámenes médico legales por presunto delito sexual contra niños, niñas y adolescentes",2020,3,3,2770,108.303249097473,1,1378,72.5689404934688,2,1392,143.67816091954
32093,68,68755,121,Tasa de exámenes médico legales por presunto delito sexual cuando la víctima está entre 18 y 28 años,2020,5,1,6340,15.7728706624606,0,3329,0,1,3011,33.2115576220525
32094,68,68770,81,"Tasa de exámenes médico legales por presunto delito sexual contra niños, niñas y adolescentes",2020,2,1,685,145.985401459854,0,350,0,1,335,298.507462686567
32095,68,68770,81,"Tasa de exámenes médico legales por presunto delito sexual contra niños, niñas y adolescentes",2020,3,5,901,554.938956714761,1,473,211.416490486258,4,428,934.579439252336
32096,68,68770,81,"Tasa de exámenes médico legales por presunto delito sexual contra niños, niñas y adolescentes",2020,4,12,942,1273.88535031847,0,502,0,12,440,2727.27272727273
32097,68,68773,81,"Tasa de exámenes médico legales por presunto delito sexual contra niños, niñas y adolescentes",2020,3,1,693,144.300144300144,0,378,0,1,315,317.460317460317
32098,68,68820,81,"Tasa de exámenes médico legales por presunto delito sexual contra niños, niñas y adolescentes",2020,2,2,658,303.951367781155,0,363,0,2,295,677.966101694915
32099,68,68820,81,"Tasa de exámenes médico legales por presunto delito sexual contra niños, niñas y adolescentes",2020,3,4,786,508.905852417303,0,408,0,4,378,1058.20105820106
32100,68,68820,81,"Tasa de exámenes médico legales por presunto delito sexual contra niños, niñas y adolescentes",2020,4,1,784,127.551020408163,0,392,0,1,392,255.102040816327
32101,68,68855,81,"Tasa de exámenes médico legales por presunto delito sexual contra niños, niñas y adolescentes",2020,2,1,482,207.46887966805,1,227,440.528634361234,0,255,0
32102,68,68855,81,"Tasa de exámenes médico legales por presunto delito sexual contra niños, niñas y adolescentes",2020,3,3,613,489.396411092985,1,307,325.732899022801,2,306,653.59477124183
32103,68,68855,81,"Tasa de exámenes médico legales por presunto delito sexual contra niños, niñas y adolescentes",2020,4,1,639,156.494522691706,0,338,0,1,301,332.225913621262
32104,68,68855,121,Tasa de exámenes médico legales por presunto delito sexual cuando la víctima está entre 18 y 28 años,2020,5,1,1070,93.4579439252336,0,563,0,1,507,197.23865877712
32105,68,68861,81,"Tasa de exámenes médico legales por presunto delito sexual contra niños, niñas y adolescentes",2020,4,2,2251,88.8494002665482,0,1148,0,2,1103,181.323662737987
32106,68,68861,121,Tasa de exámenes médico legales por presunto delito sexual cuando la víctima está entre 18 y 28 años,2020,5,1,5096,19.6232339089482,0,3281,0,1,1815,55.0964187327824
32107,68,68872,81,"Tasa de exámenes médico legales por presunto delito sexual contra niños, niñas y adolescentes",2020,2,3,552,543.478260869565,1,305,327.868852459016,2,247,809.716599190283
32108,68,68872,81,"Tasa de exámenes médico legales por presunto delito sexual contra niños, niñas y adolescentes",2020,3,1,719,139.082058414465,1,379,263.852242744063,0,340,0
32109,68,68895,81,"Tasa de exámenes médico legales por presunto delito sexual contra niños, niñas y adolescentes",2020,3,1,927,107.874865156419,0,478,0,1,449,222.71714922049
32110,68,68895,81,"Tasa de exámenes médico legales por presunto delito sexual contra niños, niñas y adolescentes",2020,4,1,899,111.234705228031,0,480,0,1,419,238.663484486874
32113,70,70110,81,"Tasa de exámenes médico legales por presunto delito sexual contra niños, niñas y adolescentes",2020,3,1,1208,82.7814569536424,0,592,0,1,616,162.337662337662
32114,70,70110,81,"Tasa de exámenes médico legales por presunto delito sexual contra niños, niñas y adolescentes",2020,4,1,1211,82.5763831544178,0,587,0,1,624,160.25641025641
32115,70,70230,81,"Tasa de exámenes médico legales por presunto delito sexual contra niños, niñas y adolescentes",2020,3,1,483,207.03933747412,0,246,0,1,237,421.940928270042
32116,70,70204,81,"Tasa de exámenes médico legales por presunto delito sexual contra niños, niñas y adolescentes",2020,2,1,760,131.578947368421,0,402,0,1,358,279.329608938547
32117,70,70204,81,"Tasa de exámenes médico legales por presunto delito sexual contra niños, niñas y adolescentes",2020,3,1,920,108.695652173913,0,484,0,1,436,229.357798165138
32118,70,70215,81,"Tasa de exámenes médico legales por presunto delito sexual contra niños, niñas y adolescentes",2020,2,9,5501,163.606616978731,3,2759,108.735048930772,6,2742,218.818380743982
32119,70,70215,81,"Tasa de exámenes médico legales por presunto delito sexual contra niños, niñas y adolescentes",2020,3,6,6909,86.8432479374729,0,3456,0,6,3453,173.761946133797
32120,70,70215,81,"Tasa de exámenes médico legales por presunto delito sexual contra niños, niñas y adolescentes",2020,4,14,7347,190.553967605826,0,3773,0,14,3574,391.717963066592
32121,70,70215,121,Tasa de exámenes médico legales por presunto delito sexual cuando la víctima está entre 18 y 28 años,2020,5,2,12745,15.6924284032954,0,6574,0,2,6171,32.4096580781073
32122,70,70221,81,"Tasa de exámenes médico legales por presunto delito sexual contra niños, niñas y adolescentes",2020,2,5,1539,324.88628979857,2,807,247.831474597274,3,732,409.83606557377
32123,70,70221,81,"Tasa de exámenes médico legales por presunto delito sexual contra niños, niñas y adolescentes",2020,3,2,1844,108.459869848156,0,964,0,2,880,227.272727272727
32124,70,70221,81,"Tasa de exámenes médico legales por presunto delito sexual contra niños, niñas y adolescentes",2020,4,9,1899,473.9336492891,0,982,0,9,917,981.461286804798
32125,70,70233,81,"Tasa de exámenes médico legales por presunto delito sexual contra niños, niñas y adolescentes",2020,3,2,1147,174.3679163034,0,558,0,2,589,339.55857385399
32126,70,70233,81,"Tasa de exámenes médico legales por presunto delito sexual contra niños, niñas y adolescentes",2020,4,4,1150,347.826086956522,0,582,0,4,568,704.225352112676
32127,70,70235,81,"Tasa de exámenes médico legales por presunto delito sexual contra niños, niñas y adolescentes",2020,2,1,2183,45.8085203847916,1,1138,87.8734622144112,0,1045,0
32128,70,70235,81,"Tasa de exámenes médico legales por presunto delito sexual contra niños, niñas y adolescentes",2020,3,1,2668,37.4812593703148,0,1361,0,1,1307,76.5110941086458
32129,70,70235,81,"Tasa de exámenes médico legales por presunto delito sexual contra niños, niñas y adolescentes",2020,4,1,2703,36.9959304476508,0,1367,0,1,1336,74.8502994011976
32130,70,70400,81,"Tasa de exámenes médico legales por presunto delito sexual contra niños, niñas y adolescentes",2020,4,1,1456,68.6813186813187,0,752,0,1,704,142.045454545455
32131,70,70418,81,"Tasa de exámenes médico legales por presunto delito sexual contra niños, niñas y adolescentes",2020,4,2,2420,82.6446280991735,0,1243,0,2,1177,169.923534409516
32132,70,70429,81,"Tasa de exámenes médico legales por presunto delito sexual contra niños, niñas y adolescentes",2020,2,1,3809,26.2536098713573,0,1911,0,1,1898,52.6870389884089
32133,70,70429,81,"Tasa de exámenes médico legales por presunto delito sexual contra niños, niñas y adolescentes",2020,4,1,4271,23.4137204401779,0,2248,0,1,2023,49.4315373208107
32134,70,70473,81,"Tasa de exámenes médico legales por presunto delito sexual contra niños, niñas y adolescentes",2020,3,4,1679,238.237045860631,0,875,0,4,804,497.512437810945
32135,70,70473,81,"Tasa de exámenes médico legales por presunto delito sexual contra niños, niñas y adolescentes",2020,4,4,1626,246.0024600246,0,832,0,4,794,503.778337531486
32136,70,70473,121,Tasa de exámenes médico legales por presunto delito sexual cuando la víctima está entre 18 y 28 años,2020,5,1,2870,34.8432055749129,0,1379,0,1,1491,67.0690811535882
32137,70,70508,81,"Tasa de exámenes médico legales por presunto delito sexual contra niños, niñas y adolescentes",2020,3,1,2375,42.1052631578947,0,1227,0,1,1148,87.1080139372822
32138,70,70508,81,"Tasa de exámenes médico legales por presunto delito sexual contra niños, niñas y adolescentes",2020,4,1,2427,41.2031314379893,0,1278,0,1,1149,87.0322019147084
32139,70,70523,81,"Tasa de exámenes médico legales por presunto delito sexual contra niños, niñas y adolescentes",2020,3,1,1783,56.0852495793606,0,910,0,1,873,114.54753722795
32140,70,70523,81,"Tasa de exámenes médico legales por presunto delito sexual contra niños, niñas y adolescentes",2020,4,7,1833,381.887615930169,0,946,0,7,887,789.177001127396
32141,70,70670,81,"Tasa de exámenes médico legales por presunto delito sexual contra niños, niñas y adolescentes",2020,2,2,4612,43.3651344319167,0,2262,0,2,2350,85.1063829787234
32142,70,70670,81,"Tasa de exámenes médico legales por presunto delito sexual contra niños, niñas y adolescentes",2020,3,8,5442,147.004777655274,4,2739,146.038700255568,4,2703,147.983721790603
32143,70,70670,81,"Tasa de exámenes médico legales por presunto delito sexual contra niños, niñas y adolescentes",2020,4,2,5437,36.7849917233769,1,2829,35.3481795687522,1,2608,38.3435582822086
32144,70,70678,81,"Tasa de exámenes médico legales por presunto delito sexual contra niños, niñas y adolescentes",2020,3,4,3387,118.098612341305,0,1719,0,4,1668,239.808153477218
32145,70,70678,81,"Tasa de exámenes médico legales por presunto delito sexual contra niños, niñas y adolescentes",2020,4,6,3523,170.309395401646,2,1823,109.709270433352,4,1700,235.294117647059
32146,70,70702,81,"Tasa de exámenes médico legales por presunto delito sexual contra niños, niñas y adolescentes",2020,2,1,1054,94.876660341556,1,567,176.36684303351,0,487,0
32147,70,70702,81,"Tasa de exámenes médico legales por presunto delito sexual contra niños, niñas y adolescentes",2020,3,1,1370,72.992700729927,0,709,0,1,661,151.285930408472
32148,70,70702,81,"Tasa de exámenes médico legales por presunto delito sexual contra niños, niñas y adolescentes",2020,4,4,1471,271.923861318831,0,743,0,4,728,549.450549450549
32149,70,70742,81,"Tasa de exámenes médico legales por presunto delito sexual contra niños, niñas y adolescentes",2020,2,1,2598,38.4911470361817,0,1337,0,1,1261,79.3021411578113
32150,70,70742,81,"Tasa de exámenes médico legales por presunto delito sexual contra niños, niñas y adolescentes",2020,3,1,3222,31.0366232153942,0,1630,0,1,1592,62.8140703517588
32151,70,70742,81,"Tasa de exámenes médico legales por presunto delito sexual contra niños, niñas y adolescentes",2020,4,6,3316,180.940892641737,0,1690,0,6,1626,369.0036900369
32152,70,70742,121,Tasa de exámenes médico legales por presunto delito sexual cuando la víctima está entre 18 y 28 años,2020,5,2,5459,36.6367466568969,0,2796,0,2,2663,75.1032669921142
32153,70,70708,81,"Tasa de exámenes médico legales por presunto delito sexual contra niños, niñas y adolescentes",2020,3,2,7081,28.2445982205903,1,3594,27.8241513633834,1,3487,28.6779466590192
32154,70,70713,81,"Tasa de exámenes médico legales por presunto delito sexual contra niños, niñas y adolescentes",2020,2,2,5162,38.7446726075165,0,2677,0,2,2485,80.4828973843058
32155,70,70713,81,"Tasa de exámenes médico legales por presunto delito sexual contra niños, niñas y adolescentes",2020,3,1,6468,15.460729746444,1,3375,29.6296296296296,0,3093,0
32156,70,70713,81,"Tasa de exámenes médico legales por presunto delito sexual contra niños, niñas y adolescentes",2020,4,4,6473,61.7951490807972,0,3403,0,4,3070,130.293159609121
32157,70,70717,81,"Tasa de exámenes médico legales por presunto delito sexual contra niños, niñas y adolescentes",2020,2,1,1640,60.9756097560976,0,816,0,1,824,121.359223300971
32158,70,70717,81,"Tasa de exámenes médico legales por presunto delito sexual contra niños, niñas y adolescentes",2020,3,4,2013,198.708395429707,0,1025,0,4,988,404.858299595142
32159,70,70717,81,"Tasa de exámenes médico legales por presunto delito sexual contra niños, niñas y adolescentes",2020,4,4,2034,196.656833824975,0,1053,0,4,981,407.747196738022
32160,70,70820,81,"Tasa de exámenes médico legales por presunto delito sexual contra niños, niñas y adolescentes",2020,3,6,3995,150.187734668335,0,2009,0,6,1986,302.114803625378
32161,70,70820,81,"Tasa de exámenes médico legales por presunto delito sexual contra niños, niñas y adolescentes",2020,4,7,3979,175.923598894195,1,2020,49.5049504950495,6,1959,306.278713629403
32162,70,70820,121,Tasa de exámenes médico legales por presunto delito sexual cuando la víctima está entre 18 y 28 años,2020,5,1,6282,15.9184972938555,0,3100,0,1,3182,31.4267756128221
32163,70,70001,81,"Tasa de exámenes médico legales por presunto delito sexual contra niños, niñas y adolescentes",2020,2,12,24341,49.2995357627049,4,12419,32.2087124567195,8,11922,67.1028350947827
32164,70,70001,81,"Tasa de exámenes médico legales por presunto delito sexual contra niños, niñas y adolescentes",2020,3,36,29564,121.769719929644,6,15098,39.7403629619817,30,14466,207.382828701783
32165,70,70001,81,"Tasa de exámenes médico legales por presunto delito sexual contra niños, niñas y adolescentes",2020,4,54,30596,176.49365930187,2,15612,12.8106584678452,52,14984,347.036839295248
32166,70,70001,121,Tasa de exámenes médico legales por presunto delito sexual cuando la víctima está entre 18 y 28 años,2020,5,7,55960,12.5089349535382,0,27386,0,7,28574,24.4977951984321
32167,70,70001,81,"Tasa de exámenes médico legales por presunto delito sexual contra niños, niñas y adolescentes",2020,1,1,4730,21.1416490486258,0,2417,0,1,2313,43.2338953739732
32168,70,70823,81,"Tasa de exámenes médico legales por presunto delito sexual contra niños, niñas y adolescentes",2020,3,3,2371,126.528890763391,0,1225,0,3,1146,261.780104712042
32169,70,70823,81,"Tasa de exámenes médico legales por presunto delito sexual contra niños, niñas y adolescentes",2020,4,3,2445,122.699386503067,0,1261,0,3,1184,253.378378378378
32170,70,70823,121,Tasa de exámenes médico legales por presunto delito sexual cuando la víctima está entre 18 y 28 años,2020,5,1,4026,24.8385494287134,0,2038,0,1,1988,50.3018108651912
32171,73,73024,81,"Tasa de exámenes médico legales por presunto delito sexual contra niños, niñas y adolescentes",2020,3,1,402,248.756218905473,1,214,467.289719626168,0,188,0
32172,73,73024,81,"Tasa de exámenes médico legales por presunto delito sexual contra niños, niñas y adolescentes",2020,4,1,440,227.272727272727,0,239,0,1,201,497.512437810945
32173,73,73026,81,"Tasa de exámenes médico legales por presunto delito sexual contra niños, niñas y adolescentes",2020,3,2,802,249.376558603491,0,407,0,2,395,506.329113924051
32174,73,73026,81,"Tasa de exámenes médico legales por presunto delito sexual contra niños, niñas y adolescentes",2020,4,3,845,355.029585798817,0,440,0,3,405,740.740740740741
32175,73,73026,121,Tasa de exámenes médico legales por presunto delito sexual cuando la víctima está entre 18 y 28 años,2020,5,1,1343,74.4601638123604,0,690,0,1,653,153.139356814701
32176,73,73030,81,"Tasa de exámenes médico legales por presunto delito sexual contra niños, niñas y adolescentes",2020,2,2,436,458.715596330275,1,209,478.468899521531,1,227,440.528634361234
32177,73,73030,81,"Tasa de exámenes médico legales por presunto delito sexual contra niños, niñas y adolescentes",2020,3,2,593,337.268128161889,0,305,0,2,288,694.444444444444
32178,73,73030,81,"Tasa de exámenes médico legales por presunto delito sexual contra niños, niñas y adolescentes",2020,4,3,636,471.698113207547,0,341,0,3,295,1016.94915254237
32179,73,73043,81,"Tasa de exámenes médico legales por presunto delito sexual contra niños, niñas y adolescentes",2020,3,1,1127,88.7311446317658,0,566,0,1,561,178.25311942959
32180,73,73043,81,"Tasa de exámenes médico legales por presunto delito sexual contra niños, niñas y adolescentes",2020,4,3,1183,253.592561284869,0,598,0,3,585,512.820512820513
32181,73,73055,81,"Tasa de exámenes médico legales por presunto delito sexual contra niños, niñas y adolescentes",2020,4,3,1121,267.618198037467,0,596,0,3,525,571.428571428571
32182,73,73055,121,Tasa de exámenes médico legales por presunto delito sexual cuando la víctima está entre 18 y 28 años,2020,5,1,1799,55.5864369093941,0,907,0,1,892,112.107623318386
32183,73,73055,81,"Tasa de exámenes médico legales por presunto delito sexual contra niños, niñas y adolescentes",2020,1,1,146,684.931506849315,0,80,0,1,66,1515.15151515152
32184,73,73067,81,"Tasa de exámenes médico legales por presunto delito sexual contra niños, niñas y adolescentes",2020,2,2,1952,102.459016393443,0,995,0,2,957,208.986415882968
32185,73,73067,81,"Tasa de exámenes médico legales por presunto delito sexual contra niños, niñas y adolescentes",2020,3,7,2384,293.624161073826,1,1195,83.6820083682008,6,1189,504.625735912532
32186,73,73067,81,"Tasa de exámenes médico legales por presunto delito sexual contra niños, niñas y adolescentes",2020,4,7,2294,305.14385353095,1,1162,86.0585197934596,6,1132,530.035335689046
32187,73,73067,121,Tasa de exámenes médico legales por presunto delito sexual cuando la víctima está entre 18 y 28 años,2020,5,1,3186,31.3873195229127,0,1707,0,1,1479,67.6132521974307
32188,73,73124,81,"Tasa de exámenes médico legales por presunto delito sexual contra niños, niñas y adolescentes",2020,4,5,1863,268.384326355341,0,968,0,5,895,558.659217877095
32189,73,73124,121,Tasa de exámenes médico legales por presunto delito sexual cuando la víctima está entre 18 y 28 años,2020,5,2,3313,60.3682463024449,0,1700,0,2,1613,123.992560446373
32190,73,73148,81,"Tasa de exámenes médico legales por presunto delito sexual contra niños, niñas y adolescentes",2020,2,2,665,300.751879699248,0,341,0,2,324,617.283950617284
32191,73,73148,81,"Tasa de exámenes médico legales por presunto delito sexual contra niños, niñas y adolescentes",2020,3,2,889,224.971878515186,0,461,0,2,428,467.289719626168
32192,73,73148,81,"Tasa de exámenes médico legales por presunto delito sexual contra niños, niñas y adolescentes",2020,4,1,999,100.1001001001,0,516,0,1,483,207.03933747412
32193,73,73148,121,Tasa de exámenes médico legales por presunto delito sexual cuando la víctima está entre 18 y 28 años,2020,5,1,1759,56.8504832291074,0,893,0,1,866,115.473441108545
32194,73,73152,81,"Tasa de exámenes médico legales por presunto delito sexual contra niños, niñas y adolescentes",2020,3,1,656,152.439024390244,0,333,0,1,323,309.597523219814
32195,73,73168,81,"Tasa de exámenes médico legales por presunto delito sexual contra niños, niñas y adolescentes",2020,2,6,4372,137.236962488564,2,2281,87.6808417360807,4,2091,191.296030607365
32196,73,73168,81,"Tasa de exámenes médico legales por presunto delito sexual contra niños, niñas y adolescentes",2020,3,14,5572,251.256281407035,2,2878,69.4927032661571,12,2694,445.43429844098
32197,73,73168,81,"Tasa de exámenes médico legales por presunto delito sexual contra niños, niñas y adolescentes",2020,4,27,5732,471.039776692254,6,2964,202.429149797571,21,2768,758.670520231214
32198,73,73168,121,Tasa de exámenes médico legales por presunto delito sexual cuando la víctima está entre 18 y 28 años,2020,5,3,8778,34.1763499658237,0,4511,0,3,4267,70.3070072650574
32199,73,73200,81,"Tasa de exámenes médico legales por presunto delito sexual contra niños, niñas y adolescentes",2020,3,1,779,128.369704749679,0,395,0,1,384,260.416666666667
32200,73,73200,81,"Tasa de exámenes médico legales por presunto delito sexual contra niños, niñas y adolescentes",2020,4,1,802,124.688279301746,0,415,0,1,387,258.397932816537
32201,73,73217,81,"Tasa de exámenes médico legales por presunto delito sexual contra niños, niñas y adolescentes",2020,3,10,2492,401.284109149278,0,1259,0,10,1233,811.0300081103
32202,73,73217,81,"Tasa de exámenes médico legales por presunto delito sexual contra niños, niñas y adolescentes",2020,4,12,2517,476.758045292014,1,1295,77.2200772200772,11,1222,900.163666121113
32203,73,73217,121,Tasa de exámenes médico legales por presunto delito sexual cuando la víctima está entre 18 y 28 años,2020,5,2,3436,58.2072176949942,0,1801,0,2,1635,122.324159021407
32204,73,73226,81,"Tasa de exámenes médico legales por presunto delito sexual contra niños, niñas y adolescentes",2020,3,1,825,121.212121212121,0,413,0,1,412,242.718446601942
32205,73,73226,81,"Tasa de exámenes médico legales por presunto delito sexual contra niños, niñas y adolescentes",2020,4,7,835,838.323353293413,0,429,0,7,406,1724.13793103448
32206,73,73236,81,"Tasa de exámenes médico legales por presunto delito sexual contra niños, niñas y adolescentes",2020,2,1,580,172.413793103448,0,299,0,1,281,355.871886120996
32207,73,73236,81,"Tasa de exámenes médico legales por presunto delito sexual contra niños, niñas y adolescentes",2020,4,3,789,380.228136882129,0,423,0,3,366,819.672131147541
32208,73,73236,81,"Tasa de exámenes médico legales por presunto delito sexual contra niños, niñas y adolescentes",2020,1,1,110,909.090909090909,0,56,0,1,54,1851.85185185185
32209,73,73268,81,"Tasa de exámenes médico legales por presunto delito sexual contra niños, niñas y adolescentes",2020,2,6,4472,134.168157423971,1,2299,43.4971726837756,5,2173,230.096640589047
32210,73,73268,81,"Tasa de exámenes médico legales por presunto delito sexual contra niños, niñas y adolescentes",2020,3,17,5817,292.246862643975,5,2995,166.944908180301,12,2822,425.230333097094
32211,73,73268,81,"Tasa de exámenes médico legales por presunto delito sexual contra niños, niñas y adolescentes",2020,4,28,6596,424.499696785931,1,3445,29.0275761973875,27,3151,856.870834655665
32212,73,73268,121,Tasa de exámenes médico legales por presunto delito sexual cuando la víctima está entre 18 y 28 años,2020,5,11,12516,87.8875039948865,2,6536,30.5997552019584,9,5980,150.501672240803
32213,73,73270,81,"Tasa de exámenes médico legales por presunto delito sexual contra niños, niñas y adolescentes",2020,3,2,709,282.087447108604,0,350,0,2,359,557.103064066852
32214,73,73270,81,"Tasa de exámenes médico legales por presunto delito sexual contra niños, niñas y adolescentes",2020,4,2,731,273.59781121751,0,367,0,2,364,549.450549450549
32215,73,73270,121,Tasa de exámenes médico legales por presunto delito sexual cuando la víctima está entre 18 y 28 años,2020,5,1,1045,95.6937799043062,0,534,0,1,511,195.694716242661
32216,73,73275,81,"Tasa de exámenes médico legales por presunto delito sexual contra niños, niñas y adolescentes",2020,3,6,2499,240.096038415366,1,1305,76.6283524904215,5,1194,418.760469011725
32217,73,73275,81,"Tasa de exámenes médico legales por presunto delito sexual contra niños, niñas y adolescentes",2020,4,3,2664,112.612612612613,0,1398,0,3,1266,236.96682464455
32218,73,73275,121,Tasa de exámenes médico legales por presunto delito sexual cuando la víctima está entre 18 y 28 años,2020,5,2,4767,41.9551080344032,0,2378,0,2,2389,83.7170364169108
32219,73,73283,81,"Tasa de exámenes médico legales por presunto delito sexual contra niños, niñas y adolescentes",2020,3,4,2958,135.226504394861,1,1535,65.1465798045603,3,1423,210.822206605762
32220,73,73283,81,"Tasa de exámenes médico legales por presunto delito sexual contra niños, niñas y adolescentes",2020,4,5,3172,157.629255989912,0,1614,0,5,1558,320.924261874198
32221,73,73283,121,Tasa de exámenes médico legales por presunto delito sexual cuando la víctima está entre 18 y 28 años,2020,5,1,5068,19.7316495659037,0,2562,0,1,2506,39.9042298483639
32222,73,73319,81,"Tasa de exámenes médico legales por presunto delito sexual contra niños, niñas y adolescentes",2020,2,7,2158,324.374420759963,0,1118,0,7,1040,673.076923076923
32223,73,73319,81,"Tasa de exámenes médico legales por presunto delito sexual contra niños, niñas y adolescentes",2020,3,11,2874,382.741823242867,1,1469,68.073519400953,10,1405,711.743772241993
32224,73,73319,81,"Tasa de exámenes médico legales por presunto delito sexual contra niños, niñas y adolescentes",2020,4,5,3093,161.655350792111,1,1577,63.4115409004439,4,1516,263.852242744063
32225,73,73319,121,Tasa de exámenes médico legales por presunto delito sexual cuando la víctima está entre 18 y 28 años,2020,5,4,4849,82.4912353062487,0,2484,0,4,2365,169.133192389006
32226,73,73347,81,"Tasa de exámenes médico legales por presunto delito sexual contra niños, niñas y adolescentes",2020,2,1,504,198.412698412698,0,274,0,1,230,434.782608695652
32227,73,73347,81,"Tasa de exámenes médico legales por presunto delito sexual contra niños, niñas y adolescentes",2020,3,3,706,424.929178470255,2,372,537.634408602151,1,334,299.40119760479
32228,73,73347,81,"Tasa de exámenes médico legales por presunto delito sexual contra niños, niñas y adolescentes",2020,4,3,741,404.858299595142,3,383,783.289817232376,0,358,0
32229,73,73347,121,Tasa de exámenes médico legales por presunto delito sexual cuando la víctima está entre 18 y 28 años,2020,5,1,1093,91.4913083257091,0,550,0,1,543,184.162062615101
32230,73,73349,81,"Tasa de exámenes médico legales por presunto delito sexual contra niños, niñas y adolescentes",2020,2,4,1401,285.510349750178,2,701,285.306704707561,2,700,285.714285714286
32231,73,73349,81,"Tasa de exámenes médico legales por presunto delito sexual contra niños, niñas y adolescentes",2020,3,3,1872,160.25641025641,0,952,0,3,920,326.086956521739
32232,73,73349,81,"Tasa de exámenes médico legales por presunto delito sexual contra niños, niñas y adolescentes",2020,4,6,2163,277.392510402219,0,1149,0,6,1014,591.715976331361
32233,73,73349,121,Tasa de exámenes médico legales por presunto delito sexual cuando la víctima está entre 18 y 28 años,2020,5,2,3933,50.8517670989067,0,2151,0,2,1782,112.233445566779
32234,73,73001,81,"Tasa de exámenes médico legales por presunto delito sexual contra niños, niñas y adolescentes",2020,2,49,32252,151.928562569763,10,16480,60.6796116504854,39,15772,247.273649505453
32235,73,73001,81,"Tasa de exámenes médico legales por presunto delito sexual contra niños, niñas y adolescentes",2020,3,87,42530,204.561486009875,17,21666,78.4639527370073,70,20864,335.506134969325
32236,73,73001,81,"Tasa de exámenes médico legales por presunto delito sexual contra niños, niñas y adolescentes",2020,4,142,49648,286.013535288431,20,25220,79.3021411578113,122,24428,499.426887178647
32237,73,73001,121,Tasa de exámenes médico legales por presunto delito sexual cuando la víctima está entre 18 y 28 años,2020,5,32,100855,31.7287194487135,3,50673,5.92031259250488,29,50182,57.7896456896895
32238,73,73001,81,"Tasa de exámenes médico legales por presunto delito sexual contra niños, niñas y adolescentes",2020,1,2,6047,33.0742516950554,0,3092,0,2,2955,67.6818950930626
32239,73,73352,81,"Tasa de exámenes médico legales por presunto delito sexual contra niños, niñas y adolescentes",2020,2,1,855,116.959064327485,0,465,0,1,390,256.410256410256
32240,73,73352,81,"Tasa de exámenes médico legales por presunto delito sexual contra niños, niñas y adolescentes",2020,3,3,1112,269.784172661871,0,586,0,3,526,570.342205323194
32241,73,73352,81,"Tasa de exámenes médico legales por presunto delito sexual contra niños, niñas y adolescentes",2020,4,5,1137,439.753737906772,1,587,170.357751277683,4,550,727.272727272727
32242,73,73408,81,"Tasa de exámenes médico legales por presunto delito sexual contra niños, niñas y adolescentes",2020,2,1,1273,78.5545954438335,0,677,0,1,596,167.785234899329
32243,73,73408,81,"Tasa de exámenes médico legales por presunto delito sexual contra niños, niñas y adolescentes",2020,3,4,1616,247.524752475248,1,840,119.047619047619,3,776,386.59793814433
32244,73,73408,81,"Tasa de exámenes médico legales por presunto delito sexual contra niños, niñas y adolescentes",2020,4,5,1696,294.811320754717,1,858,116.550116550117,4,838,477.326968973747
32245,73,73408,121,Tasa de exámenes médico legales por presunto delito sexual cuando la víctima está entre 18 y 28 años,2020,5,3,2965,101.180438448567,0,1486,0,3,1479,202.839756592292
32246,73,73411,81,"Tasa de exámenes médico legales por presunto delito sexual contra niños, niñas y adolescentes",2020,2,1,2304,43.4027777777778,0,1184,0,1,1120,89.2857142857143
32247,73,73411,81,"Tasa de exámenes médico legales por presunto delito sexual contra niños, niñas y adolescentes",2020,3,3,3204,93.6329588014981,0,1659,0,3,1545,194.174757281553
32248,73,73411,81,"Tasa de exámenes médico legales por presunto delito sexual contra niños, niñas y adolescentes",2020,4,12,3515,341.394025604552,2,1809,110.558319513543,10,1706,586.166471277843
32249,73,73411,121,Tasa de exámenes médico legales por presunto delito sexual cuando la víctima está entre 18 y 28 años,2020,5,2,5328,37.5375375375375,0,2618,0,2,2710,73.8007380073801
32250,73,73449,81,"Tasa de exámenes médico legales por presunto delito sexual contra niños, niñas y adolescentes",2020,2,4,2752,145.348837209302,2,1390,143.884892086331,2,1362,146.842878120411
32251,73,73449,81,"Tasa de exámenes médico legales por presunto delito sexual contra niños, niñas y adolescentes",2020,3,11,3351,328.260220829603,3,1722,174.216027874564,8,1629,491.09883364027
32252,73,73449,81,"Tasa de exámenes médico legales por presunto delito sexual contra niños, niñas y adolescentes",2020,4,13,3488,372.706422018349,1,1841,54.3183052688756,12,1647,728.597449908925
32253,73,73449,121,Tasa de exámenes médico legales por presunto delito sexual cuando la víctima está entre 18 y 28 años,2020,5,5,6983,71.6024631247315,0,3609,0,5,3374,148.19205690575
32254,73,73461,81,"Tasa de exámenes médico legales por presunto delito sexual contra niños, niñas y adolescentes",2020,4,4,476,840.336134453781,1,237,421.940928270042,3,239,1255.23012552301
32255,73,73483,81,"Tasa de exámenes médico legales por presunto delito sexual contra niños, niñas y adolescentes",2020,3,6,1269,472.813238770686,0,640,0,6,629,953.89507154213
32256,73,73483,81,"Tasa de exámenes médico legales por presunto delito sexual contra niños, niñas y adolescentes",2020,4,5,1415,353.356890459364,0,741,0,5,674,741.839762611276
32257,73,73504,81,"Tasa de exámenes médico legales por presunto delito sexual contra niños, niñas y adolescentes",2020,2,4,2966,134.861766689144,0,1501,0,4,1465,273.037542662116
32258,73,73504,81,"Tasa de exámenes médico legales por presunto delito sexual contra niños, niñas y adolescentes",2020,3,12,3765,318.725099601594,1,1950,51.2820512820513,11,1815,606.060606060606
32259,73,73504,81,"Tasa de exámenes médico legales por presunto delito sexual contra niños, niñas y adolescentes",2020,4,20,3850,519.480519480519,0,2037,0,20,1813,1103.14396028682
32260,73,73504,121,Tasa de exámenes médico legales por presunto delito sexual cuando la víctima está entre 18 y 28 años,2020,5,2,5988,33.4001336005344,0,3158,0,2,2830,70.6713780918728
32261,73,73520,81,"Tasa de exámenes médico legales por presunto delito sexual contra niños, niñas y adolescentes",2020,2,2,837,238.9486260454,0,414,0,2,423,472.813238770686
32262,73,73520,81,"Tasa de exámenes médico legales por presunto delito sexual contra niños, niñas y adolescentes",2020,3,1,1051,95.1474785918173,1,518,193.050193050193,0,533,0
32263,73,73520,81,"Tasa de exámenes médico legales por presunto delito sexual contra niños, niñas y adolescentes",2020,4,2,1031,193.986420950533,0,521,0,2,510,392.156862745098
32264,73,73520,121,Tasa de exámenes médico legales por presunto delito sexual cuando la víctima está entre 18 y 28 años,2020,5,1,1524,65.6167979002625,0,776,0,1,748,133.689839572193
32265,73,73547,81,"Tasa de exámenes médico legales por presunto delito sexual contra niños, niñas y adolescentes",2020,2,1,426,234.741784037559,0,215,0,1,211,473.9336492891
32266,73,73547,81,"Tasa de exámenes médico legales por presunto delito sexual contra niños, niñas y adolescentes",2020,3,1,570,175.438596491228,0,286,0,1,284,352.112676056338
32267,73,73547,81,"Tasa de exámenes médico legales por presunto delito sexual contra niños, niñas y adolescentes",2020,4,2,680,294.117647058824,1,374,267.379679144385,1,306,326.797385620915
32268,73,73555,81,"Tasa de exámenes médico legales por presunto delito sexual contra niños, niñas y adolescentes",2020,2,2,2874,69.589422407794,0,1481,0,2,1393,143.575017946877
32269,73,73555,81,"Tasa de exámenes médico legales por presunto delito sexual contra niños, niñas y adolescentes",2020,3,7,3362,208.209399167162,1,1757,56.9151963574274,6,1605,373.831775700935
32270,73,73555,81,"Tasa de exámenes médico legales por presunto delito sexual contra niños, niñas y adolescentes",2020,4,14,3178,440.528634361234,0,1686,0,14,1492,938.337801608579
32271,73,73555,121,Tasa de exámenes médico legales por presunto delito sexual cuando la víctima está entre 18 y 28 años,2020,5,8,4697,170.321481796892,1,2439,41.0004100041,7,2258,310.008857395926
32272,73,73563,81,"Tasa de exámenes médico legales por presunto delito sexual contra niños, niñas y adolescentes",2020,2,2,639,312.989045383412,0,327,0,2,312,641.025641025641
32273,73,73563,81,"Tasa de exámenes médico legales por presunto delito sexual contra niños, niñas y adolescentes",2020,3,6,807,743.494423791822,0,406,0,6,401,1496.25935162095
32274,73,73563,81,"Tasa de exámenes médico legales por presunto delito sexual contra niños, niñas y adolescentes",2020,4,5,820,609.756097560976,0,420,0,5,400,1250
32275,73,73585,81,"Tasa de exámenes médico legales por presunto delito sexual contra niños, niñas y adolescentes",2020,2,7,1663,420.92603728202,1,828,120.772946859903,6,835,718.562874251497
32276,73,73585,81,"Tasa de exámenes médico legales por presunto delito sexual contra niños, niñas y adolescentes",2020,3,14,2068,676.982591876209,4,1059,377.714825306893,10,1009,991.080277502478
32277,73,73585,81,"Tasa de exámenes médico legales por presunto delito sexual contra niños, niñas y adolescentes",2020,4,13,2104,617.87072243346,4,1094,365.63071297989,9,1010,891.089108910891
32278,73,73585,121,Tasa de exámenes médico legales por presunto delito sexual cuando la víctima está entre 18 y 28 años,2020,5,1,3389,29.5072292711714,1,1675,59.7014925373134,0,1714,0
32279,73,73616,81,"Tasa de exámenes médico legales por presunto delito sexual contra niños, niñas y adolescentes",2020,2,2,2671,74.878322725571,1,1365,73.2600732600733,1,1306,76.5696784073507
32280,73,73616,81,"Tasa de exámenes médico legales por presunto delito sexual contra niños, niñas y adolescentes",2020,3,7,3044,229.960578186597,0,1570,0,7,1474,474.898236092266
32281,73,73616,81,"Tasa de exámenes médico legales por presunto delito sexual contra niños, niñas y adolescentes",2020,4,11,2756,399.129172714078,2,1451,137.835975189524,9,1305,689.655172413793
32282,73,73622,81,"Tasa de exámenes médico legales por presunto delito sexual contra niños, niñas y adolescentes",2020,3,2,629,317.965023847377,1,332,301.204819277108,1,297,336.700336700337
32283,73,73622,81,"Tasa de exámenes médico legales por presunto delito sexual contra niños, niñas y adolescentes",2020,4,1,655,152.671755725191,0,347,0,1,308,324.675324675325
32284,73,73624,81,"Tasa de exámenes médico legales por presunto delito sexual contra niños, niñas y adolescentes",2020,2,1,1774,56.369785794814,0,885,0,1,889,112.485939257593
32285,73,73624,81,"Tasa de exámenes médico legales por presunto delito sexual contra niños, niñas y adolescentes",2020,3,6,2383,251.783466219052,2,1205,165.97510373444,4,1178,339.55857385399
32286,73,73624,81,"Tasa de exámenes médico legales por presunto delito sexual contra niños, niñas y adolescentes",2020,4,15,2520,595.238095238095,0,1296,0,15,1224,1225.49019607843
32287,73,73671,81,"Tasa de exámenes médico legales por presunto delito sexual contra niños, niñas y adolescentes",2020,2,1,980,102.040816326531,0,486,0,1,494,202.429149797571
32288,73,73671,81,"Tasa de exámenes médico legales por presunto delito sexual contra niños, niñas y adolescentes",2020,4,2,1437,139.178844815588,0,759,0,2,678,294.985250737463
32289,73,73671,121,Tasa de exámenes médico legales por presunto delito sexual cuando la víctima está entre 18 y 28 años,2020,5,3,2238,134.048257372654,0,1133,0,3,1105,271.493212669683
32290,73,73675,81,"Tasa de exámenes médico legales por presunto delito sexual contra niños, niñas y adolescentes",2020,2,7,1113,628.930817610063,2,571,350.262697022767,5,542,922.509225092251
32291,73,73675,81,"Tasa de exámenes médico legales por presunto delito sexual contra niños, niñas y adolescentes",2020,3,4,1458,274.348422496571,3,741,404.858299595142,1,717,139.470013947001
32292,73,73675,81,"Tasa de exámenes médico legales por presunto delito sexual contra niños, niñas y adolescentes",2020,4,12,1502,798.934753661784,1,776,128.865979381443,11,726,1515.15151515152
32293,73,73675,121,Tasa de exámenes médico legales por presunto delito sexual cuando la víctima está entre 18 y 28 años,2020,5,1,2040,49.0196078431373,0,1082,0,1,958,104.384133611691
32294,73,73678,81,"Tasa de exámenes médico legales por presunto delito sexual contra niños, niñas y adolescentes",2020,4,2,1298,154.083204930663,0,684,0,2,614,325.732899022801
32295,73,73443,81,"Tasa de exámenes médico legales por presunto delito sexual contra niños, niñas y adolescentes",2020,2,1,2623,38.1242851696531,0,1333,0,1,1290,77.5193798449612
32296,73,73443,81,"Tasa de exámenes médico legales por presunto delito sexual contra niños, niñas y adolescentes",2020,3,9,3428,262.543757292882,2,1745,114.613180515759,7,1683,415.92394533571
32297,73,73443,81,"Tasa de exámenes médico legales por presunto delito sexual contra niños, niñas y adolescentes",2020,4,6,3643,164.699423552018,0,1857,0,6,1786,335.946248600224
32298,73,73443,121,Tasa de exámenes médico legales por presunto delito sexual cuando la víctima está entre 18 y 28 años,2020,5,2,6202,32.2476620445018,0,3075,0,2,3127,63.9590661976335
32299,73,73686,81,"Tasa de exámenes médico legales por presunto delito sexual contra niños, niñas y adolescentes",2020,2,1,444,225.225225225225,1,231,432.900432900433,0,213,0
32300,73,73686,81,"Tasa de exámenes médico legales por presunto delito sexual contra niños, niñas y adolescentes",2020,3,1,605,165.289256198347,0,325,0,1,280,357.142857142857
32301,73,73686,121,Tasa de exámenes médico legales por presunto delito sexual cuando la víctima está entre 18 y 28 años,2020,5,2,861,232.288037166086,0,448,0,2,413,484.261501210654
32302,73,73854,81,"Tasa de exámenes médico legales por presunto delito sexual contra niños, niñas y adolescentes",2020,2,1,364,274.725274725275,0,168,0,1,196,510.204081632653
32303,73,73854,81,"Tasa de exámenes médico legales por presunto delito sexual contra niños, niñas y adolescentes",2020,3,2,513,389.863547758285,0,249,0,2,264,757.575757575758
32304,73,73861,81,"Tasa de exámenes médico legales por presunto delito sexual contra niños, niñas y adolescentes",2020,2,1,898,111.358574610245,0,453,0,1,445,224.719101123596
32305,73,73861,81,"Tasa de exámenes médico legales por presunto delito sexual contra niños, niñas y adolescentes",2020,3,1,1200,83.3333333333333,0,645,0,1,555,180.18018018018
32306,73,73861,81,"Tasa de exámenes médico legales por presunto delito sexual contra niños, niñas y adolescentes",2020,4,2,1243,160.901045856798,0,688,0,2,555,360.36036036036
32307,73,73870,81,"Tasa de exámenes médico legales por presunto delito sexual contra niños, niñas y adolescentes",2020,3,1,966,103.51966873706,0,498,0,1,468,213.675213675214
32308,73,73870,81,"Tasa de exámenes médico legales por presunto delito sexual contra niños, niñas y adolescentes",2020,4,1,939,106.496272630458,0,480,0,1,459,217.864923747277
32309,73,73873,81,"Tasa de exámenes médico legales por presunto delito sexual contra niños, niñas y adolescentes",2020,2,1,380,263.157894736842,0,190,0,1,190,526.315789473684
32310,73,73873,81,"Tasa de exámenes médico legales por presunto delito sexual contra niños, niñas y adolescentes",2020,3,1,452,221.238938053097,1,228,438.59649122807,0,224,0
32311,73,73873,81,"Tasa de exámenes médico legales por presunto delito sexual contra niños, niñas y adolescentes",2020,4,3,442,678.733031674208,0,225,0,3,217,1382.48847926267
32312,76,76020,81,"Tasa de exámenes médico legales por presunto delito sexual contra niños, niñas y adolescentes",2020,3,2,1418,141.043723554302,1,730,136.986301369863,1,688,145.348837209302
32313,76,76020,81,"Tasa de exámenes médico legales por presunto delito sexual contra niños, niñas y adolescentes",2020,4,1,1482,67.476383265857,0,747,0,1,735,136.054421768707
32314,76,76036,81,"Tasa de exámenes médico legales por presunto delito sexual contra niños, niñas y adolescentes",2020,2,2,1678,119.189511323004,1,850,117.647058823529,1,828,120.772946859903
32315,76,76036,81,"Tasa de exámenes médico legales por presunto delito sexual contra niños, niñas y adolescentes",2020,3,2,2109,94.8316737790422,1,1084,92.2509225092251,1,1025,97.5609756097561
32316,76,76036,121,Tasa de exámenes médico legales por presunto delito sexual cuando la víctima está entre 18 y 28 años,2020,5,1,3621,27.6166804750069,1,1785,56.0224089635854,0,1836,0
32317,76,76041,81,"Tasa de exámenes médico legales por presunto delito sexual contra niños, niñas y adolescentes",2020,2,2,1522,131.406044678055,0,805,0,2,717,278.940027894003
32318,76,76041,81,"Tasa de exámenes médico legales por presunto delito sexual contra niños, niñas y adolescentes",2020,4,1,1853,53.9665407447383,0,947,0,1,906,110.37527593819
32319,76,76054,81,"Tasa de exámenes médico legales por presunto delito sexual contra niños, niñas y adolescentes",2020,4,1,591,169.204737732656,0,301,0,1,290,344.827586206897
32320,76,76054,121,Tasa de exámenes médico legales por presunto delito sexual cuando la víctima está entre 18 y 28 años,2020,5,1,785,127.388535031847,0,421,0,1,364,274.725274725275
32321,76,76100,81,"Tasa de exámenes médico legales por presunto delito sexual contra niños, niñas y adolescentes",2020,2,2,1393,143.575017946877,0,683,0,2,710,281.69014084507
32322,76,76100,81,"Tasa de exámenes médico legales por presunto delito sexual contra niños, niñas y adolescentes",2020,3,4,1704,234.741784037559,3,834,359.712230215827,1,870,114.942528735632
32323,76,76100,81,"Tasa de exámenes médico legales por presunto delito sexual contra niños, niñas y adolescentes",2020,4,6,1673,358.637178720861,2,842,237.529691211401,4,831,481.347773766546
32324,76,76100,121,Tasa de exámenes médico legales por presunto delito sexual cuando la víctima está entre 18 y 28 años,2020,5,2,2338,85.5431993156544,0,1219,0,2,1119,178.731009830206
32325,76,76109,81,"Tasa de exámenes médico legales por presunto delito sexual contra niños, niñas y adolescentes",2020,2,8,37098,21.564504825058,4,18713,21.375514348314,4,18385,21.7568670111504
32326,76,76109,81,"Tasa de exámenes médico legales por presunto delito sexual contra niños, niñas y adolescentes",2020,3,20,42841,46.6842510679022,5,21653,23.0914884773473,15,21188,70.7947895034925
32327,76,76109,81,"Tasa de exámenes médico legales por presunto delito sexual contra niños, niñas y adolescentes",2020,4,24,39031,61.4895852015065,4,19681,20.3241705197907,20,19350,103.359173126615
32328,76,76109,121,Tasa de exámenes médico legales por presunto delito sexual cuando la víctima está entre 18 y 28 años,2020,5,8,57093,14.0122256668944,1,27387,3.6513674371052,7,29706,23.5642631118293
32329,76,76113,81,"Tasa de exámenes médico legales por presunto delito sexual contra niños, niñas y adolescentes",2020,4,2,2444,81.8330605564648,0,1247,0,2,1197,167.084377610693
32330,76,76122,81,"Tasa de exámenes médico legales por presunto delito sexual contra niños, niñas y adolescentes",2020,2,2,1926,103.842159916926,1,1012,98.8142292490118,1,914,109.409190371991
32331,76,76122,81,"Tasa de exámenes médico legales por presunto delito sexual contra niños, niñas y adolescentes",2020,3,9,2574,349.65034965035,1,1320,75.7575757575758,8,1254,637.958532695375
32332,76,76122,81,"Tasa de exámenes médico legales por presunto delito sexual contra niños, niñas y adolescentes",2020,4,9,2791,322.465066284486,2,1379,145.032632342277,7,1412,495.750708215297
32333,76,76001,81,"Tasa de exámenes médico legales por presunto delito sexual contra niños, niñas y adolescentes",2020,2,95,158695,59.8632597120262,17,80820,21.0343974263796,78,77875,100.16051364366
32334,76,76001,81,"Tasa de exámenes médico legales por presunto delito sexual contra niños, niñas y adolescentes",2020,3,208,191192,108.791162810159,39,96580,40.381031269414,169,94612,178.624275990361
32335,76,76001,81,"Tasa de exámenes médico legales por presunto delito sexual contra niños, niñas y adolescentes",2020,4,230,200234,114.86560723953,15,99607,15.0591825875691,215,100627,213.660349607958
32336,76,76001,121,Tasa de exámenes médico legales por presunto delito sexual cuando la víctima está entre 18 y 28 años,2020,5,75,400010,18.7495312617185,6,194696,3.08172741093808,69,205314,33.6070604050381
32337,76,76126,81,"Tasa de exámenes médico legales por presunto delito sexual contra niños, niñas y adolescentes",2020,2,1,1331,75.1314800901578,0,665,0,1,666,150.15015015015
32338,76,76126,81,"Tasa de exámenes médico legales por presunto delito sexual contra niños, niñas y adolescentes",2020,3,4,1750,228.571428571429,1,885,112.994350282486,3,865,346.820809248555
32339,76,76126,81,"Tasa de exámenes médico legales por presunto delito sexual contra niños, niñas y adolescentes",2020,4,4,1839,217.509516041327,0,933,0,4,906,441.501103752759
32340,76,76126,121,Tasa de exámenes médico legales por presunto delito sexual cuando la víctima está entre 18 y 28 años,2020,5,2,2973,67.272115708039,0,1461,0,2,1512,132.275132275132
32341,76,76130,81,"Tasa de exámenes médico legales por presunto delito sexual contra niños, niñas y adolescentes",2020,2,1,8135,12.2925629993854,1,4215,23.7247924080664,0,3920,0
32342,76,76130,81,"Tasa de exámenes médico legales por presunto delito sexual contra niños, niñas y adolescentes",2020,3,6,9635,62.2729631551635,1,4968,20.1288244766506,5,4667,107.135204628241
32343,76,76130,81,"Tasa de exámenes médico legales por presunto delito sexual contra niños, niñas y adolescentes",2020,4,11,9505,115.72856391373,1,4846,20.6355757325629,10,4659,214.638334406525
32344,76,76130,121,Tasa de exámenes médico legales por presunto delito sexual cuando la víctima está entre 18 y 28 años,2020,5,1,16503,6.0595043325456,0,8130,0,1,8373,11.9431506031291
32345,76,76147,81,"Tasa de exámenes médico legales por presunto delito sexual contra niños, niñas y adolescentes",2020,2,2,9095,21.9901044529962,0,4557,0,2,4538,44.0722785368004
32346,76,76147,81,"Tasa de exámenes médico legales por presunto delito sexual contra niños, niñas y adolescentes",2020,3,9,11844,75.9878419452887,1,5932,16.857720836143,8,5912,135.31799729364
32347,76,76147,81,"Tasa de exámenes médico legales por presunto delito sexual contra niños, niñas y adolescentes",2020,4,13,12815,101.443620756925,1,6438,15.5327741534638,12,6377,188.176258428728
32348,76,76147,121,Tasa de exámenes médico legales por presunto delito sexual cuando la víctima está entre 18 y 28 años,2020,5,3,22805,13.1550098662574,0,11391,0,3,11414,26.2835114771333
32349,76,76147,81,"Tasa de exámenes médico legales por presunto delito sexual contra niños, niñas y adolescentes",2020,1,1,1760,56.8181818181818,0,883,0,1,877,114.025085518814
32350,76,76233,81,"Tasa de exámenes médico legales por presunto delito sexual contra niños, niñas y adolescentes",2020,2,5,4007,124.781632143748,2,2039,98.0872976949485,3,1968,152.439024390244
32351,76,76233,81,"Tasa de exámenes médico legales por presunto delito sexual contra niños, niñas y adolescentes",2020,3,1,4961,20.1572263656521,0,2525,0,1,2436,41.0509031198686
32352,76,76233,81,"Tasa de exámenes médico legales por presunto delito sexual contra niños, niñas y adolescentes",2020,4,5,4970,100.603621730382,1,2529,39.5413206801107,4,2441,163.867267513314
32353,76,76246,81,"Tasa de exámenes médico legales por presunto delito sexual contra niños, niñas y adolescentes",2020,3,1,684,146.198830409357,0,351,0,1,333,300.3003003003
32354,76,76248,81,"Tasa de exámenes médico legales por presunto delito sexual contra niños, niñas y adolescentes",2020,2,5,4368,114.468864468864,1,2220,45.045045045045,4,2148,186.219739292365
32355,76,76248,81,"Tasa de exámenes médico legales por presunto delito sexual contra niños, niñas y adolescentes",2020,3,2,5432,36.8188512518409,0,2737,0,2,2695,74.2115027829313
32356,76,76248,81,"Tasa de exámenes médico legales por presunto delito sexual contra niños, niñas y adolescentes",2020,4,6,5592,107.296137339056,1,2763,36.1925443358668,5,2829,176.740897843761
32357,76,76250,81,"Tasa de exámenes médico legales por presunto delito sexual contra niños, niñas y adolescentes",2020,2,1,818,122.249388753056,0,422,0,1,396,252.525252525253
32358,76,76250,81,"Tasa de exámenes médico legales por presunto delito sexual contra niños, niñas y adolescentes",2020,3,1,999,100.1001001001,0,517,0,1,482,207.46887966805
32359,76,76250,81,"Tasa de exámenes médico legales por presunto delito sexual contra niños, niñas y adolescentes",2020,4,3,955,314.13612565445,1,488,204.918032786885,2,467,428.265524625268
32360,76,76250,121,Tasa de exámenes médico legales por presunto delito sexual cuando la víctima está entre 18 y 28 años,2020,5,1,1373,72.8332119446468,0,680,0,1,693,144.300144300144
32361,76,76275,81,"Tasa de exámenes médico legales por presunto delito sexual contra niños, niñas y adolescentes",2020,2,2,4662,42.9000429000429,0,2446,0,2,2216,90.2527075812274
32362,76,76275,81,"Tasa de exámenes médico legales por presunto delito sexual contra niños, niñas y adolescentes",2020,3,5,5895,84.8176420695505,0,3041,0,5,2854,175.192711983181
32363,76,76275,81,"Tasa de exámenes médico legales por presunto delito sexual contra niños, niñas y adolescentes",2020,4,5,6151,81.2875955129247,0,3103,0,5,3048,164.041994750656
32364,76,76306,81,"Tasa de exámenes médico legales por presunto delito sexual contra niños, niñas y adolescentes",2020,2,1,1624,61.576354679803,0,847,0,1,777,128.700128700129
32365,76,76306,81,"Tasa de exámenes médico legales por presunto delito sexual contra niños, niñas y adolescentes",2020,3,2,2166,92.3361034164358,1,1123,89.0471950133571,1,1043,95.8772770853308
32366,76,76306,81,"Tasa de exámenes médico legales por presunto delito sexual contra niños, niñas y adolescentes",2020,4,1,2303,43.4216239687364,0,1171,0,1,1132,88.339222614841
32367,76,76306,121,Tasa de exámenes médico legales por presunto delito sexual cuando la víctima está entre 18 y 28 años,2020,5,1,3748,26.6808964781217,1,1828,54.7045951859956,0,1920,0
32368,76,76318,81,"Tasa de exámenes médico legales por presunto delito sexual contra niños, niñas y adolescentes",2020,3,3,3309,90.6618313689937,0,1699,0,3,1610,186.335403726708
32369,76,76318,81,"Tasa de exámenes médico legales por presunto delito sexual contra niños, niñas y adolescentes",2020,4,3,3394,88.3912787271656,2,1748,114.41647597254,1,1646,60.7533414337788
32370,76,76318,121,Tasa de exámenes médico legales por presunto delito sexual cuando la víctima está entre 18 y 28 años,2020,5,1,5682,17.5994368180218,0,2775,0,1,2907,34.3997248022016
32371,76,76111,81,"Tasa de exámenes médico legales por presunto delito sexual contra niños, niñas y adolescentes",2020,2,2,9398,21.2811236433284,0,4725,0,2,4673,42.7990584207147
32372,76,76111,81,"Tasa de exámenes médico legales por presunto delito sexual contra niños, niñas y adolescentes",2020,3,18,11581,155.426992487695,3,5806,51.6706854977609,15,5775,259.74025974026
32373,76,76111,81,"Tasa de exámenes médico legales por presunto delito sexual contra niños, niñas y adolescentes",2020,4,15,11864,126.432906271072,0,5990,0,15,5874,255.362614913177
32374,76,76111,121,Tasa de exámenes médico legales por presunto delito sexual cuando la víctima está entre 18 y 28 años,2020,5,5,21374,23.3929072705156,1,10839,9.22594335270781,4,10535,37.96867584243
32375,76,76364,81,"Tasa de exámenes médico legales por presunto delito sexual contra niños, niñas y adolescentes",2020,2,10,12587,79.4470485421467,2,6473,30.8975745403986,8,6114,130.847235852143
32376,76,76364,81,"Tasa de exámenes médico legales por presunto delito sexual contra niños, niñas y adolescentes",2020,3,13,15745,82.5658939345824,3,8074,37.1563041862769,10,7671,130.361100247686
32377,76,76364,81,"Tasa de exámenes médico legales por presunto delito sexual contra niños, niñas y adolescentes",2020,4,16,16328,97.9911807937286,1,8283,12.0729204394543,15,8045,186.451211932878
32378,76,76364,121,Tasa de exámenes médico legales por presunto delito sexual cuando la víctima está entre 18 y 28 años,2020,5,4,29116,13.7381508448963,1,14627,6.83667190811513,3,14489,20.7053626889364
32379,76,76377,81,"Tasa de exámenes médico legales por presunto delito sexual contra niños, niñas y adolescentes",2020,2,1,1046,95.6022944550669,0,574,0,1,472,211.864406779661
32380,76,76377,81,"Tasa de exámenes médico legales por presunto delito sexual contra niños, niñas y adolescentes",2020,4,1,1483,67.4308833445718,0,737,0,1,746,134.048257372654
32381,76,76400,81,"Tasa de exámenes médico legales por presunto delito sexual contra niños, niñas y adolescentes",2020,2,11,2498,440.35228182546,3,1247,240.577385725742,8,1251,639.488409272582
32382,76,76400,81,"Tasa de exámenes médico legales por presunto delito sexual contra niños, niñas y adolescentes",2020,3,8,3294,242.865816636308,1,1669,59.9161174355902,7,1625,430.769230769231
32383,76,76400,81,"Tasa de exámenes médico legales por presunto delito sexual contra niños, niñas y adolescentes",2020,4,7,3468,201.845444059977,0,1750,0,7,1718,407.450523864959
32384,76,76497,81,"Tasa de exámenes médico legales por presunto delito sexual contra niños, niñas y adolescentes",2020,2,1,931,107.411385606874,0,454,0,1,477,209.643605870021
32385,76,76497,81,"Tasa de exámenes médico legales por presunto delito sexual contra niños, niñas y adolescentes",2020,3,2,1213,164.880461665293,1,631,158.478605388273,1,582,171.821305841924
32386,76,76497,81,"Tasa de exámenes médico legales por presunto delito sexual contra niños, niñas y adolescentes",2020,4,2,1265,158.102766798419,0,666,0,2,599,333.889816360601
32387,76,76520,81,"Tasa de exámenes médico legales por presunto delito sexual contra niños, niñas y adolescentes",2020,2,19,25789,73.6748225987824,3,13139,22.8327878834006,16,12650,126.482213438735
32388,76,76520,81,"Tasa de exámenes médico legales por presunto delito sexual contra niños, niñas y adolescentes",2020,3,28,31144,89.9049576162343,8,15815,50.5848877647803,20,15329,130.471655032944
32389,76,76520,81,"Tasa de exámenes médico legales por presunto delito sexual contra niños, niñas y adolescentes",2020,4,41,31973,128.233196759766,4,16106,24.835465044083,37,15867,233.188378395412
32390,76,76520,121,Tasa de exámenes médico legales por presunto delito sexual cuando la víctima está entre 18 y 28 años,2020,5,8,60026,13.3275580581748,2,29805,6.71028350947828,6,30221,19.8537440852387
32391,76,76563,81,"Tasa de exámenes médico legales por presunto delito sexual contra niños, niñas y adolescentes",2020,2,1,3774,26.4970853206147,0,1918,0,1,1856,53.8793103448276
32392,76,76563,81,"Tasa de exámenes médico legales por presunto delito sexual contra niños, niñas y adolescentes",2020,3,4,5048,79.2393026941363,0,2523,0,4,2525,158.415841584158
32393,76,76563,81,"Tasa de exámenes médico legales por presunto delito sexual contra niños, niñas y adolescentes",2020,4,5,5420,92.2509225092251,0,2667,0,5,2753,181.620050853614
32394,76,76563,121,Tasa de exámenes médico legales por presunto delito sexual cuando la víctima está entre 18 y 28 años,2020,5,2,8674,23.0574129582661,1,4187,23.8834487700024,1,4487,22.2866057499443
32395,76,76606,81,"Tasa de exámenes médico legales por presunto delito sexual contra niños, niñas y adolescentes",2020,3,4,1534,260.756192959583,0,786,0,4,748,534.75935828877
32396,76,76606,81,"Tasa de exámenes médico legales por presunto delito sexual contra niños, niñas y adolescentes",2020,4,2,1546,129.366106080207,0,800,0,2,746,268.096514745308
32397,76,76616,81,"Tasa de exámenes médico legales por presunto delito sexual contra niños, niñas y adolescentes",2020,3,1,1579,63.3312222925902,0,819,0,1,760,131.578947368421
32398,76,76616,81,"Tasa de exámenes médico legales por presunto delito sexual contra niños, niñas y adolescentes",2020,4,1,1570,63.6942675159236,0,806,0,1,764,130.890052356021
32399,76,76622,81,"Tasa de exámenes médico legales por presunto delito sexual contra niños, niñas y adolescentes",2020,2,2,2531,79.0201501382853,0,1300,0,2,1231,162.46953696182
32400,76,76622,81,"Tasa de exámenes médico legales por presunto delito sexual contra niños, niñas y adolescentes",2020,3,6,3391,176.938956060159,2,1732,115.473441108545,4,1659,241.109101868596
32401,76,76622,81,"Tasa de exámenes médico legales por presunto delito sexual contra niños, niñas y adolescentes",2020,4,13,3616,359.513274336283,3,1831,163.844893500819,10,1785,560.224089635854
32402,76,76622,121,Tasa de exámenes médico legales por presunto delito sexual cuando la víctima está entre 18 y 28 años,2020,5,2,5861,34.123869646818,0,2886,0,2,2975,67.2268907563025
32403,76,76670,81,"Tasa de exámenes médico legales por presunto delito sexual contra niños, niñas y adolescentes",2020,3,2,1710,116.959064327485,1,895,111.731843575419,1,815,122.699386503067
32404,76,76670,81,"Tasa de exámenes médico legales por presunto delito sexual contra niños, niñas y adolescentes",2020,4,2,1748,114.41647597254,0,884,0,2,864,231.481481481481
32405,76,76670,121,Tasa de exámenes médico legales por presunto delito sexual cuando la víctima está entre 18 y 28 años,2020,5,1,2855,35.0262697022767,0,1430,0,1,1425,70.1754385964912
32406,76,76736,81,"Tasa de exámenes médico legales por presunto delito sexual contra niños, niñas y adolescentes",2020,2,1,2687,37.2162262746558,0,1384,0,1,1303,76.7459708365311
32407,76,76736,81,"Tasa de exámenes médico legales por presunto delito sexual contra niños, niñas y adolescentes",2020,3,8,3700,216.216216216216,1,1899,52.6592943654555,7,1801,388.672959466963
32408,76,76736,81,"Tasa de exámenes médico legales por presunto delito sexual contra niños, niñas y adolescentes",2020,4,9,4000,225,1,2047,48.8519785051295,8,1953,409.626216077829
32409,76,76736,121,Tasa de exámenes médico legales por presunto delito sexual cuando la víctima está entre 18 y 28 años,2020,5,2,6335,31.5706393054459,0,3178,0,2,3157,63.351282863478
32410,76,76823,81,"Tasa de exámenes médico legales por presunto delito sexual contra niños, niñas y adolescentes",2020,4,1,1547,64.6412411118293,0,776,0,1,771,129.70168612192
32411,76,76823,121,Tasa de exámenes médico legales por presunto delito sexual cuando la víctima está entre 18 y 28 años,2020,5,1,2121,47.1475719000471,0,1067,0,1,1054,94.876660341556
32412,76,76828,81,"Tasa de exámenes médico legales por presunto delito sexual contra niños, niñas y adolescentes",2020,2,1,1539,64.9772579597141,0,759,0,1,780,128.205128205128
32413,76,76828,81,"Tasa de exámenes médico legales por presunto delito sexual contra niños, niñas y adolescentes",2020,3,1,2054,48.6854917234664,1,1058,94.5179584120983,0,996,0
32414,76,76828,121,Tasa de exámenes médico legales por presunto delito sexual cuando la víctima está entre 18 y 28 años,2020,5,1,2877,34.7584289190129,0,1423,0,1,1454,68.7757909215956
32415,76,76834,81,"Tasa de exámenes médico legales por presunto delito sexual contra niños, niñas y adolescentes",2020,2,8,15918,50.2575700464882,3,8135,36.8776889981561,5,7783,64.2425799820121
32416,76,76834,81,"Tasa de exámenes médico legales por presunto delito sexual contra niños, niñas y adolescentes",2020,3,23,20490,112.249877989263,2,10401,19.2289202961254,21,10089,208.147487362474
32417,76,76834,81,"Tasa de exámenes médico legales por presunto delito sexual contra niños, niñas y adolescentes",2020,4,24,21732,110.436223081171,3,10981,27.3199162189236,21,10751,195.330666914706
32418,76,76834,121,Tasa de exámenes médico legales por presunto delito sexual cuando la víctima está entre 18 y 28 años,2020,5,11,37781,29.115163706625,0,18670,0,11,19111,57.5584741771754
32419,76,76845,81,"Tasa de exámenes médico legales por presunto delito sexual contra niños, niñas y adolescentes",2020,3,1,543,184.162062615101,1,291,343.642611683849,0,252,0
32420,76,76845,81,"Tasa de exámenes médico legales por presunto delito sexual contra niños, niñas y adolescentes",2020,4,1,554,180.505415162455,1,301,332.225913621262,0,253,0
32421,76,76845,121,Tasa de exámenes médico legales por presunto delito sexual cuando la víctima está entre 18 y 28 años,2020,5,1,816,122.549019607843,0,426,0,1,390,256.410256410256
32422,76,76863,81,"Tasa de exámenes médico legales por presunto delito sexual contra niños, niñas y adolescentes",2020,2,1,518,193.050193050193,1,256,390625,0,262,0
32423,76,76863,81,"Tasa de exámenes médico legales por presunto delito sexual contra niños, niñas y adolescentes",2020,3,1,659,151.745068285281,1,329,303.951367781155,0,330,0
32424,76,76869,81,"Tasa de exámenes médico legales por presunto delito sexual contra niños, niñas y adolescentes",2020,3,2,1193,167.644593461861,0,615,0,2,578,346.020761245675
32425,76,76869,81,"Tasa de exámenes médico legales por presunto delito sexual contra niños, niñas y adolescentes",2020,4,2,1218,164.203612479475,0,615,0,2,603,331.67495854063
32426,76,76869,121,Tasa de exámenes médico legales por presunto delito sexual cuando la víctima está entre 18 y 28 años,2020,5,1,2007,49.825610363727,0,1003,0,1,1004,99.601593625498
32427,76,76890,81,"Tasa de exámenes médico legales por presunto delito sexual contra niños, niñas y adolescentes",2020,2,1,1193,83.8222967309304,0,620,0,1,573,174.520069808028
32428,76,76890,81,"Tasa de exámenes médico legales por presunto delito sexual contra niños, niñas y adolescentes",2020,4,5,1613,309.981401115933,0,803,0,5,810,617.283950617284
32429,76,76892,81,"Tasa de exámenes médico legales por presunto delito sexual contra niños, niñas y adolescentes",2020,2,7,8444,82.8990999526291,2,4404,45.4132606721163,5,4040,123.762376237624
32430,76,76892,81,"Tasa de exámenes médico legales por presunto delito sexual contra niños, niñas y adolescentes",2020,3,14,10540,132.827324478178,3,5340,56.1797752808989,11,5200,211.538461538462
32431,76,76892,81,"Tasa de exámenes médico legales por presunto delito sexual contra niños, niñas y adolescentes",2020,4,20,11019,181.504673745349,0,5424,0,20,5595,357.462019660411
32432,76,76892,121,Tasa de exámenes médico legales por presunto delito sexual cuando la víctima está entre 18 y 28 años,2020,5,4,19975,20.0250312891114,0,9800,0,4,10175,39.3120393120393
32433,76,76895,81,"Tasa de exámenes médico legales por presunto delito sexual contra niños, niñas y adolescentes",2020,3,3,4168,71.9769673704415,0,2072,0,3,2096,143.129770992366
32434,76,76895,81,"Tasa de exámenes médico legales por presunto delito sexual contra niños, niñas y adolescentes",2020,4,5,4405,113.507377979569,2,2185,91.533180778032,3,2220,135.135135135135
32435,76,76895,121,Tasa de exámenes médico legales por presunto delito sexual cuando la víctima está entre 18 y 28 años,2020,5,3,7263,41.3052457662123,0,3565,0,3,3698,81.1249323958897
32436,97,97161,81,"Tasa de exámenes médico legales por presunto delito sexual contra niños, niñas y adolescentes",2020,4,1,622,160.771704180064,0,322,0,1,300,333.333333333333
32437,97,97001,81,"Tasa de exámenes médico legales por presunto delito sexual contra niños, niñas y adolescentes",2020,3,4,5843,68.4579839123738,2,2916,68.5871056241427,2,2927,68.3293474547318
32438,97,97001,81,"Tasa de exámenes médico legales por presunto delito sexual contra niños, niñas y adolescentes",2020,4,4,5458,73.2869182850861,0,2773,0,4,2685,148.975791433892
32439,97,97001,121,Tasa de exámenes médico legales por presunto delito sexual cuando la víctima está entre 18 y 28 años,2020,5,1,6277,15.9311773140035,0,3466,0,1,2811,35.5745286374956
32440,97,97001,81,"Tasa de exámenes médico legales por presunto delito sexual contra niños, niñas y adolescentes",2020,1,1,928,107.758620689655,0,478,0,1,450,222.222222222222
32441,99,99773,121,Tasa de exámenes médico legales por presunto delito sexual cuando la víctima está entre 18 y 28 años,2020,5,1,16034,6.23674691281028,0,8620,0,1,7414,13.4879956838414
32442,99,99001,81,"Tasa de exámenes médico legales por presunto delito sexual contra niños, niñas y adolescentes",2020,3,1,2331,42.9000429000429,0,1196,0,1,1135,88.1057268722467
