id,cdep,cmun,cindica,nomind,periodo,edadR,casos,poblacion,tasa,casosh,poblacionh,tasah,casosm,poblacionm,tasam
34982,91,91405,81,"Tasa de exámenes médico legales por presunto delito sexual contra niños, niñas y adolescentes",2022,3,1,636,157.232704402516,0,340,0,1,296,337.837837837838
34983,91,91405,81,"Tasa de exámenes médico legales por presunto delito sexual contra niños, niñas y adolescentes",2022,4,2,558,358.4229390681,0,302,0,2,256,781.25
34984,91,91407,81,"Tasa de exámenes médico legales por presunto delito sexual contra niños, niñas y adolescentes",2022,4,2,589,339.55857385399,0,297,0,2,292,684.931506849315
34985,91,91001,81,"Tasa de exámenes médico legales por presunto delito sexual contra niños, niñas y adolescentes",2022,2,5,5754,86.8960722975322,1,2958,33.8066260987153,4,2796,143.061516452074
34986,91,91001,81,"Tasa de exámenes médico legales por presunto delito sexual contra niños, niñas y adolescentes",2022,3,23,6983,329.371330373765,4,3545,112.834978843441,19,3438,552.646887725422
34987,91,91001,81,"Tasa de exámenes médico legales por presunto delito sexual contra niños, niñas y adolescentes",2022,4,43,6728,639.120095124851,7,3433,203.903291581707,36,3295,1092.56449165402
34988,91,91001,121,Tasa de exámenes médico legales por presunto delito sexual cuando la víctima está entre 18 y 28 años,2022,5,6,10631,56.4387169598344,1,5601,17.8539546509552,5,5030,99.403578528827
34989,91,91460,121,Tasa de exámenes médico legales por presunto delito sexual cuando la víctima está entre 18 y 28 años,2022,5,1,388,257.731958762887,0,239,0,1,149,671.140939597315
34990,91,91540,81,"Tasa de exámenes médico legales por presunto delito sexual contra niños, niñas y adolescentes",2022,2,1,1284,77.8816199376947,0,626,0,1,658,151.975683890577
34991,91,91540,81,"Tasa de exámenes médico legales por presunto delito sexual contra niños, niñas y adolescentes",2022,3,1,1636,61.1246943765281,0,833,0,1,803,124.53300124533
34992,91,91540,81,"Tasa de exámenes médico legales por presunto delito sexual contra niños, niñas y adolescentes",2022,4,2,1579,126.66244458518,0,809,0,2,770,259.74025974026
34993,91,91540,121,Tasa de exámenes médico legales por presunto delito sexual cuando la víctima está entre 18 y 28 años,2022,5,1,2162,46.2534690101758,0,1152,0,1,1010,99.009900990099
34994,91,91669,81,"Tasa de exámenes médico legales por presunto delito sexual contra niños, niñas y adolescentes",2022,3,1,324,308.641975308642,0,160,0,1,164,609.756097560976
34995,5,5002,81,"Tasa de exámenes médico legales por presunto delito sexual contra niños, niñas y adolescentes",2022,2,4,1282,312.01248049922,1,647,154.559505409583,3,635,472.44094488189
34996,5,5002,81,"Tasa de exámenes médico legales por presunto delito sexual contra niños, niñas y adolescentes",2022,3,2,1790,111.731843575419,0,939,0,2,851,235.017626321974
34997,5,5002,81,"Tasa de exámenes médico legales por presunto delito sexual contra niños, niñas y adolescentes",2022,4,11,1906,577.124868835257,0,1027,0,11,879,1251.4220705347
34998,5,5030,81,"Tasa de exámenes médico legales por presunto delito sexual contra niños, niñas y adolescentes",2022,2,3,1974,151.975683890577,2,1007,198.609731876862,1,967,103.412616339193
34999,5,5030,81,"Tasa de exámenes médico legales por presunto delito sexual contra niños, niñas y adolescentes",2022,3,9,2487,361.881785283474,1,1260,79.3650793650794,8,1227,651.9967400163
35000,5,5030,81,"Tasa de exámenes médico legales por presunto delito sexual contra niños, niñas y adolescentes",2022,4,10,2633,379.794910748196,0,1332,0,10,1301,768.639508070715
35001,5,5031,81,"Tasa de exámenes médico legales por presunto delito sexual contra niños, niñas y adolescentes",2022,2,1,2135,46.8384074941452,1,1091,91.6590284142988,0,1044,0
35002,5,5031,81,"Tasa de exámenes médico legales por presunto delito sexual contra niños, niñas y adolescentes",2022,3,3,2863,104.785190359762,0,1457,0,3,1406,213.371266002845
35003,5,5031,81,"Tasa de exámenes médico legales por presunto delito sexual contra niños, niñas y adolescentes",2022,4,6,2932,204.638472032742,0,1488,0,6,1444,415.512465373961
35004,5,5031,121,Tasa de exámenes médico legales por presunto delito sexual cuando la víctima está entre 18 y 28 años,2022,5,1,4904,20.3915171288744,0,2478,0,1,2426,41.2201154163232
35005,5,5034,81,"Tasa de exámenes médico legales por presunto delito sexual contra niños, niñas y adolescentes",2022,2,5,3085,162.074554294976,1,1616,61.8811881188119,4,1469,272.294077603812
35006,5,5034,81,"Tasa de exámenes médico legales por presunto delito sexual contra niños, niñas y adolescentes",2022,3,13,3833,339.15992695017,3,2012,149.105367793241,10,1821,549.148819330038
35007,5,5034,81,"Tasa de exámenes médico legales por presunto delito sexual contra niños, niñas y adolescentes",2022,4,11,3906,281.618023553507,0,2039,0,11,1867,589.180503481521
35008,5,5034,121,Tasa de exámenes médico legales por presunto delito sexual cuando la víctima está entre 18 y 28 años,2022,5,1,7922,12.6230749810654,0,4357,0,1,3565,28.0504908835905
35009,5,5036,81,"Tasa de exámenes médico legales por presunto delito sexual contra niños, niñas y adolescentes",2022,2,1,395,253.164556962025,0,216,0,1,179,558.659217877095
35010,5,5040,81,"Tasa de exámenes médico legales por presunto delito sexual contra niños, niñas y adolescentes",2022,2,2,1915,104.43864229765,0,947,0,2,968,206.611570247934
35011,5,5040,81,"Tasa de exámenes médico legales por presunto delito sexual contra niños, niñas y adolescentes",2022,3,8,2288,349.65034965035,1,1191,83.9630562552477,7,1097,638.103919781222
35012,5,5040,81,"Tasa de exámenes médico legales por presunto delito sexual contra niños, niñas y adolescentes",2022,4,10,2136,468.164794007491,1,1133,88.261253309797,9,1003,897.308075772682
35013,5,5040,121,Tasa de exámenes médico legales por presunto delito sexual cuando la víctima está entre 18 y 28 años,2022,5,1,3722,26.8672756582483,0,1962,0,1,1760,56.8181818181818
35014,5,5044,81,"Tasa de exámenes médico legales por presunto delito sexual contra niños, niñas y adolescentes",2022,3,1,755,132.450331125828,0,395,0,1,360,277.777777777778
35015,5,5044,81,"Tasa de exámenes médico legales por presunto delito sexual contra niños, niñas y adolescentes",2022,4,2,738,271.0027100271,0,383,0,2,355,563.380281690141
35016,5,5045,81,"Tasa de exámenes médico legales por presunto delito sexual contra niños, niñas y adolescentes",2022,2,2,11320,17.6678445229682,0,5809,0,2,5511,36.2910542551261
35017,5,5045,81,"Tasa de exámenes médico legales por presunto delito sexual contra niños, niñas y adolescentes",2022,3,14,14282,98.0254866265229,1,7290,13.7174211248285,13,6992,185.926773455378
35018,5,5045,81,"Tasa de exámenes médico legales por presunto delito sexual contra niños, niñas y adolescentes",2022,4,24,14029,171.07420343574,1,7047,14.1904356463743,23,6982,329.418504726439
35019,5,5045,121,Tasa de exámenes médico legales por presunto delito sexual cuando la víctima está entre 18 y 28 años,2022,5,5,25843,19.3475989629687,2,12615,15.85414189457,3,13228,22.679165406713
35020,5,5051,81,"Tasa de exámenes médico legales por presunto delito sexual contra niños, niñas y adolescentes",2022,3,1,3904,25.6147540983607,0,2047,0,1,1857,53.850296176629
35021,5,5051,81,"Tasa de exámenes médico legales por presunto delito sexual contra niños, niñas y adolescentes",2022,4,1,3568,28.0269058295964,0,1923,0,1,1645,60.790273556231
35022,5,5059,81,"Tasa de exámenes médico legales por presunto delito sexual contra niños, niñas y adolescentes",2022,4,2,394,507.614213197969,0,200,0,2,194,1030.92783505155
35023,5,5079,81,"Tasa de exámenes médico legales por presunto delito sexual contra niños, niñas y adolescentes",2022,2,2,3217,62.1697233447311,1,1601,62.4609618988132,1,1616,61.8811881188119
35024,5,5079,81,"Tasa de exámenes médico legales por presunto delito sexual contra niños, niñas y adolescentes",2022,3,7,4160,168.269230769231,0,2111,0,7,2049,341.630063445583
35025,5,5079,81,"Tasa de exámenes médico legales por presunto delito sexual contra niños, niñas y adolescentes",2022,4,19,4508,421.472937000887,1,2307,43.3463372345037,18,2201,817.810086324398
35026,5,5079,121,Tasa de exámenes médico legales por presunto delito sexual cuando la víctima está entre 18 y 28 años,2022,5,2,9538,20.9687565527364,0,4862,0,2,4676,42.7715996578272
35027,5,5088,81,"Tasa de exámenes médico legales por presunto delito sexual contra niños, niñas y adolescentes",2022,2,33,34277,96.2744697610643,8,17572,45.526974732529,25,16705,149.655791679138
35028,5,5088,81,"Tasa de exámenes médico legales por presunto delito sexual contra niños, niñas y adolescentes",2022,3,44,42662,103.136280530683,3,21737,13.8013525325482,41,20925,195.937873357228
35029,5,5088,81,"Tasa de exámenes médico legales por presunto delito sexual contra niños, niñas y adolescentes",2022,4,67,45527,147.165418323193,8,22920,34.9040139616056,59,22607,260.981112044942
35030,5,5088,121,Tasa de exámenes médico legales por presunto delito sexual cuando la víctima está entre 18 y 28 años,2022,5,17,111207,15.2868074851403,1,56190,1.77967609894999,16,55017,29.0819201337768
35031,5,5086,81,"Tasa de exámenes médico legales por presunto delito sexual contra niños, niñas y adolescentes",2022,2,1,489,204.498977505112,0,243,0,1,246,406.50406504065
35032,5,5086,81,"Tasa de exámenes médico legales por presunto delito sexual contra niños, niñas y adolescentes",2022,3,2,664,301.204819277108,0,333,0,2,331,604.229607250755
35033,5,5091,81,"Tasa de exámenes médico legales por presunto delito sexual contra niños, niñas y adolescentes",2022,2,2,795,251.572327044025,0,410,0,2,385,519.480519480519
35034,5,5091,81,"Tasa de exámenes médico legales por presunto delito sexual contra niños, niñas y adolescentes",2022,3,3,1066,281.425891181989,0,535,0,3,531,564.971751412429
35035,5,5091,81,"Tasa de exámenes médico legales por presunto delito sexual contra niños, niñas y adolescentes",2022,4,1,1093,91.4913083257091,0,549,0,1,544,183.823529411765
35036,5,5093,81,"Tasa de exámenes médico legales por presunto delito sexual contra niños, niñas y adolescentes",2022,2,3,1352,221.89349112426,2,694,288.184438040346,1,658,151.975683890577
35037,5,5093,81,"Tasa de exámenes médico legales por presunto delito sexual contra niños, niñas y adolescentes",2022,3,2,1725,115.942028985507,0,895,0,2,830,240.963855421687
35038,5,5093,81,"Tasa de exámenes médico legales por presunto delito sexual contra niños, niñas y adolescentes",2022,4,4,1719,232.693426410704,0,885,0,4,834,479.616306954436
35039,5,5093,121,Tasa de exámenes médico legales por presunto delito sexual cuando la víctima está entre 18 y 28 años,2022,5,1,2772,36.0750360750361,0,1429,0,1,1343,74.4601638123604
35040,5,5107,81,"Tasa de exámenes médico legales por presunto delito sexual contra niños, niñas y adolescentes",2022,3,3,1005,298.507462686567,1,534,187.265917602996,2,471,424.628450106157
35041,5,5107,81,"Tasa de exámenes médico legales por presunto delito sexual contra niños, niñas y adolescentes",2022,4,1,940,106.382978723404,0,508,0,1,432,231.481481481481
35042,5,5113,81,"Tasa de exámenes médico legales por presunto delito sexual contra niños, niñas y adolescentes",2022,4,1,1001,99.9000999000999,0,496,0,1,505,198.019801980198
35043,5,5120,81,"Tasa de exámenes médico legales por presunto delito sexual contra niños, niñas y adolescentes",2022,3,1,4164,24.0153698366955,0,2212,0,1,1952,51.2295081967213
35044,5,5120,81,"Tasa de exámenes médico legales por presunto delito sexual contra niños, niñas y adolescentes",2022,4,2,3669,54.5107658762606,0,1993,0,2,1676,119.331742243437
35045,5,5120,121,Tasa de exámenes médico legales por presunto delito sexual cuando la víctima está entre 18 y 28 años,2022,5,2,5124,39.032006245121,1,2654,37.6789751318764,1,2470,40.4858299595142
35046,5,5129,81,"Tasa de exámenes médico legales por presunto delito sexual contra niños, niñas y adolescentes",2022,2,13,4338,299.677270631627,4,2204,181.488203266788,9,2134,421.74320524836
35047,5,5129,81,"Tasa de exámenes médico legales por presunto delito sexual contra niños, niñas y adolescentes",2022,3,10,5573,179.436569172797,1,2809,35.5998576005696,9,2764,325.61505065123
35048,5,5129,81,"Tasa de exámenes médico legales por presunto delito sexual contra niños, niñas y adolescentes",2022,4,18,6180,291.26213592233,1,3079,32.478077297824,17,3101,548.21025475653
35049,5,5129,121,Tasa de exámenes médico legales por presunto delito sexual cuando la víctima está entre 18 y 28 años,2022,5,2,15247,13.1173345576179,0,7545,0,2,7702,25.9672812256557
35050,5,5134,81,"Tasa de exámenes médico legales por presunto delito sexual contra niños, niñas y adolescentes",2022,2,1,820,121.951219512195,0,407,0,1,413,242.130750605327
35051,5,5134,81,"Tasa de exámenes médico legales por presunto delito sexual contra niños, niñas y adolescentes",2022,3,4,1115,358.744394618834,0,596,0,4,519,770.712909441233
35052,5,5134,81,"Tasa de exámenes médico legales por presunto delito sexual contra niños, niñas y adolescentes",2022,4,3,1107,271.0027100271,1,596,167.785234899329,2,511,391.389432485323
35053,5,5138,81,"Tasa de exámenes médico legales por presunto delito sexual contra niños, niñas y adolescentes",2022,2,3,1233,243.30900243309,1,618,161.812297734628,2,615,325.20325203252
35054,5,5138,81,"Tasa de exámenes médico legales por presunto delito sexual contra niños, niñas y adolescentes",2022,3,5,1584,315.656565656566,1,784,127.551020408163,4,800,500
35055,5,5138,81,"Tasa de exámenes médico legales por presunto delito sexual contra niños, niñas y adolescentes",2022,4,5,1578,316.856780735108,0,779,0,5,799,625.782227784731
35056,5,5145,81,"Tasa de exámenes médico legales por presunto delito sexual contra niños, niñas y adolescentes",2022,3,1,379,263.852242744063,0,193,0,1,186,537.634408602151
35057,5,5147,81,"Tasa de exámenes médico legales por presunto delito sexual contra niños, niñas y adolescentes",2022,2,1,4834,20.6868018204386,0,2476,0,1,2358,42.4088210347752
35058,5,5147,81,"Tasa de exámenes médico legales por presunto delito sexual contra niños, niñas y adolescentes",2022,3,4,6142,65.1253663301856,0,3122,0,4,3020,132.450331125828
35059,5,5147,81,"Tasa de exámenes médico legales por presunto delito sexual contra niños, niñas y adolescentes",2022,4,8,6081,131.557309653018,1,3113,32.123353678124,7,2968,235.849056603774
35060,5,5147,121,Tasa de exámenes médico legales por presunto delito sexual cuando la víctima está entre 18 y 28 años,2022,5,1,10314,9.69555943377933,0,5227,0,1,5087,19.657951641439
35061,5,5150,81,"Tasa de exámenes médico legales por presunto delito sexual contra niños, niñas y adolescentes",2022,4,2,323,619.195046439629,0,163,0,2,160,1250
35062,5,5154,81,"Tasa de exámenes médico legales por presunto delito sexual contra niños, niñas y adolescentes",2022,2,8,9305,85.9752821063944,2,4768,41.9463087248322,6,4537,132.245977518184
35063,5,5154,81,"Tasa de exámenes médico legales por presunto delito sexual contra niños, niñas y adolescentes",2022,3,16,11369,140.733573753188,3,5791,51.8045242617855,13,5578,233.058443886698
35064,5,5154,81,"Tasa de exámenes médico legales por presunto delito sexual contra niños, niñas y adolescentes",2022,4,25,10558,236.787270316348,1,5286,18.9178963299281,24,5272,455.235204855842
35065,5,5154,121,Tasa de exámenes médico legales por presunto delito sexual cuando la víctima está entre 18 y 28 años,2022,5,10,17524,57.0645971239443,2,8470,23.6127508854782,8,9054,88.3587364700685
35066,5,5172,81,"Tasa de exámenes médico legales por presunto delito sexual contra niños, niñas y adolescentes",2022,2,3,5744,52.2284122562674,1,2957,33.8180588434224,2,2787,71.7617509867241
35067,5,5172,81,"Tasa de exámenes médico legales por presunto delito sexual contra niños, niñas y adolescentes",2022,3,3,7410,40.4858299595142,1,3780,26.4550264550265,2,3630,55.0964187327824
35068,5,5172,81,"Tasa de exámenes médico legales por presunto delito sexual contra niños, niñas y adolescentes",2022,4,17,7262,234.095290553566,2,3635,55.0206327372765,15,3627,413.564929693962
35069,5,5172,121,Tasa de exámenes médico legales por presunto delito sexual cuando la víctima está entre 18 y 28 años,2022,5,1,11955,8.36470096194061,0,5742,0,1,6213,16.095284081764
35070,5,5190,81,"Tasa de exámenes médico legales por presunto delito sexual contra niños, niñas y adolescentes",2022,2,2,638,313.479623824451,0,322,0,2,316,632.911392405063
35071,5,5190,81,"Tasa de exámenes médico legales por presunto delito sexual contra niños, niñas y adolescentes",2022,3,1,859,116.414435389988,0,428,0,1,431,232.018561484919
35072,5,5190,81,"Tasa de exámenes médico legales por presunto delito sexual contra niños, niñas y adolescentes",2022,4,7,865,809.248554913295,1,427,234.192037470726,6,438,1369.86301369863
35073,5,5190,121,Tasa de exámenes médico legales por presunto delito sexual cuando la víctima está entre 18 y 28 años,2022,5,2,1570,127.388535031847,1,758,131.926121372032,1,812,123.152709359606
35074,5,5101,81,"Tasa de exámenes médico legales por presunto delito sexual contra niños, niñas y adolescentes",2022,2,2,1845,108.40108401084,0,956,0,2,889,224.971878515186
35075,5,5101,81,"Tasa de exámenes médico legales por presunto delito sexual contra niños, niñas y adolescentes",2022,3,6,2451,244.798041615667,1,1278,78.2472613458529,5,1173,426.257459505541
35076,5,5101,81,"Tasa de exámenes médico legales por presunto delito sexual contra niños, niñas y adolescentes",2022,4,3,2491,120.433560818948,0,1294,0,3,1197,250.62656641604
35077,5,5197,81,"Tasa de exámenes médico legales por presunto delito sexual contra niños, niñas y adolescentes",2022,2,1,1384,72.2543352601156,0,710,0,1,674,148.367952522255
35078,5,5197,81,"Tasa de exámenes médico legales por presunto delito sexual contra niños, niñas y adolescentes",2022,3,4,1575,253.968253968254,0,792,0,4,783,510.855683269476
35079,5,5197,81,"Tasa de exámenes médico legales por presunto delito sexual contra niños, niñas y adolescentes",2022,4,2,1445,138.40830449827,0,710,0,2,735,272.108843537415
35080,5,5206,81,"Tasa de exámenes médico legales por presunto delito sexual contra niños, niñas y adolescentes",2022,3,2,423,472.813238770686,0,237,0,2,186,1075.2688172043
35081,5,5209,81,"Tasa de exámenes médico legales por presunto delito sexual contra niños, niñas y adolescentes",2022,2,1,1473,67.8886625933469,0,756,0,1,717,139.470013947001
35082,5,5209,81,"Tasa de exámenes médico legales por presunto delito sexual contra niños, niñas y adolescentes",2022,3,5,2028,246.5483234714,1,1040,96.1538461538462,4,988,404.858299595142
35083,5,5209,81,"Tasa de exámenes médico legales por presunto delito sexual contra niños, niñas y adolescentes",2022,4,7,2143,326.644890340644,1,1088,91.9117647058823,6,1055,568.720379146919
35084,5,5209,121,Tasa de exámenes médico legales por presunto delito sexual cuando la víctima está entre 18 y 28 años,2022,5,6,3591,167.084377610693,0,1790,0,6,1801,333.148250971682
35085,5,5212,81,"Tasa de exámenes médico legales por presunto delito sexual contra niños, niñas y adolescentes",2022,2,6,4262,140.7789770061,1,2167,46.1467466543609,5,2095,238.663484486874
35086,5,5212,81,"Tasa de exámenes médico legales por presunto delito sexual contra niños, niñas y adolescentes",2022,3,15,5584,268.624641833811,3,2865,104.712041884817,12,2719,441.338727473336
35087,5,5212,81,"Tasa de exámenes médico legales por presunto delito sexual contra niños, niñas y adolescentes",2022,4,24,6337,378.728104781442,4,3232,123.762376237624,20,3105,644.122383252818
35088,5,5212,121,Tasa de exámenes médico legales por presunto delito sexual cuando la víctima está entre 18 y 28 años,2022,5,6,15138,39.6353547364249,0,7661,0,6,7477,80.2460880032098
35089,5,5212,81,"Tasa de exámenes médico legales por presunto delito sexual contra niños, niñas y adolescentes",2022,1,1,773,129.366106080207,1,393,254.452926208651,0,380,0
35090,5,5234,81,"Tasa de exámenes médico legales por presunto delito sexual contra niños, niñas y adolescentes",2022,2,3,3041,98.6517592897073,0,1573,0,3,1468,204.359673024523
35091,5,5234,81,"Tasa de exámenes médico legales por presunto delito sexual contra niños, niñas y adolescentes",2022,3,4,3268,122.399020807834,2,1688,118.483412322275,2,1580,126.582278481013
35092,5,5234,81,"Tasa de exámenes médico legales por presunto delito sexual contra niños, niñas y adolescentes",2022,4,3,2704,110.94674556213,1,1375,72.7272727272727,2,1329,150.489089541008
35093,5,5237,81,"Tasa de exámenes médico legales por presunto delito sexual contra niños, niñas y adolescentes",2022,2,4,1442,277.392510402219,2,786,254.452926208651,2,656,304.878048780488
35094,5,5237,81,"Tasa de exámenes médico legales por presunto delito sexual contra niños, niñas y adolescentes",2022,3,6,1838,326.441784548422,0,928,0,6,910,659.340659340659
35095,5,5237,81,"Tasa de exámenes médico legales por presunto delito sexual contra niños, niñas y adolescentes",2022,4,6,1898,316.122233930453,2,901,221.975582685905,4,997,401.203610832497
35096,5,5240,81,"Tasa de exámenes médico legales por presunto delito sexual contra niños, niñas y adolescentes",2022,3,1,964,103.734439834025,0,487,0,1,477,209.643605870021
35097,5,5240,81,"Tasa de exámenes médico legales por presunto delito sexual contra niños, niñas y adolescentes",2022,4,1,1006,99.403578528827,0,543,0,1,463,215.982721382289
35098,5,5240,121,Tasa de exámenes médico legales por presunto delito sexual cuando la víctima está entre 18 y 28 años,2022,5,1,1597,62.6174076393237,0,847,0,1,750,133.333333333333
35099,5,5250,81,"Tasa de exámenes médico legales por presunto delito sexual contra niños, niñas y adolescentes",2022,3,6,7471,80.3105340650515,0,3769,0,6,3702,162.074554294976
35100,5,5250,81,"Tasa de exámenes médico legales por presunto delito sexual contra niños, niñas y adolescentes",2022,4,9,6703,134.268238102342,0,3401,0,9,3302,272.562083585706
35101,5,5148,81,"Tasa de exámenes médico legales por presunto delito sexual contra niños, niñas y adolescentes",2022,2,10,4833,206.910821435961,3,2462,121.852152721365,7,2371,295.234078447912
35102,5,5148,81,"Tasa de exámenes médico legales por presunto delito sexual contra niños, niñas y adolescentes",2022,3,14,5627,248.800426515017,3,2835,105.820105820106,11,2792,393.982808022923
35103,5,5148,81,"Tasa de exámenes médico legales por presunto delito sexual contra niños, niñas y adolescentes",2022,4,14,5512,253.991291727141,0,2738,0,14,2774,504.686373467916
35104,5,5148,121,Tasa de exámenes médico legales por presunto delito sexual cuando la víctima está entre 18 y 28 años,2022,5,5,11716,42.6766814612496,0,5876,0,5,5840,85.6164383561644
35105,5,5697,81,"Tasa de exámenes médico legales por presunto delito sexual contra niños, niñas y adolescentes",2022,3,3,3903,76.8639508070715,1,1997,50.0751126690035,2,1906,104.931794333683
35106,5,5697,81,"Tasa de exámenes médico legales por presunto delito sexual contra niños, niñas y adolescentes",2022,4,9,3545,253.878702397743,1,1776,56.3063063063063,8,1769,452.232899943471
35107,5,5697,121,Tasa de exámenes médico legales por presunto delito sexual cuando la víctima está entre 18 y 28 años,2022,5,3,6361,47.1623958497092,0,3024,0,3,3337,89.9011087803416
35108,5,5264,81,"Tasa de exámenes médico legales por presunto delito sexual contra niños, niñas y adolescentes",2022,3,2,1134,176.36684303351,1,540,185.185185185185,1,594,168.350168350168
35109,5,5264,81,"Tasa de exámenes médico legales por presunto delito sexual contra niños, niñas y adolescentes",2022,4,2,1118,178.890876565295,0,547,0,2,571,350.262697022767
35110,5,5264,121,Tasa de exámenes médico legales por presunto delito sexual cuando la víctima está entre 18 y 28 años,2022,5,2,2123,94.2063118228921,0,1086,0,2,1037,192.864030858245
35111,5,5266,81,"Tasa de exámenes médico legales por presunto delito sexual contra niños, niñas y adolescentes",2022,2,6,10355,57.9430226943506,2,5267,37.9722802354281,4,5088,78.6163522012579
35112,5,5266,81,"Tasa de exámenes médico legales por presunto delito sexual contra niños, niñas y adolescentes",2022,3,10,13266,75.3806723955978,1,6863,14.5708873670407,9,6403,140.559112915821
35113,5,5266,81,"Tasa de exámenes médico legales por presunto delito sexual contra niños, niñas y adolescentes",2022,4,16,14752,108.459869848156,2,7607,26.291573550677,14,7145,195.94121763471
35114,5,5266,121,Tasa de exámenes médico legales por presunto delito sexual cuando la víctima está entre 18 y 28 años,2022,5,6,38066,15.762097409762,1,18680,5.35331905781585,5,19386,25.7918085216135
35115,5,5282,81,"Tasa de exámenes médico legales por presunto delito sexual contra niños, niñas y adolescentes",2022,3,1,1886,53.0222693531283,0,934,0,1,952,105.042016806723
35116,5,5282,81,"Tasa de exámenes médico legales por presunto delito sexual contra niños, niñas y adolescentes",2022,4,3,2028,147.92899408284,0,1038,0,3,990,303.030303030303
35117,5,5284,81,"Tasa de exámenes médico legales por presunto delito sexual contra niños, niñas y adolescentes",2022,2,2,2360,84.7457627118644,1,1198,83.4724540901503,1,1162,86.0585197934596
35118,5,5284,81,"Tasa de exámenes médico legales por presunto delito sexual contra niños, niñas y adolescentes",2022,3,1,2559,39.0777647518562,0,1311,0,1,1248,80.1282051282051
35119,5,5284,81,"Tasa de exámenes médico legales por presunto delito sexual contra niños, niñas y adolescentes",2022,4,2,2199,90.9504320145521,0,1138,0,2,1061,188.501413760603
35120,5,5306,81,"Tasa de exámenes médico legales por presunto delito sexual contra niños, niñas y adolescentes",2022,3,10,627,1594.89633173844,3,316,949.367088607595,7,311,2250.8038585209
35121,5,5306,81,"Tasa de exámenes médico legales por presunto delito sexual contra niños, niñas y adolescentes",2022,4,8,572,1398.6013986014,1,282,354.609929078014,7,290,2413.79310344828
35122,5,5306,121,Tasa de exámenes médico legales por presunto delito sexual cuando la víctima está entre 18 y 28 años,2022,5,1,952,105.042016806723,0,471,0,1,481,207.900207900208
35123,5,5308,81,"Tasa de exámenes médico legales por presunto delito sexual contra niños, niñas y adolescentes",2022,2,1,3199,31.2597686777118,1,1681,59.4883997620464,0,1518,0
35124,5,5308,81,"Tasa de exámenes médico legales por presunto delito sexual contra niños, niñas y adolescentes",2022,3,1,4009,24.9438762783737,0,2073,0,1,1936,51.6528925619835
35125,5,5308,81,"Tasa de exámenes médico legales por presunto delito sexual contra niños, niñas y adolescentes",2022,4,9,4286,209.986000933271,1,2177,45.9347726228755,8,2109,379.326695116169
35126,5,5308,121,Tasa de exámenes médico legales por presunto delito sexual cuando la víctima está entre 18 y 28 años,2022,5,4,9899,40.4081220325285,0,5009,0,4,4890,81.799591002045
35127,5,5310,81,"Tasa de exámenes médico legales por presunto delito sexual contra niños, niñas y adolescentes",2022,2,2,611,327.332242225859,0,289,0,2,322,621.11801242236
35128,5,5310,81,"Tasa de exámenes médico legales por presunto delito sexual contra niños, niñas y adolescentes",2022,3,4,858,466.200466200466,0,442,0,4,416,961.538461538462
35129,5,5310,81,"Tasa de exámenes médico legales por presunto delito sexual contra niños, niñas y adolescentes",2022,4,5,871,574.052812858783,0,468,0,5,403,1240.69478908189
35130,5,5310,121,Tasa de exámenes médico legales por presunto delito sexual cuando la víctima está entre 18 y 28 años,2022,5,1,1401,71.3775874375446,1,712,140.449438202247,0,689,0
35131,5,5313,81,"Tasa de exámenes médico legales por presunto delito sexual contra niños, niñas y adolescentes",2022,2,1,1019,98.135426889107,0,535,0,1,484,206.611570247934
35132,5,5313,81,"Tasa de exámenes médico legales por presunto delito sexual contra niños, niñas y adolescentes",2022,4,2,1005,199.004975124378,1,525,190.47619047619,1,480,208.333333333333
35133,5,5318,81,"Tasa de exámenes médico legales por presunto delito sexual contra niños, niñas y adolescentes",2022,2,5,3693,135.391280801516,4,1952,204.918032786885,1,1741,57.4382538770821
35134,5,5318,81,"Tasa de exámenes médico legales por presunto delito sexual contra niños, niñas y adolescentes",2022,3,15,4285,350.058343057176,4,2260,176.991150442478,11,2025,543.20987654321
35135,5,5318,81,"Tasa de exámenes médico legales por presunto delito sexual contra niños, niñas y adolescentes",2022,4,13,4379,296.871431833752,1,2288,43.7062937062937,12,2091,573.888091822095
35136,5,5318,121,Tasa de exámenes médico legales por presunto delito sexual cuando la víctima está entre 18 y 28 años,2022,5,3,10304,29.1149068322981,1,5281,18.9358076121947,2,5023,39.8168425243878
35137,5,5321,81,"Tasa de exámenes médico legales por presunto delito sexual contra niños, niñas y adolescentes",2022,2,1,579,172.711571675302,0,288,0,1,291,343.642611683849
35138,5,5321,81,"Tasa de exámenes médico legales por presunto delito sexual contra niños, niñas y adolescentes",2022,3,1,706,141.643059490085,1,351,284.900284900285,0,355,0
35139,5,5321,121,Tasa de exámenes médico legales por presunto delito sexual cuando la víctima está entre 18 y 28 años,2022,5,1,1488,67.2043010752688,0,747,0,1,741,134.952766531714
35140,5,5347,121,Tasa de exámenes médico legales por presunto delito sexual cuando la víctima está entre 18 y 28 años,2022,5,1,792,126.262626262626,0,419,0,1,373,268.096514745308
35141,5,5353,81,"Tasa de exámenes médico legales por presunto delito sexual contra niños, niñas y adolescentes",2022,3,1,491,203.665987780041,0,235,0,1,256,390625
35142,5,5353,81,"Tasa de exámenes médico legales por presunto delito sexual contra niños, niñas y adolescentes",2022,4,3,489,613.496932515337,0,244,0,3,245,1224.48979591837
35143,5,5360,81,"Tasa de exámenes médico legales por presunto delito sexual contra niños, niñas y adolescentes",2022,2,20,15672,127.616130678918,5,8044,62.1581302834411,15,7628,196.643943366544
35144,5,5360,81,"Tasa de exámenes médico legales por presunto delito sexual contra niños, niñas y adolescentes",2022,3,27,19380,139.318885448916,7,9939,70.4296206861857,20,9441,211.841965893444
35145,5,5360,81,"Tasa de exámenes médico legales por presunto delito sexual contra niños, niñas y adolescentes",2022,4,43,21042,204.353198365174,1,10688,9.3562874251497,42,10354,405.640332238748
35146,5,5360,121,Tasa de exámenes médico legales por presunto delito sexual cuando la víctima está entre 18 y 28 años,2022,5,16,54678,29.2622261238524,1,27414,3.6477712117896,15,27264,55.0176056338028
35147,5,5361,81,"Tasa de exámenes médico legales por presunto delito sexual contra niños, niñas y adolescentes",2022,2,2,2017,99.1571641051066,0,982,0,2,1035,193.236714975845
35148,5,5361,81,"Tasa de exámenes médico legales por presunto delito sexual contra niños, niñas y adolescentes",2022,3,3,2616,114.678899082569,0,1350,0,3,1266,236.96682464455
35149,5,5361,81,"Tasa de exámenes médico legales por presunto delito sexual contra niños, niñas y adolescentes",2022,4,4,2605,153.550863723608,0,1390,0,4,1215,329.218106995885
35150,5,5364,81,"Tasa de exámenes médico legales por presunto delito sexual contra niños, niñas y adolescentes",2022,2,3,953,314.795383001049,0,491,0,3,462,649.350649350649
35151,5,5364,81,"Tasa de exámenes médico legales por presunto delito sexual contra niños, niñas y adolescentes",2022,3,10,1226,815.660685154975,5,631,792.393026941363,5,595,840.336134453781
35152,5,5364,81,"Tasa de exámenes médico legales por presunto delito sexual contra niños, niñas y adolescentes",2022,4,5,1268,394.321766561514,1,673,148.588410104012,4,595,672.268907563025
35153,5,5364,121,Tasa de exámenes médico legales por presunto delito sexual cuando la víctima está entre 18 y 28 años,2022,5,2,2375,84.2105263157895,0,1272,0,2,1103,181.323662737987
35154,5,5368,81,"Tasa de exámenes médico legales por presunto delito sexual contra niños, niñas y adolescentes",2022,2,4,789,506.970849176172,1,403,248.138957816377,3,386,777.20207253886
35155,5,5368,81,"Tasa de exámenes médico legales por presunto delito sexual contra niños, niñas y adolescentes",2022,3,8,1057,756.85903500473,3,543,552.486187845304,5,514,972.762645914397
35156,5,5368,81,"Tasa de exámenes médico legales por presunto delito sexual contra niños, niñas y adolescentes",2022,4,7,1111,630.06300630063,0,561,0,7,550,1272.72727272727
35157,5,5368,121,Tasa de exámenes médico legales por presunto delito sexual cuando la víctima está entre 18 y 28 años,2022,5,2,2015,99.2555831265509,0,1027,0,2,988,202.429149797571
35158,5,5376,81,"Tasa de exámenes médico legales por presunto delito sexual contra niños, niñas y adolescentes",2022,2,12,4036,297.324083250743,3,1999,150.075037518759,9,2037,441.826215022091
35159,5,5376,81,"Tasa de exámenes médico legales por presunto delito sexual contra niños, niñas y adolescentes",2022,3,14,5287,264.800453943635,7,2670,262.172284644195,7,2617,267.48184944593
35160,5,5376,81,"Tasa de exámenes médico legales por presunto delito sexual contra niños, niñas y adolescentes",2022,4,18,5731,314.081312161926,3,2920,102.739726027397,15,2811,533.617929562433
35161,5,5376,121,Tasa de exámenes médico legales por presunto delito sexual cuando la víctima está entre 18 y 28 años,2022,5,2,12398,16.1316341345378,0,6246,0,2,6152,32.5097529258778
35162,5,5380,81,"Tasa de exámenes médico legales por presunto delito sexual contra niños, niñas y adolescentes",2022,2,3,4142,72.4287783679382,1,2115,47.2813238770686,2,2027,98.6679822397632
35163,5,5380,81,"Tasa de exámenes médico legales por presunto delito sexual contra niños, niñas y adolescentes",2022,3,3,5213,57.5484366008057,1,2706,36.9549150036955,2,2507,79.7766254487435
35164,5,5380,81,"Tasa de exámenes médico legales por presunto delito sexual contra niños, niñas y adolescentes",2022,4,11,5646,194.828196953595,0,2937,0,11,2709,406.053894425987
35165,5,5380,121,Tasa de exámenes médico legales por presunto delito sexual cuando la víctima está entre 18 y 28 años,2022,5,2,13851,14.4393906577142,1,6998,14.2897970848814,1,6853,14.5921494236101
35166,5,5390,81,"Tasa de exámenes médico legales por presunto delito sexual contra niños, niñas y adolescentes",2022,4,1,817,122.399020807834,0,427,0,1,390,256.410256410256
35167,5,5400,81,"Tasa de exámenes médico legales por presunto delito sexual contra niños, niñas y adolescentes",2022,2,2,1563,127.959053103007,0,788,0,2,775,258.064516129032
35168,5,5400,81,"Tasa de exámenes médico legales por presunto delito sexual contra niños, niñas y adolescentes",2022,3,2,2003,99.8502246630055,0,1027,0,2,976,204.918032786885
35169,5,5400,81,"Tasa de exámenes médico legales por presunto delito sexual contra niños, niñas y adolescentes",2022,4,6,2115,283.687943262411,1,1082,92.4214417744917,5,1033,484.027105517909
35170,5,5425,81,"Tasa de exámenes médico legales por presunto delito sexual contra niños, niñas y adolescentes",2022,4,1,789,126.742712294043,0,398,0,1,391,255.754475703325
35171,5,5425,121,Tasa de exámenes médico legales por presunto delito sexual cuando la víctima está entre 18 y 28 años,2022,5,3,1283,233.826968043648,0,636,0,3,647,463.678516228748
35172,5,5440,81,"Tasa de exámenes médico legales por presunto delito sexual contra niños, niñas y adolescentes",2022,2,3,5036,59.5710881652105,0,2642,0,3,2394,125.31328320802
35173,5,5440,81,"Tasa de exámenes médico legales por presunto delito sexual contra niños, niñas y adolescentes",2022,3,2,6020,33.2225913621262,0,3121,0,2,2899,68.9893066574681
35174,5,5440,81,"Tasa de exámenes médico legales por presunto delito sexual contra niños, niñas y adolescentes",2022,4,8,6033,132.604011271341,0,3058,0,8,2975,268.90756302521
35175,5,5440,121,Tasa de exámenes médico legales por presunto delito sexual cuando la víctima está entre 18 y 28 años,2022,5,1,12824,7.79787897691828,0,6400,0,1,6424,15.5666251556663
35176,5,5001,81,"Tasa de exámenes médico legales por presunto delito sexual contra niños, niñas y adolescentes",2022,2,126,144731,87.058059434399,36,73752,48.8122356003905,90,70979,126.798067033911
35177,5,5001,81,"Tasa de exámenes médico legales por presunto delito sexual contra niños, niñas y adolescentes",2022,3,202,183698,109.963091595989,45,93433,48.1628546659103,157,90265,173.932310419321
35178,5,5001,81,"Tasa de exámenes médico legales por presunto delito sexual contra niños, niñas y adolescentes",2022,4,358,201047,178.067814988535,39,101775,38.3198231392778,319,99272,321.339350471432
35179,5,5001,121,Tasa de exámenes médico legales por presunto delito sexual cuando la víctima está entre 18 y 28 años,2022,5,148,492680,30.039782414549,11,247629,4.44212915288597,137,245051,55.9067296195486
35180,5,5001,81,"Tasa de exámenes médico legales por presunto delito sexual contra niños, niñas y adolescentes",2022,1,1,26093,3.832445483463,1,13354,7.48839299086416,0,12739,0
35181,5,5467,81,"Tasa de exámenes médico legales por presunto delito sexual contra niños, niñas y adolescentes",2022,2,1,424,235.849056603774,0,200,0,1,224,446.428571428571
35182,5,5467,81,"Tasa de exámenes médico legales por presunto delito sexual contra niños, niñas y adolescentes",2022,3,1,561,178.25311942959,0,277,0,1,284,352.112676056338
35183,5,5467,81,"Tasa de exámenes médico legales por presunto delito sexual contra niños, niñas y adolescentes",2022,4,5,568,880.281690140845,0,292,0,5,276,1811.59420289855
35184,5,5467,121,Tasa de exámenes médico legales por presunto delito sexual cuando la víctima está entre 18 y 28 años,2022,5,1,910,109.89010989011,0,483,0,1,427,234.192037470726
35185,5,5475,81,"Tasa de exámenes médico legales por presunto delito sexual contra niños, niñas y adolescentes",2022,4,1,645,155.038759689922,0,333,0,1,312,320.51282051282
35186,5,5480,81,"Tasa de exámenes médico legales por presunto delito sexual contra niños, niñas y adolescentes",2022,3,2,2035,98.2800982800983,0,1051,0,2,984,203.252032520325
35187,5,5480,81,"Tasa de exámenes médico legales por presunto delito sexual contra niños, niñas y adolescentes",2022,4,6,1737,345.423143350604,0,910,0,6,827,725.513905683192
35188,5,5480,121,Tasa de exámenes médico legales por presunto delito sexual cuando la víctima está entre 18 y 28 años,2022,5,1,2602,38.4319754035357,0,1301,0,1,1301,76.8639508070715
35189,5,5483,81,"Tasa de exámenes médico legales por presunto delito sexual contra niños, niñas y adolescentes",2022,4,2,1095,182.648401826484,0,575,0,2,520,384.615384615385
35190,5,5495,81,"Tasa de exámenes médico legales por presunto delito sexual contra niños, niñas y adolescentes",2022,3,2,3750,53.3333333333333,0,1900,0,2,1850,108.108108108108
35191,5,5495,81,"Tasa de exámenes médico legales por presunto delito sexual contra niños, niñas y adolescentes",2022,4,2,3251,61.5195324515534,0,1662,0,2,1589,125.86532410321
35192,5,5490,81,"Tasa de exámenes médico legales por presunto delito sexual contra niños, niñas y adolescentes",2022,3,5,6055,82.5763831544178,0,3125,0,5,2930,170.648464163823
35193,5,5490,81,"Tasa de exámenes médico legales por presunto delito sexual contra niños, niñas y adolescentes",2022,4,14,5479,255.52108048914,0,2821,0,14,2658,526.711813393529
35194,5,5490,121,Tasa de exámenes médico legales por presunto delito sexual cuando la víctima está entre 18 y 28 años,2022,5,1,7626,13.11303435615,0,3619,0,1,4007,24.9563264287497
35195,5,5541,81,"Tasa de exámenes médico legales por presunto delito sexual contra niños, niñas y adolescentes",2022,2,1,1610,62.111801242236,0,795,0,1,815,122.699386503067
35196,5,5541,81,"Tasa de exámenes médico legales por presunto delito sexual contra niños, niñas y adolescentes",2022,3,2,1910,104.712041884817,0,961,0,2,949,210.748155953635
35197,5,5541,81,"Tasa de exámenes médico legales por presunto delito sexual contra niños, niñas y adolescentes",2022,4,1,1835,54.4959128065395,0,932,0,1,903,110.741971207087
35198,5,5541,121,Tasa de exámenes médico legales por presunto delito sexual cuando la víctima está entre 18 y 28 años,2022,5,1,3629,27.5558004960044,0,1796,0,1,1833,54.5553737043099
35199,5,5543,81,"Tasa de exámenes médico legales por presunto delito sexual contra niños, niñas y adolescentes",2022,4,1,903,110.741971207087,0,491,0,1,412,242.718446601942
35200,5,5579,81,"Tasa de exámenes médico legales por presunto delito sexual contra niños, niñas y adolescentes",2022,2,2,3040,65.7894736842105,0,1548,0,2,1492,134.048257372654
35201,5,5579,81,"Tasa de exámenes médico legales por presunto delito sexual contra niños, niñas y adolescentes",2022,3,3,3900,76.9230769230769,0,1991,0,3,1909,157.150340492404
35202,5,5579,81,"Tasa de exámenes médico legales por presunto delito sexual contra niños, niñas y adolescentes",2022,4,15,3861,388.500388500389,1,1964,50.9164969450102,14,1897,738.007380073801
35203,5,5579,121,Tasa de exámenes médico legales por presunto delito sexual cuando la víctima está entre 18 y 28 años,2022,5,1,7422,13.4734572891404,0,3837,0,1,3585,27.8940027894003
35204,5,5579,81,"Tasa de exámenes médico legales por presunto delito sexual contra niños, niñas y adolescentes",2022,1,1,550,181.818181818182,0,281,0,1,269,371.747211895911
35205,5,5585,81,"Tasa de exámenes médico legales por presunto delito sexual contra niños, niñas y adolescentes",2022,2,1,1138,87.8734622144112,0,567,0,1,571,175.131348511384
35206,5,5585,81,"Tasa de exámenes médico legales por presunto delito sexual contra niños, niñas y adolescentes",2022,4,3,1369,219.138056975895,0,700,0,3,669,448.430493273543
35207,5,5585,121,Tasa de exámenes médico legales por presunto delito sexual cuando la víctima está entre 18 y 28 años,2022,5,1,2061,48.5201358563804,0,1033,0,1,1028,97.2762645914397
35208,5,5591,81,"Tasa de exámenes médico legales por presunto delito sexual contra niños, niñas y adolescentes",2022,2,1,1608,62.1890547263682,0,811,0,1,797,125.470514429109
35209,5,5591,81,"Tasa de exámenes médico legales por presunto delito sexual contra niños, niñas y adolescentes",2022,3,12,1815,661.157024793388,0,930,0,12,885,1355.93220338983
35210,5,5591,81,"Tasa de exámenes médico legales por presunto delito sexual contra niños, niñas y adolescentes",2022,4,7,1708,409.83606557377,2,883,226.500566251416,5,825,606.060606060606
35211,5,5591,121,Tasa de exámenes médico legales por presunto delito sexual cuando la víctima está entre 18 y 28 años,2022,5,4,3885,102.960102960103,0,2302,0,4,1583,252.684775742262
35212,5,5604,81,"Tasa de exámenes médico legales por presunto delito sexual contra niños, niñas y adolescentes",2022,3,1,3532,28.312570781427,0,1819,0,1,1713,58.3771161704612
35213,5,5604,81,"Tasa de exámenes médico legales por presunto delito sexual contra niños, niñas y adolescentes",2022,4,1,3219,31.0655483069276,0,1642,0,1,1577,63.4115409004439
35214,5,5607,81,"Tasa de exámenes médico legales por presunto delito sexual contra niños, niñas y adolescentes",2022,2,2,1453,137.646249139711,1,764,130.890052356021,1,689,145.137880986938
35215,5,5607,81,"Tasa de exámenes médico legales por presunto delito sexual contra niños, niñas y adolescentes",2022,3,5,1789,279.485746226942,1,933,107.181136120043,4,856,467.289719626168
35216,5,5607,81,"Tasa de exámenes médico legales por presunto delito sexual contra niños, niñas y adolescentes",2022,4,6,1814,330.760749724366,3,941,318.809776833156,3,873,343.642611683849
35217,5,5607,121,Tasa de exámenes médico legales por presunto delito sexual cuando la víctima está entre 18 y 28 años,2022,5,1,3867,25.8598396689941,0,1944,0,1,1923,52.0020800832033
35218,5,5615,81,"Tasa de exámenes médico legales por presunto delito sexual contra niños, niñas y adolescentes",2022,2,6,8130,73.8007380073801,0,4117,0,6,4013,149.514079242462
35219,5,5615,81,"Tasa de exámenes médico legales por presunto delito sexual contra niños, niñas y adolescentes",2022,3,17,10161,167.306367483515,2,5212,38.3729854182655,15,4949,303.09153364316
35220,5,5615,81,"Tasa de exámenes médico legales por presunto delito sexual contra niños, niñas y adolescentes",2022,4,27,11101,243.221331411585,1,5788,17.2771250863856,26,5313,489.365706757011
35221,5,5615,121,Tasa de exámenes médico legales por presunto delito sexual cuando la víctima está entre 18 y 28 años,2022,5,2,26443,7.56343833906894,0,13710,0,2,12733,15.7072174664258
35222,5,5628,81,"Tasa de exámenes médico legales por presunto delito sexual contra niños, niñas y adolescentes",2022,3,2,1060,188.679245283019,1,540,185.185185185185,1,520,192.307692307692
35223,5,5631,81,"Tasa de exámenes médico legales por presunto delito sexual contra niños, niñas y adolescentes",2022,2,7,4743,147.585916086865,2,2445,81.799591002045,5,2298,217.580504786771
35224,5,5631,81,"Tasa de exámenes médico legales por presunto delito sexual contra niños, niñas y adolescentes",2022,3,5,5161,96.8804495252858,1,2668,37.4812593703148,4,2493,160.449257922182
35225,5,5631,81,"Tasa de exámenes médico legales por presunto delito sexual contra niños, niñas y adolescentes",2022,4,7,5049,138.641315111903,2,2553,78.3392087739914,5,2496,200.320512820513
35226,5,5631,121,Tasa de exámenes médico legales por presunto delito sexual cuando la víctima está entre 18 y 28 años,2022,5,4,15262,26.2088848119513,0,7326,0,4,7936,50.4032258064516
35227,5,5642,81,"Tasa de exámenes médico legales por presunto delito sexual contra niños, niñas y adolescentes",2022,2,4,1379,290.065264684554,2,681,293.685756240822,2,698,286.532951289398
35228,5,5642,81,"Tasa de exámenes médico legales por presunto delito sexual contra niños, niñas y adolescentes",2022,3,8,1732,461.89376443418,1,851,117.508813160987,7,881,794.551645856981
35229,5,5642,81,"Tasa de exámenes médico legales por presunto delito sexual contra niños, niñas y adolescentes",2022,4,7,1757,398.406374501992,0,871,0,7,886,790.067720090294
35230,5,5642,121,Tasa de exámenes médico legales por presunto delito sexual cuando la víctima está entre 18 y 28 años,2022,5,2,3140,63.6942675159236,0,1592,0,2,1548,129.198966408269
35231,5,5647,81,"Tasa de exámenes médico legales por presunto delito sexual contra niños, niñas y adolescentes",2022,2,1,720,138.888888888889,0,369,0,1,351,284.900284900285
35232,5,5647,81,"Tasa de exámenes médico legales por presunto delito sexual contra niños, niñas y adolescentes",2022,3,3,851,352.526439482961,1,439,227.790432801822,2,412,485.436893203883
35233,5,5647,81,"Tasa de exámenes médico legales por presunto delito sexual contra niños, niñas y adolescentes",2022,4,4,789,506.970849176172,1,409,244.498777506112,3,380,789.473684210526
35234,5,5649,81,"Tasa de exámenes médico legales por presunto delito sexual contra niños, niñas y adolescentes",2022,3,4,1628,245.700245700246,0,839,0,4,789,506.970849176172
35235,5,5649,81,"Tasa de exámenes médico legales por presunto delito sexual contra niños, niñas y adolescentes",2022,4,3,1565,191.693290734824,0,829,0,3,736,407.608695652174
35236,5,5656,81,"Tasa de exámenes médico legales por presunto delito sexual contra niños, niñas y adolescentes",2022,2,1,1105,90.4977375565611,0,503,0,1,602,166.112956810631
35237,5,5656,81,"Tasa de exámenes médico legales por presunto delito sexual contra niños, niñas y adolescentes",2022,3,2,1405,142.348754448399,0,690,0,2,715,279.72027972028
35238,5,5656,81,"Tasa de exámenes médico legales por presunto delito sexual contra niños, niñas y adolescentes",2022,4,4,1425,280.701754385965,0,724,0,4,701,570.613409415121
35239,5,5656,121,Tasa de exámenes médico legales por presunto delito sexual cuando la víctima está entre 18 y 28 años,2022,5,2,2730,73.2600732600733,0,1378,0,2,1352,147.92899408284
35240,5,5658,81,"Tasa de exámenes médico legales por presunto delito sexual contra niños, niñas y adolescentes",2022,3,3,418,717.703349282297,2,176,1136.36363636364,1,242,413.223140495868
35241,5,5658,81,"Tasa de exámenes médico legales por presunto delito sexual contra niños, niñas y adolescentes",2022,4,1,437,228.83295194508,0,202,0,1,235,425.531914893617
35242,5,5659,81,"Tasa de exámenes médico legales por presunto delito sexual contra niños, niñas y adolescentes",2022,4,1,2593,38.5653682992673,0,1324,0,1,1269,78.8022064617809
35243,5,5660,81,"Tasa de exámenes médico legales por presunto delito sexual contra niños, niñas y adolescentes",2022,2,3,1331,225.394440270473,0,672,0,3,659,455.235204855842
35244,5,5660,81,"Tasa de exámenes médico legales por presunto delito sexual contra niños, niñas y adolescentes",2022,3,5,1550,322.58064516129,1,794,125.944584382872,4,756,529.100529100529
35245,5,5660,81,"Tasa de exámenes médico legales por presunto delito sexual contra niños, niñas y adolescentes",2022,4,4,1361,293.901542983101,0,700,0,4,661,605.143721633888
35246,5,5660,121,Tasa de exámenes médico legales por presunto delito sexual cuando la víctima está entre 18 y 28 años,2022,5,1,2177,45.9347726228755,0,1076,0,1,1101,90.8265213442325
35247,5,5664,81,"Tasa de exámenes médico legales por presunto delito sexual contra niños, niñas y adolescentes",2022,2,3,1669,179.748352306771,2,833,240.096038415366,1,836,119.617224880383
35248,5,5664,81,"Tasa de exámenes médico legales por presunto delito sexual contra niños, niñas y adolescentes",2022,3,3,2103,142.65335235378,0,1061,0,3,1042,287.907869481766
35249,5,5664,81,"Tasa de exámenes médico legales por presunto delito sexual contra niños, niñas y adolescentes",2022,4,8,2172,368.324125230203,0,1088,0,8,1084,738.007380073801
35250,5,5664,121,Tasa de exámenes médico legales por presunto delito sexual cuando la víctima está entre 18 y 28 años,2022,5,4,4244,94.2507068803016,0,2095,0,4,2149,186.133085155886
35251,5,5667,81,"Tasa de exámenes médico legales por presunto delito sexual contra niños, niñas y adolescentes",2022,2,1,1190,84.0336134453782,1,621,161.030595813205,0,569,0
35252,5,5667,81,"Tasa de exámenes médico legales por presunto delito sexual contra niños, niñas y adolescentes",2022,3,3,1460,205.479452054795,0,777,0,3,683,439.238653001464
35253,5,5667,81,"Tasa de exámenes médico legales por presunto delito sexual contra niños, niñas y adolescentes",2022,4,4,1444,277.008310249307,0,765,0,4,679,589.101620029455
35254,5,5670,81,"Tasa de exámenes médico legales por presunto delito sexual contra niños, niñas y adolescentes",2022,2,2,1730,115.606936416185,1,851,117.508813160987,1,879,113.765642775882
35255,5,5670,81,"Tasa de exámenes médico legales por presunto delito sexual contra niños, niñas y adolescentes",2022,3,4,2175,183.908045977011,0,1100,0,4,1075,372.093023255814
35256,5,5670,81,"Tasa de exámenes médico legales por presunto delito sexual contra niños, niñas y adolescentes",2022,4,2,2129,93.9408172851104,0,1095,0,2,1034,193.423597678917
35257,5,5670,121,Tasa de exámenes médico legales por presunto delito sexual cuando la víctima está entre 18 y 28 años,2022,5,1,3571,28.0033604032484,0,1835,0,1,1736,57.6036866359447
35258,5,5674,81,"Tasa de exámenes médico legales por presunto delito sexual contra niños, niñas y adolescentes",2022,4,1,2021,49.480455220188,0,1101,0,1,920,108.695652173913
35259,5,5679,81,"Tasa de exámenes médico legales por presunto delito sexual contra niños, niñas y adolescentes",2022,2,2,1473,135.777325186694,0,761,0,2,712,280.898876404494
35260,5,5679,81,"Tasa de exámenes médico legales por presunto delito sexual contra niños, niñas y adolescentes",2022,3,2,2096,95.4198473282443,1,1100,90.9090909090909,1,996,100.401606425703
35261,5,5679,81,"Tasa de exámenes médico legales por presunto delito sexual contra niños, niñas y adolescentes",2022,4,5,2285,218.818380743982,0,1207,0,5,1078,463.821892393321
35262,5,5679,81,"Tasa de exámenes médico legales por presunto delito sexual contra niños, niñas y adolescentes",2022,1,1,266,375.93984962406,0,137,0,1,129,775.193798449612
35263,5,5042,81,"Tasa de exámenes médico legales por presunto delito sexual contra niños, niñas y adolescentes",2022,2,5,1926,259.605399792316,2,974,205.338809034908,3,952,315.126050420168
35264,5,5042,81,"Tasa de exámenes médico legales por presunto delito sexual contra niños, niñas y adolescentes",2022,3,7,2501,279.888044782087,0,1286,0,7,1215,576.131687242798
35265,5,5042,81,"Tasa de exámenes médico legales por presunto delito sexual contra niños, niñas y adolescentes",2022,4,17,2558,664.581704456607,2,1321,151.400454201363,15,1237,1212.61115602264
35266,5,5042,121,Tasa de exámenes médico legales por presunto delito sexual cuando la víctima está entre 18 y 28 años,2022,5,4,4839,82.6617069642488,0,2430,0,4,2409,166.04400166044
35267,5,5686,81,"Tasa de exámenes médico legales por presunto delito sexual contra niños, niñas y adolescentes",2022,2,1,3015,33.167495854063,0,1525,0,1,1490,67.1140939597315
35268,5,5686,81,"Tasa de exámenes médico legales por presunto delito sexual contra niños, niñas y adolescentes",2022,3,4,3749,106.69511869832,1,1879,53.2197977647685,3,1870,160.427807486631
35269,5,5686,81,"Tasa de exámenes médico legales por presunto delito sexual contra niños, niñas y adolescentes",2022,4,9,3799,236.904448539089,1,1898,52.6870389884089,8,1901,420.831141504471
35270,5,5690,81,"Tasa de exámenes médico legales por presunto delito sexual contra niños, niñas y adolescentes",2022,2,2,821,243.605359317905,0,413,0,2,408,490.196078431373
35271,5,5690,81,"Tasa de exámenes médico legales por presunto delito sexual contra niños, niñas y adolescentes",2022,3,1,1090,91.743119266055,1,564,177.304964539007,0,526,0
35272,5,5690,81,"Tasa de exámenes médico legales por presunto delito sexual contra niños, niñas y adolescentes",2022,4,3,1115,269.058295964126,0,587,0,3,528,568.181818181818
35273,5,5736,81,"Tasa de exámenes médico legales por presunto delito sexual contra niños, niñas y adolescentes",2022,2,3,3713,80.7971990304336,0,1900,0,3,1813,165.471594043023
35274,5,5736,81,"Tasa de exámenes médico legales por presunto delito sexual contra niños, niñas y adolescentes",2022,3,5,4453,112.283853581855,1,2283,43.8020148926851,4,2170,184.331797235023
35275,5,5736,81,"Tasa de exámenes médico legales por presunto delito sexual contra niños, niñas y adolescentes",2022,4,7,4294,163.01816488123,0,2206,0,7,2088,335.249042145594
35276,5,5736,121,Tasa de exámenes médico legales por presunto delito sexual cuando la víctima está entre 18 y 28 años,2022,5,1,8050,12.4223602484472,0,4067,0,1,3983,25.1067034898318
35277,5,5756,81,"Tasa de exámenes médico legales por presunto delito sexual contra niños, niñas y adolescentes",2022,2,3,2673,112.233445566779,1,1392,71.8390804597701,2,1281,156.128024980484
35278,5,5756,81,"Tasa de exámenes médico legales por presunto delito sexual contra niños, niñas y adolescentes",2022,3,8,3506,228.180262407302,0,1808,0,8,1698,471.142520612485
35279,5,5756,81,"Tasa de exámenes médico legales por presunto delito sexual contra niños, niñas y adolescentes",2022,4,12,3631,330.4874690168,1,1858,53.8213132400431,11,1773,620.417371686407
35280,5,5756,121,Tasa de exámenes médico legales por presunto delito sexual cuando la víctima está entre 18 y 28 años,2022,5,5,6352,78.7153652392947,0,3313,0,5,3039,164.527805199079
35281,5,5761,81,"Tasa de exámenes médico legales por presunto delito sexual contra niños, niñas y adolescentes",2022,2,1,1071,93.3706816059757,0,508,0,1,563,177.619893428064
35282,5,5761,81,"Tasa de exámenes médico legales por presunto delito sexual contra niños, niñas y adolescentes",2022,3,3,1324,226.586102719033,1,645,155.038759689922,2,679,294.550810014728
35283,5,5761,81,"Tasa de exámenes médico legales por presunto delito sexual contra niños, niñas y adolescentes",2022,4,1,1311,76.27765064836,0,666,0,1,645,155.038759689922
35284,5,5761,121,Tasa de exámenes médico legales por presunto delito sexual cuando la víctima está entre 18 y 28 años,2022,5,2,2539,78.7711697518708,0,1294,0,2,1245,160.642570281125
35285,5,5790,81,"Tasa de exámenes médico legales por presunto delito sexual contra niños, niñas y adolescentes",2022,2,2,3026,66.0938532716457,1,1541,64.8929266709929,1,1485,67.3400673400673
35286,5,5790,81,"Tasa de exámenes médico legales por presunto delito sexual contra niños, niñas y adolescentes",2022,3,4,3803,105.180120957139,1,1944,51.440329218107,3,1859,161.377084454008
35287,5,5790,81,"Tasa de exámenes médico legales por presunto delito sexual contra niños, niñas y adolescentes",2022,4,13,3510,370.37037037037,1,1785,56.0224089635854,12,1725,695.652173913043
35288,5,5790,121,Tasa de exámenes médico legales por presunto delito sexual cuando la víctima está entre 18 y 28 años,2022,5,3,4793,62.5912789484665,1,2351,42.5350914504466,2,2442,81.9000819000819
35289,5,5792,81,"Tasa de exámenes médico legales por presunto delito sexual contra niños, niñas y adolescentes",2022,3,2,555,360.36036036036,2,282,709.219858156028,0,273,0
35290,5,5809,81,"Tasa de exámenes médico legales por presunto delito sexual contra niños, niñas y adolescentes",2022,3,1,822,121.654501216545,0,410,0,1,412,242.718446601942
35291,5,5809,81,"Tasa de exámenes médico legales por presunto delito sexual contra niños, niñas y adolescentes",2022,4,1,901,110.987791342952,0,449,0,1,452,221.238938053097
35292,5,5809,121,Tasa de exámenes médico legales por presunto delito sexual cuando la víctima está entre 18 y 28 años,2022,5,1,1618,61.8046971569839,0,841,0,1,777,128.700128700129
35293,5,5837,81,"Tasa de exámenes médico legales por presunto delito sexual contra niños, niñas y adolescentes",2022,2,4,14785,27.0544470747379,0,7419,0,4,7366,54.3035568829758
35294,5,5837,81,"Tasa de exámenes médico legales por presunto delito sexual contra niños, niñas y adolescentes",2022,3,11,17214,63.9014755431625,2,8793,22.7453656317525,9,8421,106.875667972925
35295,5,5837,81,"Tasa de exámenes médico legales por presunto delito sexual contra niños, niñas y adolescentes",2022,4,11,15593,70.544475084974,1,7911,12.640626975098,10,7682,130.174433741213
35296,5,5837,121,Tasa de exámenes médico legales por presunto delito sexual cuando la víctima está entre 18 y 28 años,2022,5,2,24887,8.03632418531764,0,11821,0,2,13066,15.3069034134395
35297,5,5842,81,"Tasa de exámenes médico legales por presunto delito sexual contra niños, niñas y adolescentes",2022,3,3,795,377.358490566038,1,411,243.30900243309,2,384,520.833333333333
35298,5,5842,81,"Tasa de exámenes médico legales por presunto delito sexual contra niños, niñas y adolescentes",2022,4,4,719,556.328233657858,0,374,0,4,345,1159.42028985507
35299,5,5847,81,"Tasa de exámenes médico legales por presunto delito sexual contra niños, niñas y adolescentes",2022,2,1,2959,33.7952010814464,0,1486,0,1,1473,67.8886625933469
35300,5,5847,81,"Tasa de exámenes médico legales por presunto delito sexual contra niños, niñas y adolescentes",2022,3,6,3524,170.261066969353,0,1778,0,6,1746,343.642611683849
35301,5,5847,81,"Tasa de exámenes médico legales por presunto delito sexual contra niños, niñas y adolescentes",2022,4,7,3277,213.610009154715,0,1680,0,7,1597,438.321853475266
35302,5,5847,121,Tasa de exámenes médico legales por presunto delito sexual cuando la víctima está entre 18 y 28 años,2022,5,3,5311,56.4865373752589,0,2683,0,3,2628,114.155251141553
35303,5,5854,81,"Tasa de exámenes médico legales por presunto delito sexual contra niños, niñas y adolescentes",2022,3,1,1735,57.6368876080692,0,894,0,1,841,118.906064209275
35304,5,5854,81,"Tasa de exámenes médico legales por presunto delito sexual contra niños, niñas y adolescentes",2022,4,1,1642,60.9013398294762,0,844,0,1,798,125.31328320802
35305,5,5854,121,Tasa de exámenes médico legales por presunto delito sexual cuando la víctima está entre 18 y 28 años,2022,5,1,2607,38.3582662063675,0,1278,0,1,1329,75.2445447705041
35306,5,5858,81,"Tasa de exámenes médico legales por presunto delito sexual contra niños, niñas y adolescentes",2022,2,2,928,215.51724137931,0,486,0,2,442,452.488687782805
35307,5,5858,81,"Tasa de exámenes médico legales por presunto delito sexual contra niños, niñas y adolescentes",2022,3,3,1296,231.481481481481,0,696,0,3,600,500
35308,5,5858,81,"Tasa de exámenes médico legales por presunto delito sexual contra niños, niñas y adolescentes",2022,4,3,1324,226.586102719033,0,702,0,3,622,482.315112540193
35309,5,5861,81,"Tasa de exámenes médico legales por presunto delito sexual contra niños, niñas y adolescentes",2022,2,2,540,370.37037037037,0,285,0,2,255,784.313725490196
35310,5,5861,81,"Tasa de exámenes médico legales por presunto delito sexual contra niños, niñas y adolescentes",2022,3,1,853,117.233294255569,0,430,0,1,423,236.406619385343
35311,5,5861,81,"Tasa de exámenes médico legales por presunto delito sexual contra niños, niñas y adolescentes",2022,4,3,986,304.259634888438,0,492,0,3,494,607.287449392713
35312,5,5861,121,Tasa de exámenes médico legales por presunto delito sexual cuando la víctima está entre 18 y 28 años,2022,5,3,1752,171.232876712329,2,888,225.225225225225,1,864,115.740740740741
35313,5,5885,81,"Tasa de exámenes médico legales por presunto delito sexual contra niños, niñas y adolescentes",2022,3,3,801,374.531835205993,0,411,0,3,390,769.230769230769
35314,5,5885,81,"Tasa de exámenes médico legales por presunto delito sexual contra niños, niñas y adolescentes",2022,4,3,766,391.644908616188,0,390,0,3,376,797.872340425532
35315,5,5887,81,"Tasa de exámenes médico legales por presunto delito sexual contra niños, niñas y adolescentes",2022,2,3,3226,92.9944203347799,1,1606,62.266500622665,2,1620,123.456790123457
35316,5,5887,81,"Tasa de exámenes médico legales por presunto delito sexual contra niños, niñas y adolescentes",2022,3,7,4464,156.810035842294,3,2236,134.168157423971,4,2228,179.533213644524
35317,5,5887,81,"Tasa de exámenes médico legales por presunto delito sexual contra niños, niñas y adolescentes",2022,4,11,4640,237.068965517241,2,2347,85.2151682999574,9,2293,392.498909725251
35318,5,5887,121,Tasa de exámenes médico legales por presunto delito sexual cuando la víctima está entre 18 y 28 años,2022,5,2,7828,25.5493101686254,0,4000,0,2,3828,52.2466039707419
35319,5,5890,81,"Tasa de exámenes médico legales por presunto delito sexual contra niños, niñas y adolescentes",2022,2,3,1686,177.935943060498,0,867,0,3,819,366.300366300366
35320,5,5890,81,"Tasa de exámenes médico legales por presunto delito sexual contra niños, niñas y adolescentes",2022,3,3,2288,131.118881118881,2,1191,167.926112510495,1,1097,91.1577028258888
35321,5,5890,81,"Tasa de exámenes médico legales por presunto delito sexual contra niños, niñas y adolescentes",2022,4,9,2329,386.43194504079,0,1212,0,9,1117,805.72963294539
35322,5,5890,121,Tasa de exámenes médico legales por presunto delito sexual cuando la víctima está entre 18 y 28 años,2022,5,4,3555,112.517580872011,0,1782,0,4,1773,225.606316976875
35323,5,5893,81,"Tasa de exámenes médico legales por presunto delito sexual contra niños, niñas y adolescentes",2022,4,2,2054,97.3709834469328,0,1040,0,2,1014,197.23865877712
35324,5,5895,81,"Tasa de exámenes médico legales por presunto delito sexual contra niños, niñas y adolescentes",2022,3,2,3464,57.7367205542725,2,1783,112.170499158721,0,1681,0
35325,81,81001,81,"Tasa de exámenes médico legales por presunto delito sexual contra niños, niñas y adolescentes",2022,2,6,8124,73.8552437223043,0,4101,0,6,4023,149.142431021626
35326,81,81001,81,"Tasa de exámenes médico legales por presunto delito sexual contra niños, niñas y adolescentes",2022,3,39,9828,396.825396825397,6,4986,120.336943441637,33,4842,681.536555142503
35327,81,81001,81,"Tasa de exámenes médico legales por presunto delito sexual contra niños, niñas y adolescentes",2022,4,48,9683,495.714138180316,6,4963,120.894620189402,42,4720,889.830508474576
35328,81,81001,121,Tasa de exámenes médico legales por presunto delito sexual cuando la víctima está entre 18 y 28 años,2022,5,15,19924,75.2860871310982,1,10110,9.89119683481701,14,9814,142.65335235378
35329,81,81001,81,"Tasa de exámenes médico legales por presunto delito sexual contra niños, niñas y adolescentes",2022,1,1,1540,64.9350649350649,0,781,0,1,759,131.752305665349
35330,81,81065,81,"Tasa de exámenes médico legales por presunto delito sexual contra niños, niñas y adolescentes",2022,2,7,6096,114.829396325459,0,3169,0,7,2927,239.152716091561
35331,81,81065,81,"Tasa de exámenes médico legales por presunto delito sexual contra niños, niñas y adolescentes",2022,3,12,7206,166.527893422148,1,3762,26.581605528974,11,3444,319.396051103368
35332,81,81065,81,"Tasa de exámenes médico legales por presunto delito sexual contra niños, niñas y adolescentes",2022,4,22,6676,329.538645895746,0,3494,0,22,3182,691.389063482087
35333,81,81065,121,Tasa de exámenes médico legales por presunto delito sexual cuando la víctima está entre 18 y 28 años,2022,5,6,11506,52.1467060664001,0,5958,0,6,5548,108.147080028839
35334,81,81220,81,"Tasa de exámenes médico legales por presunto delito sexual contra niños, niñas y adolescentes",2022,3,4,437,915.33180778032,2,234,854.700854700855,2,203,985.221674876847
35335,81,81220,81,"Tasa de exámenes médico legales por presunto delito sexual contra niños, niñas y adolescentes",2022,4,2,402,497.512437810945,1,207,483.091787439613,1,195,512.820512820513
35336,81,81300,81,"Tasa de exámenes médico legales por presunto delito sexual contra niños, niñas y adolescentes",2022,2,1,2377,42.0698359276399,0,1205,0,1,1172,85.3242320819113
35337,81,81300,81,"Tasa de exámenes médico legales por presunto delito sexual contra niños, niñas y adolescentes",2022,3,10,2843,351.74111853675703,2,1419,140.944326990839,8,1424,561.797752808989
35338,81,81300,81,"Tasa de exámenes médico legales por presunto delito sexual contra niños, niñas y adolescentes",2022,4,11,2626,418.888042650419,1,1288,77.639751552795,10,1338,747.384155455904
35339,81,81591,81,"Tasa de exámenes médico legales por presunto delito sexual contra niños, niñas y adolescentes",2022,3,3,534,561.797752808989,1,269,371.747211895911,2,265,754.716981132075
35340,81,81591,81,"Tasa de exámenes médico legales por presunto delito sexual contra niños, niñas y adolescentes",2022,4,1,498,200.803212851406,0,240,0,1,258,387.596899224806
35341,81,81591,121,Tasa de exámenes médico legales por presunto delito sexual cuando la víctima está entre 18 y 28 años,2022,5,1,988,101.214574898785,0,518,0,1,470,212.765957446809
35342,81,81736,81,"Tasa de exámenes médico legales por presunto delito sexual contra niños, niñas y adolescentes",2022,2,3,5711,52.530204867799,2,2830,70.6713780918728,1,2881,34.7101700798334
35343,81,81736,81,"Tasa de exámenes médico legales por presunto delito sexual contra niños, niñas y adolescentes",2022,3,11,6938,158.547131738253,1,3463,28.8766965059197,10,3475,287.769784172662
35344,81,81736,81,"Tasa de exámenes médico legales por presunto delito sexual contra niños, niñas y adolescentes",2022,4,21,6697,313.573241750037,1,3359,29.7707651086633,20,3338,599.161174355902
35345,81,81736,121,Tasa de exámenes médico legales por presunto delito sexual cuando la víctima está entre 18 y 28 años,2022,5,3,12217,24.5559466317427,0,5970,0,3,6247,48.023051064511
35346,81,81794,81,"Tasa de exámenes médico legales por presunto delito sexual contra niños, niñas y adolescentes",2022,2,2,5152,38.8198757763975,1,2635,37.9506641366224,1,2517,39.7298371076679
35347,81,81794,81,"Tasa de exámenes médico legales por presunto delito sexual contra niños, niñas y adolescentes",2022,3,15,6148,243.981782693559,1,3159,31.6555872111428,14,2989,468.384074941452
35348,81,81794,81,"Tasa de exámenes médico legales por presunto delito sexual contra niños, niñas y adolescentes",2022,4,19,5741,330.952795680195,1,2948,33.921302578019,18,2793,644.468313641246
35349,81,81794,121,Tasa de exámenes médico legales por presunto delito sexual cuando la víctima está entre 18 y 28 años,2022,5,6,10102,59.3941793704217,0,5085,0,6,5017,119.593382499502
35350,88,88564,81,"Tasa de exámenes médico legales por presunto delito sexual contra niños, niñas y adolescentes",2022,4,1,551,181.488203266788,0,290,0,1,261,383.141762452107
35351,88,88001,81,"Tasa de exámenes médico legales por presunto delito sexual contra niños, niñas y adolescentes",2022,2,2,4095,48.8400488400488,1,2110,47.39336492891,1,1985,50.3778337531486
35352,88,88001,81,"Tasa de exámenes médico legales por presunto delito sexual contra niños, niñas y adolescentes",2022,3,6,4910,122.199592668024,1,2506,39.9042298483639,5,2404,207.986688851913
35353,88,88001,81,"Tasa de exámenes médico legales por presunto delito sexual contra niños, niñas y adolescentes",2022,4,8,4691,170.539330633127,0,2360,0,8,2331,343.200343200343
35354,88,88001,121,Tasa de exámenes médico legales por presunto delito sexual cuando la víctima está entre 18 y 28 años,2022,5,3,8971,33.4410879500613,0,4581,0,3,4390,68.3371298405467
35355,8,8078,81,"Tasa de exámenes médico legales por presunto delito sexual contra niños, niñas y adolescentes",2022,2,4,5270,75.9013282732448,1,2706,36.9549150036955,3,2564,117.004680187207
35356,8,8078,81,"Tasa de exámenes médico legales por presunto delito sexual contra niños, niñas y adolescentes",2022,3,8,6805,117.56061719324,1,3473,28.7935502447452,7,3332,210.084033613445
35357,8,8078,81,"Tasa de exámenes médico legales por presunto delito sexual contra niños, niñas y adolescentes",2022,4,16,6777,236.092666371551,0,3458,0,16,3319,482.072913528171
35358,8,8078,121,Tasa de exámenes médico legales por presunto delito sexual cuando la víctima está entre 18 y 28 años,2022,5,3,12094,24.8056887712916,0,6158,0,3,5936,50.5390835579515
35359,8,8001,81,"Tasa de exámenes médico legales por presunto delito sexual contra niños, niñas y adolescentes",2022,2,62,94396,65.6807491842875,15,47652,31.4782170737849,47,46744,100.547663871299
35360,8,8001,81,"Tasa de exámenes médico legales por presunto delito sexual contra niños, niñas y adolescentes",2022,3,149,119862,124.309622732809,20,60651,32.9755486306903,129,59211,217.864923747277
35361,8,8001,81,"Tasa de exámenes médico legales por presunto delito sexual contra niños, niñas y adolescentes",2022,4,256,121632,210.470928702973,16,61743,25.913868778647,240,59889,400.741371537344
35362,8,8001,121,Tasa de exámenes médico legales por presunto delito sexual cuando la víctima está entre 18 y 28 años,2022,5,53,238727,22.2010916234862,3,119378,2.51302585065925,50,119349,41.8939412982095
35363,8,8137,81,"Tasa de exámenes médico legales por presunto delito sexual contra niños, niñas y adolescentes",2022,3,2,2837,70.4970038773352,0,1463,0,2,1374,145.560407569141
35364,8,8137,81,"Tasa de exámenes médico legales por presunto delito sexual contra niños, niñas y adolescentes",2022,4,2,2642,75.7002271006813,0,1371,0,2,1271,157.3564122738
35365,8,8141,81,"Tasa de exámenes médico legales por presunto delito sexual contra niños, niñas y adolescentes",2022,2,2,1655,120.845921450151,0,842,0,2,813,246.0024600246
35366,8,8141,81,"Tasa de exámenes médico legales por presunto delito sexual contra niños, niñas y adolescentes",2022,3,1,2008,49.800796812749,1,1053,94.9667616334283,0,955,0
35367,8,8141,81,"Tasa de exámenes médico legales por presunto delito sexual contra niños, niñas y adolescentes",2022,4,4,1853,215.866162978953,0,975,0,4,878,455.580865603645
35368,8,8296,81,"Tasa de exámenes médico legales por presunto delito sexual contra niños, niñas y adolescentes",2022,3,5,7551,66.2163951794464,0,3943,0,5,3608,138.580931263858
35369,8,8296,81,"Tasa de exámenes médico legales por presunto delito sexual contra niños, niñas y adolescentes",2022,4,13,7195,180.681028492008,0,3741,0,13,3454,376.375217139548
35370,8,8296,121,Tasa de exámenes médico legales por presunto delito sexual cuando la víctima está entre 18 y 28 años,2022,5,3,12438,24.1196333815726,0,6245,0,3,6193,48.4417891167447
35371,8,8372,81,"Tasa de exámenes médico legales por presunto delito sexual contra niños, niñas y adolescentes",2022,4,5,2249,222.321031569586,0,1174,0,5,1075,465.116279069767
35372,8,8372,121,Tasa de exámenes médico legales por presunto delito sexual cuando la víctima está entre 18 y 28 años,2022,5,1,4178,23.9348970799426,0,2170,0,1,2008,49.800796812749
35373,8,8421,81,"Tasa de exámenes médico legales por presunto delito sexual contra niños, niñas y adolescentes",2022,3,4,3446,116.076610562972,2,1745,114.613180515759,2,1701,117.577895355673
35374,8,8421,81,"Tasa de exámenes médico legales por presunto delito sexual contra niños, niñas y adolescentes",2022,4,6,3282,182.815356489945,0,1659,0,6,1623,369.685767097967
35375,8,8421,121,Tasa de exámenes médico legales por presunto delito sexual cuando la víctima está entre 18 y 28 años,2022,5,1,5476,18.2615047479912,0,2730,0,1,2746,36.4166059723234
35376,8,8433,81,"Tasa de exámenes médico legales por presunto delito sexual contra niños, niñas y adolescentes",2022,2,6,12210,49.1400491400491,1,6148,16.2654521795706,5,6062,82.4810293632464
35377,8,8433,81,"Tasa de exámenes médico legales por presunto delito sexual contra niños, niñas y adolescentes",2022,3,17,15563,109.233438283107,3,7860,38.1679389312977,14,7703,181.747371154096
35378,8,8433,81,"Tasa de exámenes médico legales por presunto delito sexual contra niños, niñas y adolescentes",2022,4,31,15323,202.310252561509,2,7829,25.5460467492656,29,7494,386.976247664799
35379,8,8433,121,Tasa de exámenes médico legales por presunto delito sexual cuando la víctima está entre 18 y 28 años,2022,5,2,27310,7.32332478945441,0,13999,0,2,13311,15.0251671549846
35380,8,8436,81,"Tasa de exámenes médico legales por presunto delito sexual contra niños, niñas y adolescentes",2022,3,1,2650,37.7358490566038,1,1396,71.6332378223496,0,1254,0
35381,8,8436,81,"Tasa de exámenes médico legales por presunto delito sexual contra niños, niñas y adolescentes",2022,4,2,2494,80.1924619085806,0,1290,0,2,1204,166.112956810631
35382,8,8520,81,"Tasa de exámenes médico legales por presunto delito sexual contra niños, niñas y adolescentes",2022,2,1,2576,38.8198757763975,0,1322,0,1,1254,79.7448165869219
35383,8,8520,81,"Tasa de exámenes médico legales por presunto delito sexual contra niños, niñas y adolescentes",2022,3,1,3234,30.9214594928881,0,1640,0,1,1594,62.7352572145546
35384,8,8520,81,"Tasa de exámenes médico legales por presunto delito sexual contra niños, niñas y adolescentes",2022,4,2,3142,63.6537237428389,1,1575,63.4920634920635,1,1567,63.8162093171666
35385,8,8520,121,Tasa de exámenes médico legales por presunto delito sexual cuando la víctima está entre 18 y 28 años,2022,5,1,5624,17.7809388335704,0,2894,0,1,2730,36.6300366300366
35386,8,8549,81,"Tasa de exámenes médico legales por presunto delito sexual contra niños, niñas y adolescentes",2022,3,1,689,145.137880986938,1,359,278.551532033426,0,330,0
35387,8,8549,121,Tasa de exámenes médico legales por presunto delito sexual cuando la víctima está entre 18 y 28 años,2022,5,1,1296,77.1604938271605,1,673,148.588410104012,0,623,0
35388,8,8558,81,"Tasa de exámenes médico legales por presunto delito sexual contra niños, niñas y adolescentes",2022,3,1,2114,47.3036896877956,0,1080,0,1,1034,96.7117988394584
35389,8,8558,81,"Tasa de exámenes médico legales por presunto delito sexual contra niños, niñas y adolescentes",2022,4,6,2140,280.373831775701,0,1071,0,6,1069,561.272217025257
35390,8,8558,121,Tasa de exámenes médico legales por presunto delito sexual cuando la víctima está entre 18 y 28 años,2022,5,2,3410,58.6510263929619,0,1722,0,2,1688,118.483412322275
35391,8,8560,81,"Tasa de exámenes médico legales por presunto delito sexual contra niños, niñas y adolescentes",2022,2,1,2433,41.101520756268,0,1270,0,1,1163,85.9845227858985
35392,8,8560,81,"Tasa de exámenes médico legales por presunto delito sexual contra niños, niñas y adolescentes",2022,3,2,2986,66.9792364367046,0,1551,0,2,1435,139.372822299652
35393,8,8560,81,"Tasa de exámenes médico legales por presunto delito sexual contra niños, niñas y adolescentes",2022,4,5,2836,176.304654442877,0,1463,0,5,1373,364.166059723234
35394,8,8560,121,Tasa de exámenes médico legales por presunto delito sexual cuando la víctima está entre 18 y 28 años,2022,5,1,4856,20.5930807248764,1,2502,39.9680255795364,0,2354,0
35395,8,8573,81,"Tasa de exámenes médico legales por presunto delito sexual contra niños, niñas y adolescentes",2022,3,6,5068,118.389897395422,2,2603,76.8344218209758,4,2465,162.271805273834
35396,8,8573,81,"Tasa de exámenes médico legales por presunto delito sexual contra niños, niñas y adolescentes",2022,4,9,5163,174.317257408483,2,2647,75.5572346052135,7,2516,278.219395866455
35397,8,8606,81,"Tasa de exámenes médico legales por presunto delito sexual contra niños, niñas y adolescentes",2022,3,2,3212,62.266500622665,1,1658,60.313630880579,1,1554,64.3500643500643
35398,8,8606,81,"Tasa de exámenes médico legales por presunto delito sexual contra niños, niñas y adolescentes",2022,4,3,3108,96.5250965250965,0,1593,0,3,1515,198.019801980198
35399,8,8634,81,"Tasa de exámenes médico legales por presunto delito sexual contra niños, niñas y adolescentes",2022,2,3,2992,100.267379679144,0,1495,0,3,1497,200.400801603206
35400,8,8634,81,"Tasa de exámenes médico legales por presunto delito sexual contra niños, niñas y adolescentes",2022,3,3,3748,80.042689434365,1,1870,53.475935828877,2,1878,106.496272630458
35401,8,8634,81,"Tasa de exámenes médico legales por presunto delito sexual contra niños, niñas y adolescentes",2022,4,4,3680,108.695652173913,0,1848,0,4,1832,218.340611353712
35402,8,8634,121,Tasa de exámenes médico legales por presunto delito sexual cuando la víctima está entre 18 y 28 años,2022,5,2,6679,29.944602485402,0,3410,0,2,3269,61.1807892321811
35403,8,8638,81,"Tasa de exámenes médico legales por presunto delito sexual contra niños, niñas y adolescentes",2022,3,11,10919,100.741826174558,2,5605,35.6824264049955,9,5314,169.363944298081
35404,8,8638,81,"Tasa de exámenes médico legales por presunto delito sexual contra niños, niñas y adolescentes",2022,4,32,10357,308.969778893502,2,5306,37.6931775348662,30,5051,593.941793704217
35405,8,8638,121,Tasa de exámenes médico legales por presunto delito sexual cuando la víctima está entre 18 y 28 años,2022,5,1,18305,5.46298825457525,1,9163,10.9134562916076,0,9142,0
35406,8,8675,81,"Tasa de exámenes médico legales por presunto delito sexual contra niños, niñas y adolescentes",2022,2,3,1614,185.873605947955,1,840,119.047619047619,2,774,258.397932816537
35407,8,8675,81,"Tasa de exámenes médico legales por presunto delito sexual contra niños, niñas y adolescentes",2022,4,2,2052,97.4658869395711,0,1041,0,2,1011,197.82393669634
35408,8,8685,81,"Tasa de exámenes médico legales por presunto delito sexual contra niños, niñas y adolescentes",2022,3,3,3112,96.401028277635,0,1571,0,3,1541,194.678780012979
35409,8,8685,81,"Tasa de exámenes médico legales por presunto delito sexual contra niños, niñas y adolescentes",2022,4,5,3143,159.083678014636,0,1573,0,5,1570,318.471337579618
35410,8,8758,81,"Tasa de exámenes médico legales por presunto delito sexual contra niños, niñas y adolescentes",2022,2,33,55144,59.8433193094444,10,28613,34.9491489882221,23,26531,86.6910406694056
35411,8,8758,81,"Tasa de exámenes médico legales por presunto delito sexual contra niños, niñas y adolescentes",2022,3,58,68590,84.5604315497886,11,35326,31.1385381871709,47,33264,141.293891293891
35412,8,8758,81,"Tasa de exámenes médico legales por presunto delito sexual contra niños, niñas y adolescentes",2022,4,101,67364,149.931714268749,7,34216,20.4582651391162,94,33148,283.576686376252
35413,8,8758,121,Tasa de exámenes médico legales por presunto delito sexual cuando la víctima está entre 18 y 28 años,2022,5,21,130017,16.1517340040149,2,64369,3.10708570895928,19,65648,28.9422373872776
35414,8,8770,81,"Tasa de exámenes médico legales por presunto delito sexual contra niños, niñas y adolescentes",2022,4,1,1380,72.463768115942,0,684,0,1,696,143.67816091954
35415,8,8832,81,"Tasa de exámenes médico legales por presunto delito sexual contra niños, niñas y adolescentes",2022,2,1,1511,66.1813368630046,1,781,128.040973111396,0,730,0
35416,8,8832,81,"Tasa de exámenes médico legales por presunto delito sexual contra niños, niñas y adolescentes",2022,3,1,1802,55.4938956714761,0,904,0,1,898,111.358574610245
35417,8,8832,81,"Tasa de exámenes médico legales por presunto delito sexual contra niños, niñas y adolescentes",2022,4,3,1724,174.013921113689,0,850,0,3,874,343.24942791762
35418,8,8832,121,Tasa de exámenes médico legales por presunto delito sexual cuando la víctima está entre 18 y 28 años,2022,5,1,3429,29.1630212890055,0,1739,0,1,1690,59.1715976331361
35419,8,8849,81,"Tasa de exámenes médico legales por presunto delito sexual contra niños, niñas y adolescentes",2022,3,2,1302,153.609831029186,0,661,0,2,641,312.01248049922
35420,8,8849,81,"Tasa de exámenes médico legales por presunto delito sexual contra niños, niñas y adolescentes",2022,4,2,1297,154.20200462606,0,657,0,2,640,312.5
35421,11,11001,81,"Tasa de exámenes médico legales por presunto delito sexual contra niños, niñas y adolescentes",2022,2,476,486852,97.7709858437472,125,248680,50.2654013189641,351,238172,147.372487110156
35422,11,11001,81,"Tasa de exámenes médico legales por presunto delito sexual contra niños, niñas y adolescentes",2022,3,1195,574007,208.185614461148,212,292379,72.5086275006071,983,281628,349.041998664905
35423,11,11001,81,"Tasa de exámenes médico legales por presunto delito sexual contra niños, niñas y adolescentes",2022,4,2544,578444,439.800568421489,234,293897,79.6197307219876,2310,284547,811.816677034023
35424,11,11001,121,Tasa de exámenes médico legales por presunto delito sexual cuando la víctima está entre 18 y 28 años,2022,5,595,1515604,39.2582759084827,41,757811,5.4103199874375,554,757793,73.1070358264064
35425,11,11001,81,"Tasa de exámenes médico legales por presunto delito sexual contra niños, niñas y adolescentes",2022,1,3,90657,3.30917634600748,0,46344,0,3,44313,6.77002234107372
35426,13,13006,81,"Tasa de exámenes médico legales por presunto delito sexual contra niños, niñas y adolescentes",2022,4,1,2903,34.447123665174,0,1530,0,1,1373,72.8332119446468
35427,13,13030,81,"Tasa de exámenes médico legales por presunto delito sexual contra niños, niñas y adolescentes",2022,3,1,1595,62.6959247648903,0,804,0,1,791,126.422250316056
35428,13,13030,81,"Tasa de exámenes médico legales por presunto delito sexual contra niños, niñas y adolescentes",2022,4,2,1510,132.450331125828,0,785,0,2,725,275.862068965517
35429,13,13042,81,"Tasa de exámenes médico legales por presunto delito sexual contra niños, niñas y adolescentes",2022,2,1,757,132.100396301189,0,395,0,1,362,276.243093922652
35430,13,13042,81,"Tasa de exámenes médico legales por presunto delito sexual contra niños, niñas y adolescentes",2022,4,4,960,416.666666666667,1,504,198.412698412698,3,456,657.894736842105
35431,13,13052,81,"Tasa de exámenes médico legales por presunto delito sexual contra niños, niñas y adolescentes",2022,2,1,6470,15.4559505409583,0,3274,0,1,3196,31.2891113892365
35432,13,13052,81,"Tasa de exámenes médico legales por presunto delito sexual contra niños, niñas y adolescentes",2022,3,6,7967,75.3106564578888,0,4022,0,6,3945,152.091254752852
35433,13,13052,81,"Tasa de exámenes médico legales por presunto delito sexual contra niños, niñas y adolescentes",2022,4,15,7912,189.58543983822,1,3975,25.1572327044025,14,3937,355.600711201422
35434,13,13062,81,"Tasa de exámenes médico legales por presunto delito sexual contra niños, niñas y adolescentes",2022,2,1,785,127.388535031847,0,401,0,1,384,260.416666666667
35435,13,13062,81,"Tasa de exámenes médico legales por presunto delito sexual contra niños, niñas y adolescentes",2022,4,1,910,109.89010989011,0,484,0,1,426,234.741784037559
35436,13,13074,81,"Tasa de exámenes médico legales por presunto delito sexual contra niños, niñas y adolescentes",2022,3,1,2100,47.6190476190476,0,1063,0,1,1037,96.4320154291225
35437,13,13074,81,"Tasa de exámenes médico legales por presunto delito sexual contra niños, niñas y adolescentes",2022,4,3,1976,151.821862348178,0,1023,0,3,953,314.795383001049
35438,13,13140,81,"Tasa de exámenes médico legales por presunto delito sexual contra niños, niñas y adolescentes",2022,3,1,2708,36.9276218611521,0,1399,0,1,1309,76.3941940412529
35439,13,13140,81,"Tasa de exámenes médico legales por presunto delito sexual contra niños, niñas y adolescentes",2022,4,2,2659,75.2162467092892,0,1376,0,2,1283,155.884645362432
35440,13,13140,121,Tasa de exámenes médico legales por presunto delito sexual cuando la víctima está entre 18 y 28 años,2022,5,1,4334,23.0733733271804,0,2226,0,1,2108,47.438330170778
35441,13,13160,81,"Tasa de exámenes médico legales por presunto delito sexual contra niños, niñas y adolescentes",2022,4,2,1002,199.600798403194,0,521,0,2,481,415.800415800416
35442,13,13160,121,Tasa de exámenes médico legales por presunto delito sexual cuando la víctima está entre 18 y 28 años,2022,5,1,1535,65.1465798045603,0,813,0,1,722,138.504155124654
35443,13,13001,81,"Tasa de exámenes médico legales por presunto delito sexual contra niños, niñas y adolescentes",2022,2,49,82502,59.3924995757679,7,42243,16.5707927940724,42,40259,104.324498869818
35444,13,13001,81,"Tasa de exámenes médico legales por presunto delito sexual contra niños, niñas y adolescentes",2022,3,140,99786,140.300242518991,21,51169,41.0404737243253,119,48617,244.770347820721
35445,13,13001,81,"Tasa de exámenes médico legales por presunto delito sexual contra niños, niñas y adolescentes",2022,4,291,100375,289.912826899128,24,51146,46.9244906737575,267,49229,542.36324117898
35446,13,13001,121,Tasa de exámenes médico legales por presunto delito sexual cuando la víctima está entre 18 y 28 años,2022,5,90,201658,44.6300171577622,10,100138,9.9862190177555,80,101520,78.8022064617809
35447,13,13188,81,"Tasa de exámenes médico legales por presunto delito sexual contra niños, niñas y adolescentes",2022,3,2,1829,109.349371241115,1,946,105.708245243129,1,883,113.250283125708
35448,13,13188,81,"Tasa de exámenes médico legales por presunto delito sexual contra niños, niñas y adolescentes",2022,4,2,1721,116.211504938989,0,868,0,2,853,234.466588511137
35449,13,13188,121,Tasa de exámenes médico legales por presunto delito sexual cuando la víctima está entre 18 y 28 años,2022,5,1,2520,39.6825396825397,0,1240,0,1,1280,78125
35450,13,13222,81,"Tasa de exámenes médico legales por presunto delito sexual contra niños, niñas y adolescentes",2022,2,1,1584,63.1313131313131,0,801,0,1,783,127.713920817369
35451,13,13222,81,"Tasa de exámenes médico legales por presunto delito sexual contra niños, niñas y adolescentes",2022,3,3,1862,161.117078410312,1,937,106.723585912487,2,925,216.216216216216
35452,13,13222,81,"Tasa de exámenes médico legales por presunto delito sexual contra niños, niñas y adolescentes",2022,4,6,1775,338.028169014085,0,897,0,6,878,683.371298405467
35453,13,13222,121,Tasa de exámenes médico legales por presunto delito sexual cuando la víctima está entre 18 y 28 años,2022,5,1,3123,32.020493115594,0,1580,0,1,1543,64.8088139987038
35454,13,13212,81,"Tasa de exámenes médico legales por presunto delito sexual contra niños, niñas y adolescentes",2022,2,3,1523,196.979645436638,0,815,0,3,708,423.728813559322
35455,13,13212,81,"Tasa de exámenes médico legales por presunto delito sexual contra niños, niñas y adolescentes",2022,3,4,1811,220.872446162341,1,948,105.485232067511,3,863,347.624565469293
35456,13,13212,81,"Tasa de exámenes médico legales por presunto delito sexual contra niños, niñas y adolescentes",2022,4,3,1763,170.164492342598,0,892,0,3,871,344.43168771527
35457,13,13244,81,"Tasa de exámenes médico legales por presunto delito sexual contra niños, niñas y adolescentes",2022,2,4,6820,58.6510263929619,0,3465,0,4,3355,119.225037257824
35458,13,13244,81,"Tasa de exámenes médico legales por presunto delito sexual contra niños, niñas y adolescentes",2022,3,13,8251,157.556659798812,2,4242,47.1475719000471,11,4009,274.38263906211
35459,13,13244,81,"Tasa de exámenes médico legales por presunto delito sexual contra niños, niñas y adolescentes",2022,4,17,8018,212.022948366176,0,4182,0,17,3836,443.169968717414
35460,13,13244,121,Tasa de exámenes médico legales por presunto delito sexual cuando la víctima está entre 18 y 28 años,2022,5,2,13826,14.4654997830175,0,7206,0,2,6620,30.2114803625378
35461,13,13248,81,"Tasa de exámenes médico legales por presunto delito sexual contra niños, niñas y adolescentes",2022,3,1,881,113.507377979569,1,462,216.450216450216,0,419,0
35462,13,13248,81,"Tasa de exámenes médico legales por presunto delito sexual contra niños, niñas y adolescentes",2022,4,1,886,112.866817155756,0,471,0,1,415,240.963855421687
35463,13,13268,81,"Tasa de exámenes médico legales por presunto delito sexual contra niños, niñas y adolescentes",2022,3,4,1009,396.432111000991,2,535,373.831775700935,2,474,421.940928270042
35464,13,13268,81,"Tasa de exámenes médico legales por presunto delito sexual contra niños, niñas y adolescentes",2022,4,1,967,103.412616339193,1,526,190.114068441065,0,441,0
35465,13,13300,81,"Tasa de exámenes médico legales por presunto delito sexual contra niños, niñas y adolescentes",2022,4,2,1624,123.152709359606,0,842,0,2,782,255.754475703325
35466,13,13300,121,Tasa de exámenes médico legales por presunto delito sexual cuando la víctima está entre 18 y 28 años,2022,5,1,2252,44.404973357016,0,1161,0,1,1091,91.6590284142988
35467,13,13430,81,"Tasa de exámenes médico legales por presunto delito sexual contra niños, niñas y adolescentes",2022,2,6,12565,47.7516912057302,1,6524,15.3280196198651,5,6041,82.767753683165
35468,13,13430,81,"Tasa de exámenes médico legales por presunto delito sexual contra niños, niñas y adolescentes",2022,3,18,15905,113.171958503615,6,8233,72.8774444309486,12,7672,156.412930135558
35469,13,13430,81,"Tasa de exámenes médico legales por presunto delito sexual contra niños, niñas y adolescentes",2022,4,36,15865,226.914591868894,3,8163,36.7511944138185,33,7702,428.460140223319
35470,13,13430,121,Tasa de exámenes médico legales por presunto delito sexual cuando la víctima está entre 18 y 28 años,2022,5,3,25920,11.5740740740741,0,13054,0,3,12866,23.3172703248873
35471,13,13433,81,"Tasa de exámenes médico legales por presunto delito sexual contra niños, niñas y adolescentes",2022,3,4,3112,128.53470437018,2,1581,126.502213788741,2,1531,130.633572828217
35472,13,13433,81,"Tasa de exámenes médico legales por presunto delito sexual contra niños, niñas y adolescentes",2022,4,6,3211,186.857676736219,0,1703,0,6,1508,397.877984084881
35473,13,13440,81,"Tasa de exámenes médico legales por presunto delito sexual contra niños, niñas y adolescentes",2022,2,1,965,103.626943005181,0,497,0,1,468,213.675213675214
35474,13,13442,81,"Tasa de exámenes médico legales por presunto delito sexual contra niños, niñas y adolescentes",2022,2,1,4828,20.7125103562552,0,2456,0,1,2372,42.1585160202361
35475,13,13442,81,"Tasa de exámenes médico legales por presunto delito sexual contra niños, niñas y adolescentes",2022,3,4,5973,66.9680227691277,1,3097,32.2893122376493,3,2876,104.311543810848
35476,13,13442,81,"Tasa de exámenes médico legales por presunto delito sexual contra niños, niñas y adolescentes",2022,4,4,5852,68.3526999316473,0,3092,0,4,2760,144.927536231884
35477,13,13442,121,Tasa de exámenes médico legales por presunto delito sexual cuando la víctima está entre 18 y 28 años,2022,5,5,9278,53.890924768269,0,4742,0,5,4536,110.229276895944
35478,13,13468,81,"Tasa de exámenes médico legales por presunto delito sexual contra niños, niñas y adolescentes",2022,3,4,5488,72.8862973760933,1,2792,35.8166189111748,3,2696,111.275964391691
35479,13,13468,81,"Tasa de exámenes médico legales por presunto delito sexual contra niños, niñas y adolescentes",2022,4,7,5407,129.461808766414,0,2747,0,7,2660,263.157894736842
35480,13,13468,121,Tasa de exámenes médico legales por presunto delito sexual cuando la víctima está entre 18 y 28 años,2022,5,2,8233,24.2924814769829,1,4132,24.2013552758955,1,4101,24.3842965130456
35481,13,13458,81,"Tasa de exámenes médico legales por presunto delito sexual contra niños, niñas y adolescentes",2022,3,4,2275,175.824175824176,0,1199,0,4,1076,371.747211895911
35482,13,13458,81,"Tasa de exámenes médico legales por presunto delito sexual contra niños, niñas y adolescentes",2022,4,2,1922,104.058272632674,1,1028,97.2762645914397,1,894,111.856823266219
35483,13,13473,81,"Tasa de exámenes médico legales por presunto delito sexual contra niños, niñas y adolescentes",2022,4,1,2679,37.3273609555804,0,1442,0,1,1237,80.8407437348424
35484,13,13490,81,"Tasa de exámenes médico legales por presunto delito sexual contra niños, niñas y adolescentes",2022,3,1,1374,72.7802037845706,0,705,0,1,669,149.476831091181
35485,13,13549,81,"Tasa de exámenes médico legales por presunto delito sexual contra niños, niñas y adolescentes",2022,3,1,3202,31.2304809494066,0,1641,0,1,1561,64.0614990390775
35486,13,13549,81,"Tasa de exámenes médico legales por presunto delito sexual contra niños, niñas y adolescentes",2022,4,1,3195,31.2989045383412,1,1636,61.1246943765281,0,1559,0
35487,13,13580,121,Tasa de exámenes médico legales por presunto delito sexual cuando la víctima está entre 18 y 28 años,2022,5,1,1391,71.8907260963336,0,677,0,1,714,140.056022408964
35488,13,13620,81,"Tasa de exámenes médico legales por presunto delito sexual contra niños, niñas y adolescentes",2022,3,2,911,219.53896816685,0,467,0,2,444,450.45045045045
35489,13,13620,81,"Tasa de exámenes médico legales por presunto delito sexual contra niños, niñas y adolescentes",2022,4,1,912,109.649122807018,0,499,0,1,413,242.130750605327
35490,13,13647,81,"Tasa de exámenes médico legales por presunto delito sexual contra niños, niñas y adolescentes",2022,4,1,2059,48.5672656629432,0,1066,0,1,993,100.704934541793
35491,13,13654,81,"Tasa de exámenes médico legales por presunto delito sexual contra niños, niñas y adolescentes",2022,4,6,2699,222.304557243423,2,1395,143.36917562724,4,1304,306.748466257669
35492,13,13657,81,"Tasa de exámenes médico legales por presunto delito sexual contra niños, niñas y adolescentes",2022,3,8,3833,208.713801200104,1,1954,51.1770726714432,7,1879,372.538584353379
35493,13,13657,81,"Tasa de exámenes médico legales por presunto delito sexual contra niños, niñas y adolescentes",2022,4,9,3962,227.158001009591,0,2063,0,9,1899,473.9336492891
35494,13,13657,121,Tasa de exámenes médico legales por presunto delito sexual cuando la víctima está entre 18 y 28 años,2022,5,1,6901,14.4906535284741,0,3565,0,1,3336,29.9760191846523
35495,13,13667,81,"Tasa de exámenes médico legales por presunto delito sexual contra niños, niñas y adolescentes",2022,3,5,2002,249.75024975025,0,1080,0,5,922,542.299349240781
35496,13,13667,81,"Tasa de exámenes médico legales por presunto delito sexual contra niños, niñas y adolescentes",2022,4,2,1881,106.326422115896,0,1011,0,2,870,229.885057471264
35497,13,13667,121,Tasa de exámenes médico legales por presunto delito sexual cuando la víctima está entre 18 y 28 años,2022,5,1,2684,37.25782414307,0,1394,0,1,1290,77.5193798449612
35498,13,13670,81,"Tasa de exámenes médico legales por presunto delito sexual contra niños, niñas y adolescentes",2022,4,1,3598,27.7932184546971,0,1841,0,1,1757,56.9151963574274
35499,13,13673,81,"Tasa de exámenes médico legales por presunto delito sexual contra niños, niñas y adolescentes",2022,3,1,1709,58.5137507314219,0,881,0,1,828,120.772946859903
35500,13,13673,81,"Tasa de exámenes médico legales por presunto delito sexual contra niños, niñas y adolescentes",2022,4,2,1703,117.439812096301,0,866,0,2,837,238.9486260454
35501,13,13673,121,Tasa de exámenes médico legales por presunto delito sexual cuando la víctima está entre 18 y 28 años,2022,5,2,2901,68.9417442261289,0,1425,0,2,1476,135.50135501355
35502,13,13688,81,"Tasa de exámenes médico legales por presunto delito sexual contra niños, niñas y adolescentes",2022,3,1,4334,23.0733733271804,0,2196,0,1,2138,46.7726847521048
35503,13,13683,81,"Tasa de exámenes médico legales por presunto delito sexual contra niños, niñas y adolescentes",2022,2,1,1997,50.0751126690035,0,990,0,1,1007,99.304865938431
35504,13,13683,81,"Tasa de exámenes médico legales por presunto delito sexual contra niños, niñas y adolescentes",2022,3,1,2497,40.048057669203,1,1242,80.5152979066023,0,1255,0
35505,13,13683,81,"Tasa de exámenes médico legales por presunto delito sexual contra niños, niñas y adolescentes",2022,4,4,2491,160.578081091931,0,1241,0,4,1250,320
35506,13,13683,121,Tasa de exámenes médico legales por presunto delito sexual cuando la víctima está entre 18 y 28 años,2022,5,1,4359,22.9410415232852,0,2173,0,1,2186,45.7456541628545
35507,13,13744,81,"Tasa de exámenes médico legales por presunto delito sexual contra niños, niñas y adolescentes",2022,4,1,2205,45.3514739229025,0,1158,0,1,1047,95.5109837631328
35508,13,13760,81,"Tasa de exámenes médico legales por presunto delito sexual contra niños, niñas y adolescentes",2022,4,1,1088,91.9117647058823,0,547,0,1,541,184.842883548983
35509,13,13760,121,Tasa de exámenes médico legales por presunto delito sexual cuando la víctima está entre 18 y 28 años,2022,5,1,1881,53.1632110579479,0,953,0,1,928,107.758620689655
35510,13,13780,81,"Tasa de exámenes médico legales por presunto delito sexual contra niños, niñas y adolescentes",2022,2,2,1396,143.266475644699,0,668,0,2,728,274.725274725275
35511,13,13780,81,"Tasa de exámenes médico legales por presunto delito sexual contra niños, niñas y adolescentes",2022,3,3,1675,179.10447761194,1,830,120.481927710843,2,845,236.686390532544
35512,13,13780,81,"Tasa de exámenes médico legales por presunto delito sexual contra niños, niñas y adolescentes",2022,4,6,1562,384.122919334187,1,806,124.069478908189,5,756,661.375661375661
35513,13,13810,81,"Tasa de exámenes médico legales por presunto delito sexual contra niños, niñas y adolescentes",2022,3,1,2733,36.5898280278083,1,1409,70.97232079489,0,1324,0
35514,13,13810,81,"Tasa de exámenes médico legales por presunto delito sexual contra niños, niñas y adolescentes",2022,4,4,2389,167.434072833822,0,1259,0,4,1130,353.982300884956
35515,13,13836,81,"Tasa de exámenes médico legales por presunto delito sexual contra niños, niñas y adolescentes",2022,2,3,8966,33.459736783404,2,4624,43.2525951557093,1,4342,23.0308613542146
35516,13,13836,81,"Tasa de exámenes médico legales por presunto delito sexual contra niños, niñas y adolescentes",2022,3,3,11315,26.5134776844896,0,5812,0,3,5503,54.5157186988915
35517,13,13836,81,"Tasa de exámenes médico legales por presunto delito sexual contra niños, niñas y adolescentes",2022,4,4,11502,34.7765605981568,0,5880,0,4,5622,71.1490572749911
35518,13,13836,121,Tasa de exámenes médico legales por presunto delito sexual cuando la víctima está entre 18 y 28 años,2022,5,2,20747,9.6399479442811,0,10438,0,2,10309,19.400523814143
35519,13,13838,81,"Tasa de exámenes médico legales por presunto delito sexual contra niños, niñas y adolescentes",2022,2,1,1465,68.259385665529,0,758,0,1,707,141.442715700141
35520,13,13838,81,"Tasa de exámenes médico legales por presunto delito sexual contra niños, niñas y adolescentes",2022,3,1,1770,56.4971751412429,0,910,0,1,860,116.279069767442
35521,13,13838,81,"Tasa de exámenes médico legales por presunto delito sexual contra niños, niñas y adolescentes",2022,4,2,1743,114.744693057946,0,889,0,2,854,234.192037470726
35522,13,13873,81,"Tasa de exámenes médico legales por presunto delito sexual contra niños, niñas y adolescentes",2022,3,2,2957,67.6361176868448,0,1507,0,2,1450,137.931034482759
35523,13,13873,81,"Tasa de exámenes médico legales por presunto delito sexual contra niños, niñas y adolescentes",2022,4,4,2894,138.217000691085,0,1488,0,4,1406,284.495021337127
35524,13,13873,121,Tasa de exámenes médico legales por presunto delito sexual cuando la víctima está entre 18 y 28 años,2022,5,1,4738,21.1059518784297,1,2433,41.101520756268,0,2305,0
35525,13,13894,81,"Tasa de exámenes médico legales por presunto delito sexual contra niños, niñas y adolescentes",2022,4,2,1382,144.717800289436,1,743,134.589502018843,1,639,156.494522691706
35526,15,15047,81,"Tasa de exámenes médico legales por presunto delito sexual contra niños, niñas y adolescentes",2022,3,1,1662,60.1684717208183,1,844,118.483412322275,0,818,0
35527,15,15047,121,Tasa de exámenes médico legales por presunto delito sexual cuando la víctima está entre 18 y 28 años,2022,5,2,2531,79.0201501382853,0,1326,0,2,1205,165.97510373444
35528,15,15051,81,"Tasa de exámenes médico legales por presunto delito sexual contra niños, niñas y adolescentes",2022,3,2,600,333.333333333333,0,305,0,2,295,677.966101694915
35529,15,15051,81,"Tasa de exámenes médico legales por presunto delito sexual contra niños, niñas y adolescentes",2022,4,5,605,826.446280991736,0,310,0,5,295,1694.91525423729
35530,15,15051,121,Tasa de exámenes médico legales por presunto delito sexual cuando la víctima está entre 18 y 28 años,2022,5,2,1077,185.701021355617,0,554,0,2,523,382.409177820268
35531,15,15087,81,"Tasa de exámenes médico legales por presunto delito sexual contra niños, niñas y adolescentes",2022,4,4,753,531.208499335989,1,385,259.74025974026,3,368,815.217391304348
35532,15,15104,81,"Tasa de exámenes médico legales por presunto delito sexual contra niños, niñas y adolescentes",2022,4,3,512,585.9375,0,272,0,3,240,1250
35533,15,15104,121,Tasa de exámenes médico legales por presunto delito sexual cuando la víctima está entre 18 y 28 años,2022,5,1,768,130.208333333333,0,411,0,1,357,280.112044817927
35534,15,15106,81,"Tasa de exámenes médico legales por presunto delito sexual contra niños, niñas y adolescentes",2022,4,2,219,913.24200913242,0,122,0,2,97,2061.85567010309
35535,15,15109,81,"Tasa de exámenes médico legales por presunto delito sexual contra niños, niñas y adolescentes",2022,4,4,423,945.626477541371,0,241,0,4,182,2197.8021978022
35536,15,15131,81,"Tasa de exámenes médico legales por presunto delito sexual contra niños, niñas y adolescentes",2022,3,1,282,354.609929078014,1,140,714.285714285714,0,142,0
35537,15,15135,81,"Tasa de exámenes médico legales por presunto delito sexual contra niños, niñas y adolescentes",2022,3,1,327,305.810397553517,0,165,0,1,162,617.283950617284
35538,15,15172,81,"Tasa de exámenes médico legales por presunto delito sexual contra niños, niñas y adolescentes",2022,2,1,189,529.100529100529,0,100,0,1,89,1123.59550561798
35539,15,15172,81,"Tasa de exámenes médico legales por presunto delito sexual contra niños, niñas y adolescentes",2022,3,1,250,400,0,121,0,1,129,775.193798449612
35540,15,15176,81,"Tasa de exámenes médico legales por presunto delito sexual contra niños, niñas y adolescentes",2022,2,1,4017,24.8941996514812,0,2039,0,1,1978,50.5561172901921
35541,15,15176,81,"Tasa de exámenes médico legales por presunto delito sexual contra niños, niñas y adolescentes",2022,3,11,5640,195.035460992908,3,2874,104.384133611691,8,2766,289.226319595083
35542,15,15176,81,"Tasa de exámenes médico legales por presunto delito sexual contra niños, niñas y adolescentes",2022,4,23,6406,359.038401498595,2,3307,60.4777744179014,21,3099,677.637947725073
35543,15,15176,121,Tasa de exámenes médico legales por presunto delito sexual cuando la víctima está entre 18 y 28 años,2022,5,2,11083,18.0456555084363,0,5645,0,2,5438,36.7782272894447
35544,15,15232,81,"Tasa de exámenes médico legales por presunto delito sexual contra niños, niñas y adolescentes",2022,3,1,500,200,0,258,0,1,242,413.223140495868
35545,15,15232,81,"Tasa de exámenes médico legales por presunto delito sexual contra niños, niñas y adolescentes",2022,4,1,473,211.416490486258,0,256,0,1,217,460.829493087558
35546,15,15183,81,"Tasa de exámenes médico legales por presunto delito sexual contra niños, niñas y adolescentes",2022,4,1,944,105.932203389831,0,508,0,1,436,229.357798165138
35547,15,15185,81,"Tasa de exámenes médico legales por presunto delito sexual contra niños, niñas y adolescentes",2022,3,2,615,325.20325203252,0,303,0,2,312,641.025641025641
35548,15,15185,81,"Tasa de exámenes médico legales por presunto delito sexual contra niños, niñas y adolescentes",2022,4,3,557,538.599640933573,1,272,367.647058823529,2,285,701.754385964912
35549,15,15187,81,"Tasa de exámenes médico legales por presunto delito sexual contra niños, niñas y adolescentes",2022,4,3,269,1115.24163568773,0,144,0,3,125,2400
35550,15,15187,121,Tasa de exámenes médico legales por presunto delito sexual cuando la víctima está entre 18 y 28 años,2022,5,1,465,215.05376344086,0,244,0,1,221,452.488687782805
35551,15,15189,81,"Tasa de exámenes médico legales por presunto delito sexual contra niños, niñas y adolescentes",2022,4,3,448,669.642857142857,0,228,0,3,220,1363.63636363636
35552,15,15204,81,"Tasa de exámenes médico legales por presunto delito sexual contra niños, niñas y adolescentes",2022,3,2,935,213.903743315508,0,488,0,2,447,447.427293064877
35553,15,15204,81,"Tasa de exámenes médico legales por presunto delito sexual contra niños, niñas y adolescentes",2022,4,3,936,320.51282051282,0,490,0,3,446,672.645739910314
35554,15,15204,121,Tasa de exámenes médico legales por presunto delito sexual cuando la víctima está entre 18 y 28 años,2022,5,2,2373,84.2815002107038,0,1547,0,2,826,242.130750605327
35555,15,15212,81,"Tasa de exámenes médico legales por presunto delito sexual contra niños, niñas y adolescentes",2022,4,2,333,600.600600600601,0,184,0,2,149,1342.28187919463
35556,15,15215,81,"Tasa de exámenes médico legales por presunto delito sexual contra niños, niñas y adolescentes",2022,3,2,208,961.538461538462,0,130,0,2,78,2564.10256410256
35557,15,15223,81,"Tasa de exámenes médico legales por presunto delito sexual contra niños, niñas y adolescentes",2022,3,1,1685,59.3471810089021,0,847,0,1,838,119.331742243437
35558,15,15224,81,"Tasa de exámenes médico legales por presunto delito sexual contra niños, niñas y adolescentes",2022,3,1,382,261.780104712042,0,189,0,1,193,518.134715025907
35559,15,15224,81,"Tasa de exámenes médico legales por presunto delito sexual contra niños, niñas y adolescentes",2022,4,2,377,530.503978779841,0,196,0,2,181,1104.97237569061
35560,15,15224,121,Tasa de exámenes médico legales por presunto delito sexual cuando la víctima está entre 18 y 28 años,2022,5,2,711,281.293952180028,0,381,0,2,330,606.060606060606
35561,15,15238,81,"Tasa de exámenes médico legales por presunto delito sexual contra niños, niñas y adolescentes",2022,2,5,7955,62.8535512256443,1,4145,24.1254523522316,4,3810,104.98687664042
35562,15,15238,81,"Tasa de exámenes médico legales por presunto delito sexual contra niños, niñas y adolescentes",2022,3,11,10833,101.541585894951,3,5585,53.715308863026,8,5248,152.439024390244
35563,15,15238,81,"Tasa de exámenes médico legales por presunto delito sexual contra niños, niñas y adolescentes",2022,4,49,12160,402.96052631579,1,6245,16.0128102481986,48,5915,811.496196111581
35564,15,15238,121,Tasa de exámenes médico legales por presunto delito sexual cuando la víctima está entre 18 y 28 años,2022,5,9,23424,38.422131147541,0,11799,0,9,11625,77.4193548387097
35565,15,15293,81,"Tasa de exámenes médico legales por presunto delito sexual contra niños, niñas y adolescentes",2022,2,1,228,438.59649122807,0,120,0,1,108,925.925925925926
35566,15,15293,81,"Tasa de exámenes médico legales por presunto delito sexual contra niños, niñas y adolescentes",2022,3,2,275,727.272727272727,1,144,694.444444444444,1,131,763.358778625954
35567,15,15293,81,"Tasa de exámenes médico legales por presunto delito sexual contra niños, niñas y adolescentes",2022,4,4,259,1544.40154440154,0,136,0,4,123,3252.0325203252
35568,15,15296,81,"Tasa de exámenes médico legales por presunto delito sexual contra niños, niñas y adolescentes",2022,4,1,472,211.864406779661,0,250,0,1,222,450.45045045045
35569,15,15299,81,"Tasa de exámenes médico legales por presunto delito sexual contra niños, niñas y adolescentes",2022,2,1,1225,81.6326530612245,0,628,0,1,597,167.50418760469
35570,15,15299,81,"Tasa de exámenes médico legales por presunto delito sexual contra niños, niñas y adolescentes",2022,3,4,1547,258.564964447317,0,784,0,4,763,524.246395806029
35571,15,15299,81,"Tasa de exámenes médico legales por presunto delito sexual contra niños, niñas y adolescentes",2022,4,7,1567,446.713465220166,1,789,126.742712294043,6,778,771.20822622108
35572,15,15299,121,Tasa de exámenes médico legales por presunto delito sexual cuando la víctima está entre 18 y 28 años,2022,5,2,2695,74.2115027829313,1,1335,74.9063670411985,1,1360,73.5294117647059
35573,15,15322,81,"Tasa de exámenes médico legales por presunto delito sexual contra niños, niñas y adolescentes",2022,4,1,935,106.951871657754,0,484,0,1,451,221.729490022173
35574,15,15325,81,"Tasa de exámenes médico legales por presunto delito sexual contra niños, niñas y adolescentes",2022,3,1,243,411.522633744856,0,123,0,1,120,833.333333333333
35575,15,15325,81,"Tasa de exámenes médico legales por presunto delito sexual contra niños, niñas y adolescentes",2022,4,2,244,819.672131147541,0,133,0,2,111,1801.8018018018
35576,15,15332,81,"Tasa de exámenes médico legales por presunto delito sexual contra niños, niñas y adolescentes",2022,4,2,460,434.782608695652,0,249,0,2,211,947.867298578199
35577,15,15362,81,"Tasa de exámenes médico legales por presunto delito sexual contra niños, niñas y adolescentes",2022,4,1,170,588.235294117647,0,91,0,1,79,1265.82278481013
35578,15,15362,121,Tasa de exámenes médico legales por presunto delito sexual cuando la víctima está entre 18 y 28 años,2022,5,1,338,295.85798816568,0,172,0,1,166,602.409638554217
35579,15,15367,81,"Tasa de exámenes médico legales por presunto delito sexual contra niños, niñas y adolescentes",2022,4,2,702,284.900284900285,0,354,0,2,348,574.712643678161
35580,15,15368,81,"Tasa de exámenes médico legales por presunto delito sexual contra niños, niñas y adolescentes",2022,3,1,402,248.756218905473,1,205,487.80487804878,0,197,0
35581,15,15380,81,"Tasa de exámenes médico legales por presunto delito sexual contra niños, niñas y adolescentes",2022,3,2,225,888.888888888889,0,121,0,2,104,1923.07692307692
35582,15,15403,81,"Tasa de exámenes médico legales por presunto delito sexual contra niños, niñas y adolescentes",2022,3,1,241,414.9377593361,0,118,0,1,123,813.008130081301
35583,15,15403,81,"Tasa de exámenes médico legales por presunto delito sexual contra niños, niñas y adolescentes",2022,4,1,253,395.256916996047,1,128,781.25,0,125,0
35584,15,15425,81,"Tasa de exámenes médico legales por presunto delito sexual contra niños, niñas y adolescentes",2022,2,1,326,306.748466257669,0,161,0,1,165,606.060606060606
35585,15,15442,81,"Tasa de exámenes médico legales por presunto delito sexual contra niños, niñas y adolescentes",2022,4,1,593,168.634064080944,0,326,0,1,267,374.531835205993
35586,15,15455,81,"Tasa de exámenes médico legales por presunto delito sexual contra niños, niñas y adolescentes",2022,3,1,768,130.208333333333,1,434,230.414746543779,0,334,0
35587,15,15455,81,"Tasa de exámenes médico legales por presunto delito sexual contra niños, niñas y adolescentes",2022,4,1,805,124.223602484472,0,434,0,1,371,269.541778975741
35588,15,15466,81,"Tasa de exámenes médico legales por presunto delito sexual contra niños, niñas y adolescentes",2022,2,1,344,290.697674418605,0,163,0,1,181,552.486187845304
35589,15,15469,81,"Tasa de exámenes médico legales por presunto delito sexual contra niños, niñas y adolescentes",2022,2,3,1535,195.439739413681,1,802,124.688279301746,2,733,272.851296043656
35590,15,15469,81,"Tasa de exámenes médico legales por presunto delito sexual contra niños, niñas y adolescentes",2022,3,9,2031,443.131462333826,3,1053,284.900284900285,6,978,613.496932515337
35591,15,15469,81,"Tasa de exámenes médico legales por presunto delito sexual contra niños, niñas y adolescentes",2022,4,10,2114,473.036896877957,1,1097,91.1577028258888,9,1017,884.955752212389
35592,15,15469,121,Tasa de exámenes médico legales por presunto delito sexual cuando la víctima está entre 18 y 28 años,2022,5,7,3531,198.244123477768,1,1767,56.5930956423316,6,1764,340.136054421769
35593,15,15476,81,"Tasa de exámenes médico legales por presunto delito sexual contra niños, niñas y adolescentes",2022,3,1,651,153.609831029186,0,323,0,1,328,304.878048780488
35594,15,15476,81,"Tasa de exámenes médico legales por presunto delito sexual contra niños, niñas y adolescentes",2022,4,2,592,337.837837837838,0,293,0,2,299,668.896321070234
35595,15,15476,121,Tasa de exámenes médico legales por presunto delito sexual cuando la víctima está entre 18 y 28 años,2022,5,1,1014,98.6193293885602,0,510,0,1,504,198.412698412698
35596,15,15480,81,"Tasa de exámenes médico legales por presunto delito sexual contra niños, niñas y adolescentes",2022,4,3,870,344.827586206897,1,455,219.78021978022,2,415,481.927710843374
35597,15,15491,81,"Tasa de exámenes médico legales por presunto delito sexual contra niños, niñas y adolescentes",2022,4,2,1548,129.198966408269,0,786,0,2,762,262.46719160105
35598,15,15494,81,"Tasa de exámenes médico legales por presunto delito sexual contra niños, niñas y adolescentes",2022,4,4,500,800,0,270,0,4,230,1739.13043478261
35599,15,15507,81,"Tasa de exámenes médico legales por presunto delito sexual contra niños, niñas y adolescentes",2022,4,1,888,112.612612612613,0,474,0,1,414,241.545893719807
35600,15,15514,81,"Tasa de exámenes médico legales por presunto delito sexual contra niños, niñas y adolescentes",2022,3,1,312,320.51282051282,1,168,595.238095238095,0,144,0
35601,15,15516,81,"Tasa de exámenes médico legales por presunto delito sexual contra niños, niñas y adolescentes",2022,2,2,2351,85.0701829008932,0,1230,0,2,1121,178.412132024978
35602,15,15516,81,"Tasa de exámenes médico legales por presunto delito sexual contra niños, niñas y adolescentes",2022,3,6,3133,191.5097350782,3,1628,184.275184275184,3,1505,199.335548172757
35603,15,15516,81,"Tasa de exámenes médico legales por presunto delito sexual contra niños, niñas y adolescentes",2022,4,6,3398,176.574455562095,0,1746,0,6,1652,363.19612590799
35604,15,15516,121,Tasa de exámenes médico legales por presunto delito sexual cuando la víctima está entre 18 y 28 años,2022,5,3,5937,50.5305709954523,0,2947,0,3,2990,100.334448160535
35605,15,15531,81,"Tasa de exámenes médico legales por presunto delito sexual contra niños, niñas y adolescentes",2022,3,1,652,153.374233128834,0,335,0,1,317,315.457413249211
35606,15,15531,81,"Tasa de exámenes médico legales por presunto delito sexual contra niños, niñas y adolescentes",2022,4,2,734,272.479564032698,1,386,259.067357512953,1,348,287.35632183908
35607,15,15531,121,Tasa de exámenes médico legales por presunto delito sexual cuando la víctima está entre 18 y 28 años,2022,5,1,949,105.374077976818,0,511,0,1,438,228.310502283105
35608,15,15533,81,"Tasa de exámenes médico legales por presunto delito sexual contra niños, niñas y adolescentes",2022,2,1,262,381.679389312977,1,128,781.25,0,134,0
35609,15,15537,81,"Tasa de exámenes médico legales por presunto delito sexual contra niños, niñas y adolescentes",2022,4,1,383,261.096605744125,0,208,0,1,175,571.428571428571
35610,15,15542,81,"Tasa de exámenes médico legales por presunto delito sexual contra niños, niñas y adolescentes",2022,3,1,720,138.888888888889,0,385,0,1,335,298.507462686567
35611,15,15542,81,"Tasa de exámenes médico legales por presunto delito sexual contra niños, niñas y adolescentes",2022,4,1,700,142.857142857143,0,383,0,1,317,315.457413249211
35612,15,15550,81,"Tasa de exámenes médico legales por presunto delito sexual contra niños, niñas y adolescentes",2022,4,1,201,497.512437810945,0,117,0,1,84,1190.47619047619
35613,15,15572,81,"Tasa de exámenes médico legales por presunto delito sexual contra niños, niñas y adolescentes",2022,2,9,4089,220.102714600147,2,2029,98.570724494825,7,2060,339.805825242718
35614,15,15572,81,"Tasa de exámenes médico legales por presunto delito sexual contra niños, niñas y adolescentes",2022,3,8,5008,159.744408945687,1,2508,39.8724082934609,7,2500,280
35615,15,15572,81,"Tasa de exámenes médico legales por presunto delito sexual contra niños, niñas y adolescentes",2022,4,24,4895,490.296220633299,1,2512,39.8089171974522,23,2383,965.169953839698
35616,15,15572,121,Tasa de exámenes médico legales por presunto delito sexual cuando la víctima está entre 18 y 28 años,2022,5,9,8674,103.758358312197,0,4424,0,9,4250,211.764705882353
35617,15,15599,81,"Tasa de exámenes médico legales por presunto delito sexual contra niños, niñas y adolescentes",2022,3,6,1011,593.471810089021,3,491,610.997963340122,3,520,576.923076923077
35618,15,15599,81,"Tasa de exámenes médico legales por presunto delito sexual contra niños, niñas y adolescentes",2022,4,5,1085,460.829493087558,0,559,0,5,526,950.570342205323
35619,15,15599,121,Tasa de exámenes médico legales por presunto delito sexual cuando la víctima está entre 18 y 28 años,2022,5,2,1706,117.233294255569,0,916,0,2,790,253.164556962025
35620,15,15600,81,"Tasa de exámenes médico legales por presunto delito sexual contra niños, niñas y adolescentes",2022,3,3,765,392.156862745098,1,409,244.498777506112,2,356,561.797752808989
35621,15,15600,81,"Tasa de exámenes médico legales por presunto delito sexual contra niños, niñas y adolescentes",2022,4,5,763,655.307994757536,1,428,233.644859813084,4,335,1194.02985074627
35622,15,15600,121,Tasa de exámenes médico legales por presunto delito sexual cuando la víctima está entre 18 y 28 años,2022,5,1,1451,68.9179875947622,0,799,0,1,652,153.374233128834
35623,15,15621,81,"Tasa de exámenes médico legales por presunto delito sexual contra niños, niñas y adolescentes",2022,4,2,240,833.333333333333,0,127,0,2,113,1769.91150442478
35624,15,15632,81,"Tasa de exámenes médico legales por presunto delito sexual contra niños, niñas y adolescentes",2022,3,1,1415,70.6713780918728,0,700,0,1,715,139.86013986014
35625,15,15632,81,"Tasa de exámenes médico legales por presunto delito sexual contra niños, niñas y adolescentes",2022,4,3,1414,212.164073550212,0,710,0,3,704,426.136363636364
35626,15,15632,121,Tasa de exámenes médico legales por presunto delito sexual cuando la víctima está entre 18 y 28 años,2022,5,1,2192,45.6204379562044,0,1124,0,1,1068,93.6329588014981
35627,15,15638,81,"Tasa de exámenes médico legales por presunto delito sexual contra niños, niñas y adolescentes",2022,4,1,581,172.117039586919,0,298,0,1,283,353.356890459364
35628,15,15646,81,"Tasa de exámenes médico legales por presunto delito sexual contra niños, niñas y adolescentes",2022,3,10,2091,478.240076518412,2,1063,188.146754468485,8,1028,778.210116731517
35629,15,15646,81,"Tasa de exámenes médico legales por presunto delito sexual contra niños, niñas y adolescentes",2022,4,7,1969,355.510411376333,0,1005,0,7,964,726.141078838174
35630,15,15646,121,Tasa de exámenes médico legales por presunto delito sexual cuando la víctima está entre 18 y 28 años,2022,5,2,3628,55.1267916207277,0,1863,0,2,1765,113.314447592068
35631,15,15646,81,"Tasa de exámenes médico legales por presunto delito sexual contra niños, niñas y adolescentes",2022,1,1,343,291.545189504373,1,179,558.659217877095,0,164,0
35632,15,15664,81,"Tasa de exámenes médico legales por presunto delito sexual contra niños, niñas y adolescentes",2022,4,4,407,982.800982800983,1,214,467.289719626168,3,193,1554.40414507772
35633,15,15667,81,"Tasa de exámenes médico legales por presunto delito sexual contra niños, niñas y adolescentes",2022,4,1,529,189.035916824197,0,282,0,1,247,404.858299595142
35634,15,15690,81,"Tasa de exámenes médico legales por presunto delito sexual contra niños, niñas y adolescentes",2022,3,1,328,304.878048780488,0,152,0,1,176,568.181818181818
35635,15,15693,81,"Tasa de exámenes médico legales por presunto delito sexual contra niños, niñas y adolescentes",2022,2,1,754,132.62599469496,1,378,264.550264550265,0,376,0
35636,15,15693,81,"Tasa de exámenes médico legales por presunto delito sexual contra niños, niñas y adolescentes",2022,3,6,1054,569.259962049336,3,538,557.620817843866,3,516,581.395348837209
35637,15,15693,81,"Tasa de exámenes médico legales por presunto delito sexual contra niños, niñas y adolescentes",2022,4,5,1132,441.696113074205,2,575,347.826086956522,3,557,538.599640933573
35638,15,15693,121,Tasa de exámenes médico legales por presunto delito sexual cuando la víctima está entre 18 y 28 años,2022,5,1,2746,36.4166059723234,0,1771,0,1,975,102.564102564103
35639,15,15696,81,"Tasa de exámenes médico legales por presunto delito sexual contra niños, niñas y adolescentes",2022,4,2,265,754.716981132075,0,137,0,2,128,1562.5
35640,15,15686,81,"Tasa de exámenes médico legales por presunto delito sexual contra niños, niñas y adolescentes",2022,3,2,719,278.164116828929,0,372,0,2,347,576.368876080692
35641,15,15686,81,"Tasa de exámenes médico legales por presunto delito sexual contra niños, niñas y adolescentes",2022,4,4,751,532.623169107856,1,385,259.74025974026,3,366,819.672131147541
35642,15,15720,81,"Tasa de exámenes médico legales por presunto delito sexual contra niños, niñas y adolescentes",2022,4,3,183,1639.34426229508,0,89,0,3,94,3191.48936170213
35643,15,15740,81,"Tasa de exámenes médico legales por presunto delito sexual contra niños, niñas y adolescentes",2022,3,2,816,245.098039215686,0,418,0,2,398,502.51256281407
35644,15,15740,81,"Tasa de exámenes médico legales por presunto delito sexual contra niños, niñas y adolescentes",2022,4,9,727,1237.96423658872,0,366,0,9,361,2493.07479224377
35645,15,15753,81,"Tasa de exámenes médico legales por presunto delito sexual contra niños, niñas y adolescentes",2022,3,1,745,134.228187919463,0,373,0,1,372,268.817204301075
35646,15,15757,81,"Tasa de exámenes médico legales por presunto delito sexual contra niños, niñas y adolescentes",2022,2,1,679,147.275405007364,0,348,0,1,331,302.114803625378
35647,15,15755,81,"Tasa de exámenes médico legales por presunto delito sexual contra niños, niñas y adolescentes",2022,4,1,706,141.643059490085,0,358,0,1,348,287.35632183908
35648,15,15759,81,"Tasa de exámenes médico legales por presunto delito sexual contra niños, niñas y adolescentes",2022,2,3,8466,35.4358610914245,2,4328,46.2107208872458,1,4138,24.1662638956017
35649,15,15759,81,"Tasa de exámenes médico legales por presunto delito sexual contra niños, niñas y adolescentes",2022,3,11,11105,99.0544799639802,3,5761,52.0742926575247,8,5344,149.700598802395
35650,15,15759,81,"Tasa de exámenes médico legales por presunto delito sexual contra niños, niñas y adolescentes",2022,4,33,12174,271.069492360769,1,6352,15.7430730478589,32,5822,549.639299209894
35651,15,15759,121,Tasa de exámenes médico legales por presunto delito sexual cuando la víctima está entre 18 y 28 años,2022,5,4,24068,16.6195778627223,0,12119,0,4,11949,33.475604653109
35652,15,15761,81,"Tasa de exámenes médico legales por presunto delito sexual contra niños, niñas y adolescentes",2022,3,1,185,540.540540540541,0,84,0,1,101,990.09900990099
35653,15,15762,81,"Tasa de exámenes médico legales por presunto delito sexual contra niños, niñas y adolescentes",2022,4,1,308,324.675324675325,0,163,0,1,145,689.655172413793
35654,15,15764,81,"Tasa de exámenes médico legales por presunto delito sexual contra niños, niñas y adolescentes",2022,3,1,708,141.242937853107,0,352,0,1,356,280.898876404494
35655,15,15764,81,"Tasa de exámenes médico legales por presunto delito sexual contra niños, niñas y adolescentes",2022,4,5,684,730.994152046784,1,345,289.855072463768,4,339,1179.94100294985
35656,15,15764,121,Tasa de exámenes médico legales por presunto delito sexual cuando la víctima está entre 18 y 28 años,2022,5,1,1010,99.009900990099,0,509,0,1,501,199.600798403194
35657,15,15763,81,"Tasa de exámenes médico legales por presunto delito sexual contra niños, niñas y adolescentes",2022,3,3,871,344.43168771527,1,451,221.729490022173,2,420,476.190476190476
35658,15,15763,81,"Tasa de exámenes médico legales por presunto delito sexual contra niños, niñas y adolescentes",2022,4,3,820,365.853658536585,0,437,0,3,383,783.289817232376
35659,15,15776,81,"Tasa de exámenes médico legales por presunto delito sexual contra niños, niñas y adolescentes",2022,4,2,611,327.332242225859,0,335,0,2,276,724.63768115942
35660,15,15778,81,"Tasa de exámenes médico legales por presunto delito sexual contra niños, niñas y adolescentes",2022,4,1,349,286.532951289398,0,180,0,1,169,591.715976331361
35661,15,15790,81,"Tasa de exámenes médico legales por presunto delito sexual contra niños, niñas y adolescentes",2022,3,2,597,335.00837520938,0,317,0,2,280,714.285714285714
35662,15,15790,81,"Tasa de exámenes médico legales por presunto delito sexual contra niños, niñas y adolescentes",2022,4,4,582,687.285223367698,0,295,0,4,287,1393.72822299652
35663,15,15798,121,Tasa de exámenes médico legales por presunto delito sexual cuando la víctima está entre 18 y 28 años,2022,5,1,459,217.864923747277,0,250,0,1,209,478.468899521531
35664,15,15804,81,"Tasa de exámenes médico legales por presunto delito sexual contra niños, niñas y adolescentes",2022,2,1,686,145.772594752187,0,361,0,1,325,307.692307692308
35665,15,15804,81,"Tasa de exámenes médico legales por presunto delito sexual contra niños, niñas y adolescentes",2022,4,2,823,243.013365735115,0,426,0,2,397,503.778337531486
35666,15,15806,81,"Tasa de exámenes médico legales por presunto delito sexual contra niños, niñas y adolescentes",2022,2,1,952,105.042016806723,0,509,0,1,443,225.733634311512
35667,15,15806,81,"Tasa de exámenes médico legales por presunto delito sexual contra niños, niñas y adolescentes",2022,3,3,1157,259.291270527226,0,608,0,3,549,546.448087431694
35668,15,15806,81,"Tasa de exámenes médico legales por presunto delito sexual contra niños, niñas y adolescentes",2022,4,3,1216,246.710526315789,0,633,0,3,583,514.579759862779
35669,15,15806,121,Tasa de exámenes médico legales por presunto delito sexual cuando la víctima está entre 18 y 28 años,2022,5,1,2372,42.1585160202361,0,1229,0,1,1143,87.4890638670166
35670,15,15808,81,"Tasa de exámenes médico legales por presunto delito sexual contra niños, niñas y adolescentes",2022,4,1,278,359.712230215827,0,147,0,1,131,763.358778625954
35671,15,15814,81,"Tasa de exámenes médico legales por presunto delito sexual contra niños, niñas y adolescentes",2022,3,1,991,100.908173562059,1,524,190.839694656489,0,467,0
35672,15,15814,81,"Tasa de exámenes médico legales por presunto delito sexual contra niños, niñas y adolescentes",2022,4,1,924,108.225108225108,0,475,0,1,449,222.71714922049
35673,15,15814,121,Tasa de exámenes médico legales por presunto delito sexual cuando la víctima está entre 18 y 28 años,2022,5,1,1532,65.2741514360313,0,771,0,1,761,131.406044678055
35674,15,15816,81,"Tasa de exámenes médico legales por presunto delito sexual contra niños, niñas y adolescentes",2022,3,2,489,408.997955010225,0,249,0,2,240,833.333333333333
35675,15,15816,81,"Tasa de exámenes médico legales por presunto delito sexual contra niños, niñas y adolescentes",2022,4,2,435,459.770114942529,0,227,0,2,208,961.538461538462
35676,15,15820,81,"Tasa de exámenes médico legales por presunto delito sexual contra niños, niñas y adolescentes",2022,3,1,370,270.27027027027,0,181,0,1,189,529.100529100529
35677,15,15820,81,"Tasa de exámenes médico legales por presunto delito sexual contra niños, niñas y adolescentes",2022,4,1,370,270.27027027027,0,173,0,1,197,507.614213197969
35678,15,15001,81,"Tasa de exámenes médico legales por presunto delito sexual contra niños, niñas y adolescentes",2022,2,14,11634,120.336943441637,3,5923,50.6500084416681,11,5711,192.61075118193
35679,15,15001,81,"Tasa de exámenes médico legales por presunto delito sexual contra niños, niñas y adolescentes",2022,3,34,15399,220.793558023248,6,7890,76.0456273764259,28,7509,372.885870288987
35680,15,15001,81,"Tasa de exámenes médico legales por presunto delito sexual contra niños, niñas y adolescentes",2022,4,95,17695,536.87482339644,13,9058,143.51954073747,82,8637,949.403728146347
35681,15,15001,121,Tasa de exámenes médico legales por presunto delito sexual cuando la víctima está entre 18 y 28 años,2022,5,28,37529,74.6089690639239,4,18638,21.4615302071038,24,18891,127.044624424329
35682,15,15832,81,"Tasa de exámenes médico legales por presunto delito sexual contra niños, niñas y adolescentes",2022,3,1,154,649.350649350649,0,88,0,1,66,1515.15151515152
35683,15,15835,81,"Tasa de exámenes médico legales por presunto delito sexual contra niños, niñas y adolescentes",2022,2,1,417,239.808153477218,1,225,444.444444444444,0,192,0
35684,15,15835,81,"Tasa de exámenes médico legales por presunto delito sexual contra niños, niñas y adolescentes",2022,3,1,574,174.216027874564,0,300,0,1,274,364.963503649635
35685,15,15835,81,"Tasa de exámenes médico legales por presunto delito sexual contra niños, niñas y adolescentes",2022,4,3,576,520.833333333333,0,297,0,3,279,1075.2688172043
35686,15,15835,121,Tasa de exámenes médico legales por presunto delito sexual cuando la víctima está entre 18 y 28 años,2022,5,2,747,267.737617135207,1,381,262.46719160105,1,366,273.224043715847
35687,15,15837,81,"Tasa de exámenes médico legales por presunto delito sexual contra niños, niñas y adolescentes",2022,3,4,860,465.116279069767,1,431,232.018561484919,3,429,699.300699300699
35688,15,15837,81,"Tasa de exámenes médico legales por presunto delito sexual contra niños, niñas y adolescentes",2022,4,5,816,612.745098039216,0,406,0,5,410,1219.51219512195
35689,15,15837,121,Tasa de exámenes médico legales por presunto delito sexual cuando la víctima está entre 18 y 28 años,2022,5,1,1370,72.992700729927,0,686,0,1,684,146.198830409357
35690,15,15839,81,"Tasa de exámenes médico legales por presunto delito sexual contra niños, niñas y adolescentes",2022,3,1,198,505.050505050505,1,103,970.873786407767,0,95,0
35691,15,15842,81,"Tasa de exámenes médico legales por presunto delito sexual contra niños, niñas y adolescentes",2022,3,2,754,265.25198938992,0,379,0,2,375,533.333333333333
35692,15,15842,81,"Tasa de exámenes médico legales por presunto delito sexual contra niños, niñas y adolescentes",2022,4,3,741,404.858299595142,0,393,0,3,348,862.068965517241
35693,15,15842,121,Tasa de exámenes médico legales por presunto delito sexual cuando la víctima está entre 18 y 28 años,2022,5,1,1025,97.5609756097561,0,551,0,1,474,210.970464135021
35694,15,15861,81,"Tasa de exámenes médico legales por presunto delito sexual contra niños, niñas y adolescentes",2022,4,5,1649,303.214069132808,0,863,0,5,786,636.132315521628
35695,15,15861,121,Tasa de exámenes médico legales por presunto delito sexual cuando la víctima está entre 18 y 28 años,2022,5,2,2699,74.1015190811412,1,1337,74.794315632012,1,1362,73.4214390602056
35696,15,15407,81,"Tasa de exámenes médico legales por presunto delito sexual contra niños, niñas y adolescentes",2022,2,1,1220,81.9672131147541,0,617,0,1,603,165.837479270315
35697,15,15407,81,"Tasa de exámenes médico legales por presunto delito sexual contra niños, niñas y adolescentes",2022,3,2,1468,136.239782016349,1,753,132.802124833997,1,715,139.86013986014
35698,15,15407,81,"Tasa de exámenes médico legales por presunto delito sexual contra niños, niñas y adolescentes",2022,4,1,1497,66.8002672010688,0,776,0,1,721,138.69625520111
35699,15,15407,121,Tasa de exámenes médico legales por presunto delito sexual cuando la víctima está entre 18 y 28 años,2022,5,1,3084,32.4254215304799,0,1564,0,1,1520,65.7894736842105
35700,15,15879,121,Tasa de exámenes médico legales por presunto delito sexual cuando la víctima está entre 18 y 28 años,2022,5,1,388,257.731958762887,0,224,0,1,164,609.756097560976
35701,15,15897,81,"Tasa de exámenes médico legales por presunto delito sexual contra niños, niñas y adolescentes",2022,4,1,456,219.298245614035,0,242,0,1,214,467.289719626168
35702,17,17013,81,"Tasa de exámenes médico legales por presunto delito sexual contra niños, niñas y adolescentes",2022,2,2,1622,123.304562268804,0,858,0,2,764,261.780104712042
35703,17,17013,81,"Tasa de exámenes médico legales por presunto delito sexual contra niños, niñas y adolescentes",2022,3,2,1941,103.039670273055,1,992,100.806451612903,1,949,105.374077976818
35704,17,17013,81,"Tasa de exámenes médico legales por presunto delito sexual contra niños, niñas y adolescentes",2022,4,1,1856,53.8793103448276,0,933,0,1,923,108.342361863489
35705,17,17042,81,"Tasa de exámenes médico legales por presunto delito sexual contra niños, niñas y adolescentes",2022,2,2,2339,85.5066267635742,0,1206,0,2,1133,176.522506619594
35706,17,17042,81,"Tasa de exámenes médico legales por presunto delito sexual contra niños, niñas y adolescentes",2022,3,5,2973,168.180289270098,3,1537,195.185426154847,2,1436,139.275766016713
35707,17,17042,81,"Tasa de exámenes médico legales por presunto delito sexual contra niños, niñas y adolescentes",2022,4,8,3013,265.516096913375,0,1558,0,8,1455,549.828178694158
35708,17,17042,121,Tasa de exámenes médico legales por presunto delito sexual cuando la víctima está entre 18 y 28 años,2022,5,3,5685,52.7704485488127,0,2914,0,3,2771,108.26416456153
35709,17,17050,81,"Tasa de exámenes médico legales por presunto delito sexual contra niños, niñas y adolescentes",2022,2,1,767,130.378096479791,0,400,0,1,367,272.479564032698
35710,17,17050,81,"Tasa de exámenes médico legales por presunto delito sexual contra niños, niñas y adolescentes",2022,3,2,951,210.304942166141,0,483,0,2,468,427.350427350427
35711,17,17050,81,"Tasa de exámenes médico legales por presunto delito sexual contra niños, niñas y adolescentes",2022,4,1,931,107.411385606874,0,447,0,1,484,206.611570247934
35712,17,17088,81,"Tasa de exámenes médico legales por presunto delito sexual contra niños, niñas y adolescentes",2022,3,1,1040,96.1538461538462,0,554,0,1,486,205.761316872428
35713,17,17088,81,"Tasa de exámenes médico legales por presunto delito sexual contra niños, niñas y adolescentes",2022,4,1,949,105.374077976818,1,488,204.918032786885,0,461,0
35714,17,17174,81,"Tasa de exámenes médico legales por presunto delito sexual contra niños, niñas y adolescentes",2022,3,7,4062,172.32890201871,0,2063,0,7,1999,350.175087543772
35715,17,17174,81,"Tasa de exámenes médico legales por presunto delito sexual contra niños, niñas y adolescentes",2022,4,9,4382,205.385668644455,0,2179,0,9,2203,408.533817521562
35716,17,17174,121,Tasa de exámenes médico legales por presunto delito sexual cuando la víctima está entre 18 y 28 años,2022,5,1,8939,11.1869336614834,0,4376,0,1,4563,21.9154065307911
35717,17,17272,81,"Tasa de exámenes médico legales por presunto delito sexual contra niños, niñas y adolescentes",2022,4,1,944,105.932203389831,0,486,0,1,458,218.340611353712
35718,17,17272,121,Tasa de exámenes médico legales por presunto delito sexual cuando la víctima está entre 18 y 28 años,2022,5,2,1524,131.233595800525,0,779,0,2,745,268.456375838926
35719,17,17380,81,"Tasa de exámenes médico legales por presunto delito sexual contra niños, niñas y adolescentes",2022,2,9,5403,166.574125485841,1,2737,36.5363536719035,8,2666,300.075018754689
35720,17,17380,81,"Tasa de exámenes médico legales por presunto delito sexual contra niños, niñas y adolescentes",2022,3,20,6759,295.901760615476,3,3397,88.3132175448926,17,3362,505.651397977394
35721,17,17380,81,"Tasa de exámenes médico legales por presunto delito sexual contra niños, niñas y adolescentes",2022,4,30,6644,451.53521974714,0,3313,0,30,3331,900.630441308916
35722,17,17380,121,Tasa de exámenes médico legales por presunto delito sexual cuando la víctima está entre 18 y 28 años,2022,5,6,12227,49.0717265069109,0,6065,0,6,6162,97.3709834469328
35723,17,17388,81,"Tasa de exámenes médico legales por presunto delito sexual contra niños, niñas y adolescentes",2022,2,1,366,273.224043715847,0,194,0,1,172,581.395348837209
35724,17,17388,81,"Tasa de exámenes médico legales por presunto delito sexual contra niños, niñas y adolescentes",2022,3,1,471,212.314225053079,1,240,416.666666666667,0,231,0
35725,17,17001,81,"Tasa de exámenes médico legales por presunto delito sexual contra niños, niñas y adolescentes",2022,2,24,22945,104.597951623447,4,11554,34.6200450060585,20,11391,175.577210078132
35726,17,17001,81,"Tasa de exámenes médico legales por presunto delito sexual contra niños, niñas y adolescentes",2022,3,61,29582,206.206476911635,13,15000,86.6666666666667,48,14582,329.172952955699
35727,17,17001,81,"Tasa de exámenes médico legales por presunto delito sexual contra niños, niñas y adolescentes",2022,4,131,33720,388.493475682088,13,17185,75.6473668897294,118,16535,713.637738131237
35728,17,17001,121,Tasa de exámenes médico legales por presunto delito sexual cuando la víctima está entre 18 y 28 años,2022,5,24,80006,29.9977501687373,2,40069,4.99138985250443,22,39937,55.0867616495981
35729,17,17433,121,Tasa de exámenes médico legales por presunto delito sexual cuando la víctima está entre 18 y 28 años,2022,5,1,2745,36.4298724954463,0,1388,0,1,1357,73.6919675755343
35730,17,17442,81,"Tasa de exámenes médico legales por presunto delito sexual contra niños, niñas y adolescentes",2022,4,1,820,121.951219512195,0,416,0,1,404,247.524752475248
35731,17,17442,121,Tasa de exámenes médico legales por presunto delito sexual cuando la víctima está entre 18 y 28 años,2022,5,1,1696,58.9622641509434,0,870,0,1,826,121.065375302663
35732,17,17444,81,"Tasa de exámenes médico legales por presunto delito sexual contra niños, niñas y adolescentes",2022,4,1,1196,83.6120401337793,0,634,0,1,562,177.935943060498
35733,17,17446,81,"Tasa de exámenes médico legales por presunto delito sexual contra niños, niñas y adolescentes",2022,3,1,233,429.184549356223,1,130,769.230769230769,0,103,0
35734,17,17446,81,"Tasa de exámenes médico legales por presunto delito sexual contra niños, niñas y adolescentes",2022,4,1,209,478.468899521531,0,113,0,1,96,1041.66666666667
35735,17,17486,81,"Tasa de exámenes médico legales por presunto delito sexual contra niños, niñas y adolescentes",2022,2,1,1475,67.7966101694915,0,769,0,1,706,141.643059490085
35736,17,17486,81,"Tasa de exámenes médico legales por presunto delito sexual contra niños, niñas y adolescentes",2022,3,3,1812,165.562913907285,1,963,103.842159916926,2,849,235.571260306243
35737,17,17486,81,"Tasa de exámenes médico legales por presunto delito sexual contra niños, niñas y adolescentes",2022,4,4,1803,221.852468108708,0,961,0,4,842,475.059382422803
35738,17,17486,121,Tasa de exámenes médico legales por presunto delito sexual cuando la víctima está entre 18 y 28 años,2022,5,2,3283,60.9198903441974,0,1626,0,2,1657,120.70006035003
35739,17,17495,81,"Tasa de exámenes médico legales por presunto delito sexual contra niños, niñas y adolescentes",2022,3,2,629,317.965023847377,1,332,301.204819277108,1,297,336.700336700337
35740,17,17495,81,"Tasa de exámenes médico legales por presunto delito sexual contra niños, niñas y adolescentes",2022,4,1,621,161.030595813205,0,318,0,1,303,330.03300330033
35741,17,17513,81,"Tasa de exámenes médico legales por presunto delito sexual contra niños, niñas y adolescentes",2022,3,3,1131,265.25198938992,0,575,0,3,556,539.568345323741
35742,17,17513,81,"Tasa de exámenes médico legales por presunto delito sexual contra niños, niñas y adolescentes",2022,4,5,1146,436.30017452007,1,602,166.112956810631,4,544,735.294117647059
35743,17,17524,81,"Tasa de exámenes médico legales por presunto delito sexual contra niños, niñas y adolescentes",2022,2,1,1163,85.9845227858985,0,609,0,1,554,180.505415162455
35744,17,17524,81,"Tasa de exámenes médico legales por presunto delito sexual contra niños, niñas y adolescentes",2022,3,2,1331,150.26296018031601,1,672,148.809523809524,1,659,151.745068285281
35745,17,17524,121,Tasa de exámenes médico legales por presunto delito sexual cuando la víctima está entre 18 y 28 años,2022,5,1,2547,39.2618767177071,0,1263,0,1,1284,77.8816199376947
35746,17,17541,81,"Tasa de exámenes médico legales por presunto delito sexual contra niños, niñas y adolescentes",2022,4,2,1738,115.074798619102,1,879,113.765642775882,1,859,116.414435389988
35747,17,17614,81,"Tasa de exámenes médico legales por presunto delito sexual contra niños, niñas y adolescentes",2022,2,3,3972,75.5287009063444,1,2014,49.6524329692155,2,1958,102.145045965271
35748,17,17614,81,"Tasa de exámenes médico legales por presunto delito sexual contra niños, niñas y adolescentes",2022,3,10,4531,220.701831825204,3,2337,128.369704749679,7,2194,319.051959890611
35749,17,17614,81,"Tasa de exámenes médico legales por presunto delito sexual contra niños, niñas y adolescentes",2022,4,29,4325,670.520231213873,3,2270,132.15859030837,26,2055,1265.20681265207
35750,17,17614,121,Tasa de exámenes médico legales por presunto delito sexual cuando la víctima está entre 18 y 28 años,2022,5,4,8484,47.1475719000471,0,4352,0,4,4132,96.8054211035818
35751,17,17616,81,"Tasa de exámenes médico legales por presunto delito sexual contra niños, niñas y adolescentes",2022,3,1,903,110.741971207087,0,481,0,1,422,236.96682464455
35752,17,17616,81,"Tasa de exámenes médico legales por presunto delito sexual contra niños, niñas y adolescentes",2022,4,1,914,109.409190371991,1,496,201.612903225806,0,418,0
35753,17,17653,81,"Tasa de exámenes médico legales por presunto delito sexual contra niños, niñas y adolescentes",2022,2,2,1154,173.310225303293,0,595,0,2,559,357.78175313059
35754,17,17653,81,"Tasa de exámenes médico legales por presunto delito sexual contra niños, niñas y adolescentes",2022,3,2,1523,131.319763624425,0,794,0,2,729,274.348422496571
35755,17,17653,81,"Tasa de exámenes médico legales por presunto delito sexual contra niños, niñas y adolescentes",2022,4,8,1559,513.149454778704,0,819,0,8,740,1081.08108108108
35756,17,17653,121,Tasa de exámenes médico legales por presunto delito sexual cuando la víctima está entre 18 y 28 años,2022,5,1,2747,36.4033491081179,0,1419,0,1,1328,75.3012048192771
35757,17,17662,81,"Tasa de exámenes médico legales por presunto delito sexual contra niños, niñas y adolescentes",2022,3,4,2049,195.217179111762,2,1052,190.114068441065,2,997,200.601805416249
35758,17,17662,81,"Tasa de exámenes médico legales por presunto delito sexual contra niños, niñas y adolescentes",2022,4,5,1845,271.0027100271,0,954,0,5,891,561.167227833894
35759,17,17777,81,"Tasa de exámenes médico legales por presunto delito sexual contra niños, niñas y adolescentes",2022,2,2,2243,89.1662951404369,2,1201,166.527893422148,0,1042,0
35760,17,17777,81,"Tasa de exámenes médico legales por presunto delito sexual contra niños, niñas y adolescentes",2022,3,4,2556,156.494522691706,0,1341,0,4,1215,329.218106995885
35761,17,17777,81,"Tasa de exámenes médico legales por presunto delito sexual contra niños, niñas y adolescentes",2022,4,8,2453,326.131267835304,0,1253,0,8,1200,666.666666666667
35762,17,17867,81,"Tasa de exámenes médico legales por presunto delito sexual contra niños, niñas y adolescentes",2022,3,2,970,206.185567010309,1,482,207.46887966805,1,488,204.918032786885
35763,17,17867,81,"Tasa de exámenes médico legales por presunto delito sexual contra niños, niñas y adolescentes",2022,4,2,925,216.216216216216,0,477,0,2,448,446.428571428571
35764,17,17867,121,Tasa de exámenes médico legales por presunto delito sexual cuando la víctima está entre 18 y 28 años,2022,5,1,1524,65.6167979002625,0,750,0,1,774,129.198966408269
35765,17,17873,81,"Tasa de exámenes médico legales por presunto delito sexual contra niños, niñas y adolescentes",2022,3,10,5295,188.857412653447,4,2753,145.296040682891,6,2542,236.0346184107
35766,17,17873,81,"Tasa de exámenes médico legales por presunto delito sexual contra niños, niñas y adolescentes",2022,4,23,5514,417.120058034095,2,2870,69.6864111498258,21,2644,794.251134644478
35767,17,17873,121,Tasa de exámenes médico legales por presunto delito sexual cuando la víctima está entre 18 y 28 años,2022,5,3,11610,25.8397932816537,0,5774,0,3,5836,51.4050719671008
35768,17,17873,81,"Tasa de exámenes médico legales por presunto delito sexual contra niños, niñas y adolescentes",2022,1,1,761,131.406044678055,1,389,257.06940874036,0,372,0
35769,17,17877,81,"Tasa de exámenes médico legales por presunto delito sexual contra niños, niñas y adolescentes",2022,3,3,1008,297.619047619048,1,518,193.050193050193,2,490,408.163265306122
35770,17,17877,81,"Tasa de exámenes médico legales por presunto delito sexual contra niños, niñas y adolescentes",2022,4,2,1127,177.462289263532,0,548,0,2,579,345.423143350604
35771,17,17877,121,Tasa de exámenes médico legales por presunto delito sexual cuando la víctima está entre 18 y 28 años,2022,5,1,2101,47.5963826749167,0,1008,0,1,1093,91.4913083257091
35772,18,18029,81,"Tasa de exámenes médico legales por presunto delito sexual contra niños, niñas y adolescentes",2022,4,3,573,523.560209424084,0,295,0,3,278,1079.13669064748
35773,18,18029,121,Tasa de exámenes médico legales por presunto delito sexual cuando la víctima está entre 18 y 28 años,2022,5,1,852,117.370892018779,0,433,0,1,419,238.663484486874
35774,18,18094,81,"Tasa de exámenes médico legales por presunto delito sexual contra niños, niñas y adolescentes",2022,3,1,1404,71.2250712250712,0,738,0,1,666,150.15015015015
35775,18,18094,81,"Tasa de exámenes médico legales por presunto delito sexual contra niños, niñas y adolescentes",2022,4,4,1547,258.564964447317,0,737,0,4,810,493.827160493827
35776,18,18094,121,Tasa de exámenes médico legales por presunto delito sexual cuando la víctima está entre 18 y 28 años,2022,5,1,2067,48.3792936623125,0,1042,0,1,1025,97.5609756097561
35777,18,18150,81,"Tasa de exámenes médico legales por presunto delito sexual contra niños, niñas y adolescentes",2022,2,4,3738,107.009095773141,3,1872,160.25641025641,1,1866,53.5905680600214
35778,18,18150,81,"Tasa de exámenes médico legales por presunto delito sexual contra niños, niñas y adolescentes",2022,3,6,4415,135.900339750849,2,2250,88.8888888888889,4,2165,184.757505773672
35779,18,18150,81,"Tasa de exámenes médico legales por presunto delito sexual contra niños, niñas y adolescentes",2022,4,9,4017,224.047796863331,0,2047,0,9,1970,456.852791878173
35780,18,18150,121,Tasa de exámenes médico legales por presunto delito sexual cuando la víctima está entre 18 y 28 años,2022,5,2,5856,34.1530054644809,0,2870,0,2,2986,66.9792364367046
35781,18,18205,81,"Tasa de exámenes médico legales por presunto delito sexual contra niños, niñas y adolescentes",2022,3,1,1046,95.6022944550669,0,522,0,1,524,190.839694656489
35782,18,18205,81,"Tasa de exámenes médico legales por presunto delito sexual contra niños, niñas y adolescentes",2022,4,1,998,100.200400801603,0,527,0,1,471,212.314225053079
35783,18,18205,121,Tasa de exámenes médico legales por presunto delito sexual cuando la víctima está entre 18 y 28 años,2022,5,1,1398,71.5307582260372,0,714,0,1,684,146.198830409357
35784,18,18247,81,"Tasa de exámenes médico legales por presunto delito sexual contra niños, niñas y adolescentes",2022,2,1,1755,56.980056980057,0,909,0,1,846,118.203309692671
35785,18,18247,81,"Tasa de exámenes médico legales por presunto delito sexual contra niños, niñas y adolescentes",2022,3,4,2288,174.825174825175,1,1185,84.3881856540084,3,1103,271.985494106981
35786,18,18247,81,"Tasa de exámenes médico legales por presunto delito sexual contra niños, niñas y adolescentes",2022,4,4,2286,174.978127734033,0,1180,0,4,1106,361.663652802893
35787,18,18256,81,"Tasa de exámenes médico legales por presunto delito sexual contra niños, niñas y adolescentes",2022,3,7,2299,304.480208786429,1,1186,84.3170320404722,6,1113,539.083557951482
35788,18,18256,81,"Tasa de exámenes médico legales por presunto delito sexual contra niños, niñas y adolescentes",2022,4,8,2187,365.797896662094,0,1138,0,8,1049,762.631077216397
35789,18,18256,121,Tasa de exámenes médico legales por presunto delito sexual cuando la víctima está entre 18 y 28 años,2022,5,1,3482,28.7191269385411,0,1810,0,1,1672,59.8086124401914
35790,18,18001,81,"Tasa de exámenes médico legales por presunto delito sexual contra niños, niñas y adolescentes",2022,2,14,14135,99.0449239476477,1,7351,13.6035913481159,13,6784,191.627358490566
35791,18,18001,81,"Tasa de exámenes médico legales por presunto delito sexual contra niños, niñas y adolescentes",2022,3,61,17625,346.099290780142,12,9078,132.187706543291,49,8547,573.300573300573
35792,18,18001,81,"Tasa de exámenes médico legales por presunto delito sexual contra niños, niñas y adolescentes",2022,4,121,18690,647.405029427501,2,9501,21.050415745711,119,9189,1295.02666231364
35793,18,18001,121,Tasa de exámenes médico legales por presunto delito sexual cuando la víctima está entre 18 y 28 años,2022,5,27,37390,72.211821342605,3,19389,15.4726907009129,24,18001,133.325926337426
35794,18,18410,81,"Tasa de exámenes médico legales por presunto delito sexual contra niños, niñas y adolescentes",2022,2,2,1552,128.865979381443,1,809,123.609394313968,1,743,134.589502018843
35795,18,18410,81,"Tasa de exámenes médico legales por presunto delito sexual contra niños, niñas y adolescentes",2022,3,2,2037,98.1836033382425,0,1049,0,2,988,202.429149797571
35796,18,18410,81,"Tasa de exámenes médico legales por presunto delito sexual contra niños, niñas y adolescentes",2022,4,5,1921,260.281103591879,0,994,0,5,927,539.374325782093
35797,18,18410,121,Tasa de exámenes médico legales por presunto delito sexual cuando la víctima está entre 18 y 28 años,2022,5,3,2615,114.72275334608,1,1332,75.0750750750751,2,1283,155.884645362432
35798,18,18460,81,"Tasa de exámenes médico legales por presunto delito sexual contra niños, niñas y adolescentes",2022,3,2,1514,132.100396301189,0,770,0,2,744,268.817204301075
35799,18,18460,81,"Tasa de exámenes médico legales por presunto delito sexual contra niños, niñas y adolescentes",2022,4,6,1364,439.882697947214,1,740,135.135135135135,5,624,801.282051282051
35800,18,18460,121,Tasa de exámenes médico legales por presunto delito sexual cuando la víctima está entre 18 y 28 años,2022,5,2,1750,114.285714285714,0,926,0,2,824,242.718446601942
35801,18,18479,81,"Tasa de exámenes médico legales por presunto delito sexual contra niños, niñas y adolescentes",2022,4,4,409,977.99511002445,0,197,0,4,212,1886.79245283019
35802,18,18592,81,"Tasa de exámenes médico legales por presunto delito sexual contra niños, niñas y adolescentes",2022,2,1,2594,38.550501156515,1,1297,77.1010023130301,0,1297,0
35803,18,18592,81,"Tasa de exámenes médico legales por presunto delito sexual contra niños, niñas y adolescentes",2022,3,2,3420,58.4795321637427,0,1731,0,2,1689,118.413262285376
35804,18,18592,81,"Tasa de exámenes médico legales por presunto delito sexual contra niños, niñas y adolescentes",2022,4,8,3479,229.951135383731,0,1800,0,8,1679,476.474091721263
35805,18,18592,121,Tasa de exámenes médico legales por presunto delito sexual cuando la víctima está entre 18 y 28 años,2022,5,2,5076,39.4011032308905,1,2655,37.6647834274953,1,2421,41.3052457662123
35806,18,18610,81,"Tasa de exámenes médico legales por presunto delito sexual contra niños, niñas y adolescentes",2022,2,1,1317,75.9301442672741,0,679,0,1,638,156.739811912226
35807,18,18610,81,"Tasa de exámenes médico legales por presunto delito sexual contra niños, niñas y adolescentes",2022,4,5,1812,275.938189845475,0,916,0,5,896,558.035714285714
35808,18,18753,81,"Tasa de exámenes médico legales por presunto delito sexual contra niños, niñas y adolescentes",2022,2,10,5910,169.204737732656,2,3024,66.1375661375661,8,2886,277.200277200277
35809,18,18753,81,"Tasa de exámenes médico legales por presunto delito sexual contra niños, niñas y adolescentes",2022,3,29,6826,424.846176384413,7,3474,201.496833621186,22,3352,656.324582338902
35810,18,18753,81,"Tasa de exámenes médico legales por presunto delito sexual contra niños, niñas y adolescentes",2022,4,75,6277,1194.83829855026,1,3241,30.8546744831842,74,3036,2437.41765480896
35811,18,18753,121,Tasa de exámenes médico legales por presunto delito sexual cuando la víctima está entre 18 y 28 años,2022,5,8,10273,77.8740387423343,1,5506,18.1620050853614,7,4767,146.842878120411
35812,18,18756,81,"Tasa de exámenes médico legales por presunto delito sexual contra niños, niñas y adolescentes",2022,3,2,1666,120.048019207683,0,856,0,2,810,246.913580246914
35813,18,18756,81,"Tasa de exámenes médico legales por presunto delito sexual contra niños, niñas y adolescentes",2022,4,5,1531,326.583932070542,0,817,0,5,714,700.280112044818
35814,18,18785,81,"Tasa de exámenes médico legales por presunto delito sexual contra niños, niñas y adolescentes",2022,3,1,802,124.688279301746,0,394,0,1,408,245.098039215686
35815,18,18785,81,"Tasa de exámenes médico legales por presunto delito sexual contra niños, niñas y adolescentes",2022,4,2,814,245.700245700246,0,409,0,2,405,493.827160493827
35816,18,18860,81,"Tasa de exámenes médico legales por presunto delito sexual contra niños, niñas y adolescentes",2022,2,1,564,177.304964539007,0,292,0,1,272,367.647058823529
35817,18,18860,81,"Tasa de exámenes médico legales por presunto delito sexual contra niños, niñas y adolescentes",2022,3,2,902,221.729490022173,0,481,0,2,421,475.059382422803
35818,18,18860,81,"Tasa de exámenes médico legales por presunto delito sexual contra niños, niñas y adolescentes",2022,4,1,1019,98.135426889107,0,530,0,1,489,204.498977505112
35819,85,85010,81,"Tasa de exámenes médico legales por presunto delito sexual contra niños, niñas y adolescentes",2022,2,7,3258,214.855739717618,0,1712,0,7,1546,452.781371280724
35820,85,85010,81,"Tasa de exámenes médico legales por presunto delito sexual contra niños, niñas y adolescentes",2022,3,17,4017,423.201394075181,1,2087,47.9156684235745,16,1930,829.015544041451
35821,85,85010,81,"Tasa de exámenes médico legales por presunto delito sexual contra niños, niñas y adolescentes",2022,4,25,4024,621.272365805169,1,2053,48.7092060399415,24,1971,1217.65601217656
35822,85,85010,121,Tasa de exámenes médico legales por presunto delito sexual cuando la víctima está entre 18 y 28 años,2022,5,3,7559,39.687789390131,0,3847,0,3,3712,80.8189655172414
35823,85,85015,81,"Tasa de exámenes médico legales por presunto delito sexual contra niños, niñas y adolescentes",2022,4,1,256,390625,0,133,0,1,123,813.008130081301
35824,85,85125,81,"Tasa de exámenes médico legales por presunto delito sexual contra niños, niñas y adolescentes",2022,2,1,1407,71.0732054015636,1,694,144.092219020173,0,713,0
35825,85,85125,81,"Tasa de exámenes médico legales por presunto delito sexual contra niños, niñas y adolescentes",2022,3,2,1753,114.090131203651,0,891,0,2,862,232.018561484919
35826,85,85125,81,"Tasa de exámenes médico legales por presunto delito sexual contra niños, niñas y adolescentes",2022,4,6,1642,365.408038976857,1,855,116.959064327485,5,787,635.324015247776
35827,85,85125,121,Tasa de exámenes médico legales por presunto delito sexual cuando la víctima está entre 18 y 28 años,2022,5,2,2373,84.2815002107038,0,1258,0,2,1115,179.372197309417
35828,85,85139,81,"Tasa de exámenes médico legales por presunto delito sexual contra niños, niñas y adolescentes",2022,2,3,1624,184.729064039409,0,836,0,3,788,380.710659898477
35829,85,85139,81,"Tasa de exámenes médico legales por presunto delito sexual contra niños, niñas y adolescentes",2022,3,4,1897,210.859251449657,1,1005,99.502487562189,3,892,336.322869955157
35830,85,85139,81,"Tasa de exámenes médico legales por presunto delito sexual contra niños, niñas y adolescentes",2022,4,12,1769,678.349349915206,2,941,212.539851222104,10,828,1207.72946859903
35831,85,85139,121,Tasa de exámenes médico legales por presunto delito sexual cuando la víctima está entre 18 y 28 años,2022,5,2,3173,63.0318310746927,1,1623,61.6142945163278,1,1550,64.5161290322581
35832,85,85162,81,"Tasa de exámenes médico legales por presunto delito sexual contra niños, niñas y adolescentes",2022,2,2,1573,127.145581691036,1,794,125.944584382872,1,779,128.369704749679
35833,85,85162,81,"Tasa de exámenes médico legales por presunto delito sexual contra niños, niñas y adolescentes",2022,3,1,1894,52.7983104540655,0,951,0,1,943,106.044538706257
35834,85,85162,81,"Tasa de exámenes médico legales por presunto delito sexual contra niños, niñas y adolescentes",2022,4,6,1841,325.909831613254,0,919,0,6,922,650.759219088937
35835,85,85162,121,Tasa de exámenes médico legales por presunto delito sexual cuando la víctima está entre 18 y 28 años,2022,5,2,3459,57.8201792425557,0,1722,0,2,1737,115.141047783535
35836,85,85225,81,"Tasa de exámenes médico legales por presunto delito sexual contra niños, niñas y adolescentes",2022,2,1,881,113.507377979569,0,458,0,1,423,236.406619385343
35837,85,85225,81,"Tasa de exámenes médico legales por presunto delito sexual contra niños, niñas y adolescentes",2022,3,2,992,201.612903225806,0,517,0,2,475,421.052631578947
35838,85,85225,81,"Tasa de exámenes médico legales por presunto delito sexual contra niños, niñas y adolescentes",2022,4,2,930,215.05376344086,0,489,0,2,441,453.514739229025
35839,85,85225,121,Tasa de exámenes médico legales por presunto delito sexual cuando la víctima está entre 18 y 28 años,2022,5,2,1723,116.076610562972,0,955,0,2,768,260.416666666667
35840,85,85230,81,"Tasa de exámenes médico legales por presunto delito sexual contra niños, niñas y adolescentes",2022,2,1,1428,70.0280112044818,0,701,0,1,727,137.551581843191
35841,85,85230,81,"Tasa de exámenes médico legales por presunto delito sexual contra niños, niñas y adolescentes",2022,3,3,1761,170.357751277683,1,892,112.107623318386,2,869,230.149597238205
35842,85,85230,81,"Tasa de exámenes médico legales por presunto delito sexual contra niños, niñas y adolescentes",2022,4,10,1640,609.756097560976,2,854,234.192037470726,8,786,1017.81170483461
35843,85,85230,121,Tasa de exámenes médico legales por presunto delito sexual cuando la víctima está entre 18 y 28 años,2022,5,1,2415,41.407867494824,0,1217,0,1,1198,83.4724540901503
35844,85,85250,81,"Tasa de exámenes médico legales por presunto delito sexual contra niños, niñas y adolescentes",2022,2,7,3920,178.571428571429,3,1988,150.905432595573,4,1932,207.03933747412
35845,85,85250,81,"Tasa de exámenes médico legales por presunto delito sexual contra niños, niñas y adolescentes",2022,3,22,4597,478.572982379813,6,2355,254.777070063694,16,2242,713.648528099911
35846,85,85250,81,"Tasa de exámenes médico legales por presunto delito sexual contra niños, niñas y adolescentes",2022,4,29,4214,688.182249644044,1,2163,46.2320850670365,28,2051,1365.18771331058
35847,85,85250,121,Tasa de exámenes médico legales por presunto delito sexual cuando la víctima está entre 18 y 28 años,2022,5,2,7260,27.548209366391202,1,3704,26.9978401727862,1,3556,28.1214848143982
35848,85,85263,81,"Tasa de exámenes médico legales por presunto delito sexual contra niños, niñas y adolescentes",2022,3,3,1467,204.498977505112,0,762,0,3,705,425.531914893617
35849,85,85263,81,"Tasa de exámenes médico legales por presunto delito sexual contra niños, niñas y adolescentes",2022,4,8,1388,576.368876080692,0,714,0,8,674,1186.94362017804
35850,85,85263,121,Tasa de exámenes médico legales por presunto delito sexual cuando la víctima está entre 18 y 28 años,2022,5,1,2293,43.6109899694723,0,1174,0,1,1119,89.3655049151028
35851,85,85279,81,"Tasa de exámenes médico legales por presunto delito sexual contra niños, niñas y adolescentes",2022,3,1,137,729.92700729927,0,73,0,1,64,1562.5
35852,85,85300,81,"Tasa de exámenes médico legales por presunto delito sexual contra niños, niñas y adolescentes",2022,3,1,360,277.777777777778,0,200,0,1,160,625
35853,85,85300,81,"Tasa de exámenes médico legales por presunto delito sexual contra niños, niñas y adolescentes",2022,4,1,381,262.46719160105,1,210,476.190476190476,0,171,0
35854,85,85315,121,Tasa de exámenes médico legales por presunto delito sexual cuando la víctima está entre 18 y 28 años,2022,5,1,455,219.78021978022,0,244,0,1,211,473.9336492891
35855,85,85325,81,"Tasa de exámenes médico legales por presunto delito sexual contra niños, niñas y adolescentes",2022,4,1,884,113.122171945701,0,438,0,1,446,224.215246636771
35856,85,85400,81,"Tasa de exámenes médico legales por presunto delito sexual contra niños, niñas y adolescentes",2022,4,4,836,478.468899521531,1,432,231.481481481481,3,404,742.574257425743
35857,85,85410,81,"Tasa de exámenes médico legales por presunto delito sexual contra niños, niñas y adolescentes",2022,3,10,2821,354.484225451967,0,1429,0,10,1392,718.390804597701
35858,85,85410,81,"Tasa de exámenes médico legales por presunto delito sexual contra niños, niñas y adolescentes",2022,4,10,2842,351.864883884588,0,1479,0,10,1363,733.675715333822
35859,85,85410,121,Tasa de exámenes médico legales por presunto delito sexual cuando la víctima está entre 18 y 28 años,2022,5,3,5007,59.9161174355902,0,2588,0,3,2419,124.018189334436
35860,85,85430,81,"Tasa de exámenes médico legales por presunto delito sexual contra niños, niñas y adolescentes",2022,2,3,1498,200.267022696929,0,753,0,3,745,402.684563758389
35861,85,85430,81,"Tasa de exámenes médico legales por presunto delito sexual contra niños, niñas y adolescentes",2022,3,2,1708,117.096018735363,0,882,0,2,826,242.130750605327
35862,85,85430,81,"Tasa de exámenes médico legales por presunto delito sexual contra niños, niñas y adolescentes",2022,4,1,1555,64.3086816720257,0,806,0,1,749,133.511348464619
35863,85,85440,81,"Tasa de exámenes médico legales por presunto delito sexual contra niños, niñas y adolescentes",2022,2,1,3310,30.2114803625378,1,1757,56.9151963574274,0,1553,0
35864,85,85440,81,"Tasa de exámenes médico legales por presunto delito sexual contra niños, niñas y adolescentes",2022,3,8,4029,198.560436832961,4,2079,192.400192400192,4,1950,205.128205128205
35865,85,85440,81,"Tasa de exámenes médico legales por presunto delito sexual contra niños, niñas y adolescentes",2022,4,11,3988,275.827482447342,1,1978,50.5561172901921,10,2010,497.512437810945
35866,85,85440,121,Tasa de exámenes médico legales por presunto delito sexual cuando la víctima está entre 18 y 28 años,2022,5,3,7597,39.4892720810846,0,3786,0,3,3811,78.7194961952244
35867,85,85001,81,"Tasa de exámenes médico legales por presunto delito sexual contra niños, niñas y adolescentes",2022,2,13,14974,86.8171497261921,5,7580,65.9630606860158,8,7394,108.195834460373
35868,85,85001,81,"Tasa de exámenes médico legales por presunto delito sexual contra niños, niñas y adolescentes",2022,3,61,18233,334.5582186146,9,9228,97.5292587776333,52,9005,577.456968350916
35869,85,85001,81,"Tasa de exámenes médico legales por presunto delito sexual contra niños, niñas y adolescentes",2022,4,79,18425,428.76526458616,8,9301,86.0122567465864,71,9124,778.167470407716
35870,85,85001,121,Tasa de exámenes médico legales por presunto delito sexual cuando la víctima está entre 18 y 28 años,2022,5,28,37756,74.1603983472826,4,18848,21.2224108658744,24,18908,126.930399830759
35871,19,19022,121,Tasa de exámenes médico legales por presunto delito sexual cuando la víctima está entre 18 y 28 años,2022,5,1,3510,28.4900284900285,0,1803,0,1,1707,58.5823081429408
35872,19,19050,81,"Tasa de exámenes médico legales por presunto delito sexual contra niños, niñas y adolescentes",2022,2,2,2113,94.6521533364884,0,1071,0,2,1042,191.938579654511
35873,19,19050,81,"Tasa de exámenes médico legales por presunto delito sexual contra niños, niñas y adolescentes",2022,3,6,2652,226.244343891403,0,1358,0,6,1294,463.678516228748
35874,19,19050,81,"Tasa de exámenes médico legales por presunto delito sexual contra niños, niñas y adolescentes",2022,4,5,2849,175.500175500176,0,1502,0,5,1347,371.195248700817
35875,19,19075,81,"Tasa de exámenes médico legales por presunto delito sexual contra niños, niñas y adolescentes",2022,3,2,2013,99.3541977148535,1,1031,96.9932104752667,1,982,101.83299389002
35876,19,19075,81,"Tasa de exámenes médico legales por presunto delito sexual contra niños, niñas y adolescentes",2022,4,2,2251,88.8494002665482,0,1174,0,2,1077,185.701021355617
35877,19,19075,121,Tasa de exámenes médico legales por presunto delito sexual cuando la víctima está entre 18 y 28 años,2022,5,1,4113,24.3131534159981,0,2101,0,1,2012,49.7017892644135
35878,19,19100,81,"Tasa de exámenes médico legales por presunto delito sexual contra niños, niñas y adolescentes",2022,2,1,2273,43.994720633524,0,1162,0,1,1111,90.00900090009
35879,19,19100,81,"Tasa de exámenes médico legales por presunto delito sexual contra niños, niñas y adolescentes",2022,3,2,3048,65.6167979002625,0,1581,0,2,1467,136.332651670075
35880,19,19100,81,"Tasa de exámenes médico legales por presunto delito sexual contra niños, niñas y adolescentes",2022,4,2,3473,57.5871004894904,0,1835,0,2,1638,122.100122100122
35881,19,19110,81,"Tasa de exámenes médico legales por presunto delito sexual contra niños, niñas y adolescentes",2022,3,1,3677,27.196083763938,0,1896,0,1,1781,56.1482313307131
35882,19,19110,81,"Tasa de exámenes médico legales por presunto delito sexual contra niños, niñas y adolescentes",2022,4,4,3759,106.411279595637,0,1914,0,4,1845,216.80216802168
35883,19,19130,81,"Tasa de exámenes médico legales por presunto delito sexual contra niños, niñas y adolescentes",2022,3,3,4353,68.9179875947622,0,2248,0,3,2105,142.517814726841
35884,19,19130,81,"Tasa de exámenes médico legales por presunto delito sexual contra niños, niñas y adolescentes",2022,4,4,4667,85.7081637025927,0,2407,0,4,2260,176.991150442478
35885,19,19130,121,Tasa de exámenes médico legales por presunto delito sexual cuando la víctima está entre 18 y 28 años,2022,5,1,8177,12.2294239941299,0,4181,0,1,3996,25.025025025025
35886,19,19137,81,"Tasa de exámenes médico legales por presunto delito sexual contra niños, niñas y adolescentes",2022,2,2,4500,44.4444444444444,1,2268,44.0917107583774,1,2232,44.8028673835125
35887,19,19137,81,"Tasa de exámenes médico legales por presunto delito sexual contra niños, niñas y adolescentes",2022,3,8,5187,154.231733179102,0,2622,0,8,2565,311.890838206628
35888,19,19137,81,"Tasa de exámenes médico legales por presunto delito sexual contra niños, niñas y adolescentes",2022,4,4,4877,82.0176337912651,0,2483,0,4,2394,167.084377610693
35889,19,19137,121,Tasa de exámenes médico legales por presunto delito sexual cuando la víctima está entre 18 y 28 años,2022,5,1,8364,11.9560019129603,0,4316,0,1,4048,24.703557312253
35890,19,19142,81,"Tasa de exámenes médico legales por presunto delito sexual contra niños, niñas y adolescentes",2022,2,1,2412,41.4593698175788,0,1276,0,1,1136,88.0281690140845
35891,19,19142,81,"Tasa de exámenes médico legales por presunto delito sexual contra niños, niñas y adolescentes",2022,4,8,3229,247.754722824404,1,1635,61.1620795107034,7,1594,439.146800501882
35892,19,19142,121,Tasa de exámenes médico legales por presunto delito sexual cuando la víctima está entre 18 y 28 años,2022,5,1,6375,15.6862745098039,0,3210,0,1,3165,31.5955766192733
35893,19,19212,81,"Tasa de exámenes médico legales por presunto delito sexual contra niños, niñas y adolescentes",2022,2,1,1800,55.5555555555556,0,899,0,1,901,110.987791342952
35894,19,19212,81,"Tasa de exámenes médico legales por presunto delito sexual contra niños, niñas y adolescentes",2022,4,2,2839,70.4473406128919,0,1486,0,2,1353,147.819660014782
35895,19,19212,121,Tasa de exámenes médico legales por presunto delito sexual cuando la víctima está entre 18 y 28 años,2022,5,1,5543,18.0407721450478,0,2977,0,1,2566,38.9711613406079
35896,19,19256,81,"Tasa de exámenes médico legales por presunto delito sexual contra niños, niñas y adolescentes",2022,3,3,4944,60.6796116504854,0,2515,0,3,2429,123.507616303005
35897,19,19256,81,"Tasa de exámenes médico legales por presunto delito sexual contra niños, niñas y adolescentes",2022,4,2,5299,37.7429703717683,0,2712,0,2,2587,77.3096250483185
35898,19,19290,81,"Tasa de exámenes médico legales por presunto delito sexual contra niños, niñas y adolescentes",2022,3,3,453,662.251655629139,0,247,0,3,206,1456.31067961165
35899,19,19290,121,Tasa de exámenes médico legales por presunto delito sexual cuando la víctima está entre 18 y 28 años,2022,5,1,1046,95.6022944550669,0,530,0,1,516,193.798449612403
35900,19,19300,81,"Tasa de exámenes médico legales por presunto delito sexual contra niños, niñas y adolescentes",2022,3,1,1849,54.0832882639264,1,931,107.411385606874,0,918,0
35901,19,19300,81,"Tasa de exámenes médico legales por presunto delito sexual contra niños, niñas y adolescentes",2022,4,3,2069,144.99758337361,0,1030,0,3,1039,288.739172281039
35902,19,19318,81,"Tasa de exámenes médico legales por presunto delito sexual contra niños, niñas y adolescentes",2022,3,5,3811,131.199160325374,0,1956,0,5,1855,269.541778975741
35903,19,19318,81,"Tasa de exámenes médico legales por presunto delito sexual contra niños, niñas y adolescentes",2022,4,3,3717,80.7102502017756,1,1977,50.5816894284269,2,1740,114.942528735632
35904,19,19355,81,"Tasa de exámenes médico legales por presunto delito sexual contra niños, niñas y adolescentes",2022,3,1,3642,27.4574409665019,0,1828,0,1,1814,55.1267916207277
35905,19,19355,81,"Tasa de exámenes médico legales por presunto delito sexual contra niños, niñas y adolescentes",2022,4,1,3484,28.7026406429392,0,1713,0,1,1771,56.4652738565782
35906,19,19355,121,Tasa de exámenes médico legales por presunto delito sexual cuando la víctima está entre 18 y 28 años,2022,5,1,5819,17.1850833476542,0,2906,0,1,2913,34.3288705801579
35907,19,19364,81,"Tasa de exámenes médico legales por presunto delito sexual contra niños, niñas y adolescentes",2022,2,1,1968,50.8130081300813,0,983,0,1,985,101.522842639594
35908,19,19364,81,"Tasa de exámenes médico legales por presunto delito sexual contra niños, niñas y adolescentes",2022,3,3,2253,133.155792276964,1,1124,88.9679715302491,2,1129,177.147918511957
35909,19,19392,81,"Tasa de exámenes médico legales por presunto delito sexual contra niños, niñas y adolescentes",2022,3,1,905,110.497237569061,0,451,0,1,454,220.264317180617
35910,19,19392,81,"Tasa de exámenes médico legales por presunto delito sexual contra niños, niñas y adolescentes",2022,4,3,958,313.152400835073,1,487,205.338809034908,2,471,424.628450106157
35911,19,19397,81,"Tasa de exámenes médico legales por presunto delito sexual contra niños, niñas y adolescentes",2022,3,1,2187,45.7247370827618,0,1115,0,1,1072,93.2835820895522
35912,19,19418,81,"Tasa de exámenes médico legales por presunto delito sexual contra niños, niñas y adolescentes",2022,2,1,2431,41.1353352529823,0,1252,0,1,1179,84.8176420695505
35913,19,19450,81,"Tasa de exámenes médico legales por presunto delito sexual contra niños, niñas y adolescentes",2022,3,2,2023,98.8630746416213,0,1047,0,2,976,204.918032786885
35914,19,19450,81,"Tasa de exámenes médico legales por presunto delito sexual contra niños, niñas y adolescentes",2022,4,2,2263,88.3782589482987,1,1172,85.3242320819113,1,1091,91.6590284142988
35915,19,19450,121,Tasa de exámenes médico legales por presunto delito sexual cuando la víctima está entre 18 y 28 años,2022,5,1,3895,25.6739409499358,0,2028,0,1,1867,53.5618639528656
35916,19,19455,81,"Tasa de exámenes médico legales por presunto delito sexual contra niños, niñas y adolescentes",2022,2,2,2235,89.4854586129754,1,1135,88.1057268722467,1,1100,90.9090909090909
35917,19,19455,81,"Tasa de exámenes médico legales por presunto delito sexual contra niños, niñas y adolescentes",2022,3,4,2893,138.264777048047,0,1463,0,4,1430,279.72027972028
35918,19,19455,81,"Tasa de exámenes médico legales por presunto delito sexual contra niños, niñas y adolescentes",2022,4,1,3150,31.7460317460317,0,1585,0,1,1565,63.8977635782748
35919,19,19455,121,Tasa de exámenes médico legales por presunto delito sexual cuando la víctima está entre 18 y 28 años,2022,5,2,6425,31.1284046692607,0,3209,0,2,3216,62.1890547263682
35920,19,19473,81,"Tasa de exámenes médico legales por presunto delito sexual contra niños, niñas y adolescentes",2022,3,2,4540,44.0528634361234,0,2283,0,2,2257,88.6132033673017
35921,19,19473,81,"Tasa de exámenes médico legales por presunto delito sexual contra niños, niñas y adolescentes",2022,4,4,4350,91.9540229885057,0,2172,0,4,2178,183.654729109275
35922,19,19513,81,"Tasa de exámenes médico legales por presunto delito sexual contra niños, niñas y adolescentes",2022,3,1,899,111.234705228031,0,457,0,1,442,226.244343891403
35923,19,19513,81,"Tasa de exámenes médico legales por presunto delito sexual contra niños, niñas y adolescentes",2022,4,1,1021,97.9431929480901,0,524,0,1,497,201.207243460765
35924,19,19517,81,"Tasa de exámenes médico legales por presunto delito sexual contra niños, niñas y adolescentes",2022,2,1,5990,16.6944908180301,0,3068,0,1,2922,34.2231348391513
35925,19,19517,81,"Tasa de exámenes médico legales por presunto delito sexual contra niños, niñas y adolescentes",2022,3,1,6654,15.0285542530809,0,3366,0,1,3288,30.4136253041363
35926,19,19517,81,"Tasa de exámenes médico legales por presunto delito sexual contra niños, niñas y adolescentes",2022,4,3,5881,51.0117326985207,0,2935,0,3,2946,101.83299389002
35927,19,19532,81,"Tasa de exámenes médico legales por presunto delito sexual contra niños, niñas y adolescentes",2022,2,2,2493,80.2246289610911,2,1209,165.425971877585,0,1284,0
35928,19,19532,81,"Tasa de exámenes médico legales por presunto delito sexual contra niños, niñas y adolescentes",2022,3,2,3455,57.8871201157742,0,1739,0,2,1716,116.550116550117
35929,19,19532,81,"Tasa de exámenes médico legales por presunto delito sexual contra niños, niñas y adolescentes",2022,4,12,3882,309.119010819165,0,2010,0,12,1872,641.025641025641
35930,19,19532,121,Tasa de exámenes médico legales por presunto delito sexual cuando la víctima está entre 18 y 28 años,2022,5,5,6905,72.4112961622013,0,3457,0,5,3448,145.011600928074
35931,19,19533,81,"Tasa de exámenes médico legales por presunto delito sexual contra niños, niñas y adolescentes",2022,4,1,1156,86.5051903114187,0,565,0,1,591,169.204737732656
35932,19,19533,121,Tasa de exámenes médico legales por presunto delito sexual cuando la víctima está entre 18 y 28 años,2022,5,1,1788,55.9284116331096,0,919,0,1,869,115.074798619102
35933,19,19548,81,"Tasa de exámenes médico legales por presunto delito sexual contra niños, niñas y adolescentes",2022,3,3,3879,77.3395204949729,0,1968,0,3,1911,156.985871271586
35934,19,19548,81,"Tasa de exámenes médico legales por presunto delito sexual contra niños, niñas y adolescentes",2022,4,2,4111,48.6499635125274,0,2073,0,2,2038,98.135426889107
35935,19,19548,121,Tasa de exámenes médico legales por presunto delito sexual cuando la víctima está entre 18 y 28 años,2022,5,1,8038,12.4409056979348,0,3967,0,1,4071,24.5639891918448
35936,19,19001,81,"Tasa de exámenes médico legales por presunto delito sexual contra niños, niñas y adolescentes",2022,2,19,19895,95.5013822568485,4,10283,38.8991539434017,15,9612,156.05493133583
35937,19,19001,81,"Tasa de exámenes médico legales por presunto delito sexual contra niños, niñas y adolescentes",2022,3,44,24891,176.770720340685,5,12785,39.1083300743058,39,12106,322.154303651082
35938,19,19001,81,"Tasa de exámenes médico legales por presunto delito sexual contra niños, niñas y adolescentes",2022,4,83,27142,305.799130498858,5,13819,36.1820681670164,78,13323,585.453726638145
35939,19,19001,121,Tasa de exámenes médico legales por presunto delito sexual cuando la víctima está entre 18 y 28 años,2022,5,35,63500,55.1181102362205,1,32335,3.09262409154167,34,31165,109.096743141344
35940,19,19573,81,"Tasa de exámenes médico legales por presunto delito sexual contra niños, niñas y adolescentes",2022,2,1,3127,31.9795330988168,0,1637,0,1,1490,67.1140939597315
35941,19,19573,81,"Tasa de exámenes médico legales por presunto delito sexual contra niños, niñas y adolescentes",2022,3,6,3936,152.439024390244,1,2028,49.3096646942801,5,1908,262.054507337526
35942,19,19573,81,"Tasa de exámenes médico legales por presunto delito sexual contra niños, niñas y adolescentes",2022,4,11,4091,268.882913713029,1,2044,48.9236790606654,10,2047,488.519785051295
35943,19,19573,121,Tasa de exámenes médico legales por presunto delito sexual cuando la víctima está entre 18 y 28 años,2022,5,6,8593,69.8242755731409,1,4083,24.4917952485917,5,4510,110.864745011086
35944,19,19585,81,"Tasa de exámenes médico legales por presunto delito sexual contra niños, niñas y adolescentes",2022,4,1,1843,54.2593597395551,0,940,0,1,903,110.741971207087
35945,19,19585,121,Tasa de exámenes médico legales por presunto delito sexual cuando la víctima está entre 18 y 28 años,2022,5,1,3841,26.0348867482426,0,1951,0,1,1890,52.9100529100529
35946,19,19622,81,"Tasa de exámenes médico legales por presunto delito sexual contra niños, niñas y adolescentes",2022,3,1,873,114.54753722795,1,444,225.225225225225,0,429,0
35947,19,19693,81,"Tasa de exámenes médico legales por presunto delito sexual contra niños, niñas y adolescentes",2022,4,2,1083,184.672206832872,0,537,0,2,546,366.300366300366
35948,19,19693,121,Tasa de exámenes médico legales por presunto delito sexual cuando la víctima está entre 18 y 28 años,2022,5,1,2174,45.9981600735971,0,1091,0,1,1083,92.3361034164358
35949,19,19701,81,"Tasa de exámenes médico legales por presunto delito sexual contra niños, niñas y adolescentes",2022,2,1,448,223.214285714286,0,237,0,1,211,473.9336492891
35950,19,19701,81,"Tasa de exámenes médico legales por presunto delito sexual contra niños, niñas y adolescentes",2022,3,1,565,176.991150442478,0,280,0,1,285,350.877192982456
35951,19,19701,81,"Tasa de exámenes médico legales por presunto delito sexual contra niños, niñas y adolescentes",2022,4,3,587,511.073253833049,0,287,0,3,300,1000
35952,19,19698,81,"Tasa de exámenes médico legales por presunto delito sexual contra niños, niñas y adolescentes",2022,2,3,8595,34.9040139616056,0,4475,0,3,4120,72.8155339805825
35953,19,19698,81,"Tasa de exámenes médico legales por presunto delito sexual contra niños, niñas y adolescentes",2022,3,17,10447,162.726141476022,3,5416,55.3914327917282,14,5031,278.274696879348
35954,19,19698,81,"Tasa de exámenes médico legales por presunto delito sexual contra niños, niñas y adolescentes",2022,4,25,10787,231.760452396403,2,5535,36.13369467028,23,5252,437.928408225438
35955,19,19698,121,Tasa de exámenes médico legales por presunto delito sexual cuando la víctima está entre 18 y 28 años,2022,5,15,22775,65.8616904500549,2,11420,17.5131348511384,13,11355,114.487010127697
35956,19,19743,81,"Tasa de exámenes médico legales por presunto delito sexual contra niños, niñas y adolescentes",2022,2,2,3701,54.0394487976223,0,1877,0,2,1824,109.649122807018
35957,19,19743,81,"Tasa de exámenes médico legales por presunto delito sexual contra niños, niñas y adolescentes",2022,3,3,4233,70.871722182849,0,2149,0,3,2084,143.953934740883
35958,19,19743,81,"Tasa de exámenes médico legales por presunto delito sexual contra niños, niñas y adolescentes",2022,4,9,4171,215.775593382882,0,2124,0,9,2047,439.667806546165
35959,19,19743,121,Tasa de exámenes médico legales por presunto delito sexual cuando la víctima está entre 18 y 28 años,2022,5,2,8209,24.3635034717992,0,4126,0,2,4083,48.9835904971834
35960,19,19760,81,"Tasa de exámenes médico legales por presunto delito sexual contra niños, niñas y adolescentes",2022,4,1,1341,74.5712155108128,0,675,0,1,666,150.15015015015
35961,19,19760,121,Tasa de exámenes médico legales por presunto delito sexual cuando la víctima está entre 18 y 28 años,2022,5,1,2789,35.8551452133381,0,1402,0,1,1387,72.0980533525595
35962,19,19780,81,"Tasa de exámenes médico legales por presunto delito sexual contra niños, niñas y adolescentes",2022,2,1,2876,34.7705146036161,0,1467,0,1,1409,70.97232079489
35963,19,19780,81,"Tasa de exámenes médico legales por presunto delito sexual contra niños, niñas y adolescentes",2022,3,3,3519,85.2514919011083,0,1781,0,3,1738,172.612197928654
35964,19,19780,81,"Tasa de exámenes médico legales por presunto delito sexual contra niños, niñas y adolescentes",2022,4,4,3581,111.700642278693,0,1796,0,4,1785,224.089635854342
35965,19,19780,121,Tasa de exámenes médico legales por presunto delito sexual cuando la víctima está entre 18 y 28 años,2022,5,1,6600,15.1515151515152,0,3282,0,1,3318,30.1386377335744
35966,19,19807,81,"Tasa de exámenes médico legales por presunto delito sexual contra niños, niñas y adolescentes",2022,3,4,3035,131.795716639209,1,1551,64.4745325596389,3,1484,202.156334231806
35967,19,19807,81,"Tasa de exámenes médico legales por presunto delito sexual contra niños, niñas y adolescentes",2022,4,3,3286,91.2964090079124,2,1661,120.409391932571,1,1625,61.5384615384615
35968,19,19807,121,Tasa de exámenes médico legales por presunto delito sexual cuando la víctima está entre 18 y 28 años,2022,5,4,6606,60.5510142294883,0,3298,0,4,3308,120.918984280532
35969,19,19809,81,"Tasa de exámenes médico legales por presunto delito sexual contra niños, niñas y adolescentes",2022,4,3,3489,85.9845227858985,0,1841,0,3,1648,182.038834951456
35970,19,19821,81,"Tasa de exámenes médico legales por presunto delito sexual contra niños, niñas y adolescentes",2022,4,1,4340,23.0414746543779,0,2163,0,1,2177,45.9347726228755
35971,19,19821,121,Tasa de exámenes médico legales por presunto delito sexual cuando la víctima está entre 18 y 28 años,2022,5,1,8345,11.983223487118,0,4186,0,1,4159,24.0442414041837
35972,19,19824,81,"Tasa de exámenes médico legales por presunto delito sexual contra niños, niñas y adolescentes",2022,4,3,2920,102.739726027397,0,1436,0,3,1484,202.156334231806
35973,19,19845,81,"Tasa de exámenes médico legales por presunto delito sexual contra niños, niñas y adolescentes",2022,3,1,1971,50.7356671740233,0,995,0,1,976,102.459016393443
35974,19,19845,81,"Tasa de exámenes médico legales por presunto delito sexual contra niños, niñas y adolescentes",2022,4,3,2034,147.492625368732,0,988,0,3,1046,286.806883365201
35975,20,20011,81,"Tasa de exámenes médico legales por presunto delito sexual contra niños, niñas y adolescentes",2022,2,4,10662,37.516413430876,1,5455,18.3318056828598,3,5207,57.6147493758402
35976,20,20011,81,"Tasa de exámenes médico legales por presunto delito sexual contra niños, niñas y adolescentes",2022,3,18,13399,134.338383461452,2,6863,29.1417747340813,16,6536,244.798041615667
35977,20,20011,81,"Tasa de exámenes médico legales por presunto delito sexual contra niños, niñas y adolescentes",2022,4,18,13434,133.988387673068,0,6822,0,18,6612,272.232304900181
35978,20,20011,121,Tasa de exámenes médico legales por presunto delito sexual cuando la víctima está entre 18 y 28 años,2022,5,6,23907,25.0972518509223,0,11771,0,6,12136,49.439683586025
35979,20,20013,81,"Tasa de exámenes médico legales por presunto delito sexual contra niños, niñas y adolescentes",2022,2,5,6549,76.3475339746526,2,3306,60.4960677555959,3,3243,92.5069380203515
35980,20,20013,81,"Tasa de exámenes médico legales por presunto delito sexual contra niños, niñas y adolescentes",2022,3,10,8050,124.223602484472,0,4079,0,10,3971,251.82573659028
35981,20,20013,81,"Tasa de exámenes médico legales por presunto delito sexual contra niños, niñas y adolescentes",2022,4,18,7720,233.160621761658,0,3917,0,18,3803,473.310544307126
35982,20,20013,121,Tasa de exámenes médico legales por presunto delito sexual cuando la víctima está entre 18 y 28 años,2022,5,3,12778,23.4778525590859,0,6345,0,3,6433,46.6345406497746
35983,20,20032,81,"Tasa de exámenes médico legales por presunto delito sexual contra niños, niñas y adolescentes",2022,3,5,2854,175.192711983181,0,1476,0,5,1378,362.844702467344
35984,20,20032,81,"Tasa de exámenes médico legales por presunto delito sexual contra niños, niñas y adolescentes",2022,4,5,2714,184.229918938836,0,1407,0,5,1307,382.555470543229
35985,20,20045,81,"Tasa de exámenes médico legales por presunto delito sexual contra niños, niñas y adolescentes",2022,2,3,2783,107.797340998922,1,1429,69.9790062981106,2,1354,147.710487444609
35986,20,20045,81,"Tasa de exámenes médico legales por presunto delito sexual contra niños, niñas y adolescentes",2022,3,2,3284,60.9013398294762,0,1677,0,2,1607,124.455507156192
35987,20,20045,81,"Tasa de exámenes médico legales por presunto delito sexual contra niños, niñas y adolescentes",2022,4,6,3009,199.401794616152,0,1527,0,6,1482,404.858299595142
35988,20,20060,81,"Tasa de exámenes médico legales por presunto delito sexual contra niños, niñas y adolescentes",2022,2,4,4358,91.7852225791648,1,2208,45.2898550724638,3,2150,139.53488372093
35989,20,20060,81,"Tasa de exámenes médico legales por presunto delito sexual contra niños, niñas y adolescentes",2022,3,3,5664,52.9661016949153,1,2909,34.3760742523204,2,2755,72.5952813067151
35990,20,20060,81,"Tasa de exámenes médico legales por presunto delito sexual contra niños, niñas y adolescentes",2022,4,14,5646,247.963159759122,1,2921,34.2348510783978,13,2725,477.064220183486
35991,20,20060,121,Tasa de exámenes médico legales por presunto delito sexual cuando la víctima está entre 18 y 28 años,2022,5,5,8866,56.3952176855403,0,4455,0,5,4411,113.352981183405
35992,20,20175,81,"Tasa de exámenes médico legales por presunto delito sexual contra niños, niñas y adolescentes",2022,2,1,3886,25.7334019557386,1,1926,51.9210799584631,0,1960,0
35993,20,20175,81,"Tasa de exámenes médico legales por presunto delito sexual contra niños, niñas y adolescentes",2022,4,1,4787,20.8899101733863,0,2472,0,1,2315,43.1965442764579
35994,20,20175,121,Tasa de exámenes médico legales por presunto delito sexual cuando la víctima está entre 18 y 28 años,2022,5,1,6077,16.4554879052164,0,3066,0,1,3011,33.2115576220525
35995,20,20178,81,"Tasa de exámenes médico legales por presunto delito sexual contra niños, niñas y adolescentes",2022,2,4,3153,126.86330478909,1,1628,61.4250614250614,3,1525,196.72131147541
35996,20,20178,81,"Tasa de exámenes médico legales por presunto delito sexual contra niños, niñas y adolescentes",2022,3,4,3785,105.680317040951,1,1928,51.8672199170124,3,1857,161.550888529887
35997,20,20178,81,"Tasa de exámenes médico legales por presunto delito sexual contra niños, niñas y adolescentes",2022,4,9,3528,255.102040816327,0,1778,0,9,1750,514.285714285714
35998,20,20228,81,"Tasa de exámenes médico legales por presunto delito sexual contra niños, niñas y adolescentes",2022,3,4,5068,78.9265982636148,1,2607,38.3582662063675,3,2461,121.901665989435
35999,20,20228,81,"Tasa de exámenes médico legales por presunto delito sexual contra niños, niñas y adolescentes",2022,4,4,5048,79.2393026941363,0,2574,0,4,2474,161.681487469685
36000,20,20238,81,"Tasa de exámenes médico legales por presunto delito sexual contra niños, niñas y adolescentes",2022,3,2,4113,48.6263068319961,0,2084,0,2,2029,98.570724494825
36001,20,20238,81,"Tasa de exámenes médico legales por presunto delito sexual contra niños, niñas y adolescentes",2022,4,1,3994,25.0375563345018,0,2036,0,1,1958,51.0725229826353
36002,20,20250,81,"Tasa de exámenes médico legales por presunto delito sexual contra niños, niñas y adolescentes",2022,3,4,5546,72.1240533717995,2,2838,70.4721634954193,2,2708,73.8552437223043
36003,20,20250,81,"Tasa de exámenes médico legales por presunto delito sexual contra niños, niñas y adolescentes",2022,4,2,5056,39.5569620253165,0,2540,0,2,2516,79.4912559618442
36004,20,20250,121,Tasa de exámenes médico legales por presunto delito sexual cuando la víctima está entre 18 y 28 años,2022,5,1,8210,12.1802679658953,0,4003,0,1,4207,23.7699072973615
36005,20,20295,81,"Tasa de exámenes médico legales por presunto delito sexual contra niños, niñas y adolescentes",2022,4,3,1773,169.204737732656,0,883,0,3,890,337.078651685393
36006,20,20383,81,"Tasa de exámenes médico legales por presunto delito sexual contra niños, niñas y adolescentes",2022,2,2,1743,114.744693057946,1,867,115.340253748558,1,876,114.155251141553
36007,20,20383,81,"Tasa de exámenes médico legales por presunto delito sexual contra niños, niñas y adolescentes",2022,3,2,2146,93.1966449207828,0,1118,0,2,1028,194.552529182879
36008,20,20383,81,"Tasa de exámenes médico legales por presunto delito sexual contra niños, niñas y adolescentes",2022,4,4,2104,190.114068441065,0,1150,0,4,954,419.287211740042
36009,20,20383,121,Tasa de exámenes médico legales por presunto delito sexual cuando la víctima está entre 18 y 28 años,2022,5,1,3434,29.120559114735,0,1819,0,1,1615,61.9195046439629
36010,20,20400,81,"Tasa de exámenes médico legales por presunto delito sexual contra niños, niñas y adolescentes",2022,4,4,6315,63.341250989707,0,3236,0,4,3079,129.912309191296
36011,20,20400,121,Tasa de exámenes médico legales por presunto delito sexual cuando la víctima está entre 18 y 28 años,2022,5,1,10768,9.28677563150074,0,5308,0,1,5460,18.3150183150183
36012,20,20621,81,"Tasa de exámenes médico legales por presunto delito sexual contra niños, niñas y adolescentes",2022,2,1,3031,32.9924117452986,0,1530,0,1,1501,66.6222518321119
36013,20,20621,81,"Tasa de exámenes médico legales por presunto delito sexual contra niños, niñas y adolescentes",2022,3,2,3755,53.2623169107856,0,1921,0,2,1834,109.051254089422
36014,20,20621,81,"Tasa de exámenes médico legales por presunto delito sexual contra niños, niñas y adolescentes",2022,4,11,3627,303.280948442239,0,1872,0,11,1755,626.780626780627
36015,20,20621,121,Tasa de exámenes médico legales por presunto delito sexual cuando la víctima está entre 18 y 28 años,2022,5,1,5845,17.1086398631309,0,2909,0,1,2936,34.0599455040872
36016,20,20443,81,"Tasa de exámenes médico legales por presunto delito sexual contra niños, niñas y adolescentes",2022,4,3,1331,225.394440270473,0,682,0,3,649,462.249614791988
36017,20,20443,121,Tasa de exámenes médico legales por presunto delito sexual cuando la víctima está entre 18 y 28 años,2022,5,2,2172,92.0810313075506,0,1078,0,2,1094,182.815356489945
36018,20,20517,81,"Tasa de exámenes médico legales por presunto delito sexual contra niños, niñas y adolescentes",2022,2,1,1789,55.8971492453885,0,908,0,1,881,113.507377979569
36019,20,20517,81,"Tasa de exámenes médico legales por presunto delito sexual contra niños, niñas y adolescentes",2022,3,1,2393,41.7885499373172,0,1208,0,1,1185,84.3881856540084
36020,20,20517,81,"Tasa de exámenes médico legales por presunto delito sexual contra niños, niñas y adolescentes",2022,4,1,2449,40.8329930583912,0,1235,0,1,1214,82.3723228995058
36021,20,20550,81,"Tasa de exámenes médico legales por presunto delito sexual contra niños, niñas y adolescentes",2022,3,3,2819,106.420716566158,0,1484,0,3,1335,224.719101123596
36022,20,20550,81,"Tasa de exámenes médico legales por presunto delito sexual contra niños, niñas y adolescentes",2022,4,4,2750,145.454545454545,1,1434,69.7350069735007,3,1316,227.963525835866
36023,20,20550,121,Tasa de exámenes médico legales por presunto delito sexual cuando la víctima está entre 18 y 28 años,2022,5,1,4242,23.5737859500236,0,2114,0,1,2128,46.9924812030075
36024,20,20570,81,"Tasa de exámenes médico legales por presunto delito sexual contra niños, niñas y adolescentes",2022,2,3,4317,69.4927032661571,0,2145,0,3,2172,138.121546961326
36025,20,20570,81,"Tasa de exámenes médico legales por presunto delito sexual contra niños, niñas y adolescentes",2022,3,6,4769,125.812539316419,0,2375,0,6,2394,250.62656641604
36026,20,20570,81,"Tasa de exámenes médico legales por presunto delito sexual contra niños, niñas y adolescentes",2022,4,8,4039,198.068828918049,0,2036,0,8,2003,399.400898652022
36027,20,20570,121,Tasa de exámenes médico legales por presunto delito sexual cuando la víctima está entre 18 y 28 años,2022,5,2,5681,35.2050695300123,0,2877,0,2,2804,71.3266761768902
36028,20,20614,81,"Tasa de exámenes médico legales por presunto delito sexual contra niños, niñas y adolescentes",2022,4,1,1870,53.475935828877,0,969,0,1,901,110.987791342952
36029,20,20614,121,Tasa de exámenes médico legales por presunto delito sexual cuando la víctima está entre 18 y 28 años,2022,5,3,3378,88.809946714032,0,1734,0,3,1644,182.481751824818
36030,20,20710,81,"Tasa de exámenes médico legales por presunto delito sexual contra niños, niñas y adolescentes",2022,2,1,2732,36.6032210834553,0,1386,0,1,1346,74.2942050520059
36031,20,20710,81,"Tasa de exámenes médico legales por presunto delito sexual contra niños, niñas y adolescentes",2022,3,4,3305,121.028744326778,1,1656,60.3864734299517,3,1649,181.928441479685
36032,20,20710,81,"Tasa de exámenes médico legales por presunto delito sexual contra niños, niñas y adolescentes",2022,4,1,3152,31.7258883248731,0,1564,0,1,1588,62.9722921914358
36033,20,20750,81,"Tasa de exámenes médico legales por presunto delito sexual contra niños, niñas y adolescentes",2022,2,2,2051,97.5134080936129,0,1057,0,2,994,201.207243460765
36034,20,20750,81,"Tasa de exámenes médico legales por presunto delito sexual contra niños, niñas y adolescentes",2022,3,1,2457,40.7000407000407,0,1269,0,1,1188,84.1750841750842
36035,20,20750,81,"Tasa de exámenes médico legales por presunto delito sexual contra niños, niñas y adolescentes",2022,4,7,2309,303.161541792984,1,1178,84.8896434634974,6,1131,530.503978779841
36036,20,20770,81,"Tasa de exámenes médico legales por presunto delito sexual contra niños, niñas y adolescentes",2022,3,1,3382,29.5683027794205,0,1704,0,1,1678,59.5947556615018
36037,20,20770,81,"Tasa de exámenes médico legales por presunto delito sexual contra niños, niñas y adolescentes",2022,4,4,3410,117.302052785924,0,1706,0,4,1704,234.741784037559
36038,20,20770,121,Tasa de exámenes médico legales por presunto delito sexual cuando la víctima está entre 18 y 28 años,2022,5,2,5823,34.346556757685,0,2953,0,2,2870,69.6864111498258
36039,20,20001,81,"Tasa de exámenes médico legales por presunto delito sexual contra niños, niñas y adolescentes",2022,2,28,48902,57.2573718866304,7,25200,27.7777777777778,21,23702,88.6001181334908
36040,20,20001,81,"Tasa de exámenes médico legales por presunto delito sexual contra niños, niñas y adolescentes",2022,3,73,59843,121.985863008205,9,30823,29.1989747915518,64,29020,220.537560303239
36041,20,20001,81,"Tasa de exámenes médico legales por presunto delito sexual contra niños, niñas y adolescentes",2022,4,135,59075,228.52306390182,9,30259,29.7432168941472,126,28816,437.257079400333
36042,20,20001,121,Tasa de exámenes médico legales por presunto delito sexual cuando la víctima está entre 18 y 28 años,2022,5,48,107962,44.4600878086734,2,53983,3.70487005168294,46,53979,85.2183256451583
36043,20,20001,81,"Tasa de exámenes médico legales por presunto delito sexual contra niños, niñas y adolescentes",2022,1,1,9104,10.9841827768014,0,4702,0,1,4402,22.7169468423444
36044,27,27025,81,"Tasa de exámenes médico legales por presunto delito sexual contra niños, niñas y adolescentes",2022,3,1,4272,23.4082397003745,0,2188,0,1,2084,47.9846449136276
36045,27,27025,81,"Tasa de exámenes médico legales por presunto delito sexual contra niños, niñas y adolescentes",2022,4,1,4273,23.4027615258601,0,2232,0,1,2041,48.9955903968643
36046,27,27025,121,Tasa de exámenes médico legales por presunto delito sexual cuando la víctima está entre 18 y 28 años,2022,5,1,6648,15.0421179302046,0,3423,0,1,3225,31.0077519379845
36047,27,27050,81,"Tasa de exámenes médico legales por presunto delito sexual contra niños, niñas y adolescentes",2022,3,1,746,134.048257372654,0,414,0,1,332,301.204819277108
36048,27,27050,81,"Tasa de exámenes médico legales por presunto delito sexual contra niños, niñas y adolescentes",2022,4,1,817,122.399020807834,0,471,0,1,346,289.017341040462
36049,27,27073,81,"Tasa de exámenes médico legales por presunto delito sexual contra niños, niñas y adolescentes",2022,4,1,1456,68.6813186813187,0,730,0,1,726,137.741046831956
36050,27,27075,81,"Tasa de exámenes médico legales por presunto delito sexual contra niños, niñas y adolescentes",2022,3,1,1326,75.4147812971342,0,664,0,1,662,151.057401812689
36051,27,27075,81,"Tasa de exámenes médico legales por presunto delito sexual contra niños, niñas y adolescentes",2022,4,1,1397,71.5819613457409,0,737,0,1,660,151.515151515152
36052,27,27075,121,Tasa de exámenes médico legales por presunto delito sexual cuando la víctima está entre 18 y 28 años,2022,5,1,2194,45.5788514129444,0,1220,0,1,974,102.669404517454
36053,27,27077,121,Tasa de exámenes médico legales por presunto delito sexual cuando la víctima está entre 18 y 28 años,2022,5,1,6099,16.3961305131989,0,3278,0,1,2821,35.4484225451967
36054,27,27099,81,"Tasa de exámenes médico legales por presunto delito sexual contra niños, niñas y adolescentes",2022,3,1,2117,47.2366556447803,0,1095,0,1,1022,97.8473581213307
36055,27,27150,81,"Tasa de exámenes médico legales por presunto delito sexual contra niños, niñas y adolescentes",2022,3,1,3004,33.288948069241,0,1554,0,1,1450,68.9655172413793
36056,27,27205,81,"Tasa de exámenes médico legales por presunto delito sexual contra niños, niñas y adolescentes",2022,2,1,1186,84.3170320404722,0,607,0,1,579,172.711571675302
36057,27,27205,81,"Tasa de exámenes médico legales por presunto delito sexual contra niños, niñas y adolescentes",2022,4,3,1672,179.425837320574,0,877,0,3,795,377.358490566038
36058,27,27135,121,Tasa de exámenes médico legales por presunto delito sexual cuando la víctima está entre 18 y 28 años,2022,5,1,1198,83.4724540901503,0,627,0,1,571,175.131348511384
36059,27,27250,81,"Tasa de exámenes médico legales por presunto delito sexual contra niños, niñas y adolescentes",2022,3,1,3663,27.3000273000273,0,1898,0,1,1765,56.657223796034
36060,27,27250,81,"Tasa de exámenes médico legales por presunto delito sexual contra niños, niñas y adolescentes",2022,4,1,3566,28.0426247896803,0,1818,0,1,1748,57.20823798627
36061,27,27361,81,"Tasa de exámenes médico legales por presunto delito sexual contra niños, niñas y adolescentes",2022,2,1,3046,32.8299409061064,0,1551,0,1,1495,66.8896321070234
36062,27,27361,81,"Tasa de exámenes médico legales por presunto delito sexual contra niños, niñas y adolescentes",2022,3,2,3927,50.9294626941686,0,1985,0,2,1942,102.986611740474
36063,27,27361,81,"Tasa de exámenes médico legales por presunto delito sexual contra niños, niñas y adolescentes",2022,4,5,3922,127.48597654258,0,1952,0,5,1970,253.807106598985
36064,27,27413,81,"Tasa de exámenes médico legales por presunto delito sexual contra niños, niñas y adolescentes",2022,3,1,1715,58.3090379008746,0,816,0,1,899,111.234705228031
36065,27,27413,81,"Tasa de exámenes médico legales por presunto delito sexual contra niños, niñas y adolescentes",2022,4,1,1133,88.261253309797,0,594,0,1,539,185.528756957328
36066,27,27430,81,"Tasa de exámenes médico legales por presunto delito sexual contra niños, niñas y adolescentes",2022,3,2,2330,85.8369098712446,0,1227,0,2,1103,181.323662737987
36067,27,27430,121,Tasa de exámenes médico legales por presunto delito sexual cuando la víctima está entre 18 y 28 años,2022,5,1,2868,34.8675034867503,1,1467,68.1663258350375,0,1401,0
36068,27,27491,81,"Tasa de exámenes médico legales por presunto delito sexual contra niños, niñas y adolescentes",2022,3,3,1233,243.30900243309,0,637,0,3,596,503.355704697987
36069,27,27491,81,"Tasa de exámenes médico legales por presunto delito sexual contra niños, niñas y adolescentes",2022,4,1,1132,88.339222614841,0,595,0,1,537,186.219739292365
36070,27,27495,121,Tasa de exámenes médico legales por presunto delito sexual cuando la víctima está entre 18 y 28 años,2022,5,1,3248,30.7881773399015,0,1710,0,1,1538,65.0195058517555
36071,27,27001,81,"Tasa de exámenes médico legales por presunto delito sexual contra niños, niñas y adolescentes",2022,2,11,13595,80.9121000367782,2,6990,28.6123032904149,9,6605,136.260408781226
36072,27,27001,81,"Tasa de exámenes médico legales por presunto delito sexual contra niños, niñas y adolescentes",2022,3,21,16500,127.272727272727,3,8217,36.5096750638919,18,8283,217.312567910177
36073,27,27001,81,"Tasa de exámenes médico legales por presunto delito sexual contra niños, niñas y adolescentes",2022,4,29,16232,178.65943814687,3,7830,38.3141762452107,26,8402,309.450130921209
36074,27,27001,121,Tasa de exámenes médico legales por presunto delito sexual cuando la víctima está entre 18 y 28 años,2022,5,16,28999,55.1743163557364,0,13693,0,16,15306,104.53416960669
36075,27,27580,81,"Tasa de exámenes médico legales por presunto delito sexual contra niños, niñas y adolescentes",2022,3,1,773,129.366106080207,0,394,0,1,379,263.852242744063
36076,27,27580,121,Tasa de exámenes médico legales por presunto delito sexual cuando la víctima está entre 18 y 28 años,2022,5,1,925,108.108108108108,0,489,0,1,436,229.357798165138
36077,27,27600,81,"Tasa de exámenes médico legales por presunto delito sexual contra niños, niñas y adolescentes",2022,4,1,1064,93.984962406015,0,551,0,1,513,194.931773879142
36078,27,27615,81,"Tasa de exámenes médico legales por presunto delito sexual contra niños, niñas y adolescentes",2022,3,4,6484,61.6903146206046,0,3370,0,4,3114,128.452151573539
36079,27,27615,81,"Tasa de exámenes médico legales por presunto delito sexual contra niños, niñas y adolescentes",2022,4,2,7247,27.597626604112,0,3785,0,2,3462,57.7700751010976
36080,27,27615,121,Tasa de exámenes médico legales por presunto delito sexual cuando la víctima está entre 18 y 28 años,2022,5,1,11757,8.50557114910266,0,6228,0,1,5529,18.0864532465184
36081,27,27660,81,"Tasa de exámenes médico legales por presunto delito sexual contra niños, niñas y adolescentes",2022,4,1,660,151.515151515152,0,328,0,1,332,301.204819277108
36082,27,27787,81,"Tasa de exámenes médico legales por presunto delito sexual contra niños, niñas y adolescentes",2022,3,4,2404,166.389351081531,0,1207,0,4,1197,334.168755221387
36083,27,27787,81,"Tasa de exámenes médico legales por presunto delito sexual contra niños, niñas y adolescentes",2022,4,6,2331,257.400257400257,0,1166,0,6,1165,515.021459227468
36084,27,27787,121,Tasa de exámenes médico legales por presunto delito sexual cuando la víctima está entre 18 y 28 años,2022,5,1,3436,29.1036088474971,0,1656,0,1,1780,56.1797752808989
36085,27,27800,81,"Tasa de exámenes médico legales por presunto delito sexual contra niños, niñas y adolescentes",2022,4,1,1834,54.525627044711,0,943,0,1,891,112.233445566779
36086,27,27800,121,Tasa de exámenes médico legales por presunto delito sexual cuando la víctima está entre 18 y 28 años,2022,5,1,2515,39.7614314115308,0,1278,0,1,1237,80.8407437348424
36087,27,27810,81,"Tasa de exámenes médico legales por presunto delito sexual contra niños, niñas y adolescentes",2022,3,2,785,254.777070063694,0,397,0,2,388,515.463917525773
36088,27,27810,81,"Tasa de exámenes médico legales por presunto delito sexual contra niños, niñas y adolescentes",2022,4,4,799,500.625782227785,1,408,245.098039215686,3,391,767.263427109974
36089,27,27810,121,Tasa de exámenes médico legales por presunto delito sexual cuando la víctima está entre 18 y 28 años,2022,5,1,1424,70.2247191011236,0,735,0,1,689,145.137880986938
36090,23,23068,81,"Tasa de exámenes médico legales por presunto delito sexual contra niños, niñas y adolescentes",2022,3,1,5904,16.9376693766938,0,3031,0,1,2873,34.8068221371389
36091,23,23068,81,"Tasa de exámenes médico legales por presunto delito sexual contra niños, niñas y adolescentes",2022,4,4,5694,70.2493853178785,1,2972,33.6473755047106,3,2722,110.213078618663
36092,23,23079,81,"Tasa de exámenes médico legales por presunto delito sexual contra niños, niñas y adolescentes",2022,3,1,2552,39.1849529780564,1,1317,75.9301442672741,0,1235,0
36093,23,23090,81,"Tasa de exámenes médico legales por presunto delito sexual contra niños, niñas y adolescentes",2022,2,1,1445,69.2041522491349,0,687,0,1,758,131.926121372032
36094,23,23090,81,"Tasa de exámenes médico legales por presunto delito sexual contra niños, niñas y adolescentes",2022,3,3,1865,160.857908847185,1,943,106.044538706257,2,922,216.919739696312
36095,23,23090,81,"Tasa de exámenes médico legales por presunto delito sexual contra niños, niñas y adolescentes",2022,4,3,1852,161.987041036717,0,973,0,3,879,341.296928327645
36096,23,23162,81,"Tasa de exámenes médico legales por presunto delito sexual contra niños, niñas y adolescentes",2022,3,10,10165,98.3767830791933,0,5181,0,10,4984,200.642054574639
36097,23,23162,81,"Tasa de exámenes médico legales por presunto delito sexual contra niños, niñas y adolescentes",2022,4,10,10347,96.6463709287716,0,5255,0,10,5092,196.386488609584
36098,23,23162,121,Tasa de exámenes médico legales por presunto delito sexual cuando la víctima está entre 18 y 28 años,2022,5,4,19974,20.0260338439972,0,9965,0,4,10009,39.9640323708662
36099,23,23168,81,"Tasa de exámenes médico legales por presunto delito sexual contra niños, niñas y adolescentes",2022,3,2,1704,117.370892018779,0,870,0,2,834,239.808153477218
36100,23,23168,81,"Tasa de exámenes médico legales por presunto delito sexual contra niños, niñas y adolescentes",2022,4,2,1783,112.170499158721,0,901,0,2,882,226.757369614512
36101,23,23182,81,"Tasa de exámenes médico legales por presunto delito sexual contra niños, niñas y adolescentes",2022,2,2,3689,54.2152344808891,0,1880,0,2,1809,110.558319513543
36102,23,23182,81,"Tasa de exámenes médico legales por presunto delito sexual contra niños, niñas y adolescentes",2022,3,5,4525,110.497237569061,0,2317,0,5,2208,226.449275362319
36103,23,23182,81,"Tasa de exámenes médico legales por presunto delito sexual contra niños, niñas y adolescentes",2022,4,10,4568,218.914185639229,0,2339,0,10,2229,448.631673396142
36104,23,23182,121,Tasa de exámenes médico legales por presunto delito sexual cuando la víctima está entre 18 y 28 años,2022,5,4,8706,45.9453250631748,0,4456,0,4,4250,94.1176470588235
36105,23,23189,81,"Tasa de exámenes médico legales por presunto delito sexual contra niños, niñas y adolescentes",2022,2,1,4781,20.9161263334031,1,2443,40.9332787556283,0,2338,0
36106,23,23189,81,"Tasa de exámenes médico legales por presunto delito sexual contra niños, niñas y adolescentes",2022,3,10,6035,165.700082850041,1,3104,32.2164948453608,9,2931,307.062436028659
36107,23,23189,81,"Tasa de exámenes médico legales por presunto delito sexual contra niños, niñas y adolescentes",2022,4,7,6186,113.158745554478,0,3175,0,7,3011,232.480903354367
36108,23,23189,121,Tasa de exámenes médico legales por presunto delito sexual cuando la víctima está entre 18 y 28 años,2022,5,1,10857,9.21064750851985,0,5538,0,1,5319,18.8005264147396
36109,23,23350,81,"Tasa de exámenes médico legales por presunto delito sexual contra niños, niñas y adolescentes",2022,3,1,1739,57.5043128234618,0,897,0,1,842,118.764845605701
36110,23,23350,81,"Tasa de exámenes médico legales por presunto delito sexual contra niños, niñas y adolescentes",2022,4,9,1730,520.231213872832,1,897,111.482720178372,8,833,960.384153661465
36111,23,23350,121,Tasa de exámenes médico legales por presunto delito sexual cuando la víctima está entre 18 y 28 años,2022,5,1,2843,35.1741118536757,0,1403,0,1,1440,69.4444444444444
36112,23,23417,81,"Tasa de exámenes médico legales por presunto delito sexual contra niños, niñas y adolescentes",2022,2,4,9264,43.1778929188256,1,4679,21.3720880530028,3,4585,65.4307524536532
36113,23,23417,81,"Tasa de exámenes médico legales por presunto delito sexual contra niños, niñas y adolescentes",2022,3,11,11421,96.3138078977322,6,5799,103.466114847387,5,5622,88.9363215937389
36114,23,23417,81,"Tasa de exámenes médico legales por presunto delito sexual contra niños, niñas y adolescentes",2022,4,14,11418,122.613417411105,0,5778,0,14,5640,248.22695035461
36115,23,23417,121,Tasa de exámenes médico legales por presunto delito sexual cuando la víctima está entre 18 y 28 años,2022,5,2,20144,9.92851469420175,0,10035,0,2,10109,19.7843505786923
36116,23,23419,81,"Tasa de exámenes médico legales por presunto delito sexual contra niños, niñas y adolescentes",2022,3,3,2248,133.451957295374,0,1137,0,3,1111,270.02700270027
36117,23,23419,81,"Tasa de exámenes médico legales por presunto delito sexual contra niños, niñas y adolescentes",2022,4,4,2249,177.856825255669,1,1158,86.3557858376511,3,1091,274.977085242896
36118,23,23464,81,"Tasa de exámenes médico legales por presunto delito sexual contra niños, niñas y adolescentes",2022,3,1,2026,49.3583415597236,0,1019,0,1,1007,99.304865938431
36119,23,23464,81,"Tasa de exámenes médico legales por presunto delito sexual contra niños, niñas y adolescentes",2022,4,4,2150,186.046511627907,0,1064,0,4,1086,368.324125230203
36120,23,23466,81,"Tasa de exámenes médico legales por presunto delito sexual contra niños, niñas y adolescentes",2022,2,4,7972,50.1756146512795,0,4095,0,4,3877,103.172556100077
36121,23,23466,81,"Tasa de exámenes médico legales por presunto delito sexual contra niños, niñas y adolescentes",2022,3,18,10065,178.837555886736,6,5125,117.073170731707,12,4940,242.914979757085
36122,23,23466,81,"Tasa de exámenes médico legales por presunto delito sexual contra niños, niñas y adolescentes",2022,4,18,9904,181.744749596123,2,4976,40.1929260450161,16,4928,324.675324675325
36123,23,23466,121,Tasa de exámenes médico legales por presunto delito sexual cuando la víctima está entre 18 y 28 años,2022,5,4,15438,25.9100919808265,0,7482,0,4,7956,50.2765208647562
36124,23,23001,81,"Tasa de exámenes médico legales por presunto delito sexual contra niños, niñas y adolescentes",2022,2,23,40796,56.3780762819884,4,20996,19.0512478567346,19,19800,95.959595959596
36125,23,23001,81,"Tasa de exámenes médico legales por presunto delito sexual contra niños, niñas y adolescentes",2022,3,66,49927,132.193001782603,14,25600,54.6875,52,24327,213.754264808649
36126,23,23001,81,"Tasa de exámenes médico legales por presunto delito sexual contra niños, niñas y adolescentes",2022,4,121,50535,239.438013258138,5,25570,19.5541650371529,116,24965,464.650510715001
36127,23,23001,121,Tasa de exámenes médico legales por presunto delito sexual cuando la víctima está entre 18 y 28 años,2022,5,24,97964,24.4987954758891,2,48598,4.1153956952961,22,49366,44.5650852813677
36128,23,23001,81,"Tasa de exámenes médico legales por presunto delito sexual contra niños, niñas y adolescentes",2022,1,1,7478,13.3725595078898,1,3847,25.9942812581232,0,3631,0
36129,23,23500,81,"Tasa de exámenes médico legales por presunto delito sexual contra niños, niñas y adolescentes",2022,3,5,3693,135.391280801516,1,1924,51.975051975052,4,1769,226.116449971735
36130,23,23555,81,"Tasa de exámenes médico legales por presunto delito sexual contra niños, niñas y adolescentes",2022,2,2,5489,36.4365093824012,0,2805,0,2,2684,74.5156482861401
36131,23,23555,81,"Tasa de exámenes médico legales por presunto delito sexual contra niños, niñas y adolescentes",2022,3,2,7064,28.312570781427,0,3626,0,2,3438,58.173356602676
36132,23,23555,81,"Tasa de exámenes médico legales por presunto delito sexual contra niños, niñas y adolescentes",2022,4,11,7180,153.203342618384,1,3669,27.2553829381303,10,3511,284.819139846198
36133,23,23570,81,"Tasa de exámenes médico legales por presunto delito sexual contra niños, niñas y adolescentes",2022,2,1,3207,31.1817898347365,0,1632,0,1,1575,63.4920634920635
36134,23,23570,81,"Tasa de exámenes médico legales por presunto delito sexual contra niños, niñas y adolescentes",2022,3,1,4030,24.8138957816377,0,2044,0,1,1986,50.3524672708963
36135,23,23570,81,"Tasa de exámenes médico legales por presunto delito sexual contra niños, niñas y adolescentes",2022,4,4,4076,98.135426889107,0,2081,0,4,1995,200.501253132832
36136,23,23570,121,Tasa de exámenes médico legales por presunto delito sexual cuando la víctima está entre 18 y 28 años,2022,5,2,6667,29.9985000749963,1,3447,29.0107339715695,1,3220,31.055900621118
36137,23,23574,81,"Tasa de exámenes médico legales por presunto delito sexual contra niños, niñas y adolescentes",2022,2,1,2174,45.9981600735971,0,1101,0,1,1073,93.1966449207828
36138,23,23574,81,"Tasa de exámenes médico legales por presunto delito sexual contra niños, niñas y adolescentes",2022,3,2,2833,70.5965407695023,1,1472,67.9347826086957,1,1361,73.4753857457752
36139,23,23574,81,"Tasa de exámenes médico legales por presunto delito sexual contra niños, niñas y adolescentes",2022,4,6,2870,209.059233449477,0,1516,0,6,1354,443.131462333826
36140,23,23580,81,"Tasa de exámenes médico legales por presunto delito sexual contra niños, niñas y adolescentes",2022,4,5,5255,95.1474785918173,0,2725,0,5,2530,197.628458498024
36141,23,23580,121,Tasa de exámenes médico legales por presunto delito sexual cuando la víctima está entre 18 y 28 años,2022,5,1,8019,12.4703828407532,0,4033,0,1,3986,25.0878073256397
36142,23,23586,81,"Tasa de exámenes médico legales por presunto delito sexual contra niños, niñas y adolescentes",2022,3,3,1848,162.337662337662,0,972,0,3,876,342.465753424658
36143,23,23586,81,"Tasa de exámenes médico legales por presunto delito sexual contra niños, niñas y adolescentes",2022,4,1,1821,54.9148819330038,0,949,0,1,872,114.678899082569
36144,23,23660,81,"Tasa de exámenes médico legales por presunto delito sexual contra niños, niñas y adolescentes",2022,2,3,8546,35.1041422887901,0,4337,0,3,4209,71.2758374910905
36145,23,23660,81,"Tasa de exámenes médico legales por presunto delito sexual contra niños, niñas y adolescentes",2022,3,7,10803,64.7968156993428,1,5513,18.138944313441,6,5290,113.421550094518
36146,23,23660,81,"Tasa de exámenes médico legales por presunto delito sexual contra niños, niñas y adolescentes",2022,4,30,11097,270.343336036767,1,5663,17.6584849019954,29,5434,533.676849466323
36147,23,23660,121,Tasa de exámenes médico legales por presunto delito sexual cuando la víctima está entre 18 y 28 años,2022,5,2,19608,10.1999184006528,0,9811,0,2,9797,20.4144125752781
36148,23,23670,81,"Tasa de exámenes médico legales por presunto delito sexual contra niños, niñas y adolescentes",2022,3,3,5812,51.6173434273916,0,2957,0,3,2855,105.07880910683
36149,23,23670,81,"Tasa de exámenes médico legales por presunto delito sexual contra niños, niñas y adolescentes",2022,4,13,5519,235.54991846349,1,2803,35.6760613628255,12,2716,441.826215022091
36150,23,23670,121,Tasa de exámenes médico legales por presunto delito sexual cuando la víctima está entre 18 y 28 años,2022,5,2,9940,20.1207243460765,0,5259,0,2,4681,42.7259132663961
36151,23,23672,81,"Tasa de exámenes médico legales por presunto delito sexual contra niños, niñas y adolescentes",2022,2,1,3387,29.5246530853262,1,1787,55.9597090095132,0,1600,0
36152,23,23672,81,"Tasa de exámenes médico legales por presunto delito sexual contra niños, niñas y adolescentes",2022,3,4,3925,101.910828025478,0,2027,0,4,1898,210.748155953635
36153,23,23672,81,"Tasa de exámenes médico legales por presunto delito sexual contra niños, niñas y adolescentes",2022,4,7,3720,188.172043010753,0,1870,0,7,1850,378.378378378378
36154,23,23675,81,"Tasa de exámenes médico legales por presunto delito sexual contra niños, niñas y adolescentes",2022,3,1,4238,23.5960358659745,0,2207,0,1,2031,49.2368291482029
36155,23,23675,81,"Tasa de exámenes médico legales por presunto delito sexual contra niños, niñas y adolescentes",2022,4,7,4220,165.876777251185,1,2227,44.9034575662326,6,1993,301.053687907677
36156,23,23675,121,Tasa de exámenes médico legales por presunto delito sexual cuando la víctima está entre 18 y 28 años,2022,5,3,6602,45.4407755225689,0,3312,0,3,3290,91.1854103343465
36157,23,23678,81,"Tasa de exámenes médico legales por presunto delito sexual contra niños, niñas y adolescentes",2022,4,2,2919,68.5166152792052,0,1484,0,2,1435,139.372822299652
36158,23,23682,81,"Tasa de exámenes médico legales por presunto delito sexual contra niños, niñas y adolescentes",2022,2,2,1651,121.138703815869,1,851,117.508813160987,1,800,125
36159,23,23682,81,"Tasa de exámenes médico legales por presunto delito sexual contra niños, niñas y adolescentes",2022,4,1,1825,54.7945205479452,0,947,0,1,878,113.895216400911
36160,23,23686,81,"Tasa de exámenes médico legales por presunto delito sexual contra niños, niñas y adolescentes",2022,3,2,4720,42.3728813559322,0,2464,0,2,2256,88.6524822695036
36161,23,23686,81,"Tasa de exámenes médico legales por presunto delito sexual contra niños, niñas y adolescentes",2022,4,5,4964,100.725221595487,0,2591,0,5,2373,210.703750526759
36162,23,23686,121,Tasa de exámenes médico legales por presunto delito sexual cuando la víctima está entre 18 y 28 años,2022,5,1,8921,11.2095056608004,0,4600,0,1,4321,23.1427910205971
36163,23,23807,81,"Tasa de exámenes médico legales por presunto delito sexual contra niños, niñas y adolescentes",2022,4,9,11421,78.8022064617809,0,5761,0,9,5660,159.010600706714
36164,23,23807,121,Tasa de exámenes médico legales por presunto delito sexual cuando la víctima está entre 18 y 28 años,2022,5,4,17874,22.3788743426206,0,9035,0,4,8839,45.2539880076932
36165,23,23815,81,"Tasa de exámenes médico legales por presunto delito sexual contra niños, niñas y adolescentes",2022,3,4,7449,53.6984830178547,2,3858,51.8403317781234,2,3591,55.6947925368978
36166,23,23815,81,"Tasa de exámenes médico legales por presunto delito sexual contra niños, niñas y adolescentes",2022,4,1,6654,15.0285542530809,1,3400,29.4117647058824,0,3254,0
36167,23,23815,81,"Tasa de exámenes médico legales por presunto delito sexual contra niños, niñas y adolescentes",2022,1,1,1327,75.3579502637528,0,698,0,1,629,158.982511923688
36168,23,23855,81,"Tasa de exámenes médico legales por presunto delito sexual contra niños, niñas y adolescentes",2022,4,1,4329,23.1000231000231,1,2254,44.3655723158829,0,2075,0
36169,25,25001,81,"Tasa de exámenes médico legales por presunto delito sexual contra niños, niñas y adolescentes",2022,3,1,905,110.497237569061,0,475,0,1,430,232.558139534884
36170,25,25001,81,"Tasa de exámenes médico legales por presunto delito sexual contra niños, niñas y adolescentes",2022,4,1,997,100.300902708124,0,513,0,1,484,206.611570247934
36171,25,25019,81,"Tasa de exámenes médico legales por presunto delito sexual contra niños, niñas y adolescentes",2022,3,4,582,687.285223367698,3,297,1010.10101010101,1,285,350.877192982456
36172,25,25019,81,"Tasa de exámenes médico legales por presunto delito sexual contra niños, niñas y adolescentes",2022,4,13,630,2063.49206349206,8,327,2446.48318042813,5,303,1650.16501650165
36173,25,25035,81,"Tasa de exámenes médico legales por presunto delito sexual contra niños, niñas y adolescentes",2022,2,1,1107,90.3342366757001,0,554,0,1,553,180.831826401447
36174,25,25035,81,"Tasa de exámenes médico legales por presunto delito sexual contra niños, niñas y adolescentes",2022,3,5,1294,386.398763523957,1,653,153.139356814701,4,641,624.02496099844
36175,25,25035,81,"Tasa de exámenes médico legales por presunto delito sexual contra niños, niñas y adolescentes",2022,4,15,1292,1160.9907120743,2,665,300.751879699248,13,627,2073.36523125997
36176,25,25035,121,Tasa de exámenes médico legales por presunto delito sexual cuando la víctima está entre 18 y 28 años,2022,5,3,2504,119.808306709265,0,1261,0,3,1243,241.351568785197
36177,25,25040,81,"Tasa de exámenes médico legales por presunto delito sexual contra niños, niñas y adolescentes",2022,3,1,1241,80.58017727639,0,650,0,1,591,169.204737732656
36178,25,25040,81,"Tasa de exámenes médico legales por presunto delito sexual contra niños, niñas y adolescentes",2022,4,1,1258,79.4912559618442,0,659,0,1,599,166.944908180301
36179,25,25599,81,"Tasa de exámenes médico legales por presunto delito sexual contra niños, niñas y adolescentes",2022,2,1,679,147.275405007364,1,344,290.697674418605,0,335,0
36180,25,25599,81,"Tasa de exámenes médico legales por presunto delito sexual contra niños, niñas y adolescentes",2022,3,1,762,131.233595800525,0,395,0,1,367,272.479564032698
36181,25,25599,81,"Tasa de exámenes médico legales por presunto delito sexual contra niños, niñas y adolescentes",2022,4,3,745,402.684563758389,0,393,0,3,352,852.272727272727
36182,25,25599,121,Tasa de exámenes médico legales por presunto delito sexual cuando la víctima está entre 18 y 28 años,2022,5,2,1390,143.884892086331,0,714,0,2,676,295.85798816568
36183,25,25053,81,"Tasa de exámenes médico legales por presunto delito sexual contra niños, niñas y adolescentes",2022,3,3,906,331.12582781457,2,449,445.43429844098,1,457,218.818380743982
36184,25,25053,81,"Tasa de exámenes médico legales por presunto delito sexual contra niños, niñas y adolescentes",2022,4,3,972,308.641975308642,0,505,0,3,467,642.398286937902
36185,25,25095,81,"Tasa de exámenes médico legales por presunto delito sexual contra niños, niñas y adolescentes",2022,4,2,183,1092.89617486339,0,97,0,2,86,2325.58139534884
36186,25,25099,81,"Tasa de exámenes médico legales por presunto delito sexual contra niños, niñas y adolescentes",2022,2,1,827,120.918984280532,0,406,0,1,421,237.529691211401
36187,25,25099,81,"Tasa de exámenes médico legales por presunto delito sexual contra niños, niñas y adolescentes",2022,3,1,1065,93.8967136150235,0,533,0,1,532,187.96992481203
36188,25,25099,81,"Tasa de exámenes médico legales por presunto delito sexual contra niños, niñas y adolescentes",2022,4,1,1171,85.397096498719,0,598,0,1,573,174.520069808028
36189,25,25120,81,"Tasa de exámenes médico legales por presunto delito sexual contra niños, niñas y adolescentes",2022,4,2,522,383.141762452107,0,273,0,2,249,803.212851405622
36190,25,25123,81,"Tasa de exámenes médico legales por presunto delito sexual contra niños, niñas y adolescentes",2022,2,2,754,265.25198938992,0,347,0,2,407,491.400491400491
36191,25,25123,81,"Tasa de exámenes médico legales por presunto delito sexual contra niños, niñas y adolescentes",2022,3,3,910,329.67032967033,0,442,0,3,468,641.025641025641
36192,25,25123,81,"Tasa de exámenes médico legales por presunto delito sexual contra niños, niñas y adolescentes",2022,4,4,897,445.930880713489,0,475,0,4,422,947.867298578199
36193,25,25126,81,"Tasa de exámenes médico legales por presunto delito sexual contra niños, niñas y adolescentes",2022,2,8,6874,116.380564445738,2,3469,57.6535024502739,6,3405,176.211453744493
36194,25,25126,81,"Tasa de exámenes médico legales por presunto delito sexual contra niños, niñas y adolescentes",2022,3,9,8084,111.331024245423,1,4165,24.0096038415366,8,3919,204.133707578464
36195,25,25126,81,"Tasa de exámenes médico legales por presunto delito sexual contra niños, niñas y adolescentes",2022,4,33,8137,405.554872803244,0,4212,0,33,3925,840.764331210191
36196,25,25126,121,Tasa de exámenes médico legales por presunto delito sexual cuando la víctima está entre 18 y 28 años,2022,5,8,16876,47.4045982460299,0,8299,0,8,8577,93.272706074385
36197,25,25148,81,"Tasa de exámenes médico legales por presunto delito sexual contra niños, niñas y adolescentes",2022,2,3,797,376.411543287327,0,394,0,3,403,744.416873449131
36198,25,25148,81,"Tasa de exámenes médico legales por presunto delito sexual contra niños, niñas y adolescentes",2022,3,5,1115,448.430493273543,3,574,522.648083623693,2,541,369.685767097967
36199,25,25148,81,"Tasa de exámenes médico legales por presunto delito sexual contra niños, niñas y adolescentes",2022,4,16,1166,1372.21269296741,1,619,161.550888529887,15,547,2742.23034734918
36200,25,25148,121,Tasa de exámenes médico legales por presunto delito sexual cuando la víctima está entre 18 y 28 años,2022,5,2,1677,119.260584376863,1,889,112.485939257593,1,788,126.903553299492
36201,25,25151,81,"Tasa de exámenes médico legales por presunto delito sexual contra niños, niñas y adolescentes",2022,2,2,1470,136.054421768707,0,785,0,2,685,291.970802919708
36202,25,25151,81,"Tasa de exámenes médico legales por presunto delito sexual contra niños, niñas y adolescentes",2022,3,3,1718,174.621653084983,1,910,109.89010989011,2,808,247.524752475248
36203,25,25151,81,"Tasa de exámenes médico legales por presunto delito sexual contra niños, niñas y adolescentes",2022,4,12,1656,724.63768115942,1,860,116.279069767442,11,796,1381.90954773869
36204,25,25154,81,"Tasa de exámenes médico legales por presunto delito sexual contra niños, niñas y adolescentes",2022,3,1,796,125.628140703518,0,417,0,1,379,263.852242744063
36205,25,25154,81,"Tasa de exámenes médico legales por presunto delito sexual contra niños, niñas y adolescentes",2022,4,3,801,374.531835205993,0,422,0,3,379,791.55672823219
36206,25,25168,81,"Tasa de exámenes médico legales por presunto delito sexual contra niños, niñas y adolescentes",2022,3,3,350,857.142857142857,1,185,540.540540540541,2,165,1212.12121212121
36207,25,25168,81,"Tasa de exámenes médico legales por presunto delito sexual contra niños, niñas y adolescentes",2022,4,1,358,279.329608938547,0,196,0,1,162,617.283950617284
36208,25,25175,81,"Tasa de exámenes médico legales por presunto delito sexual contra niños, niñas y adolescentes",2022,2,23,8840,260.180995475113,7,4516,155.004428697963,16,4324,370.027752081406
36209,25,25175,81,"Tasa de exámenes médico legales por presunto delito sexual contra niños, niñas y adolescentes",2022,3,27,11643,231.898995104355,6,5990,100.16694490818,21,5653,371.484167698567
36210,25,25175,81,"Tasa de exámenes médico legales por presunto delito sexual contra niños, niñas y adolescentes",2022,4,59,13299,443.64237912625,7,6865,101.966496722505,52,6434,808.206403481504
36211,25,25175,121,Tasa de exámenes médico legales por presunto delito sexual cuando la víctima está entre 18 y 28 años,2022,5,17,28476,59.6993959825818,0,14454,0,17,14022,121.238054485808
36212,25,25178,81,"Tasa de exámenes médico legales por presunto delito sexual contra niños, niñas y adolescentes",2022,3,1,973,102.774922918808,0,502,0,1,471,212.314225053079
36213,25,25178,81,"Tasa de exámenes médico legales por presunto delito sexual contra niños, niñas y adolescentes",2022,4,9,945,952.380952380953,0,484,0,9,461,1952.27765726681
36214,25,25181,81,"Tasa de exámenes médico legales por presunto delito sexual contra niños, niñas y adolescentes",2022,2,2,764,261.780104712042,1,415,240.963855421687,1,349,286.532951289398
36215,25,25181,81,"Tasa de exámenes médico legales por presunto delito sexual contra niños, niñas y adolescentes",2022,3,1,1003,99.7008973080758,0,510,0,1,493,202.839756592292
36216,25,25181,81,"Tasa de exámenes médico legales por presunto delito sexual contra niños, niñas y adolescentes",2022,4,4,1072,373.134328358209,0,525,0,4,547,731.261425959781
36217,25,25183,81,"Tasa de exámenes médico legales por presunto delito sexual contra niños, niñas y adolescentes",2022,2,1,1953,51.2032770097286,0,989,0,1,964,103.734439834025
36218,25,25183,81,"Tasa de exámenes médico legales por presunto delito sexual contra niños, niñas y adolescentes",2022,3,2,2371,84.3525938422606,0,1213,0,2,1158,172.711571675302
36219,25,25183,81,"Tasa de exámenes médico legales por presunto delito sexual contra niños, niñas y adolescentes",2022,4,5,2368,211.148648648649,0,1204,0,5,1164,429.553264604811
36220,25,25200,81,"Tasa de exámenes médico legales por presunto delito sexual contra niños, niñas y adolescentes",2022,3,5,2243,222.915737851092,0,1116,0,5,1127,443.655723158829
36221,25,25200,81,"Tasa de exámenes médico legales por presunto delito sexual contra niños, niñas y adolescentes",2022,4,3,2272,132.042253521127,0,1154,0,3,1118,268.336314847943
36222,25,25200,121,Tasa de exámenes médico legales por presunto delito sexual cuando la víctima está entre 18 y 28 años,2022,5,1,4445,22.4971878515186,0,2269,0,1,2176,45.9558823529412
36223,25,25214,81,"Tasa de exámenes médico legales por presunto delito sexual contra niños, niñas y adolescentes",2022,2,5,2520,198.412698412698,2,1316,151.975683890577,3,1204,249.169435215947
36224,25,25214,81,"Tasa de exámenes médico legales por presunto delito sexual contra niños, niñas y adolescentes",2022,3,6,3299,181.87329493786,1,1759,56.8504832291074,5,1540,324.675324675325
36225,25,25214,81,"Tasa de exámenes médico legales por presunto delito sexual contra niños, niñas y adolescentes",2022,4,6,3561,168.49199663016,1,1901,52.6038926880589,5,1660,301.204819277108
36226,25,25214,121,Tasa de exámenes médico legales por presunto delito sexual cuando la víctima está entre 18 y 28 años,2022,5,2,6901,28.9813070569483,1,3459,28.9100896212778,1,3442,29.0528762347472
36227,25,25224,81,"Tasa de exámenes médico legales por presunto delito sexual contra niños, niñas y adolescentes",2022,3,1,908,110.132158590308,0,478,0,1,430,232.558139534884
36228,25,25224,81,"Tasa de exámenes médico legales por presunto delito sexual contra niños, niñas y adolescentes",2022,4,7,763,917.431192660551,0,398,0,7,365,1917.80821917808
36229,25,25245,81,"Tasa de exámenes médico legales por presunto delito sexual contra niños, niñas y adolescentes",2022,2,2,1604,124.688279301746,0,792,0,2,812,246.305418719212
36230,25,25245,81,"Tasa de exámenes médico legales por presunto delito sexual contra niños, niñas y adolescentes",2022,3,15,2116,708.884688090737,4,1077,371.402042711235,11,1039,1058.71029836381
36231,25,25245,81,"Tasa de exámenes médico legales por presunto delito sexual contra niños, niñas y adolescentes",2022,4,17,2178,780.532598714417,3,1139,263.388937664618,14,1039,1347.44947064485
36232,25,25245,121,Tasa de exámenes médico legales por presunto delito sexual cuando la víctima está entre 18 y 28 años,2022,5,2,3540,56.4971751412429,0,1788,0,2,1752,114.155251141553
36233,25,25258,81,"Tasa de exámenes médico legales por presunto delito sexual contra niños, niñas y adolescentes",2022,2,1,341,293.255131964809,0,180,0,1,161,621.11801242236
36234,25,25258,81,"Tasa de exámenes médico legales por presunto delito sexual contra niños, niñas y adolescentes",2022,3,2,462,432.900432900433,1,253,395.256916996047,1,209,478.468899521531
36235,25,25258,81,"Tasa de exámenes médico legales por presunto delito sexual contra niños, niñas y adolescentes",2022,4,1,431,232.018561484919,0,236,0,1,195,512.820512820513
36236,25,25260,81,"Tasa de exámenes médico legales por presunto delito sexual contra niños, niñas y adolescentes",2022,3,1,2448,40.8496732026144,0,1261,0,1,1187,84.24599831508
36237,25,25260,81,"Tasa de exámenes médico legales por presunto delito sexual contra niños, niñas y adolescentes",2022,4,4,2492,160.513643659711,1,1245,80.3212851405623,3,1247,240.577385725742
36238,25,25260,121,Tasa de exámenes médico legales por presunto delito sexual cuando la víctima está entre 18 y 28 años,2022,5,3,5553,54.0248514316586,0,2798,0,3,2755,108.892921960073
36239,25,25269,81,"Tasa de exámenes médico legales por presunto delito sexual contra niños, niñas y adolescentes",2022,2,8,11364,70.3977472720873,3,5754,52.1376433785193,5,5610,89.126559714795
36240,25,25269,81,"Tasa de exámenes médico legales por presunto delito sexual contra niños, niñas y adolescentes",2022,3,23,14073,163.43352519008,6,7100,84.5070422535211,17,6973,243.797504660835
36241,25,25269,81,"Tasa de exámenes médico legales por presunto delito sexual contra niños, niñas y adolescentes",2022,4,60,15012,399.680255795364,5,7612,65.6857593273778,55,7400,743.243243243243
36242,25,25269,121,Tasa de exámenes médico legales por presunto delito sexual cuando la víctima está entre 18 y 28 años,2022,5,11,33372,32.9617643533501,0,16935,0,11,16437,66.9221877471558
36243,25,25269,81,"Tasa de exámenes médico legales por presunto delito sexual contra niños, niñas y adolescentes",2022,1,1,2060,48.5436893203883,0,1043,0,1,1017,98.3284169124877
36244,25,25279,81,"Tasa de exámenes médico legales por presunto delito sexual contra niños, niñas y adolescentes",2022,2,3,1040,288.461538461538,0,538,0,3,502,597.609561752988
36245,25,25279,81,"Tasa de exámenes médico legales por presunto delito sexual contra niños, niñas y adolescentes",2022,3,9,1212,742.574257425743,0,642,0,9,570,1578.94736842105
36246,25,25279,81,"Tasa de exámenes médico legales por presunto delito sexual contra niños, niñas y adolescentes",2022,4,8,1144,699.300699300699,0,610,0,8,534,1498.12734082397
36247,25,25281,81,"Tasa de exámenes médico legales por presunto delito sexual contra niños, niñas y adolescentes",2022,2,1,534,187.265917602996,0,258,0,1,276,362.31884057971
36248,25,25281,81,"Tasa de exámenes médico legales por presunto delito sexual contra niños, niñas y adolescentes",2022,3,1,642,155.763239875389,0,318,0,1,324,308.641975308642
36249,25,25281,81,"Tasa de exámenes médico legales por presunto delito sexual contra niños, niñas y adolescentes",2022,4,1,636,157.232704402516,0,332,0,1,304,328.947368421053
36250,25,25286,81,"Tasa de exámenes médico legales por presunto delito sexual contra niños, niñas y adolescentes",2022,2,5,7476,66.8806848582129,2,3715,53.835800807537,3,3761,79.7660196756182
36251,25,25286,81,"Tasa de exámenes médico legales por presunto delito sexual contra niños, niñas y adolescentes",2022,3,10,9167,109.086942293008,2,4620,43.2900432900433,8,4547,175.940180338685
36252,25,25286,81,"Tasa de exámenes médico legales por presunto delito sexual contra niños, niñas y adolescentes",2022,4,22,9521,231.068165108707,2,4873,41.0424789657295,20,4648,430.292598967298
36253,25,25286,121,Tasa de exámenes médico legales por presunto delito sexual cuando la víctima está entre 18 y 28 años,2022,5,1,20711,4.82835208343392,1,10549,9.47957152336714,0,10162,0
36254,25,25288,81,"Tasa de exámenes médico legales por presunto delito sexual contra niños, niñas y adolescentes",2022,2,1,428,233.644859813084,0,230,0,1,198,505.050505050505
36255,25,25288,81,"Tasa de exámenes médico legales por presunto delito sexual contra niños, niñas y adolescentes",2022,3,2,478,418.410041841004,0,242,0,2,236,847.457627118644
36256,25,25290,81,"Tasa de exámenes médico legales por presunto delito sexual contra niños, niñas y adolescentes",2022,2,6,9233,64.98429546193,2,4699,42.5622472866567,4,4534,88.2223202470225
36257,25,25290,81,"Tasa de exámenes médico legales por presunto delito sexual contra niños, niñas y adolescentes",2022,3,33,12101,272.704735145856,8,6223,128.555359151535,25,5878,425.314732902348
36258,25,25290,81,"Tasa de exámenes médico legales por presunto delito sexual contra niños, niñas y adolescentes",2022,4,76,13319,570.613409415121,8,6922,115.573533660792,68,6397,1062.99828044396
36259,25,25290,121,Tasa de exámenes médico legales por presunto delito sexual cuando la víctima está entre 18 y 28 años,2022,5,10,25999,38.4630178083772,1,13131,7.61556621734826,9,12868,69.9409387628225
36260,25,25295,81,"Tasa de exámenes médico legales por presunto delito sexual contra niños, niñas y adolescentes",2022,2,3,1705,175.95307917888599,1,867,115.340253748558,2,838,238.663484486874
36261,25,25295,81,"Tasa de exámenes médico legales por presunto delito sexual contra niños, niñas y adolescentes",2022,3,4,1884,212.314225053079,0,962,0,4,922,433.839479392625
36262,25,25295,81,"Tasa de exámenes médico legales por presunto delito sexual contra niños, niñas y adolescentes",2022,4,5,1824,274.122807017544,0,925,0,5,899,556.173526140156
36263,25,25295,121,Tasa de exámenes médico legales por presunto delito sexual cuando la víctima está entre 18 y 28 años,2022,5,2,4333,46.1573967228248,0,2174,0,2,2159,92.6354793886058
36264,25,25297,121,Tasa de exámenes médico legales por presunto delito sexual cuando la víctima está entre 18 y 28 años,2022,5,1,1224,81.6993464052288,0,632,0,1,592,168.918918918919
36265,25,25299,81,"Tasa de exámenes médico legales por presunto delito sexual contra niños, niñas y adolescentes",2022,3,1,303,330.03300330033,1,165,606.060606060606,0,138,0
36266,25,25299,81,"Tasa de exámenes médico legales por presunto delito sexual contra niños, niñas y adolescentes",2022,4,1,312,320.51282051282,0,169,0,1,143,699.300699300699
36267,25,25307,81,"Tasa de exámenes médico legales por presunto delito sexual contra niños, niñas y adolescentes",2022,2,4,7260,55.096418732782404,0,3804,0,4,3456,115.740740740741
36268,25,25307,81,"Tasa de exámenes médico legales por presunto delito sexual contra niños, niñas y adolescentes",2022,3,15,8804,170.377101317583,3,4538,66.1084178052005,12,4266,281.293952180028
36269,25,25307,81,"Tasa de exámenes médico legales por presunto delito sexual contra niños, niñas y adolescentes",2022,4,23,9043,254.340373769767,4,4574,87.4508089199825,19,4469,425.151040501231
36270,25,25307,121,Tasa de exámenes médico legales por presunto delito sexual cuando la víctima está entre 18 y 28 años,2022,5,6,19247,31.1736894061412,0,9851,0,6,9396,63.8569604086846
36271,25,25312,121,Tasa de exámenes médico legales por presunto delito sexual cuando la víctima está entre 18 y 28 años,2022,5,1,1372,72.8862973760933,1,678,147.492625368732,0,694,0
36272,25,25317,81,"Tasa de exámenes médico legales por presunto delito sexual contra niños, niñas y adolescentes",2022,4,1,1414,70.7213578500707,0,739,0,1,675,148.148148148148
36273,25,25317,121,Tasa de exámenes médico legales por presunto delito sexual cuando la víctima está entre 18 y 28 años,2022,5,1,2510,39.8406374501992,0,1261,0,1,1249,80.0640512409928
36274,25,25320,81,"Tasa de exámenes médico legales por presunto delito sexual contra niños, niñas y adolescentes",2022,2,6,2005,299.25187032419,1,1024,97.65625,5,981,509.683995922528
36275,25,25320,81,"Tasa de exámenes médico legales por presunto delito sexual contra niños, niñas y adolescentes",2022,3,8,2512,318.471337579618,1,1296,77.1604938271605,7,1216,575.657894736842
36276,25,25320,81,"Tasa de exámenes médico legales por presunto delito sexual contra niños, niñas y adolescentes",2022,4,19,2555,743.639921722114,7,1334,524.737631184408,12,1221,982.800982800983
36277,25,25320,121,Tasa de exámenes médico legales por presunto delito sexual cuando la víctima está entre 18 y 28 años,2022,5,3,5713,52.5118151584106,1,3445,29.0275761973875,2,2268,88.1834215167548
36278,25,25322,81,"Tasa de exámenes médico legales por presunto delito sexual contra niños, niñas y adolescentes",2022,3,1,1528,65.4450261780105,0,742,0,1,786,127.226463104326
36279,25,25322,81,"Tasa de exámenes médico legales por presunto delito sexual contra niños, niñas y adolescentes",2022,4,4,1590,251.572327044025,0,789,0,4,801,499.375780274657
36280,25,25324,81,"Tasa de exámenes médico legales por presunto delito sexual contra niños, niñas y adolescentes",2022,3,1,236,423.728813559322,0,124,0,1,112,892.857142857143
36281,25,25324,81,"Tasa de exámenes médico legales por presunto delito sexual contra niños, niñas y adolescentes",2022,4,2,260,769.230769230769,0,144,0,2,116,1724.13793103448
36282,25,25326,81,"Tasa de exámenes médico legales por presunto delito sexual contra niños, niñas y adolescentes",2022,4,2,617,324.149108589951,0,332,0,2,285,701.754385964912
36283,25,25326,121,Tasa de exámenes médico legales por presunto delito sexual cuando la víctima está entre 18 y 28 años,2022,5,1,1176,85.0340136054422,0,604,0,1,572,174.825174825175
36284,25,25328,81,"Tasa de exámenes médico legales por presunto delito sexual contra niños, niñas y adolescentes",2022,3,1,401,249.376558603491,0,195,0,1,206,485.436893203883
36285,25,25328,81,"Tasa de exámenes médico legales por presunto delito sexual contra niños, niñas y adolescentes",2022,4,5,396,1262.62626262626,0,201,0,5,195,2564.10256410256
36286,25,25335,81,"Tasa de exámenes médico legales por presunto delito sexual contra niños, niñas y adolescentes",2022,2,1,743,134.589502018843,0,375,0,1,368,271.739130434783
36287,25,25335,81,"Tasa de exámenes médico legales por presunto delito sexual contra niños, niñas y adolescentes",2022,3,1,722,138.504155124654,0,359,0,1,363,275.482093663912
36288,25,25335,81,"Tasa de exámenes médico legales por presunto delito sexual contra niños, niñas y adolescentes",2022,4,4,613,652.52854812398,0,305,0,4,308,1298.7012987013
36289,25,25339,81,"Tasa de exámenes médico legales por presunto delito sexual contra niños, niñas y adolescentes",2022,2,2,328,609.756097560976,0,160,0,2,168,1190.47619047619
36290,25,25339,81,"Tasa de exámenes médico legales por presunto delito sexual contra niños, niñas y adolescentes",2022,3,2,365,547.945205479452,0,184,0,2,181,1104.97237569061
36291,25,25377,81,"Tasa de exámenes médico legales por presunto delito sexual contra niños, niñas y adolescentes",2022,3,4,2640,151.515151515152,4,1341,298.284862043251,0,1299,0
36292,25,25377,81,"Tasa de exámenes médico legales por presunto delito sexual contra niños, niñas y adolescentes",2022,4,5,2816,177.556818181818,0,1440,0,5,1376,363.372093023256
36293,25,25377,121,Tasa de exámenes médico legales por presunto delito sexual cuando la víctima está entre 18 y 28 años,2022,5,1,5810,17.2117039586919,0,2949,0,1,2861,34.952813701503
36294,25,25386,81,"Tasa de exámenes médico legales por presunto delito sexual contra niños, niñas y adolescentes",2022,2,8,2332,343.053173241853,2,1193,167.644593461861,6,1139,526.777875329236
36295,25,25386,81,"Tasa de exámenes médico legales por presunto delito sexual contra niños, niñas y adolescentes",2022,3,9,2852,315.568022440393,0,1476,0,9,1376,654.06976744186
36296,25,25386,81,"Tasa de exámenes médico legales por presunto delito sexual contra niños, niñas y adolescentes",2022,4,25,2855,875.656742556918,6,1490,402.684563758389,19,1365,1391.94139194139
36297,25,25386,121,Tasa de exámenes médico legales por presunto delito sexual cuando la víctima está entre 18 y 28 años,2022,5,4,5312,75.3012048192771,0,2705,0,4,2607,153.43306482547
36298,25,25394,81,"Tasa de exámenes médico legales por presunto delito sexual contra niños, niñas y adolescentes",2022,4,2,795,251.572327044025,0,430,0,2,365,547.945205479452
36299,25,25394,121,Tasa de exámenes médico legales por presunto delito sexual cuando la víctima está entre 18 y 28 años,2022,5,1,1153,86.7302688638335,0,605,0,1,548,182.481751824818
36300,25,25398,81,"Tasa de exámenes médico legales por presunto delito sexual contra niños, niñas y adolescentes",2022,2,1,349,286.532951289398,0,199,0,1,150,666.666666666667
36301,25,25398,81,"Tasa de exámenes médico legales por presunto delito sexual contra niños, niñas y adolescentes",2022,4,2,507,394.477317554241,0,266,0,2,241,829.875518672199
36302,25,25402,81,"Tasa de exámenes médico legales por presunto delito sexual contra niños, niñas y adolescentes",2022,2,1,1351,74.019245003701,0,672,0,1,679,147.275405007364
36303,25,25402,81,"Tasa de exámenes médico legales por presunto delito sexual contra niños, niñas y adolescentes",2022,3,5,1625,307.692307692308,2,814,245.700245700246,3,811,369.913686806412
36304,25,25402,81,"Tasa de exámenes médico legales por presunto delito sexual contra niños, niñas y adolescentes",2022,4,12,1609,745.80484773151,5,823,607.533414337789,7,786,890.58524173028
36305,25,25402,121,Tasa de exámenes médico legales por presunto delito sexual cuando la víctima está entre 18 y 28 años,2022,5,1,2854,35.0385423966363,0,1391,0,1,1463,68.3526999316473
36306,25,25407,81,"Tasa de exámenes médico legales por presunto delito sexual contra niños, niñas y adolescentes",2022,2,2,1144,174.825174825175,0,600,0,2,544,367.647058823529
36307,25,25407,81,"Tasa de exámenes médico legales por presunto delito sexual contra niños, niñas y adolescentes",2022,3,3,1202,249.584026622296,0,624,0,3,578,519.031141868512
36308,25,25407,81,"Tasa de exámenes médico legales por presunto delito sexual contra niños, niñas y adolescentes",2022,4,4,1041,384.245917387128,0,543,0,4,498,803.212851405622
36309,25,25407,121,Tasa de exámenes médico legales por presunto delito sexual cuando la víctima está entre 18 y 28 años,2022,5,1,1900,52.6315789473684,0,969,0,1,931,107.411385606874
36310,25,25426,81,"Tasa de exámenes médico legales por presunto delito sexual contra niños, niñas y adolescentes",2022,4,2,564,354.609929078014,0,297,0,2,267,749.063670411985
36311,25,25430,81,"Tasa de exámenes médico legales por presunto delito sexual contra niños, niñas y adolescentes",2022,2,2,10323,19.3742129226,0,5259,0,2,5064,39.4944707740916
36312,25,25430,81,"Tasa de exámenes médico legales por presunto delito sexual contra niños, niñas y adolescentes",2022,3,20,11932,167.616493462957,1,6022,16.6057788110262,19,5910,321.489001692047
36313,25,25430,81,"Tasa de exámenes médico legales por presunto delito sexual contra niños, niñas y adolescentes",2022,4,23,11696,196.648426812585,6,5870,102.21465076661,17,5826,291.795399931342
36314,25,25430,121,Tasa de exámenes médico legales por presunto delito sexual cuando la víctima está entre 18 y 28 años,2022,5,6,26732,22.4450097261709,0,13430,0,6,13302,45.10599909788
36315,25,25436,81,"Tasa de exámenes médico legales por presunto delito sexual contra niños, niñas y adolescentes",2022,3,2,257,778.210116731517,0,140,0,2,117,1709.40170940171
36316,25,25436,81,"Tasa de exámenes médico legales por presunto delito sexual contra niños, niñas y adolescentes",2022,4,3,276,1086.95652173913,0,153,0,3,123,2439.0243902439
36317,25,25436,121,Tasa de exámenes médico legales por presunto delito sexual cuando la víctima está entre 18 y 28 años,2022,5,1,431,232.018561484919,0,228,0,1,203,492.610837438424
36318,25,25438,81,"Tasa de exámenes médico legales por presunto delito sexual contra niños, niñas y adolescentes",2022,4,8,885,903.954802259887,0,476,0,8,409,1955.9902200489
36319,25,25438,121,Tasa de exámenes médico legales por presunto delito sexual cuando la víctima está entre 18 y 28 años,2022,5,1,1368,73.0994152046784,0,726,0,1,642,155.763239875389
36320,25,25473,81,"Tasa de exámenes médico legales por presunto delito sexual contra niños, niñas y adolescentes",2022,2,2,10838,18.4535892231039,0,5566,0,2,5272,37.9362670713202
36321,25,25473,81,"Tasa de exámenes médico legales por presunto delito sexual contra niños, niñas y adolescentes",2022,3,6,13073,45.8961217777098,0,6681,0,6,6392,93.8673341677096
36322,25,25473,81,"Tasa de exámenes médico legales por presunto delito sexual contra niños, niñas y adolescentes",2022,4,17,13365,127.197904975683,2,6753,29.6164667555161,15,6612,226.860254083485
36323,25,25473,121,Tasa de exámenes médico legales por presunto delito sexual cuando la víctima está entre 18 y 28 años,2022,5,5,29674,16.8497674732089,0,14795,0,5,14879,33.6044088984475
36324,25,25483,81,"Tasa de exámenes médico legales por presunto delito sexual contra niños, niñas y adolescentes",2022,3,1,188,531.914893617021,0,103,0,1,85,1176.47058823529
36325,25,25483,81,"Tasa de exámenes médico legales por presunto delito sexual contra niños, niñas y adolescentes",2022,4,1,212,471.698113207547,0,118,0,1,94,1063.82978723404
36326,25,25486,81,"Tasa de exámenes médico legales por presunto delito sexual contra niños, niñas y adolescentes",2022,2,2,1485,134.680134680135,1,775,129.032258064516,1,710,140.845070422535
36327,25,25486,81,"Tasa de exámenes médico legales por presunto delito sexual contra niños, niñas y adolescentes",2022,3,3,1570,191.082802547771,0,799,0,3,771,389.105058365759
36328,25,25486,81,"Tasa de exámenes médico legales por presunto delito sexual contra niños, niñas y adolescentes",2022,4,5,1457,343.170899107756,0,722,0,5,735,680.272108843537
36329,25,25486,121,Tasa de exámenes médico legales por presunto delito sexual cuando la víctima está entre 18 y 28 años,2022,5,2,2923,68.4228532329798,1,1437,69.589422407794,1,1486,67.2947510094213
36330,25,25488,81,"Tasa de exámenes médico legales por presunto delito sexual contra niños, niñas y adolescentes",2022,2,2,792,252.525252525253,1,418,239.234449760766,1,374,267.379679144385
36331,25,25488,81,"Tasa de exámenes médico legales por presunto delito sexual contra niños, niñas y adolescentes",2022,3,3,830,361.44578313253,2,434,460.829493087558,1,396,252.525252525253
36332,25,25488,81,"Tasa de exámenes médico legales por presunto delito sexual contra niños, niñas y adolescentes",2022,4,2,770,259.74025974026,0,433,0,2,337,593.471810089021
36333,25,25488,121,Tasa de exámenes médico legales por presunto delito sexual cuando la víctima está entre 18 y 28 años,2022,5,5,4649,107.550010755001,3,3914,76.6479305058763,2,735,272.108843537415
36334,25,25489,81,"Tasa de exámenes médico legales por presunto delito sexual contra niños, niñas y adolescentes",2022,4,1,291,343.642611683849,0,164,0,1,127,787.40157480315
36335,25,25489,121,Tasa de exámenes médico legales por presunto delito sexual cuando la víctima está entre 18 y 28 años,2022,5,1,495,202.020202020202,0,254,0,1,241,414.9377593361
36336,25,25491,81,"Tasa de exámenes médico legales por presunto delito sexual contra niños, niñas y adolescentes",2022,2,1,467,214.132762312634,0,217,0,1,250,400
36337,25,25491,81,"Tasa de exámenes médico legales por presunto delito sexual contra niños, niñas y adolescentes",2022,3,1,508,196.850393700787,0,253,0,1,255,392.156862745098
36338,25,25491,81,"Tasa de exámenes médico legales por presunto delito sexual contra niños, niñas y adolescentes",2022,4,2,489,408.997955010225,0,263,0,2,226,884.955752212389
36339,25,25513,81,"Tasa de exámenes médico legales por presunto delito sexual contra niños, niñas y adolescentes",2022,3,1,2373,42.1407501053519,1,1206,82.9187396351576,0,1167,0
36340,25,25513,81,"Tasa de exámenes médico legales por presunto delito sexual contra niños, niñas y adolescentes",2022,4,4,2465,162.271805273834,1,1290,77.5193798449612,3,1175,255.31914893617
36341,25,25513,121,Tasa de exámenes médico legales por presunto delito sexual cuando la víctima está entre 18 y 28 años,2022,5,1,3964,25.2270433905146,0,1978,0,1,1986,50.3524672708963
36342,25,25518,81,"Tasa de exámenes médico legales por presunto delito sexual contra niños, niñas y adolescentes",2022,4,1,444,225.225225225225,0,247,0,1,197,507.614213197969
36343,25,25530,81,"Tasa de exámenes médico legales por presunto delito sexual contra niños, niñas y adolescentes",2022,2,3,927,323.624595469256,1,487,205.338809034908,2,440,454.545454545455
36344,25,25530,81,"Tasa de exámenes médico legales por presunto delito sexual contra niños, niñas y adolescentes",2022,3,2,1063,188.146754468485,0,538,0,2,525,380.952380952381
36345,25,25530,81,"Tasa de exámenes médico legales por presunto delito sexual contra niños, niñas y adolescentes",2022,4,1,983,101.729399796541,0,476,0,1,507,197.23865877712
36346,25,25530,121,Tasa de exámenes médico legales por presunto delito sexual cuando la víctima está entre 18 y 28 años,2022,5,1,1710,58.4795321637427,0,851,0,1,859,116.414435389988
36347,25,25535,81,"Tasa de exámenes médico legales por presunto delito sexual contra niños, niñas y adolescentes",2022,2,1,720,138.888888888889,0,385,0,1,335,298.507462686567
36348,25,25535,81,"Tasa de exámenes médico legales por presunto delito sexual contra niños, niñas y adolescentes",2022,3,4,935,427.807486631016,2,488,409.83606557377,2,447,447.427293064877
36349,25,25535,81,"Tasa de exámenes médico legales por presunto delito sexual contra niños, niñas y adolescentes",2022,4,6,1001,599.400599400599,0,514,0,6,487,1232.03285420945
36350,25,25535,121,Tasa de exámenes médico legales por presunto delito sexual cuando la víctima está entre 18 y 28 años,2022,5,3,1674,179.21146953405,0,869,0,3,805,372.670807453416
36351,25,25572,81,"Tasa de exámenes médico legales por presunto delito sexual contra niños, niñas y adolescentes",2022,3,1,1533,65.2315720808871,0,764,0,1,769,130.039011703511
36352,25,25572,81,"Tasa de exámenes médico legales por presunto delito sexual contra niños, niñas y adolescentes",2022,4,5,1531,326.583932070542,0,795,0,5,736,679.347826086957
36353,25,25572,121,Tasa de exámenes médico legales por presunto delito sexual cuando la víctima está entre 18 y 28 años,2022,5,1,3168,31.5656565656566,0,1741,0,1,1427,70.0770847932726
36354,25,25580,81,"Tasa de exámenes médico legales por presunto delito sexual contra niños, niñas y adolescentes",2022,3,1,320,312.5,1,153,653.59477124183,0,167,0
36355,25,25592,81,"Tasa de exámenes médico legales por presunto delito sexual contra niños, niñas y adolescentes",2022,4,2,391,511.50895140665,0,193,0,2,198,1010.10101010101
36356,25,25594,81,"Tasa de exámenes médico legales por presunto delito sexual contra niños, niñas y adolescentes",2022,2,1,528,189.393939393939,0,263,0,1,265,377.358490566038
36357,25,25594,81,"Tasa de exámenes médico legales por presunto delito sexual contra niños, niñas y adolescentes",2022,3,7,577,1213.17157712305,0,301,0,7,276,2536.23188405797
36358,25,25594,81,"Tasa de exámenes médico legales por presunto delito sexual contra niños, niñas y adolescentes",2022,4,1,531,188.323917137476,0,282,0,1,249,401.606425702811
36359,25,25612,81,"Tasa de exámenes médico legales por presunto delito sexual contra niños, niñas y adolescentes",2022,3,3,1258,238.473767885533,1,650,153.846153846154,2,608,328.947368421053
36360,25,25612,81,"Tasa de exámenes médico legales por presunto delito sexual contra niños, niñas y adolescentes",2022,4,6,1191,503.778337531486,0,607,0,6,584,1027.39726027397
36361,25,25612,121,Tasa de exámenes médico legales por presunto delito sexual cuando la víctima está entre 18 y 28 años,2022,5,2,2362,84.6740050804403,0,1158,0,2,1204,166.112956810631
36362,25,25645,81,"Tasa de exámenes médico legales por presunto delito sexual contra niños, niñas y adolescentes",2022,3,1,1029,97.1817298347911,0,524,0,1,505,198.019801980198
36363,25,25645,81,"Tasa de exámenes médico legales por presunto delito sexual contra niños, niñas y adolescentes",2022,4,6,1029,583.090379008746,1,531,188.323917137476,5,498,1004.01606425703
36364,25,25649,81,"Tasa de exámenes médico legales por presunto delito sexual contra niños, niñas y adolescentes",2022,4,2,829,241.254523522316,0,438,0,2,391,511.50895140665
36365,25,25649,121,Tasa de exámenes médico legales por presunto delito sexual cuando la víctima está entre 18 y 28 años,2022,5,1,1393,71.7875089734386,0,679,0,1,714,140.056022408964
36366,25,25653,121,Tasa de exámenes médico legales por presunto delito sexual cuando la víctima está entre 18 y 28 años,2022,5,1,757,132.100396301189,0,398,0,1,359,278.551532033426
36367,25,25658,81,"Tasa de exámenes médico legales por presunto delito sexual contra niños, niñas y adolescentes",2022,2,1,846,118.203309692671,1,440,227.272727272727,0,406,0
36368,25,25658,81,"Tasa de exámenes médico legales por presunto delito sexual contra niños, niñas y adolescentes",2022,4,1,987,101.317122593718,0,501,0,1,486,205.761316872428
36369,25,25662,81,"Tasa de exámenes médico legales por presunto delito sexual contra niños, niñas y adolescentes",2022,3,1,768,130.208333333333,0,404,0,1,364,274.725274725275
36370,25,25662,81,"Tasa de exámenes médico legales por presunto delito sexual contra niños, niñas y adolescentes",2022,4,1,744,134.408602150538,1,391,255.754475703325,0,353,0
36371,25,25718,81,"Tasa de exámenes médico legales por presunto delito sexual contra niños, niñas y adolescentes",2022,2,1,709,141.043723554302,0,350,0,1,359,278.551532033426
36372,25,25718,81,"Tasa de exámenes médico legales por presunto delito sexual contra niños, niñas y adolescentes",2022,3,5,1044,478.927203065134,1,560,178.571428571429,4,484,826.446280991736
36373,25,25718,81,"Tasa de exámenes médico legales por presunto delito sexual contra niños, niñas y adolescentes",2022,4,4,1122,356.50623885918,2,640,312.5,2,482,414.9377593361
36374,25,25736,81,"Tasa de exámenes médico legales por presunto delito sexual contra niños, niñas y adolescentes",2022,2,1,1011,98.9119683481701,0,523,0,1,488,204.918032786885
36375,25,25736,81,"Tasa de exámenes médico legales por presunto delito sexual contra niños, niñas y adolescentes",2022,3,4,1200,333.333333333333,1,624,160.25641025641,3,576,520.833333333333
36376,25,25736,81,"Tasa de exámenes médico legales por presunto delito sexual contra niños, niñas y adolescentes",2022,4,1,1235,80.9716599190283,0,641,0,1,594,168.350168350168
36377,25,25736,121,Tasa de exámenes médico legales por presunto delito sexual cuando la víctima está entre 18 y 28 años,2022,5,1,2355,42.4628450106157,0,1185,0,1,1170,85.4700854700855
36378,25,25740,81,"Tasa de exámenes médico legales por presunto delito sexual contra niños, niñas y adolescentes",2022,2,1,2712,36.8731563421829,0,1365,0,1,1347,74.2390497401633
36379,25,25740,81,"Tasa de exámenes médico legales por presunto delito sexual contra niños, niñas y adolescentes",2022,3,7,3360,208.333333333333,2,1695,117.994100294985,5,1665,300.3003003003
36380,25,25740,81,"Tasa de exámenes médico legales por presunto delito sexual contra niños, niñas y adolescentes",2022,4,10,3498,285.87764436821,0,1806,0,10,1692,591.016548463357
36381,25,25740,121,Tasa de exámenes médico legales por presunto delito sexual cuando la víctima está entre 18 y 28 años,2022,5,2,7314,27.3448181569593,0,3697,0,2,3617,55.2944429084877
36382,25,25743,81,"Tasa de exámenes médico legales por presunto delito sexual contra niños, niñas y adolescentes",2022,3,4,2124,188.323917137476,1,1114,89.7666068222621,3,1010,297.029702970297
36383,25,25743,81,"Tasa de exámenes médico legales por presunto delito sexual contra niños, niñas y adolescentes",2022,4,6,2087,287.494010541447,1,1087,91.9963201471941,5,1000,500
36384,25,25743,121,Tasa de exámenes médico legales por presunto delito sexual cuando la víctima está entre 18 y 28 años,2022,5,1,3597,27.8009452321379,0,1817,0,1,1780,56.1797752808989
36385,25,25745,81,"Tasa de exámenes médico legales por presunto delito sexual contra niños, niñas y adolescentes",2022,3,1,1500,66.6666666666667,0,771,0,1,729,137.174211248285
36386,25,25754,81,"Tasa de exámenes médico legales por presunto delito sexual contra niños, niñas y adolescentes",2022,2,24,57687,41.6038275521348,7,29495,23.7328360739108,17,28192,60.3007945516459
36387,25,25754,81,"Tasa de exámenes médico legales por presunto delito sexual contra niños, niñas y adolescentes",2022,3,77,70001,109.998428593877,16,35665,44.8619094350203,61,34336,177.656104380242
36388,25,25754,81,"Tasa de exámenes médico legales por presunto delito sexual contra niños, niñas y adolescentes",2022,4,170,71311,238.392393880327,10,35912,27.8458453998663,160,35399,451.99016921382
36389,25,25754,121,Tasa de exámenes médico legales por presunto delito sexual cuando la víctima está entre 18 y 28 años,2022,5,32,154175,20.7556348305497,1,76071,1.31456139659003,31,78104,39.6906688517874
36390,25,25754,81,"Tasa de exámenes médico legales por presunto delito sexual contra niños, niñas y adolescentes",2022,1,1,10448,9.57120980091884,0,5340,0,1,5108,19.5771339075959
36391,25,25758,81,"Tasa de exámenes médico legales por presunto delito sexual contra niños, niñas y adolescentes",2022,3,3,2390,125.523012552301,1,1244,80.3858520900322,2,1146,174.520069808028
36392,25,25758,81,"Tasa de exámenes médico legales por presunto delito sexual contra niños, niñas y adolescentes",2022,4,4,2702,148.038490007402,1,1382,72.3589001447178,3,1320,227.272727272727
36393,25,25769,81,"Tasa de exámenes médico legales por presunto delito sexual contra niños, niñas y adolescentes",2022,4,3,1491,201.207243460765,0,737,0,3,754,397.877984084881
36394,25,25772,81,"Tasa de exámenes médico legales por presunto delito sexual contra niños, niñas y adolescentes",2022,2,1,1618,61.8046971569839,1,840,119.047619047619,0,778,0
36395,25,25772,81,"Tasa de exámenes médico legales por presunto delito sexual contra niños, niñas y adolescentes",2022,3,1,1876,53.3049040511727,0,962,0,1,914,109.409190371991
36396,25,25772,81,"Tasa de exámenes médico legales por presunto delito sexual contra niños, niñas y adolescentes",2022,4,11,1917,573.813249869588,0,975,0,11,942,1167.72823779193
36397,25,25777,81,"Tasa de exámenes médico legales por presunto delito sexual contra niños, niñas y adolescentes",2022,3,1,479,208.768267223382,0,234,0,1,245,408.163265306122
36398,25,25779,81,"Tasa de exámenes médico legales por presunto delito sexual contra niños, niñas y adolescentes",2022,4,6,707,848.656294200849,0,361,0,6,346,1734.10404624277
36399,25,25781,81,"Tasa de exámenes médico legales por presunto delito sexual contra niños, niñas y adolescentes",2022,2,2,669,298.953662182362,1,354,282.485875706215,1,315,317.460317460317
36400,25,25781,81,"Tasa de exámenes médico legales por presunto delito sexual contra niños, niñas y adolescentes",2022,3,3,699,429.184549356223,0,353,0,3,346,867.052023121387
36401,25,25781,81,"Tasa de exámenes médico legales por presunto delito sexual contra niños, niñas y adolescentes",2022,4,3,627,478.468899521531,0,312,0,3,315,952.380952380953
36402,25,25785,81,"Tasa de exámenes médico legales por presunto delito sexual contra niños, niñas y adolescentes",2022,3,3,2083,144.02304368699,1,1044,95.7854406130268,2,1039,192.492781520693
36403,25,25785,81,"Tasa de exámenes médico legales por presunto delito sexual contra niños, niñas y adolescentes",2022,4,1,2093,47.7783086478739,1,1060,94.3396226415094,0,1033,0
36404,25,25785,121,Tasa de exámenes médico legales por presunto delito sexual cuando la víctima está entre 18 y 28 años,2022,5,1,4579,21.8388294387421,0,2304,0,1,2275,43.956043956044
36405,25,25793,81,"Tasa de exámenes médico legales por presunto delito sexual contra niños, niñas y adolescentes",2022,3,1,961,104.058272632674,0,489,0,1,472,211.864406779661
36406,25,25793,121,Tasa de exámenes médico legales por presunto delito sexual cuando la víctima está entre 18 y 28 años,2022,5,1,1586,63.0517023959647,0,799,0,1,787,127.064803049555
36407,25,25797,81,"Tasa de exámenes médico legales por presunto delito sexual contra niños, niñas y adolescentes",2022,2,1,748,133.689839572193,0,365,0,1,383,261.096605744125
36408,25,25797,81,"Tasa de exámenes médico legales por presunto delito sexual contra niños, niñas y adolescentes",2022,3,2,873,229.095074455899,0,449,0,2,424,471.698113207547
36409,25,25797,81,"Tasa de exámenes médico legales por presunto delito sexual contra niños, niñas y adolescentes",2022,4,11,877,1254.27594070696,1,481,207.900207900208,10,396,2525.25252525253
36410,25,25797,121,Tasa de exámenes médico legales por presunto delito sexual cuando la víctima está entre 18 y 28 años,2022,5,2,1488,134.408602150538,1,795,125.786163522013,1,693,144.300144300144
36411,25,25799,81,"Tasa de exámenes médico legales por presunto delito sexual contra niños, niñas y adolescentes",2022,3,1,2115,47.2813238770686,0,1073,0,1,1042,95.9692898272553
36412,25,25799,121,Tasa de exámenes médico legales por presunto delito sexual cuando la víctima está entre 18 y 28 años,2022,5,1,4701,21.2720697723889,0,2343,0,1,2358,42.4088210347752
36413,25,25805,81,"Tasa de exámenes médico legales por presunto delito sexual contra niños, niñas y adolescentes",2022,4,3,420,714.285714285714,0,201,0,3,219,1369.86301369863
36414,25,25807,81,"Tasa de exámenes médico legales por presunto delito sexual contra niños, niñas y adolescentes",2022,2,1,177,564.971751412429,0,91,0,1,86,1162.79069767442
36415,25,25815,81,"Tasa de exámenes médico legales por presunto delito sexual contra niños, niñas y adolescentes",2022,2,2,990,202.020202020202,1,506,197.628458498024,1,484,206.611570247934
36416,25,25815,81,"Tasa de exámenes médico legales por presunto delito sexual contra niños, niñas y adolescentes",2022,3,7,1339,522.778192681105,2,700,285.714285714286,5,639,782.472613458529
36417,25,25815,81,"Tasa de exámenes médico legales por presunto delito sexual contra niños, niñas y adolescentes",2022,4,6,1466,409.276944065484,0,788,0,6,678,884.955752212389
36418,25,25815,121,Tasa de exámenes médico legales por presunto delito sexual cuando la víctima está entre 18 y 28 años,2022,5,1,2563,39.0167772142021,0,1345,0,1,1218,82.1018062397373
36419,25,25817,81,"Tasa de exámenes médico legales por presunto delito sexual contra niños, niñas y adolescentes",2022,3,3,4377,68.5400959561343,2,2252,88.809946714032,1,2125,47.0588235294118
36420,25,25817,81,"Tasa de exámenes médico legales por presunto delito sexual contra niños, niñas y adolescentes",2022,4,5,4281,116.795141322121,0,2194,0,5,2087,239.578342117873
36421,25,25817,121,Tasa de exámenes médico legales por presunto delito sexual cuando la víctima está entre 18 y 28 años,2022,5,1,9845,10.1574403250381,1,4977,20.0924251557163,0,4868,0
36422,25,25823,81,"Tasa de exámenes médico legales por presunto delito sexual contra niños, niñas y adolescentes",2022,3,2,357,560.22408963585406,0,183,0,2,174,1149.42528735632
36423,25,25823,81,"Tasa de exámenes médico legales por presunto delito sexual contra niños, niñas y adolescentes",2022,4,1,362,276.243093922652,0,195,0,1,167,598.802395209581
36424,25,25839,81,"Tasa de exámenes médico legales por presunto delito sexual contra niños, niñas y adolescentes",2022,3,2,697,286.944045911047,1,357,280.112044817927,1,340,294.117647058824
36425,25,25839,81,"Tasa de exámenes médico legales por presunto delito sexual contra niños, niñas y adolescentes",2022,4,1,750,133.333333333333,1,389,257.06940874036,0,361,0
36426,25,25839,121,Tasa de exámenes médico legales por presunto delito sexual cuando la víctima está entre 18 y 28 años,2022,5,1,1528,65.4450261780105,0,1000,0,1,528,189.393939393939
36427,25,25841,81,"Tasa de exámenes médico legales por presunto delito sexual contra niños, niñas y adolescentes",2022,2,3,515,582.52427184466,2,300,666.666666666667,1,215,465.116279069767
36428,25,25841,81,"Tasa de exámenes médico legales por presunto delito sexual contra niños, niñas y adolescentes",2022,3,7,629,1112.87758346582,3,338,887.573964497041,4,291,1374.5704467354
36429,25,25841,121,Tasa de exámenes médico legales por presunto delito sexual cuando la víctima está entre 18 y 28 años,2022,5,1,1031,96.9932104752667,0,553,0,1,478,209.205020920502
36430,25,25845,81,"Tasa de exámenes médico legales por presunto delito sexual contra niños, niñas y adolescentes",2022,3,3,675,444.444444444444,1,341,293.255131964809,2,334,598.802395209581
36431,25,25845,81,"Tasa de exámenes médico legales por presunto delito sexual contra niños, niñas y adolescentes",2022,4,6,723,829.875518672199,1,367,272.479564032698,5,356,1404.49438202247
36432,25,25851,81,"Tasa de exámenes médico legales por presunto delito sexual contra niños, niñas y adolescentes",2022,4,1,359,278.551532033426,0,180,0,1,179,558.659217877095
36433,25,25851,121,Tasa de exámenes médico legales por presunto delito sexual cuando la víctima está entre 18 y 28 años,2022,5,1,610,163.934426229508,0,326,0,1,284,352.112676056338
36434,25,25506,81,"Tasa de exámenes médico legales por presunto delito sexual contra niños, niñas y adolescentes",2022,2,1,353,283.28611898017,0,176,0,1,177,564.971751412429
36435,25,25506,81,"Tasa de exámenes médico legales por presunto delito sexual contra niños, niñas y adolescentes",2022,3,4,404,990.09900990099,0,212,0,4,192,2083.33333333333
36436,25,25506,81,"Tasa de exámenes médico legales por presunto delito sexual contra niños, niñas y adolescentes",2022,4,1,405,246.913580246914,0,224,0,1,181,552.486187845304
36437,25,25862,81,"Tasa de exámenes médico legales por presunto delito sexual contra niños, niñas y adolescentes",2022,3,1,579,172.711571675302,1,297,336.700336700337,0,282,0
36438,25,25862,81,"Tasa de exámenes médico legales por presunto delito sexual contra niños, niñas y adolescentes",2022,4,4,570,701.754385964912,0,298,0,4,272,1470.58823529412
36439,25,25862,121,Tasa de exámenes médico legales por presunto delito sexual cuando la víctima está entre 18 y 28 años,2022,5,1,878,113.895216400911,0,462,0,1,416,240.384615384615
36440,25,25843,81,"Tasa de exámenes médico legales por presunto delito sexual contra niños, niñas y adolescentes",2022,2,7,3931,178.071737471381,1,2043,48.9476260401371,6,1888,317.796610169492
36441,25,25843,81,"Tasa de exámenes médico legales por presunto delito sexual contra niños, niñas y adolescentes",2022,3,5,4756,105.130361648444,0,2403,0,5,2353,212.494687632809
36442,25,25843,81,"Tasa de exámenes médico legales por presunto delito sexual contra niños, niñas y adolescentes",2022,4,11,4734,232.361639205746,0,2346,0,11,2388,460.636515912898
36443,25,25843,121,Tasa de exámenes médico legales por presunto delito sexual cuando la víctima está entre 18 y 28 años,2022,5,11,9175,119.891008174387,0,4526,0,11,4649,236.610023661002
36444,25,25873,81,"Tasa de exámenes médico legales por presunto delito sexual contra niños, niñas y adolescentes",2022,2,1,1704,58.6854460093897,0,849,0,1,855,116.959064327485
36445,25,25873,81,"Tasa de exámenes médico legales por presunto delito sexual contra niños, niñas y adolescentes",2022,3,2,2050,97.5609756097561,0,1040,0,2,1010,198.019801980198
36446,25,25873,81,"Tasa de exámenes médico legales por presunto delito sexual contra niños, niñas y adolescentes",2022,4,5,2022,247.279920870425,0,1064,0,5,958,521.920668058455
36447,25,25875,81,"Tasa de exámenes médico legales por presunto delito sexual contra niños, niñas y adolescentes",2022,2,2,1980,101.010101010101,0,1007,0,2,973,205.549845837616
36448,25,25875,81,"Tasa de exámenes médico legales por presunto delito sexual contra niños, niñas y adolescentes",2022,3,14,2490,562.248995983936,0,1277,0,14,1213,1154.16323165705
36449,25,25875,81,"Tasa de exámenes médico legales por presunto delito sexual contra niños, niñas y adolescentes",2022,4,12,2587,463.857750289911,0,1350,0,12,1237,970.088924818108
36450,25,25875,121,Tasa de exámenes médico legales por presunto delito sexual cuando la víctima está entre 18 y 28 años,2022,5,3,4878,61.5006150061501,0,2473,0,3,2405,124.740124740125
36451,25,25878,81,"Tasa de exámenes médico legales por presunto delito sexual contra niños, niñas y adolescentes",2022,2,1,956,104.602510460251,0,463,0,1,493,202.839756592292
36452,25,25878,81,"Tasa de exámenes médico legales por presunto delito sexual contra niños, niñas y adolescentes",2022,3,8,1253,638.467677573823,1,629,158.982511923688,7,624,1121.79487179487
36453,25,25878,81,"Tasa de exámenes médico legales por presunto delito sexual contra niños, niñas y adolescentes",2022,4,8,1285,622.568093385214,1,675,148.148148148148,7,610,1147.54098360656
36454,25,25885,81,"Tasa de exámenes médico legales por presunto delito sexual contra niños, niñas y adolescentes",2022,3,1,1154,86.6551126516464,0,613,0,1,541,184.842883548983
36455,25,25885,81,"Tasa de exámenes médico legales por presunto delito sexual contra niños, niñas y adolescentes",2022,4,5,1158,431.778929188256,0,637,0,5,521,959.692898272553
36456,25,25898,81,"Tasa de exámenes médico legales por presunto delito sexual contra niños, niñas y adolescentes",2022,3,1,447,223.713646532438,1,246,406.50406504065,0,201,0
36457,25,25899,81,"Tasa de exámenes médico legales por presunto delito sexual contra niños, niñas y adolescentes",2022,2,8,11182,71.5435521373636,1,5756,17.3731758165393,7,5426,129.008477699963
36458,25,25899,81,"Tasa de exámenes médico legales por presunto delito sexual contra niños, niñas y adolescentes",2022,3,16,12880,124.223602484472,5,6563,76.1846716440652,11,6317,174.133291119202
36459,25,25899,81,"Tasa de exámenes médico legales por presunto delito sexual contra niños, niñas y adolescentes",2022,4,37,12934,286.067728467605,1,6510,15.3609831029186,36,6424,560.398505603985
36460,25,25899,121,Tasa de exámenes médico legales por presunto delito sexual cuando la víctima está entre 18 y 28 años,2022,5,8,29134,27.4593258735498,0,14566,0,8,14568,54.9148819330038
36461,94,94343,81,"Tasa de exámenes médico legales por presunto delito sexual contra niños, niñas y adolescentes",2022,4,1,1924,51.975051975052,0,1007,0,1,917,109.051254089422
36462,94,94001,81,"Tasa de exámenes médico legales por presunto delito sexual contra niños, niñas y adolescentes",2022,2,9,3804,236.593059936909,2,1945,102.827763496144,7,1859,376.546530392684
36463,94,94001,81,"Tasa de exámenes médico legales por presunto delito sexual contra niños, niñas y adolescentes",2022,3,12,4838,248.036378668871,3,2447,122.599100939926,9,2391,376.411543287327
36464,94,94001,81,"Tasa de exámenes médico legales por presunto delito sexual contra niños, niñas y adolescentes",2022,4,24,4822,497.71878888428,0,2438,0,24,2384,1006.71140939597
36465,94,94001,121,Tasa de exámenes médico legales por presunto delito sexual cuando la víctima está entre 18 y 28 años,2022,5,5,8051,62.1040864488883,0,4240,0,5,3811,131.199160325374
36466,94,94883,81,"Tasa de exámenes médico legales por presunto delito sexual contra niños, niñas y adolescentes",2022,4,1,310,322.58064516129,0,167,0,1,143,699.300699300699
36467,95,95015,81,"Tasa de exámenes médico legales por presunto delito sexual contra niños, niñas y adolescentes",2022,4,1,1169,85.5431993156544,0,624,0,1,545,183.48623853211
36468,95,95025,81,"Tasa de exámenes médico legales por presunto delito sexual contra niños, niñas y adolescentes",2022,2,1,1646,60.7533414337788,0,832,0,1,814,122.850122850123
36469,95,95025,81,"Tasa de exámenes médico legales por presunto delito sexual contra niños, niñas y adolescentes",2022,3,4,2166,184.672206832872,1,1097,91.1577028258888,3,1069,280.636108512629
36470,95,95025,81,"Tasa de exámenes médico legales por presunto delito sexual contra niños, niñas y adolescentes",2022,4,3,2212,135.623869801085,0,1181,0,3,1031,290.9796314258
36471,95,95025,121,Tasa de exámenes médico legales por presunto delito sexual cuando la víctima está entre 18 y 28 años,2022,5,1,2814,35.5366027007818,0,1500,0,1,1314,76.103500761035
36472,95,95200,81,"Tasa de exámenes médico legales por presunto delito sexual contra niños, niñas y adolescentes",2022,4,2,865,231.21387283237,0,438,0,2,427,468.384074941452
36473,95,95001,81,"Tasa de exámenes médico legales por presunto delito sexual contra niños, niñas y adolescentes",2022,2,8,5952,134.408602150538,1,3040,32.8947368421053,7,2912,240.384615384615
36474,95,95001,81,"Tasa de exámenes médico legales por presunto delito sexual contra niños, niñas y adolescentes",2022,3,22,6904,318.655851680185,6,3480,172.413793103448,16,3424,467.289719626168
36475,95,95001,81,"Tasa de exámenes médico legales por presunto delito sexual contra niños, niñas y adolescentes",2022,4,47,6832,687.939110070258,3,3493,85.8860578299456,44,3339,1317.75980832585
36476,95,95001,121,Tasa de exámenes médico legales por presunto delito sexual cuando la víctima está entre 18 y 28 años,2022,5,12,12676,94.6670874092774,1,6708,14.9075730471079,11,5968,184.316353887399
36477,41,41006,81,"Tasa de exámenes médico legales por presunto delito sexual contra niños, niñas y adolescentes",2022,2,3,2796,107.296137339056,0,1396,0,3,1400,214.285714285714
36478,41,41006,81,"Tasa de exámenes médico legales por presunto delito sexual contra niños, niñas y adolescentes",2022,3,5,3416,146.370023419204,0,1710,0,5,1706,293.083235638921
36479,41,41006,81,"Tasa de exámenes médico legales por presunto delito sexual contra niños, niñas y adolescentes",2022,4,6,3286,182.592818015825,0,1676,0,6,1610,372.670807453416
36480,41,41006,121,Tasa de exámenes médico legales por presunto delito sexual cuando la víctima está entre 18 y 28 años,2022,5,1,4938,20.2511138112596,0,2519,0,1,2419,41.3393964448119
36481,41,41013,81,"Tasa de exámenes médico legales por presunto delito sexual contra niños, niñas y adolescentes",2022,4,5,1057,473.036896877957,1,531,188.323917137476,4,526,760.456273764259
36482,41,41016,81,"Tasa de exámenes médico legales por presunto delito sexual contra niños, niñas y adolescentes",2022,3,3,1944,154.320987654321,2,967,206.825232678387,1,977,102.354145342886
36483,41,41016,81,"Tasa de exámenes médico legales por presunto delito sexual contra niños, niñas y adolescentes",2022,4,5,1855,269.541778975741,0,934,0,5,921,542.888165038002
36484,41,41016,121,Tasa de exámenes médico legales por presunto delito sexual cuando la víctima está entre 18 y 28 años,2022,5,4,2985,134.003350083752,1,1464,68.3060109289618,3,1521,197.23865877712
36485,41,41020,81,"Tasa de exámenes médico legales por presunto delito sexual contra niños, niñas y adolescentes",2022,2,2,2001,99.9500249875062,0,994,0,2,1007,198.609731876862
36486,41,41020,81,"Tasa de exámenes médico legales por presunto delito sexual contra niños, niñas y adolescentes",2022,3,5,2697,185.391175380052,1,1366,73.2064421669107,4,1331,300.525920360631
36487,41,41020,81,"Tasa de exámenes médico legales por presunto delito sexual contra niños, niñas y adolescentes",2022,4,21,2834,741.002117148906,1,1503,66.5335994677312,20,1331,1502.62960180316
36488,41,41020,121,Tasa de exámenes médico legales por presunto delito sexual cuando la víctima está entre 18 y 28 años,2022,5,2,4343,46.0511167395809,0,2330,0,2,2013,99.3541977148535
36489,41,41026,81,"Tasa de exámenes médico legales por presunto delito sexual contra niños, niñas y adolescentes",2022,4,5,452,1106.19469026549,0,244,0,5,208,2403.84615384615
36490,41,41078,81,"Tasa de exámenes médico legales por presunto delito sexual contra niños, niñas y adolescentes",2022,3,2,868,230.414746543779,0,446,0,2,422,473.9336492891
36491,41,41078,81,"Tasa de exámenes médico legales por presunto delito sexual contra niños, niñas y adolescentes",2022,4,1,1020,98.0392156862745,0,541,0,1,479,208.768267223382
36492,41,41078,121,Tasa de exámenes médico legales por presunto delito sexual cuando la víctima está entre 18 y 28 años,2022,5,1,1672,59.8086124401914,0,1024,0,1,648,154.320987654321
36493,41,41132,81,"Tasa de exámenes médico legales por presunto delito sexual contra niños, niñas y adolescentes",2022,2,2,2723,73.4484024972457,1,1404,71.2250712250712,1,1319,75.8150113722517
36494,41,41132,81,"Tasa de exámenes médico legales por presunto delito sexual contra niños, niñas y adolescentes",2022,3,12,3350,358.208955223881,0,1731,0,12,1619,741.198270537369
36495,41,41132,81,"Tasa de exámenes médico legales por presunto delito sexual contra niños, niñas y adolescentes",2022,4,12,3329,360.468609191949,0,1712,0,12,1617,742.115027829314
36496,41,41132,121,Tasa de exámenes médico legales por presunto delito sexual cuando la víctima está entre 18 y 28 años,2022,5,5,5670,88.1834215167548,0,2859,0,5,2811,177.872643187478
36497,41,41206,81,"Tasa de exámenes médico legales por presunto delito sexual contra niños, niñas y adolescentes",2022,3,3,822,364.963503649635,0,434,0,3,388,773.19587628866
36498,41,41206,81,"Tasa de exámenes médico legales por presunto delito sexual contra niños, niñas y adolescentes",2022,4,3,763,393.184796854522,0,423,0,3,340,882.352941176471
36499,41,41244,81,"Tasa de exámenes médico legales por presunto delito sexual contra niños, niñas y adolescentes",2022,3,1,466,214.592274678112,0,226,0,1,240,416.666666666667
36500,41,41298,81,"Tasa de exámenes médico legales por presunto delito sexual contra niños, niñas y adolescentes",2022,2,1,6939,14.4112984579911,0,3533,0,1,3406,29.3599530240752
36501,41,41298,81,"Tasa de exámenes médico legales por presunto delito sexual contra niños, niñas y adolescentes",2022,3,9,8522,105.609011969021,0,4346,0,9,4176,215.51724137931
36502,41,41298,81,"Tasa de exámenes médico legales por presunto delito sexual contra niños, niñas y adolescentes",2022,4,22,8488,259.189443920829,2,4399,45.4648783814503,20,4089,489.117143555882
36503,41,41298,121,Tasa de exámenes médico legales por presunto delito sexual cuando la víctima está entre 18 y 28 años,2022,5,8,13865,57.6992426974396,0,7072,0,8,6793,117.768290887679
36504,41,41306,81,"Tasa de exámenes médico legales por presunto delito sexual contra niños, niñas y adolescentes",2022,2,1,2097,47.6871721506915,0,1047,0,1,1050,95.2380952380952
36505,41,41306,81,"Tasa de exámenes médico legales por presunto delito sexual contra niños, niñas y adolescentes",2022,3,3,2764,108.538350217077,0,1341,0,3,1423,210.822206605762
36506,41,41306,81,"Tasa de exámenes médico legales por presunto delito sexual contra niños, niñas y adolescentes",2022,4,6,2863,209.570380719525,0,1390,0,6,1473,407.331975560081
36507,41,41306,121,Tasa de exámenes médico legales por presunto delito sexual cuando la víctima está entre 18 y 28 años,2022,5,2,4427,45.1773209848656,2,2219,90.1306894997747,0,2208,0
36508,41,41319,81,"Tasa de exámenes médico legales por presunto delito sexual contra niños, niñas y adolescentes",2022,2,1,1827,54.7345374931582,0,902,0,1,925,108.108108108108
36509,41,41319,81,"Tasa de exámenes médico legales por presunto delito sexual contra niños, niñas y adolescentes",2022,3,3,2244,133.689839572193,0,1129,0,3,1115,269.058295964126
36510,41,41319,81,"Tasa de exámenes médico legales por presunto delito sexual contra niños, niñas y adolescentes",2022,4,4,2181,183.402109124255,1,1127,88.7311446317658,3,1054,284.629981024668
36511,41,41349,81,"Tasa de exámenes médico legales por presunto delito sexual contra niños, niñas y adolescentes",2022,4,4,827,483.675937122128,0,430,0,4,397,1007.55667506297
36512,41,41357,81,"Tasa de exámenes médico legales por presunto delito sexual contra niños, niñas y adolescentes",2022,2,1,1026,97.4658869395711,0,513,0,1,513,194.931773879142
36513,41,41357,81,"Tasa de exámenes médico legales por presunto delito sexual contra niños, niñas y adolescentes",2022,3,1,1175,85.1063829787234,0,595,0,1,580,172.413793103448
36514,41,41357,81,"Tasa de exámenes médico legales por presunto delito sexual contra niños, niñas y adolescentes",2022,4,7,1099,636.942675159236,1,572,174.825174825175,6,527,1138.51992409867
36515,41,41359,81,"Tasa de exámenes médico legales por presunto delito sexual contra niños, niñas y adolescentes",2022,3,7,2882,242.886884108258,0,1443,0,7,1439,486.448922863099
36516,41,41359,81,"Tasa de exámenes médico legales por presunto delito sexual contra niños, niñas y adolescentes",2022,4,6,2925,205.128205128205,0,1502,0,6,1423,421.644413211525
36517,41,41359,121,Tasa de exámenes médico legales por presunto delito sexual cuando la víctima está entre 18 y 28 años,2022,5,1,5047,19.8137507430157,0,2573,0,1,2474,40.4203718674212
36518,41,41378,81,"Tasa de exámenes médico legales por presunto delito sexual contra niños, niñas y adolescentes",2022,4,3,1596,187.96992481203,1,818,122.249388753056,2,778,257.06940874036
36519,41,41378,121,Tasa de exámenes médico legales por presunto delito sexual cuando la víctima está entre 18 y 28 años,2022,5,1,2446,40.8830744071954,0,1208,0,1,1238,80.7754442649435
36520,41,41396,81,"Tasa de exámenes médico legales por presunto delito sexual contra niños, niñas y adolescentes",2022,2,2,6767,29.5551943254027,0,3471,0,2,3296,60.6796116504854
36521,41,41396,81,"Tasa de exámenes médico legales por presunto delito sexual contra niños, niñas y adolescentes",2022,3,17,7900,215.189873417722,3,4042,74.220682830282,14,3858,362.882322446864
36522,41,41396,81,"Tasa de exámenes médico legales por presunto delito sexual contra niños, niñas y adolescentes",2022,4,26,7409,350.924551221487,0,3807,0,26,3602,721.821210438645
36523,41,41396,121,Tasa de exámenes médico legales por presunto delito sexual cuando la víctima está entre 18 y 28 años,2022,5,7,11839,59.1266154236,0,6049,0,7,5790,120.898100172712
36524,41,41483,81,"Tasa de exámenes médico legales por presunto delito sexual contra niños, niñas y adolescentes",2022,4,1,773,129.366106080207,0,394,0,1,379,263.852242744063
36525,41,41001,81,"Tasa de exámenes médico legales por presunto delito sexual contra niños, niñas y adolescentes",2022,2,41,31149,131.625413335902,8,15999,50.0031251953247,33,15150,217.821782178218
36526,41,41001,81,"Tasa de exámenes médico legales por presunto delito sexual contra niños, niñas y adolescentes",2022,3,82,36669,223.622133136982,13,18728,69.4147800085434,69,17941,384.593946825706
36527,41,41001,81,"Tasa de exámenes médico legales por presunto delito sexual contra niños, niñas y adolescentes",2022,4,149,35824,415.92228673515,12,18169,66.0465628267929,137,17655,775.984140470122
36528,41,41001,121,Tasa de exámenes médico legales por presunto delito sexual cuando la víctima está entre 18 y 28 años,2022,5,44,68185,64.5303219183105,5,33861,14.7662502584094,39,34324,113.623120848386
36529,41,41503,81,"Tasa de exámenes médico legales por presunto delito sexual contra niños, niñas y adolescentes",2022,2,1,1448,69.060773480663,0,715,0,1,733,136.425648021828
36530,41,41503,81,"Tasa de exámenes médico legales por presunto delito sexual contra niños, niñas y adolescentes",2022,3,2,1662,120.336943441637,0,837,0,2,825,242.424242424242
36531,41,41503,81,"Tasa de exámenes médico legales por presunto delito sexual contra niños, niñas y adolescentes",2022,4,2,1528,130.890052356021,0,774,0,2,754,265.25198938992
36532,41,41503,121,Tasa de exámenes médico legales por presunto delito sexual cuando la víctima está entre 18 y 28 años,2022,5,1,2246,44.5235975066785,0,1128,0,1,1118,89.4454382826476
36533,41,41518,81,"Tasa de exámenes médico legales por presunto delito sexual contra niños, niñas y adolescentes",2022,2,1,630,158.730158730159,0,336,0,1,294,340.136054421769
36534,41,41518,81,"Tasa de exámenes médico legales por presunto delito sexual contra niños, niñas y adolescentes",2022,4,1,798,125.31328320802,0,419,0,1,379,263.852242744063
36535,41,41524,81,"Tasa de exámenes médico legales por presunto delito sexual contra niños, niñas y adolescentes",2022,2,4,2435,164.271047227926,0,1264,0,4,1171,341.588385994876
36536,41,41524,81,"Tasa de exámenes médico legales por presunto delito sexual contra niños, niñas y adolescentes",2022,3,10,2846,351.370344342937,1,1464,68.3060109289618,9,1382,651.23010130246
36537,41,41524,81,"Tasa de exámenes médico legales por presunto delito sexual contra niños, niñas y adolescentes",2022,4,11,2747,400.436840189297,1,1407,71.0732054015636,10,1340,746.268656716418
36538,41,41524,121,Tasa de exámenes médico legales por presunto delito sexual cuando la víctima está entre 18 y 28 años,2022,5,2,4903,40.7913522333265,0,2504,0,2,2399,83.3680700291788
36539,41,41530,81,"Tasa de exámenes médico legales por presunto delito sexual contra niños, niñas y adolescentes",2022,3,2,1373,145.666423889294,0,717,0,2,656,304.878048780488
36540,41,41530,81,"Tasa de exámenes médico legales por presunto delito sexual contra niños, niñas y adolescentes",2022,4,1,1253,79.8084596967279,0,635,0,1,618,161.812297734628
36541,41,41530,121,Tasa de exámenes médico legales por presunto delito sexual cuando la víctima está entre 18 y 28 años,2022,5,1,2188,45.7038391224863,0,1096,0,1,1092,91.5750915750916
36542,41,41548,81,"Tasa de exámenes médico legales por presunto delito sexual contra niños, niñas y adolescentes",2022,3,5,1827,273.672687465791,0,932,0,5,895,558.659217877095
36543,41,41548,81,"Tasa de exámenes médico legales por presunto delito sexual contra niños, niñas y adolescentes",2022,4,10,1624,615.76354679803,2,835,239.520958083832,8,789,1013.94169835234
36544,41,41548,121,Tasa de exámenes médico legales por presunto delito sexual cuando la víctima está entre 18 y 28 años,2022,5,2,2492,80.2568218298555,0,1237,0,2,1255,159.362549800797
36545,41,41551,81,"Tasa de exámenes médico legales por presunto delito sexual contra niños, niñas y adolescentes",2022,2,8,11816,67.7048070412999,1,6094,16.4095831965868,7,5722,122.33484795526
36546,41,41551,81,"Tasa de exámenes médico legales por presunto delito sexual contra niños, niñas y adolescentes",2022,3,27,14430,187.110187110187,4,7351,54.4143653924636,23,7079,324.904647549089
36547,41,41551,81,"Tasa de exámenes médico legales por presunto delito sexual contra niños, niñas y adolescentes",2022,4,31,14549,213.073063440786,3,7357,40.7774908250646,28,7192,389.321468298109
36548,41,41551,121,Tasa de exámenes médico legales por presunto delito sexual cuando la víctima está entre 18 y 28 años,2022,5,8,25867,30.9274365021069,0,13052,0,8,12815,62.4268435427234
36549,41,41615,81,"Tasa de exámenes médico legales por presunto delito sexual contra niños, niñas y adolescentes",2022,2,3,1992,150.602409638554,0,1034,0,3,958,313.152400835073
36550,41,41615,81,"Tasa de exámenes médico legales por presunto delito sexual contra niños, niñas y adolescentes",2022,3,8,2423,330.169211721007,0,1261,0,8,1162,688.468158347676
36551,41,41615,81,"Tasa de exámenes médico legales por presunto delito sexual contra niños, niñas y adolescentes",2022,4,16,2498,640.512409927942,1,1339,74.6825989544436,15,1159,1294.21915444349
36552,41,41615,121,Tasa de exámenes médico legales por presunto delito sexual cuando la víctima está entre 18 y 28 años,2022,5,4,4999,80.0160032006401,2,2853,70.1016473887136,2,2146,93.1966449207828
36553,41,41660,81,"Tasa de exámenes médico legales por presunto delito sexual contra niños, niñas y adolescentes",2022,3,2,1443,138.600138600139,0,765,0,2,678,294.985250737463
36554,41,41660,81,"Tasa de exámenes médico legales por presunto delito sexual contra niños, niñas y adolescentes",2022,4,4,1324,302.114803625378,1,701,142.65335235378,3,623,481.540930979133
36555,41,41660,121,Tasa de exámenes médico legales por presunto delito sexual cuando la víctima está entre 18 y 28 años,2022,5,2,1980,101.010101010101,0,968,0,2,1012,197.628458498024
36556,41,41668,81,"Tasa de exámenes médico legales por presunto delito sexual contra niños, niñas y adolescentes",2022,2,2,3076,65.0195058517555,0,1610,0,2,1466,136.425648021828
36557,41,41668,81,"Tasa de exámenes médico legales por presunto delito sexual contra niños, niñas y adolescentes",2022,3,5,3605,138.69625520111,1,1877,53.276505061268,4,1728,231.481481481481
36558,41,41668,81,"Tasa de exámenes médico legales por presunto delito sexual contra niños, niñas y adolescentes",2022,4,10,3524,283.768444948922,1,1822,54.8847420417124,9,1702,528.789659224442
36559,41,41668,121,Tasa de exámenes médico legales por presunto delito sexual cuando la víctima está entre 18 y 28 años,2022,5,2,6560,30.4878048780488,0,3378,0,2,3182,62.8535512256443
36560,41,41676,81,"Tasa de exámenes médico legales por presunto delito sexual contra niños, niñas y adolescentes",2022,3,2,1301,153.727901614143,1,655,152.671755725191,1,646,154.798761609907
36561,41,41676,81,"Tasa de exámenes médico legales por presunto delito sexual contra niños, niñas y adolescentes",2022,4,11,1164,945.017182130584,1,609,164.203612479475,10,555,1801.8018018018
36562,41,41676,121,Tasa de exámenes médico legales por presunto delito sexual cuando la víctima está entre 18 y 28 años,2022,5,1,1913,52.2739153162572,0,970,0,1,943,106.044538706257
36563,41,41770,81,"Tasa de exámenes médico legales por presunto delito sexual contra niños, niñas y adolescentes",2022,2,3,2449,122.498979175174,3,1275,235.294117647059,0,1174,0
36564,41,41770,81,"Tasa de exámenes médico legales por presunto delito sexual contra niños, niñas y adolescentes",2022,3,5,2769,180.570603105814,0,1417,0,5,1352,369.822485207101
36565,41,41770,81,"Tasa de exámenes médico legales por presunto delito sexual contra niños, niñas y adolescentes",2022,4,5,2546,196.386488609584,0,1297,0,5,1249,400.320256204964
36566,41,41770,121,Tasa de exámenes médico legales por presunto delito sexual cuando la víctima está entre 18 y 28 años,2022,5,1,4175,23.9520958083832,0,2090,0,1,2085,47.9616306954436
36567,41,41791,81,"Tasa de exámenes médico legales por presunto delito sexual contra niños, niñas y adolescentes",2022,4,5,2210,226.244343891403,1,1137,87.9507475813544,4,1073,372.786579683131
36568,41,41791,121,Tasa de exámenes médico legales por presunto delito sexual cuando la víctima está entre 18 y 28 años,2022,5,1,3384,29.5508274231678,0,1760,0,1,1624,61.576354679803
36569,41,41799,81,"Tasa de exámenes médico legales por presunto delito sexual contra niños, niñas y adolescentes",2022,3,1,1384,72.2543352601156,0,740,0,1,644,155.27950310559
36570,41,41799,81,"Tasa de exámenes médico legales por presunto delito sexual contra niños, niñas y adolescentes",2022,4,2,1372,145.772594752187,0,727,0,2,645,310.077519379845
36571,41,41801,81,"Tasa de exámenes médico legales por presunto delito sexual contra niños, niñas y adolescentes",2022,3,2,927,215.749730312837,0,487,0,2,440,454.545454545455
36572,41,41801,81,"Tasa de exámenes médico legales por presunto delito sexual contra niños, niñas y adolescentes",2022,4,2,869,230.149597238205,0,454,0,2,415,481.927710843374
36573,41,41797,81,"Tasa de exámenes médico legales por presunto delito sexual contra niños, niñas y adolescentes",2022,2,1,1021,97.9431929480901,0,537,0,1,484,206.611570247934
36574,41,41797,81,"Tasa de exámenes médico legales por presunto delito sexual contra niños, niñas y adolescentes",2022,3,4,1229,325.46786004882,0,641,0,4,588,680.272108843537
36575,41,41797,81,"Tasa de exámenes médico legales por presunto delito sexual contra niños, niñas y adolescentes",2022,4,2,1193,167.644593461861,0,620,0,2,573,349.040139616056
36576,41,41797,121,Tasa de exámenes médico legales por presunto delito sexual cuando la víctima está entre 18 y 28 años,2022,5,1,1919,52.1104742053153,0,989,0,1,930,107.52688172043
36577,41,41807,81,"Tasa de exámenes médico legales por presunto delito sexual contra niños, niñas y adolescentes",2022,4,3,2497,120.144173007609,0,1317,0,3,1180,254.237288135593
36578,41,41872,81,"Tasa de exámenes médico legales por presunto delito sexual contra niños, niñas y adolescentes",2022,3,2,709,282.087447108604,0,372,0,2,337,593.471810089021
36579,41,41872,81,"Tasa de exámenes médico legales por presunto delito sexual contra niños, niñas y adolescentes",2022,4,2,643,311.04199066874,0,340,0,2,303,660.06600660066
36580,41,41872,121,Tasa de exámenes médico legales por presunto delito sexual cuando la víctima está entre 18 y 28 años,2022,5,1,1211,82.5763831544178,0,604,0,1,607,164.744645799012
36581,41,41885,81,"Tasa de exámenes médico legales por presunto delito sexual contra niños, niñas y adolescentes",2022,3,2,758,263.852242744063,0,388,0,2,370,540.540540540541
36582,41,41885,81,"Tasa de exámenes médico legales por presunto delito sexual contra niños, niñas y adolescentes",2022,4,3,756,396.825396825397,0,399,0,3,357,840.336134453781
36583,44,44035,81,"Tasa de exámenes médico legales por presunto delito sexual contra niños, niñas y adolescentes",2022,2,1,3806,26.2743037309511,0,1917,0,1,1889,52.9380624669137
36584,44,44035,81,"Tasa de exámenes médico legales por presunto delito sexual contra niños, niñas y adolescentes",2022,3,6,4627,129.673654635833,0,2291,0,6,2336,256.849315068493
36585,44,44035,81,"Tasa de exámenes médico legales por presunto delito sexual contra niños, niñas y adolescentes",2022,4,4,4376,91.4076782449726,0,2205,0,4,2171,184.246890833717
36586,44,44035,121,Tasa de exámenes médico legales por presunto delito sexual cuando la víctima está entre 18 y 28 años,2022,5,2,7686,26.0213374967473,0,4023,0,2,3663,54.6000546000546
36587,44,44078,81,"Tasa de exámenes médico legales por presunto delito sexual contra niños, niñas y adolescentes",2022,2,1,4250,23.5294117647059,0,2181,0,1,2069,48.3325277912035
36588,44,44078,81,"Tasa de exámenes médico legales por presunto delito sexual contra niños, niñas y adolescentes",2022,3,1,5239,19.0876121397213,0,2716,0,1,2523,39.6353547364249
36589,44,44078,81,"Tasa de exámenes médico legales por presunto delito sexual contra niños, niñas y adolescentes",2022,4,2,5008,39.936102236421704,0,2601,0,2,2407,83.0909846281678
36590,44,44090,81,"Tasa de exámenes médico legales por presunto delito sexual contra niños, niñas y adolescentes",2022,2,2,4994,40.048057669203,0,2526,0,2,2468,81.0372771474878
36591,44,44090,81,"Tasa de exámenes médico legales por presunto delito sexual contra niños, niñas y adolescentes",2022,3,4,6315,63.341250989707,0,3314,0,4,3001,133.288903698767
36592,44,44090,81,"Tasa de exámenes médico legales por presunto delito sexual contra niños, niñas y adolescentes",2022,4,13,5882,221.013260795648,1,3194,31.3087038196619,12,2688,446.428571428571
36593,44,44090,121,Tasa de exámenes médico legales por presunto delito sexual cuando la víctima está entre 18 y 28 años,2022,5,3,9194,32.6299760713509,0,4721,0,3,4473,67.0690811535882
36594,44,44098,81,"Tasa de exámenes médico legales por presunto delito sexual contra niños, niñas y adolescentes",2022,4,2,1644,121.654501216545,0,857,0,2,787,254.129606099111
36595,44,44110,81,"Tasa de exámenes médico legales por presunto delito sexual contra niños, niñas y adolescentes",2022,2,1,658,151.975683890577,0,331,0,1,327,305.810397553517
36596,44,44110,81,"Tasa de exámenes médico legales por presunto delito sexual contra niños, niñas y adolescentes",2022,3,1,860,116.279069767442,1,446,224.215246636771,0,414,0
36597,44,44110,81,"Tasa de exámenes médico legales por presunto delito sexual contra niños, niñas y adolescentes",2022,4,2,828,241.545893719807,0,437,0,2,391,511.50895140665
36598,44,44279,81,"Tasa de exámenes médico legales por presunto delito sexual contra niños, niñas y adolescentes",2022,3,4,6220,64.3086816720257,0,3213,0,4,3007,133.022946458264
36599,44,44279,81,"Tasa de exámenes médico legales por presunto delito sexual contra niños, niñas y adolescentes",2022,4,14,5294,264.450321118247,0,2737,0,14,2557,547.516621040282
36600,44,44279,121,Tasa de exámenes médico legales por presunto delito sexual cuando la víctima está entre 18 y 28 años,2022,5,2,9632,20.7641196013289,0,4728,0,2,4904,40.7830342577488
36601,44,44378,81,"Tasa de exámenes médico legales por presunto delito sexual contra niños, niñas y adolescentes",2022,4,2,2897,69.0369347600966,0,1464,0,2,1433,139.567341242149
36602,44,44420,81,"Tasa de exámenes médico legales por presunto delito sexual contra niños, niñas y adolescentes",2022,3,1,500,200,0,249,0,1,251,398.406374501992
36603,44,44430,81,"Tasa de exámenes médico legales por presunto delito sexual contra niños, niñas y adolescentes",2022,2,11,22341,49.2368291482029,2,11533,17.3415416630538,9,10808,83.2716506291636
36604,44,44430,81,"Tasa de exámenes médico legales por presunto delito sexual contra niños, niñas y adolescentes",2022,3,28,26595,105.282947922542,8,13676,58.4966364434045,20,12919,154.810743865624
36605,44,44430,81,"Tasa de exámenes médico legales por presunto delito sexual contra niños, niñas y adolescentes",2022,4,46,23592,194.981349610037,4,11998,33.3388898149692,42,11594,362.256339485941
36606,44,44430,121,Tasa de exámenes médico legales por presunto delito sexual cuando la víctima está entre 18 y 28 años,2022,5,7,40648,17.2210194843535,0,19777,0,7,20871,33.5393608356092
36607,44,44560,81,"Tasa de exámenes médico legales por presunto delito sexual contra niños, niñas y adolescentes",2022,2,1,13000,7.69230769230769,1,6684,14.9611011370437,0,6316,0
36608,44,44560,81,"Tasa de exámenes médico legales por presunto delito sexual contra niños, niñas y adolescentes",2022,3,4,15279,26.1797238039139,0,7784,0,4,7495,53.3689126084056
36609,44,44560,81,"Tasa de exámenes médico legales por presunto delito sexual contra niños, niñas y adolescentes",2022,4,5,13186,37.9190050053087,0,6598,0,5,6588,75.8955676988464
36610,44,44560,121,Tasa de exámenes médico legales por presunto delito sexual cuando la víctima está entre 18 y 28 años,2022,5,1,19202,5.20779085511926,0,9372,0,1,9830,10.1729399796541
36611,44,44001,81,"Tasa de exámenes médico legales por presunto delito sexual contra niños, niñas y adolescentes",2022,2,8,24260,32.9760923330585,1,12295,8.13338755591704,7,11965,58.503969912244
36612,44,44001,81,"Tasa de exámenes médico legales por presunto delito sexual contra niños, niñas y adolescentes",2022,3,27,28571,94.5014175212628,3,14446,20.7669943236882,24,14125,169.911504424779
36613,44,44001,81,"Tasa de exámenes médico legales por presunto delito sexual contra niños, niñas y adolescentes",2022,4,61,25032,243.688079258549,3,12598,23.8133036989998,58,12434,466.462924239987
36614,44,44001,121,Tasa de exámenes médico legales por presunto delito sexual cuando la víctima está entre 18 y 28 años,2022,5,12,44694,26.8492415089274,1,21758,4.59601066274474,11,22936,47.95953958842
36615,44,44650,81,"Tasa de exámenes médico legales por presunto delito sexual contra niños, niñas y adolescentes",2022,3,8,5931,134.884505142472,2,3016,66.3129973474801,6,2915,205.831903945111
36616,44,44650,81,"Tasa de exámenes médico legales por presunto delito sexual contra niños, niñas y adolescentes",2022,4,5,5732,87.2295882763433,0,2931,0,5,2801,178.507675830061
36617,44,44650,121,Tasa de exámenes médico legales por presunto delito sexual cuando la víctima está entre 18 y 28 años,2022,5,2,10437,19.1625946153109,1,5214,19.1791331031837,1,5223,19.146084625694
36618,44,44847,81,"Tasa de exámenes médico legales por presunto delito sexual contra niños, niñas y adolescentes",2022,3,2,25503,7.84221464141474,2,13044,15.3327200245324,0,12459,0
36619,44,44847,81,"Tasa de exámenes médico legales por presunto delito sexual contra niños, niñas y adolescentes",2022,4,11,25069,43.8788942518649,0,12365,0,11,12704,86.5869017632242
36620,44,44847,121,Tasa de exámenes médico legales por presunto delito sexual cuando la víctima está entre 18 y 28 años,2022,5,3,40854,7.34322220590395,0,20006,0,3,20848,14.3898695318496
36621,44,44855,81,"Tasa de exámenes médico legales por presunto delito sexual contra niños, niñas y adolescentes",2022,3,1,1382,72.3589001447178,0,688,0,1,694,144.092219020173
36622,44,44855,81,"Tasa de exámenes médico legales por presunto delito sexual contra niños, niñas y adolescentes",2022,4,6,1310,458.015267175573,0,623,0,6,687,873.362445414847
36623,44,44874,81,"Tasa de exámenes médico legales por presunto delito sexual contra niños, niñas y adolescentes",2022,3,2,3874,51.6262261228704,0,1925,0,2,1949,102.616726526424
36624,44,44874,81,"Tasa de exámenes médico legales por presunto delito sexual contra niños, niñas y adolescentes",2022,4,3,3509,85.494442861214,0,1764,0,3,1745,171.919770773639
36625,47,47030,81,"Tasa de exámenes médico legales por presunto delito sexual contra niños, niñas y adolescentes",2022,4,1,2178,45.9136822773186,0,1139,0,1,1039,96.2463907603465
36626,47,47053,81,"Tasa de exámenes médico legales por presunto delito sexual contra niños, niñas y adolescentes",2022,2,2,4262,46.9263256687001,0,2225,0,2,2037,98.1836033382425
36627,47,47053,81,"Tasa de exámenes médico legales por presunto delito sexual contra niños, niñas y adolescentes",2022,3,1,5420,18.450184501845,0,2803,0,1,2617,38.2116927779901
36628,47,47053,81,"Tasa de exámenes médico legales por presunto delito sexual contra niños, niñas y adolescentes",2022,4,4,5446,73.4484024972457,0,2827,0,4,2619,152.730049637266
36629,47,47053,121,Tasa de exámenes médico legales por presunto delito sexual cuando la víctima está entre 18 y 28 años,2022,5,3,8888,33.7533753375338,0,4615,0,3,4273,70.2082845775802
36630,47,47058,81,"Tasa de exámenes médico legales por presunto delito sexual contra niños, niñas y adolescentes",2022,3,3,3968,75.6048387096774,1,2040,49.0196078431373,2,1928,103.734439834025
36631,47,47058,81,"Tasa de exámenes médico legales por presunto delito sexual contra niños, niñas y adolescentes",2022,4,4,3865,103.492884864166,0,2008,0,4,1857,215.401184706516
36632,47,47058,81,"Tasa de exámenes médico legales por presunto delito sexual contra niños, niñas y adolescentes",2022,1,1,589,169.779286926995,1,299,334.448160535117,0,290,0
36633,47,47170,81,"Tasa de exámenes médico legales por presunto delito sexual contra niños, niñas y adolescentes",2022,3,2,2930,68.259385665529,0,1551,0,2,1379,145.032632342277
36634,47,47170,81,"Tasa de exámenes médico legales por presunto delito sexual contra niños, niñas y adolescentes",2022,4,2,2829,70.6963591375044,0,1504,0,2,1325,150.943396226415
36635,47,47189,81,"Tasa de exámenes médico legales por presunto delito sexual contra niños, niñas y adolescentes",2022,3,1,14414,6.93769945885944,0,7346,0,1,7068,14.1482739105829
36636,47,47189,81,"Tasa de exámenes médico legales por presunto delito sexual contra niños, niñas y adolescentes",2022,4,9,14878,60.49200161312,0,7700,0,9,7178,125.383115073837
36637,47,47189,121,Tasa de exámenes médico legales por presunto delito sexual cuando la víctima está entre 18 y 28 años,2022,5,3,25838,11.6108057899218,0,13219,0,3,12619,23.7736746176401
36638,47,47205,81,"Tasa de exámenes médico legales por presunto delito sexual contra niños, niñas y adolescentes",2022,3,1,1160,86.2068965517241,0,620,0,1,540,185.185185185185
36639,47,47245,81,"Tasa de exámenes médico legales por presunto delito sexual contra niños, niñas y adolescentes",2022,2,3,6883,43.5856457939852,0,3541,0,3,3342,89.7666068222621
36640,47,47245,81,"Tasa de exámenes médico legales por presunto delito sexual contra niños, niñas y adolescentes",2022,3,7,8687,80.58017727639,2,4440,45.045045045045,5,4247,117.730162467624
36641,47,47245,81,"Tasa de exámenes médico legales por presunto delito sexual contra niños, niñas y adolescentes",2022,4,14,8446,165.758939142789,0,4334,0,14,4112,340.466926070039
36642,47,47245,121,Tasa de exámenes médico legales por presunto delito sexual cuando la víctima está entre 18 y 28 años,2022,5,3,13246,22.648346670693,1,6840,14.6198830409357,2,6406,31.2207305650952
36643,47,47268,81,"Tasa de exámenes médico legales por presunto delito sexual contra niños, niñas y adolescentes",2022,2,2,2080,96.1538461538462,0,1087,0,2,993,201.409869083585
36644,47,47268,81,"Tasa de exámenes médico legales por presunto delito sexual contra niños, niñas y adolescentes",2022,3,2,2729,73.2869182850861,2,1430,139.86013986014,0,1299,0
36645,47,47268,81,"Tasa de exámenes médico legales por presunto delito sexual contra niños, niñas y adolescentes",2022,4,2,2774,72.0980533525595,0,1455,0,2,1319,151.630022744503
36646,47,47268,121,Tasa de exámenes médico legales por presunto delito sexual cuando la víctima está entre 18 y 28 años,2022,5,2,4328,46.2107208872458,0,2221,0,2,2107,94.921689606075
36647,47,47288,81,"Tasa de exámenes médico legales por presunto delito sexual contra niños, niñas y adolescentes",2022,3,3,8902,33.7002920691979,1,4543,22.0118864186661,2,4359,45.8820830465703
36648,47,47288,81,"Tasa de exámenes médico legales por presunto delito sexual contra niños, niñas y adolescentes",2022,4,6,8992,66.7259786476868,0,4608,0,6,4384,136.861313868613
36649,47,47288,121,Tasa de exámenes médico legales por presunto delito sexual cuando la víctima está entre 18 y 28 años,2022,5,3,13989,21.4454214025306,0,7078,0,3,6911,43.4090580234409
36650,47,47318,81,"Tasa de exámenes médico legales por presunto delito sexual contra niños, niñas y adolescentes",2022,4,1,3310,30.2114803625378,0,1781,0,1,1529,65.402223675605
36651,47,47460,81,"Tasa de exámenes médico legales por presunto delito sexual contra niños, niñas y adolescentes",2022,2,1,2202,45.4132606721163,0,1138,0,1,1064,93.984962406015
36652,47,47460,81,"Tasa de exámenes médico legales por presunto delito sexual contra niños, niñas y adolescentes",2022,3,2,2801,71.4030703320243,0,1451,0,2,1350,148.148148148148
36653,47,47460,81,"Tasa de exámenes médico legales por presunto delito sexual contra niños, niñas y adolescentes",2022,4,3,2685,111.731843575419,0,1399,0,3,1286,233.281493001555
36654,47,47551,81,"Tasa de exámenes médico legales por presunto delito sexual contra niños, niñas y adolescentes",2022,3,1,4428,22.583559168925,0,2258,0,1,2170,46.0829493087558
36655,47,47551,81,"Tasa de exámenes médico legales por presunto delito sexual contra niños, niñas y adolescentes",2022,4,2,4325,46.242774566474,0,2225,0,2,2100,95.2380952380952
36656,47,47551,121,Tasa de exámenes médico legales por presunto delito sexual cuando la víctima está entre 18 y 28 años,2022,5,2,6887,29.0402207056774,1,3571,28.0033604032484,1,3316,30.1568154402895
36657,47,47555,81,"Tasa de exámenes médico legales por presunto delito sexual contra niños, niñas y adolescentes",2022,2,3,6304,47.5888324873096,0,3140,0,3,3164,94.8166877370417
36658,47,47555,81,"Tasa de exámenes médico legales por presunto delito sexual contra niños, niñas y adolescentes",2022,3,4,8073,49.5478756348322,0,4073,0,4,4000,100
36659,47,47555,81,"Tasa de exámenes médico legales por presunto delito sexual contra niños, niñas y adolescentes",2022,4,24,7989,300.413067968457,0,4116,0,24,3873,619.674670797831
36660,47,47555,121,Tasa de exámenes médico legales por presunto delito sexual cuando la víctima está entre 18 y 28 años,2022,5,1,12663,7.89702282239596,0,6496,0,1,6167,16.215339711367
36661,47,47570,81,"Tasa de exámenes médico legales por presunto delito sexual contra niños, niñas y adolescentes",2022,3,2,3981,50.2386335091686,0,1959,0,2,2022,98.9119683481701
36662,47,47570,81,"Tasa de exámenes médico legales por presunto delito sexual contra niños, niñas y adolescentes",2022,4,2,3837,52.1240552514986,0,1910,0,2,1927,103.788271925272
36663,47,47605,81,"Tasa de exámenes médico legales por presunto delito sexual contra niños, niñas y adolescentes",2022,4,1,1278,78.2472613458529,0,672,0,1,606,165.016501650165
36664,47,47660,81,"Tasa de exámenes médico legales por presunto delito sexual contra niños, niñas y adolescentes",2022,4,2,2062,96.9932104752667,0,1114,0,2,948,210.970464135021
36665,47,47692,81,"Tasa de exámenes médico legales por presunto delito sexual contra niños, niñas y adolescentes",2022,4,4,2475,161.616161616162,0,1316,0,4,1159,345.125107851596
36666,47,47707,81,"Tasa de exámenes médico legales por presunto delito sexual contra niños, niñas y adolescentes",2022,4,2,3197,62.5586487331874,0,1688,0,2,1509,132.538104705103
36667,47,47720,81,"Tasa de exámenes médico legales por presunto delito sexual contra niños, niñas y adolescentes",2022,4,1,1339,74.6825989544436,0,696,0,1,643,155.52099533437
36668,47,47001,81,"Tasa de exámenes médico legales por presunto delito sexual contra niños, niñas y adolescentes",2022,2,27,41611,64.886688615991,10,21361,46.8142877206123,17,20250,83.9506172839506
36669,47,47001,81,"Tasa de exámenes médico legales por presunto delito sexual contra niños, niñas y adolescentes",2022,3,79,53975,146.364057433997,18,27659,65.0782747026284,61,26316,231.798145614835
36670,47,47001,81,"Tasa de exámenes médico legales por presunto delito sexual contra niños, niñas y adolescentes",2022,4,172,56618,303.790314034406,9,28839,31.2077395194008,163,27779,586.774181935995
36671,47,47001,121,Tasa de exámenes médico legales por presunto delito sexual cuando la víctima está entre 18 y 28 años,2022,5,48,108583,44.2058149065692,1,54101,1.84839466922977,47,54482,86.2670239712199
36672,47,47745,81,"Tasa de exámenes médico legales por presunto delito sexual contra niños, niñas y adolescentes",2022,2,1,2776,36.0230547550432,0,1409,0,1,1367,73.1528895391368
36673,47,47745,81,"Tasa de exámenes médico legales por presunto delito sexual contra niños, niñas y adolescentes",2022,3,1,3518,28.4252416145537,1,1782,56.1167227833895,0,1736,0
36674,47,47745,81,"Tasa de exámenes médico legales por presunto delito sexual contra niños, niñas y adolescentes",2022,4,4,3496,114.41647597254,1,1778,56.2429696287964,3,1718,174.621653084983
36675,47,47798,81,"Tasa de exámenes médico legales por presunto delito sexual contra niños, niñas y adolescentes",2022,3,2,1711,116.890707188778,2,890,224.719101123596,0,821,0
36676,47,47798,81,"Tasa de exámenes médico legales por presunto delito sexual contra niños, niñas y adolescentes",2022,4,3,1703,176.159718144451,0,880,0,3,823,364.520048602673
36677,47,47960,81,"Tasa de exámenes médico legales por presunto delito sexual contra niños, niñas y adolescentes",2022,4,2,1231,162.46953696182,0,633,0,2,598,334.448160535117
36678,47,47980,81,"Tasa de exámenes médico legales por presunto delito sexual contra niños, niñas y adolescentes",2022,3,3,9399,31.9182891797,0,4758,0,3,4641,64.6412411118293
36679,47,47980,81,"Tasa de exámenes médico legales por presunto delito sexual contra niños, niñas y adolescentes",2022,4,2,9103,21.9707788641107,0,4631,0,2,4472,44.7227191413238
36680,50,50006,81,"Tasa de exámenes médico legales por presunto delito sexual contra niños, niñas y adolescentes",2022,2,7,6962,100.545820166619,1,3575,27.972027972028,6,3387,177.147918511957
36681,50,50006,81,"Tasa de exámenes médico legales por presunto delito sexual contra niños, niñas y adolescentes",2022,3,12,8725,137.535816618911,2,4460,44.8430493273543,10,4265,234.466588511137
36682,50,50006,81,"Tasa de exámenes médico legales por presunto delito sexual contra niños, niñas y adolescentes",2022,4,43,8741,491.934561263013,3,4381,68.4775165487332,40,4360,917.431192660551
36683,50,50006,121,Tasa de exámenes médico legales por presunto delito sexual cuando la víctima está entre 18 y 28 años,2022,5,8,17620,45.4029511918275,0,9249,0,8,8371,95.568032493131
36684,50,50110,81,"Tasa de exámenes médico legales por presunto delito sexual contra niños, niñas y adolescentes",2022,3,1,859,116.414435389988,0,420,0,1,439,227.790432801822
36685,50,50110,81,"Tasa de exámenes médico legales por presunto delito sexual contra niños, niñas y adolescentes",2022,4,3,860,348.837209302326,0,424,0,3,436,688.073394495413
36686,50,50124,81,"Tasa de exámenes médico legales por presunto delito sexual contra niños, niñas y adolescentes",2022,3,6,722,831.024930747922,0,386,0,6,336,1785.71428571429
36687,50,50124,81,"Tasa de exámenes médico legales por presunto delito sexual contra niños, niñas y adolescentes",2022,4,5,652,766.871165644172,1,354,282.485875706215,4,298,1342.28187919463
36688,50,50124,121,Tasa de exámenes médico legales por presunto delito sexual cuando la víctima está entre 18 y 28 años,2022,5,2,1170,170.940170940171,0,622,0,2,548,364.963503649635
36689,50,50150,81,"Tasa de exámenes médico legales por presunto delito sexual contra niños, niñas y adolescentes",2022,3,2,1643,121.728545343883,0,821,0,2,822,243.30900243309
36690,50,50150,81,"Tasa de exámenes médico legales por presunto delito sexual contra niños, niñas y adolescentes",2022,4,3,1612,186.104218362283,0,801,0,3,811,369.913686806412
36691,50,50226,81,"Tasa de exámenes médico legales por presunto delito sexual contra niños, niñas y adolescentes",2022,2,1,1895,52.7704485488127,0,967,0,1,928,107.758620689655
36692,50,50226,81,"Tasa de exámenes médico legales por presunto delito sexual contra niños, niñas y adolescentes",2022,3,11,2484,442.834138486312,1,1256,79.6178343949045,10,1228,814.332247557003
36693,50,50226,81,"Tasa de exámenes médico legales por presunto delito sexual contra niños, niñas y adolescentes",2022,4,19,2553,744.222483352918,0,1280,0,19,1273,1492.53731343284
36694,50,50251,81,"Tasa de exámenes médico legales por presunto delito sexual contra niños, niñas y adolescentes",2022,4,3,925,324.324324324324,1,485,206.185567010309,2,440,454.545454545455
36695,50,50270,81,"Tasa de exámenes médico legales por presunto delito sexual contra niños, niñas y adolescentes",2022,2,1,284,352.112676056338,0,139,0,1,145,689.655172413793
36696,50,50270,81,"Tasa de exámenes médico legales por presunto delito sexual contra niños, niñas y adolescentes",2022,3,2,458,436.681222707424,1,234,427.350427350427,1,224,446.428571428571
36697,50,50270,81,"Tasa de exámenes médico legales por presunto delito sexual contra niños, niñas y adolescentes",2022,4,2,510,392.156862745098,1,266,375.93984962406,1,244,409.83606557377
36698,50,50287,81,"Tasa de exámenes médico legales por presunto delito sexual contra niños, niñas y adolescentes",2022,3,4,1371,291.757840991977,0,690,0,4,681,587.371512481645
36699,50,50287,81,"Tasa de exámenes médico legales por presunto delito sexual contra niños, niñas y adolescentes",2022,4,3,1393,215.362526920316,0,706,0,3,687,436.681222707424
36700,50,50313,81,"Tasa de exámenes médico legales por presunto delito sexual contra niños, niñas y adolescentes",2022,3,4,7738,51.6929439131559,0,3861,0,4,3877,103.172556100077
36701,50,50313,81,"Tasa de exámenes médico legales por presunto delito sexual contra niños, niñas y adolescentes",2022,4,15,7852,191.034131431482,1,3910,25.5754475703325,14,3942,355.149670218163
36702,50,50313,121,Tasa de exámenes médico legales por presunto delito sexual cuando la víctima está entre 18 y 28 años,2022,5,1,13491,7.41234897338967,1,6484,15.4225786551511,0,7007,0
36703,50,50318,81,"Tasa de exámenes médico legales por presunto delito sexual contra niños, niñas y adolescentes",2022,3,2,1465,136.518771331058,1,748,133.689839572193,1,717,139.470013947001
36704,50,50318,81,"Tasa de exámenes médico legales por presunto delito sexual contra niños, niñas y adolescentes",2022,4,3,1443,207.900207900208,1,732,136.612021857924,2,711,281.293952180028
36705,50,50318,121,Tasa de exámenes médico legales por presunto delito sexual cuando la víctima está entre 18 y 28 años,2022,5,2,2627,76.1324704986677,1,1294,77.2797527047913,1,1333,75.0187546886722
36706,50,50350,81,"Tasa de exámenes médico legales por presunto delito sexual contra niños, niñas y adolescentes",2022,2,2,3144,63.6132315521629,1,1534,65.1890482398957,1,1610,62.111801242236
36707,50,50350,81,"Tasa de exámenes médico legales por presunto delito sexual contra niños, niñas y adolescentes",2022,3,3,3792,79.1139240506329,0,1916,0,3,1876,159.914712153518
36708,50,50350,81,"Tasa de exámenes médico legales por presunto delito sexual contra niños, niñas y adolescentes",2022,4,8,3456,231.481481481481,0,1811,0,8,1645,486.322188449848
36709,50,50400,81,"Tasa de exámenes médico legales por presunto delito sexual contra niños, niñas y adolescentes",2022,2,2,1004,199.203187250996,1,496,201.612903225806,1,508,196.850393700787
36710,50,50400,81,"Tasa de exámenes médico legales por presunto delito sexual contra niños, niñas y adolescentes",2022,3,1,1303,76.7459708365311,1,678,147.492625368732,0,625,0
36711,50,50400,81,"Tasa de exámenes médico legales por presunto delito sexual contra niños, niñas y adolescentes",2022,4,5,1305,383.141762452107,1,696,143.67816091954,4,609,656.814449917898
36712,50,50325,81,"Tasa de exámenes médico legales por presunto delito sexual contra niños, niñas y adolescentes",2022,3,1,1097,91.1577028258888,1,547,182.815356489945,0,550,0
36713,50,50325,81,"Tasa de exámenes médico legales por presunto delito sexual contra niños, niñas y adolescentes",2022,4,9,816,1102.94117647059,1,423,236.406619385343,8,393,2035.62340966921
36714,50,50330,81,"Tasa de exámenes médico legales por presunto delito sexual contra niños, niñas y adolescentes",2022,2,1,1037,96.4320154291225,0,506,0,1,531,188.323917137476
36715,50,50330,81,"Tasa de exámenes médico legales por presunto delito sexual contra niños, niñas y adolescentes",2022,3,4,1311,305.11060259344,1,669,149.476831091181,3,642,467.289719626168
36716,50,50330,81,"Tasa de exámenes médico legales por presunto delito sexual contra niños, niñas y adolescentes",2022,4,2,1274,156.985871271586,0,670,0,2,604,331.12582781457
36717,50,50450,81,"Tasa de exámenes médico legales por presunto delito sexual contra niños, niñas y adolescentes",2022,3,4,1140,350.877192982456,0,596,0,4,544,735.294117647059
36718,50,50450,81,"Tasa de exámenes médico legales por presunto delito sexual contra niños, niñas y adolescentes",2022,4,9,1069,841.908325537886,4,542,738.007380073801,5,527,948.76660341556
36719,50,50450,121,Tasa de exámenes médico legales por presunto delito sexual cuando la víctima está entre 18 y 28 años,2022,5,1,1405,71.1743772241993,1,705,141.843971631206,0,700,0
36720,50,50568,81,"Tasa de exámenes médico legales por presunto delito sexual contra niños, niñas y adolescentes",2022,2,1,5655,17.683465959328,0,2840,0,1,2815,35.5239786856128
36721,50,50568,81,"Tasa de exámenes médico legales por presunto delito sexual contra niños, niñas y adolescentes",2022,3,1,6020,16.6112956810631,0,3013,0,1,3007,33.255736614566
36722,50,50568,81,"Tasa de exámenes médico legales por presunto delito sexual contra niños, niñas y adolescentes",2022,4,7,5121,136.692052333529,1,2617,38.2116927779901,6,2504,239.61661341853
36723,50,50577,81,"Tasa de exámenes médico legales por presunto delito sexual contra niños, niñas y adolescentes",2022,2,2,928,215.51724137931,0,478,0,2,450,444.444444444444
36724,50,50577,81,"Tasa de exámenes médico legales por presunto delito sexual contra niños, niñas y adolescentes",2022,3,15,1277,1174.62803445576,5,665,751.87969924812,10,612,1633.98692810458
36725,50,50577,81,"Tasa de exámenes médico legales por presunto delito sexual contra niños, niñas y adolescentes",2022,4,9,1301,691.775557263643,2,684,292.397660818713,7,617,1134.52188006483
36726,50,50577,121,Tasa de exámenes médico legales por presunto delito sexual cuando la víctima está entre 18 y 28 años,2022,5,1,1822,54.8847420417124,1,942,106.157112526539,0,880,0
36727,50,50573,81,"Tasa de exámenes médico legales por presunto delito sexual contra niños, niñas y adolescentes",2022,2,4,2943,135.915732246007,2,1515,132.013201320132,2,1428,140.056022408964
36728,50,50573,81,"Tasa de exámenes médico legales por presunto delito sexual contra niños, niñas y adolescentes",2022,3,20,3656,547.045951859956,7,1896,369.198312236287,13,1760,738.636363636364
36729,50,50573,81,"Tasa de exámenes médico legales por presunto delito sexual contra niños, niñas y adolescentes",2022,4,37,3472,1065.66820276498,2,1806,110.741971207087,35,1666,2100.84033613445
36730,50,50573,121,Tasa de exámenes médico legales por presunto delito sexual cuando la víctima está entre 18 y 28 años,2022,5,6,5738,104.566050888811,0,2858,0,6,2880,208.333333333333
36731,50,50590,81,"Tasa de exámenes médico legales por presunto delito sexual contra niños, niñas y adolescentes",2022,3,3,1491,201.207243460765,0,739,0,3,752,398.936170212766
36732,50,50590,81,"Tasa de exámenes médico legales por presunto delito sexual contra niños, niñas y adolescentes",2022,4,2,1409,141.94464158978,0,705,0,2,704,284.090909090909
36733,50,50606,81,"Tasa de exámenes médico legales por presunto delito sexual contra niños, niñas y adolescentes",2022,2,2,1449,138.026224982747,1,729,137.174211248285,1,720,138.888888888889
36734,50,50606,81,"Tasa de exámenes médico legales por presunto delito sexual contra niños, niñas y adolescentes",2022,3,7,1847,378.992961559285,0,951,0,7,896,781.25
36735,50,50606,81,"Tasa de exámenes médico legales por presunto delito sexual contra niños, niñas y adolescentes",2022,4,10,1874,533.617929562433,0,981,0,10,893,1119.82082866741
36736,50,50606,121,Tasa de exámenes médico legales por presunto delito sexual cuando la víctima está entre 18 y 28 años,2022,5,2,3391,58.9796520200531,0,1727,0,2,1664,120.192307692308
36737,50,50680,81,"Tasa de exámenes médico legales por presunto delito sexual contra niños, niñas y adolescentes",2022,3,4,1547,258.564964447317,1,780,128.205128205128,3,767,391.134289439374
36738,50,50680,81,"Tasa de exámenes médico legales por presunto delito sexual contra niños, niñas y adolescentes",2022,4,1,1434,69.7350069735007,0,724,0,1,710,140.845070422535
36739,50,50680,121,Tasa de exámenes médico legales por presunto delito sexual cuando la víctima está entre 18 y 28 años,2022,5,1,2479,40.3388463089956,0,1260,0,1,1219,82.0344544708778
36740,50,50683,81,"Tasa de exámenes médico legales por presunto delito sexual contra niños, niñas y adolescentes",2022,3,2,945,211.640211640212,1,472,211.864406779661,1,473,211.416490486258
36741,50,50223,81,"Tasa de exámenes médico legales por presunto delito sexual contra niños, niñas y adolescentes",2022,3,2,730,273.972602739726,0,382,0,2,348,574.712643678161
36742,50,50689,81,"Tasa de exámenes médico legales por presunto delito sexual contra niños, niñas y adolescentes",2022,3,1,3045,32.8407224958949,0,1538,0,1,1507,66.35700066357
36743,50,50689,81,"Tasa de exámenes médico legales por presunto delito sexual contra niños, niñas y adolescentes",2022,4,4,3123,128.081972462376,0,1601,0,4,1522,262.81208935611
36744,50,50370,81,"Tasa de exámenes médico legales por presunto delito sexual contra niños, niñas y adolescentes",2022,2,1,817,122.399020807834,0,426,0,1,391,255.754475703325
36745,50,50370,81,"Tasa de exámenes médico legales por presunto delito sexual contra niños, niñas y adolescentes",2022,3,1,1123,89.0471950133571,0,575,0,1,548,182.481751824818
36746,50,50370,81,"Tasa de exámenes médico legales por presunto delito sexual contra niños, niñas y adolescentes",2022,4,1,1319,75.8150113722517,0,707,0,1,612,163.398692810458
36747,50,50001,81,"Tasa de exámenes médico legales por presunto delito sexual contra niños, niñas y adolescentes",2022,2,41,39733,103.188785140815,3,20559,14.5921494236101,38,19174,198.185042244706
36748,50,50001,81,"Tasa de exámenes médico legales por presunto delito sexual contra niños, niñas y adolescentes",2022,3,115,50913,225.875513130242,14,26382,53.0664847244333,101,24531,411.723941135706
36749,50,50001,81,"Tasa de exámenes médico legales por presunto delito sexual contra niños, niñas y adolescentes",2022,4,212,53767,394.293897743969,13,27720,46.8975468975469,199,26047,764.003532076631
36750,50,50001,121,Tasa de exámenes médico legales por presunto delito sexual cuando la víctima está entre 18 y 28 años,2022,5,34,108687,31.2824900862109,3,55738,5.38232444651764,31,52949,58.5469036242422
36751,50,50711,81,"Tasa de exámenes médico legales por presunto delito sexual contra niños, niñas y adolescentes",2022,2,2,1537,130.123617436565,1,783,127.713920817369,1,754,132.62599469496
36752,50,50711,81,"Tasa de exámenes médico legales por presunto delito sexual contra niños, niñas y adolescentes",2022,3,4,2101,190.385530699667,2,1060,188.679245283019,2,1041,192.122958693564
36753,50,50711,81,"Tasa de exámenes médico legales por presunto delito sexual contra niños, niñas y adolescentes",2022,4,9,2132,422.138836772983,0,1072,0,9,1060,849.056603773585
36754,52,52019,81,"Tasa de exámenes médico legales por presunto delito sexual contra niños, niñas y adolescentes",2022,4,1,808,123.762376237624,0,407,0,1,401,249.376558603491
36755,52,52051,81,"Tasa de exámenes médico legales por presunto delito sexual contra niños, niñas y adolescentes",2022,4,2,777,257.400257400257,0,377,0,2,400,500
36756,52,52079,81,"Tasa de exámenes médico legales por presunto delito sexual contra niños, niñas y adolescentes",2022,3,1,8076,12.3823675086677,0,4123,0,1,3953,25.2972426005565
36757,52,52110,81,"Tasa de exámenes médico legales por presunto delito sexual contra niños, niñas y adolescentes",2022,3,1,2004,49.9001996007984,0,1042,0,1,962,103.950103950104
36758,52,52240,121,Tasa de exámenes médico legales por presunto delito sexual cuando la víctima está entre 18 y 28 años,2022,5,2,2808,71.2250712250712,0,1422,0,2,1386,144.300144300144
36759,52,52224,81,"Tasa de exámenes médico legales por presunto delito sexual contra niños, niñas y adolescentes",2022,4,1,813,123.0012300123,0,418,0,1,395,253.164556962025
36760,52,52250,81,"Tasa de exámenes médico legales por presunto delito sexual contra niños, niñas y adolescentes",2022,4,1,2847,35.1246926589392,0,1462,0,1,1385,72.202166064982
36761,52,52260,81,"Tasa de exámenes médico legales por presunto delito sexual contra niños, niñas y adolescentes",2022,3,1,1061,94.2507068803016,1,555,180.18018018018,0,506,0
36762,52,52356,81,"Tasa de exámenes médico legales por presunto delito sexual contra niños, niñas y adolescentes",2022,4,4,10620,37.6647834274953,0,5407,0,4,5213,76.7312488010742
36763,52,52356,121,Tasa de exámenes médico legales por presunto delito sexual cuando la víctima está entre 18 y 28 años,2022,5,2,21899,9.13283711585004,0,11089,0,2,10810,18.5013876040703
36764,52,52378,81,"Tasa de exámenes médico legales por presunto delito sexual contra niños, niñas y adolescentes",2022,4,2,1481,135.043889264011,0,744,0,2,737,271.370420624152
36765,52,52405,81,"Tasa de exámenes médico legales por presunto delito sexual contra niños, niñas y adolescentes",2022,3,1,980,102.040816326531,0,494,0,1,486,205.761316872428
36766,52,52405,81,"Tasa de exámenes médico legales por presunto delito sexual contra niños, niñas y adolescentes",2022,4,1,1079,92.678405931418,0,559,0,1,520,192.307692307692
36767,52,52473,81,"Tasa de exámenes médico legales por presunto delito sexual contra niños, niñas y adolescentes",2022,4,1,1506,66.4010624169987,0,749,0,1,757,132.100396301189
36768,52,52001,81,"Tasa de exámenes médico legales por presunto delito sexual contra niños, niñas y adolescentes",2022,2,2,23875,8.37696335078534,0,12099,0,2,11776,16.9836956521739
36769,52,52001,81,"Tasa de exámenes médico legales por presunto delito sexual contra niños, niñas y adolescentes",2022,3,11,29324,37.5119356158778,1,14893,6.7145638890754,10,14431,69.2952671332548
36770,52,52001,81,"Tasa de exámenes médico legales por presunto delito sexual contra niños, niñas y adolescentes",2022,4,24,31950,75.1173708920188,1,16132,6.19885940986858,23,15818,145.403970160577
36771,52,52001,121,Tasa de exámenes médico legales por presunto delito sexual cuando la víctima está entre 18 y 28 años,2022,5,31,74877,41.4012313527518,0,37468,0,31,37409,82.8677590954048
36772,52,52621,81,"Tasa de exámenes médico legales por presunto delito sexual contra niños, niñas y adolescentes",2022,4,1,1667,59.9880023995201,0,860,0,1,807,123.915737298637
36773,52,52678,121,Tasa de exámenes médico legales por presunto delito sexual cuando la víctima está entre 18 y 28 años,2022,5,3,5580,53.7634408602151,0,2796,0,3,2784,107.758620689655
36774,52,52835,81,"Tasa de exámenes médico legales por presunto delito sexual contra niños, niñas y adolescentes",2022,3,1,30657,3.26189777212382,0,15570,0,1,15087,6.62822297342083
36775,52,52835,81,"Tasa de exámenes médico legales por presunto delito sexual contra niños, niñas y adolescentes",2022,4,5,29498,16.9503017153705,0,14967,0,5,14531,34.4091941366733
36776,52,52835,121,Tasa de exámenes médico legales por presunto delito sexual cuando la víctima está entre 18 y 28 años,2022,5,6,51744,11.595547309833,0,26058,0,6,25686,23.3590282644242
36777,52,52687,81,"Tasa de exámenes médico legales por presunto delito sexual contra niños, niñas y adolescentes",2022,2,1,1084,92.2509225092251,0,536,0,1,548,182.481751824818
36778,52,52687,81,"Tasa de exámenes médico legales por presunto delito sexual contra niños, niñas y adolescentes",2022,3,1,1464,68.3060109289618,0,738,0,1,726,137.741046831956
36779,52,52693,81,"Tasa de exámenes médico legales por presunto delito sexual contra niños, niñas y adolescentes",2022,3,1,1147,87.1839581517001,1,561,178.25311942959,0,586,0
36780,52,52683,81,"Tasa de exámenes médico legales por presunto delito sexual contra niños, niñas y adolescentes",2022,3,1,1472,67.9347826086957,1,788,126.903553299492,0,684,0
36781,52,52786,81,"Tasa de exámenes médico legales por presunto delito sexual contra niños, niñas y adolescentes",2022,4,1,1484,67.3854447439353,0,774,0,1,710,140.845070422535
36782,52,52838,81,"Tasa de exámenes médico legales por presunto delito sexual contra niños, niñas y adolescentes",2022,3,1,3572,27.9955207166853,0,1822,0,1,1750,57.1428571428571
36783,52,52838,81,"Tasa de exámenes médico legales por presunto delito sexual contra niños, niñas y adolescentes",2022,4,1,3985,25.0941028858218,1,2064,48.4496124031008,0,1921,0
36784,52,52885,81,"Tasa de exámenes médico legales por presunto delito sexual contra niños, niñas y adolescentes",2022,4,1,962,103.950103950104,0,474,0,1,488,204.918032786885
36785,54,54003,81,"Tasa de exámenes médico legales por presunto delito sexual contra niños, niñas y adolescentes",2022,3,1,4022,24.8632521133764,0,2033,0,1,1989,50.2765208647562
36786,54,54003,81,"Tasa de exámenes médico legales por presunto delito sexual contra niños, niñas y adolescentes",2022,4,4,3768,106.157112526539,0,1898,0,4,1870,213.903743315508
36787,54,54051,81,"Tasa de exámenes médico legales por presunto delito sexual contra niños, niñas y adolescentes",2022,4,1,1113,89.8472596585804,0,612,0,1,501,199.600798403194
36788,54,54099,81,"Tasa de exámenes médico legales por presunto delito sexual contra niños, niñas y adolescentes",2022,2,1,674,148.367952522255,0,342,0,1,332,301.204819277108
36789,54,54099,81,"Tasa de exámenes médico legales por presunto delito sexual contra niños, niñas y adolescentes",2022,4,1,864,115.740740740741,0,493,0,1,371,269.541778975741
36790,54,54099,121,Tasa de exámenes médico legales por presunto delito sexual cuando la víctima está entre 18 y 28 años,2022,5,1,1529,65.402223675605,0,824,0,1,705,141.843971631206
36791,54,54109,81,"Tasa de exámenes médico legales por presunto delito sexual contra niños, niñas y adolescentes",2022,3,1,879,113.765642775882,1,452,221.238938053097,0,427,0
36792,54,54109,121,Tasa de exámenes médico legales por presunto delito sexual cuando la víctima está entre 18 y 28 años,2022,5,1,1258,79.4912559618442,0,670,0,1,588,170.068027210884
36793,54,54128,81,"Tasa de exámenes médico legales por presunto delito sexual contra niños, niñas y adolescentes",2022,4,5,1340,373.134328358209,0,711,0,5,629,794.912559618442
36794,54,54125,81,"Tasa de exámenes médico legales por presunto delito sexual contra niños, niñas y adolescentes",2022,3,1,305,327.868852459016,0,157,0,1,148,675.675675675676
36795,54,54172,81,"Tasa de exámenes médico legales por presunto delito sexual contra niños, niñas y adolescentes",2022,2,3,1403,213.827512473272,0,696,0,3,707,424.328147100424
36796,54,54172,81,"Tasa de exámenes médico legales por presunto delito sexual contra niños, niñas y adolescentes",2022,3,4,1802,221.975582685905,1,893,111.982082866741,3,909,330.03300330033
36797,54,54172,81,"Tasa de exámenes médico legales por presunto delito sexual contra niños, niñas y adolescentes",2022,4,6,1813,330.943188086045,1,900,111.111111111111,5,913,547.645125958379
36798,54,54172,121,Tasa de exámenes médico legales por presunto delito sexual cuando la víctima está entre 18 y 28 años,2022,5,3,3239,92.6211793763507,0,1609,0,3,1630,184.049079754601
36799,54,54174,81,"Tasa de exámenes médico legales por presunto delito sexual contra niños, niñas y adolescentes",2022,3,2,1372,145.772594752187,0,721,0,2,651,307.219662058372
36800,54,54174,81,"Tasa de exámenes médico legales por presunto delito sexual contra niños, niñas y adolescentes",2022,4,5,1351,370.096225018505,0,715,0,5,636,786.163522012579
36801,54,54206,81,"Tasa de exámenes médico legales por presunto delito sexual contra niños, niñas y adolescentes",2022,3,1,2556,39.1236306729264,0,1270,0,1,1286,77.7604976671851
36802,54,54206,81,"Tasa de exámenes médico legales por presunto delito sexual contra niños, niñas y adolescentes",2022,4,1,2379,42.0344682639765,0,1223,0,1,1156,86.5051903114187
36803,54,54001,81,"Tasa de exámenes médico legales por presunto delito sexual contra niños, niñas y adolescentes",2022,2,44,59457,74.0030610357065,10,30581,32.7000425100553,34,28876,117.744840005541
36804,54,54001,81,"Tasa de exámenes médico legales por presunto delito sexual contra niños, niñas y adolescentes",2022,3,97,73760,131.507592190889,19,37809,50.2525853632733,78,35951,216.96197602292
36805,54,54001,81,"Tasa de exámenes médico legales por presunto delito sexual contra niños, niñas y adolescentes",2022,4,135,73982,182.476818685626,17,37719,45.0701238102813,118,36263,325.400546011086
36806,54,54001,121,Tasa de exámenes médico legales por presunto delito sexual cuando la víctima está entre 18 y 28 años,2022,5,33,151937,21.7195284887815,4,76230,5.2472779745507,29,75707,38.3055728004015
36807,54,54223,81,"Tasa de exámenes médico legales por presunto delito sexual contra niños, niñas y adolescentes",2022,4,2,926,215.982721382289,0,476,0,2,450,444.444444444444
36808,54,54223,121,Tasa de exámenes médico legales por presunto delito sexual cuando la víctima está entre 18 y 28 años,2022,5,1,1540,64.9350649350649,0,801,0,1,739,135.31799729364
36809,54,54239,81,"Tasa de exámenes médico legales por presunto delito sexual contra niños, niñas y adolescentes",2022,4,1,449,222.71714922049,0,240,0,1,209,478.468899521531
36810,54,54245,81,"Tasa de exámenes médico legales por presunto delito sexual contra niños, niñas y adolescentes",2022,3,1,1789,55.8971492453885,0,906,0,1,883,113.250283125708
36811,54,54250,81,"Tasa de exámenes médico legales por presunto delito sexual contra niños, niñas y adolescentes",2022,4,1,2744,36.4431486880466,0,1420,0,1,1324,75.5287009063444
36812,54,54250,121,Tasa de exámenes médico legales por presunto delito sexual cuando la víctima está entre 18 y 28 años,2022,5,1,4731,21.137180300148,0,2411,0,1,2320,43.1034482758621
36813,54,54261,81,"Tasa de exámenes médico legales por presunto delito sexual contra niños, niñas y adolescentes",2022,3,2,3293,60.7348921955664,1,1711,58.4453535943892,1,1582,63.2111251580278
36814,54,54261,81,"Tasa de exámenes médico legales por presunto delito sexual contra niños, niñas y adolescentes",2022,4,4,3121,128.164049983979,0,1611,0,4,1510,264.900662251656
36815,54,54261,121,Tasa de exámenes médico legales por presunto delito sexual cuando la víctima está entre 18 y 28 años,2022,5,2,5891,33.9500933627567,1,2966,33.7154416722859,1,2925,34.1880341880342
36816,54,54385,81,"Tasa de exámenes médico legales por presunto delito sexual contra niños, niñas y adolescentes",2022,3,1,1656,60.3864734299517,0,836,0,1,820,121.951219512195
36817,54,54385,81,"Tasa de exámenes médico legales por presunto delito sexual contra niños, niñas y adolescentes",2022,4,1,1460,68.4931506849315,0,730,0,1,730,136.986301369863
36818,54,54385,121,Tasa de exámenes médico legales por presunto delito sexual cuando la víctima está entre 18 y 28 años,2022,5,1,2178,45.9136822773186,0,1117,0,1,1061,94.2507068803016
36819,54,54398,81,"Tasa de exámenes médico legales por presunto delito sexual contra niños, niñas y adolescentes",2022,2,1,801,124.843945068664,0,411,0,1,390,256.410256410256
36820,54,54398,81,"Tasa de exámenes médico legales por presunto delito sexual contra niños, niñas y adolescentes",2022,4,1,920,108.695652173913,0,462,0,1,458,218.340611353712
36821,54,54377,81,"Tasa de exámenes médico legales por presunto delito sexual contra niños, niñas y adolescentes",2022,2,1,541,184.842883548983,0,270,0,1,271,369.0036900369
36822,54,54377,81,"Tasa de exámenes médico legales por presunto delito sexual contra niños, niñas y adolescentes",2022,3,2,696,287.35632183908,0,349,0,2,347,576.368876080692
36823,54,54377,81,"Tasa de exámenes médico legales por presunto delito sexual contra niños, niñas y adolescentes",2022,4,1,687,145.560407569141,0,344,0,1,343,291.545189504373
36824,54,54377,121,Tasa de exámenes médico legales por presunto delito sexual cuando la víctima está entre 18 y 28 años,2022,5,1,1130,88.4955752212389,0,592,0,1,538,185.873605947955
36825,54,54405,81,"Tasa de exámenes médico legales por presunto delito sexual contra niños, niñas y adolescentes",2022,2,4,7378,54.2152344808891,0,3698,0,4,3680,108.695652173913
36826,54,54405,81,"Tasa de exámenes médico legales por presunto delito sexual contra niños, niñas y adolescentes",2022,3,11,9381,117.258288028995,1,4776,20.9380234505863,10,4605,217.155266015201
36827,54,54405,81,"Tasa de exámenes médico legales por presunto delito sexual contra niños, niñas y adolescentes",2022,4,18,9422,191.042241562301,0,4855,0,18,4567,394.131815195971
36828,54,54405,121,Tasa de exámenes médico legales por presunto delito sexual cuando la víctima está entre 18 y 28 años,2022,5,3,18474,16.239038648912,0,9118,0,3,9356,32.0649850363403
36829,54,54405,81,"Tasa de exámenes médico legales por presunto delito sexual contra niños, niñas y adolescentes",2022,1,1,1360,73.5294117647059,0,684,0,1,676,147.92899408284
36830,54,54480,81,"Tasa de exámenes médico legales por presunto delito sexual contra niños, niñas y adolescentes",2022,4,1,455,219.78021978022,0,238,0,1,217,460.829493087558
36831,54,54480,121,Tasa de exámenes médico legales por presunto delito sexual cuando la víctima está entre 18 y 28 años,2022,5,1,856,116.822429906542,0,443,0,1,413,242.130750605327
36832,54,54498,81,"Tasa de exámenes médico legales por presunto delito sexual contra niños, niñas y adolescentes",2022,2,4,9937,40.2535976652913,1,4956,20.1775625504439,3,4981,60.2288697048785
36833,54,54498,81,"Tasa de exámenes médico legales por presunto delito sexual contra niños, niñas y adolescentes",2022,3,12,12602,95.222980479289,5,6304,79.3147208121827,7,6298,111.146395681169
36834,54,54498,81,"Tasa de exámenes médico legales por presunto delito sexual contra niños, niñas y adolescentes",2022,4,13,12883,100.908173562059,1,6452,15.4990700557967,12,6431,186.596174778417
36835,54,54498,121,Tasa de exámenes médico legales por presunto delito sexual cuando la víctima está entre 18 y 28 años,2022,5,5,24981,20.0152115607862,0,12246,0,5,12735,39.2618767177071
36836,54,54518,81,"Tasa de exámenes médico legales por presunto delito sexual contra niños, niñas y adolescentes",2022,2,6,3337,179.802217560683,1,1683,59.41770647653,5,1654,302.29746070133
36837,54,54518,81,"Tasa de exámenes médico legales por presunto delito sexual contra niños, niñas y adolescentes",2022,3,5,4556,109.745390693591,0,2284,0,5,2272,220.070422535211
36838,54,54518,81,"Tasa de exámenes médico legales por presunto delito sexual contra niños, niñas y adolescentes",2022,4,14,5397,259.403372243839,0,2739,0,14,2658,526.711813393529
36839,54,54518,121,Tasa de exámenes médico legales por presunto delito sexual cuando la víctima está entre 18 y 28 años,2022,5,9,11598,77.5995861355406,0,5974,0,9,5624,160.028449502134
36840,54,54520,81,"Tasa de exámenes médico legales por presunto delito sexual contra niños, niñas y adolescentes",2022,2,1,479,208.768267223382,0,259,0,1,220,454.545454545455
36841,54,54599,81,"Tasa de exámenes médico legales por presunto delito sexual contra niños, niñas y adolescentes",2022,2,1,469,213.219616204691,1,257,389.105058365759,0,212,0
36842,54,54599,81,"Tasa de exámenes médico legales por presunto delito sexual contra niños, niñas y adolescentes",2022,3,4,589,679.11714770798,0,323,0,4,266,1503.75939849624
36843,54,54599,81,"Tasa de exámenes médico legales por presunto delito sexual contra niños, niñas y adolescentes",2022,4,4,598,668.896321070234,0,324,0,4,274,1459.85401459854
36844,54,54673,81,"Tasa de exámenes médico legales por presunto delito sexual contra niños, niñas y adolescentes",2022,2,2,723,276.625172890733,0,346,0,2,377,530.503978779841
36845,54,54673,81,"Tasa de exámenes médico legales por presunto delito sexual contra niños, niñas y adolescentes",2022,4,1,771,129.70168612192,0,410,0,1,361,277.008310249307
36846,54,54673,121,Tasa de exámenes médico legales por presunto delito sexual cuando la víctima está entre 18 y 28 años,2022,5,1,1468,68.1198910081744,0,722,0,1,746,134.048257372654
36847,54,54680,81,"Tasa de exámenes médico legales por presunto delito sexual contra niños, niñas y adolescentes",2022,3,1,367,272.479564032698,0,185,0,1,182,549.450549450549
36848,54,54720,81,"Tasa de exámenes médico legales por presunto delito sexual contra niños, niñas y adolescentes",2022,3,3,3404,88.1316098707403,2,1721,116.211504938989,1,1683,59.41770647653
36849,54,54720,81,"Tasa de exámenes médico legales por presunto delito sexual contra niños, niñas y adolescentes",2022,4,3,3186,94.1619585687382,0,1619,0,3,1567,191.4486279515
36850,54,54743,81,"Tasa de exámenes médico legales por presunto delito sexual contra niños, niñas y adolescentes",2022,2,2,648,308.641975308642,0,353,0,2,295,677.966101694915
36851,54,54800,81,"Tasa de exámenes médico legales por presunto delito sexual contra niños, niñas y adolescentes",2022,3,1,2450,40.8163265306122,0,1231,0,1,1219,82.0344544708778
36852,54,54800,81,"Tasa de exámenes médico legales por presunto delito sexual contra niños, niñas y adolescentes",2022,4,1,2095,47.7326968973747,0,1064,0,1,1031,96.9932104752667
36853,54,54800,121,Tasa de exámenes médico legales por presunto delito sexual cuando la víctima está entre 18 y 28 años,2022,5,1,3489,28.6615075952995,0,1728,0,1,1761,56.785917092561
36854,54,54810,81,"Tasa de exámenes médico legales por presunto delito sexual contra niños, niñas y adolescentes",2022,2,4,7233,55.3020876538089,1,3754,26.638252530634,3,3479,86.2316757688991
36855,54,54810,81,"Tasa de exámenes médico legales por presunto delito sexual contra niños, niñas y adolescentes",2022,3,5,7901,63.2831287178838,0,4143,0,5,3758,133.049494411921
36856,54,54810,81,"Tasa de exámenes médico legales por presunto delito sexual contra niños, niñas y adolescentes",2022,4,5,6849,73.0033581544751,0,3595,0,5,3254,153.657037492317
36857,54,54820,81,"Tasa de exámenes médico legales por presunto delito sexual contra niños, niñas y adolescentes",2022,3,5,1776,281.531531531532,0,904,0,5,872,573.394495412844
36858,54,54820,81,"Tasa de exámenes médico legales por presunto delito sexual contra niños, niñas y adolescentes",2022,4,18,1766,1019.25254813137,2,944,211.864406779661,16,822,1946.47201946472
36859,54,54820,121,Tasa de exámenes médico legales por presunto delito sexual cuando la víctima está entre 18 y 28 años,2022,5,1,2813,35.5492356914326,0,1513,0,1,1300,76.9230769230769
36860,54,54871,81,"Tasa de exámenes médico legales por presunto delito sexual contra niños, niñas y adolescentes",2022,2,1,564,177.304964539007,0,268,0,1,296,337.837837837838
36861,54,54871,81,"Tasa de exámenes médico legales por presunto delito sexual contra niños, niñas y adolescentes",2022,4,1,618,161.812297734628,0,335,0,1,283,353.356890459364
36862,54,54874,81,"Tasa de exámenes médico legales por presunto delito sexual contra niños, niñas y adolescentes",2022,2,5,8885,56.274620146314,2,4578,43.6871996505024,3,4307,69.6540515439982
36863,54,54874,81,"Tasa de exámenes médico legales por presunto delito sexual contra niños, niñas y adolescentes",2022,3,7,10901,64.2142922667645,3,5627,53.3143771103608,4,5274,75.8437618505878
36864,54,54874,81,"Tasa de exámenes médico legales por presunto delito sexual contra niños, niñas y adolescentes",2022,4,13,10573,122.954695923579,2,5397,37.0576246062627,11,5176,212.519319938176
36865,54,54874,121,Tasa de exámenes médico legales por presunto delito sexual cuando la víctima está entre 18 y 28 años,2022,5,1,21089,4.74180852577173,0,10203,0,1,10886,9.18611060077163
36866,86,86219,81,"Tasa de exámenes médico legales por presunto delito sexual contra niños, niñas y adolescentes",2022,4,2,494,404.858299595142,0,244,0,2,250,800
36867,86,86001,81,"Tasa de exámenes médico legales por presunto delito sexual contra niños, niñas y adolescentes",2022,2,8,4735,168.954593453009,1,2387,41.8935902806871,7,2348,298.126064735945
36868,86,86001,81,"Tasa de exámenes médico legales por presunto delito sexual contra niños, niñas y adolescentes",2022,3,12,5766,208.116545265349,0,2906,0,12,2860,419.58041958042
36869,86,86001,81,"Tasa de exámenes médico legales por presunto delito sexual contra niños, niñas y adolescentes",2022,4,31,6051,512.312014543051,0,3056,0,31,2995,1035.05843071786
36870,86,86001,121,Tasa de exámenes médico legales por presunto delito sexual cuando la víctima está entre 18 y 28 años,2022,5,4,13083,30.5740273637545,0,6607,0,4,6476,61.7665225447807
36871,86,86320,81,"Tasa de exámenes médico legales por presunto delito sexual contra niños, niñas y adolescentes",2022,3,19,4451,426.870366209841,2,2265,88.3002207505519,17,2186,777.676120768527
36872,86,86320,81,"Tasa de exámenes médico legales por presunto delito sexual contra niños, niñas y adolescentes",2022,4,16,4499,355.634585463436,0,2302,0,16,2197,728.265817023213
36873,86,86320,121,Tasa de exámenes médico legales por presunto delito sexual cuando la víctima está entre 18 y 28 años,2022,5,2,7912,25.2780586450961,0,3947,0,2,3965,50.4413619167718
36874,86,86568,81,"Tasa de exámenes médico legales por presunto delito sexual contra niños, niñas y adolescentes",2022,2,6,5683,105.578039767728,2,2896,69.060773480663,4,2787,143.523501973448
36875,86,86568,81,"Tasa de exámenes médico legales por presunto delito sexual contra niños, niñas y adolescentes",2022,3,10,7332,136.388434260775,2,3716,53.8213132400431,8,3616,221.238938053097
36876,86,86568,81,"Tasa de exámenes médico legales por presunto delito sexual contra niños, niñas y adolescentes",2022,4,19,7822,242.904627972386,0,3983,0,19,3839,494.920552227142
36877,86,86568,121,Tasa de exámenes médico legales por presunto delito sexual cuando la víctima está entre 18 y 28 años,2022,5,4,14962,26.7343937976206,0,7693,0,4,7269,55.0282019535012
36878,86,86569,81,"Tasa de exámenes médico legales por presunto delito sexual contra niños, niñas y adolescentes",2022,2,2,1455,137.45704467354,0,728,0,2,727,275.103163686382
36879,86,86569,81,"Tasa de exámenes médico legales por presunto delito sexual contra niños, niñas y adolescentes",2022,3,3,1673,179.31858936043,0,855,0,3,818,366.748166259169
36880,86,86569,81,"Tasa de exámenes médico legales por presunto delito sexual contra niños, niñas y adolescentes",2022,4,4,1630,245.398773006135,0,861,0,4,769,520.156046814044
36881,86,86569,121,Tasa de exámenes médico legales por presunto delito sexual cuando la víctima está entre 18 y 28 años,2022,5,2,3315,60.3318250377074,0,1792,0,2,1523,131.319763624425
36882,86,86571,81,"Tasa de exámenes médico legales por presunto delito sexual contra niños, niñas y adolescentes",2022,3,1,4874,20.5170291341814,0,2471,0,1,2403,41.6146483562214
36883,86,86571,81,"Tasa de exámenes médico legales por presunto delito sexual contra niños, niñas y adolescentes",2022,4,5,4608,108.506944444444,1,2280,43.859649122807,4,2328,171.821305841924
36884,86,86573,81,"Tasa de exámenes médico legales por presunto delito sexual contra niños, niñas y adolescentes",2022,2,1,3488,28.6697247706422,0,1728,0,1,1760,56.8181818181818
36885,86,86573,81,"Tasa de exámenes médico legales por presunto delito sexual contra niños, niñas y adolescentes",2022,3,2,4177,47.8812544888676,0,2110,0,2,2067,96.7585873246251
36886,86,86573,81,"Tasa de exámenes médico legales por presunto delito sexual contra niños, niñas y adolescentes",2022,4,9,3869,232.618247609201,0,2005,0,9,1864,482.832618025751
36887,86,86573,121,Tasa de exámenes médico legales por presunto delito sexual cuando la víctima está entre 18 y 28 años,2022,5,1,6572,15.2160681679854,0,3758,0,1,2814,35.5366027007818
36888,86,86755,81,"Tasa de exámenes médico legales por presunto delito sexual contra niños, niñas y adolescentes",2022,4,1,593,168.634064080944,0,287,0,1,306,326.797385620915
36889,86,86755,121,Tasa de exámenes médico legales por presunto delito sexual cuando la víctima está entre 18 y 28 años,2022,5,2,1086,184.162062615101,0,532,0,2,554,361.01083032491
36890,86,86757,81,"Tasa de exámenes médico legales por presunto delito sexual contra niños, niñas y adolescentes",2022,2,2,1914,104.493207941484,1,970,103.092783505155,1,944,105.932203389831
36891,86,86757,81,"Tasa de exámenes médico legales por presunto delito sexual contra niños, niñas y adolescentes",2022,3,7,2309,303.161541792984,0,1163,0,7,1146,610.820244328098
36892,86,86757,81,"Tasa de exámenes médico legales por presunto delito sexual contra niños, niñas y adolescentes",2022,4,8,2325,344.086021505376,0,1155,0,8,1170,683.760683760684
36893,86,86757,121,Tasa de exámenes médico legales por presunto delito sexual cuando la víctima está entre 18 y 28 años,2022,5,2,4204,47.5737392959087,0,2108,0,2,2096,95.4198473282443
36894,86,86760,81,"Tasa de exámenes médico legales por presunto delito sexual contra niños, niñas y adolescentes",2022,2,1,699,143.061516452074,0,350,0,1,349,286.532951289398
36895,86,86760,81,"Tasa de exámenes médico legales por presunto delito sexual contra niños, niñas y adolescentes",2022,4,1,736,135.869565217391,0,377,0,1,359,278.551532033426
36896,86,86749,81,"Tasa de exámenes médico legales por presunto delito sexual contra niños, niñas y adolescentes",2022,3,4,1456,274.725274725275,0,760,0,4,696,574.712643678161
36897,86,86749,81,"Tasa de exámenes médico legales por presunto delito sexual contra niños, niñas y adolescentes",2022,4,3,1532,195.822454308094,0,790,0,3,742,404.312668463612
36898,86,86749,121,Tasa de exámenes médico legales por presunto delito sexual cuando la víctima está entre 18 y 28 años,2022,5,1,3146,31.7863954227591,1,1551,64.4745325596389,0,1595,0
36899,86,86865,81,"Tasa de exámenes médico legales por presunto delito sexual contra niños, niñas y adolescentes",2022,2,2,2624,76.219512195122,0,1368,0,2,1256,159.235668789809
36900,86,86865,81,"Tasa de exámenes médico legales por presunto delito sexual contra niños, niñas y adolescentes",2022,3,11,3591,306.321358952938,4,1876,213.219616204691,7,1715,408.163265306122
36901,86,86865,81,"Tasa de exámenes médico legales por presunto delito sexual contra niños, niñas y adolescentes",2022,4,45,3989,1128.1022812735,3,2073,144.717800289436,42,1916,2192.06680584551
36902,86,86865,121,Tasa de exámenes médico legales por presunto delito sexual cuando la víctima está entre 18 y 28 años,2022,5,4,7237,55.2715213486251,0,3657,0,4,3580,111.731843575419
36903,86,86885,81,"Tasa de exámenes médico legales por presunto delito sexual contra niños, niñas y adolescentes",2022,3,8,2902,275.671950379049,0,1471,0,8,1431,559.049615653389
36904,86,86885,81,"Tasa de exámenes médico legales por presunto delito sexual contra niños, niñas y adolescentes",2022,4,6,2924,205.198358413133,0,1500,0,6,1424,421.348314606742
36905,86,86885,121,Tasa de exámenes médico legales por presunto delito sexual cuando la víctima está entre 18 y 28 años,2022,5,3,5502,54.525627044711,0,2812,0,3,2690,111.524163568773
36906,63,63001,81,"Tasa de exámenes médico legales por presunto delito sexual contra niños, niñas y adolescentes",2022,2,43,17085,251.682762657302,8,8718,91.7641660931406,35,8367,418.310027488945
36907,63,63001,81,"Tasa de exámenes médico legales por presunto delito sexual contra niños, niñas y adolescentes",2022,3,53,20914,253.418762551401,13,10682,121.700056169257,40,10232,390.930414386239
36908,63,63001,81,"Tasa de exámenes médico legales por presunto delito sexual contra niños, niñas y adolescentes",2022,4,100,22384,446.74767691208,9,11397,78.9681495130297,91,10987,828.251570037317
36909,63,63001,121,Tasa de exámenes médico legales por presunto delito sexual cuando la víctima está entre 18 y 28 años,2022,5,19,52330,36.3080450984139,2,25945,7.70861437656581,17,26385,64.4305476596551
36910,63,63111,81,"Tasa de exámenes médico legales por presunto delito sexual contra niños, niñas y adolescentes",2022,2,1,228,438.59649122807,0,108,0,1,120,833.333333333333
36911,63,63111,81,"Tasa de exámenes médico legales por presunto delito sexual contra niños, niñas y adolescentes",2022,3,1,273,366.300366300366,0,143,0,1,130,769.230769230769
36912,63,63111,81,"Tasa de exámenes médico legales por presunto delito sexual contra niños, niñas y adolescentes",2022,4,1,274,364.963503649635,0,151,0,1,123,813.008130081301
36913,63,63111,121,Tasa de exámenes médico legales por presunto delito sexual cuando la víctima está entre 18 y 28 años,2022,5,1,501,199.600798403194,0,276,0,1,225,444.444444444444
36914,63,63130,81,"Tasa de exámenes médico legales por presunto delito sexual contra niños, niñas y adolescentes",2022,2,3,4486,66.8747213553277,1,2323,43.0477830391735,2,2163,92.464170134073
36915,63,63130,81,"Tasa de exámenes médico legales por presunto delito sexual contra niños, niñas y adolescentes",2022,3,16,5540,288.808664259928,3,2829,106.044538706257,13,2711,479.527849502029
36916,63,63130,81,"Tasa de exámenes médico legales por presunto delito sexual contra niños, niñas y adolescentes",2022,4,29,5866,494.374360722809,5,2973,168.180289270098,24,2893,829.588662288282
36917,63,63130,121,Tasa de exámenes médico legales por presunto delito sexual cuando la víctima está entre 18 y 28 años,2022,5,2,12970,15.420200462606,1,6723,14.8743120630671,1,6247,16.0076836881703
36918,63,63190,81,"Tasa de exámenes médico legales por presunto delito sexual contra niños, niñas y adolescentes",2022,2,3,1767,169.779286926995,1,879,113.765642775882,2,888,225.225225225225
36919,63,63190,81,"Tasa de exámenes médico legales por presunto delito sexual contra niños, niñas y adolescentes",2022,3,6,2142,280.11204481792703,1,1095,91.324200913242,5,1047,477.554918815664
36920,63,63190,81,"Tasa de exámenes médico legales por presunto delito sexual contra niños, niñas y adolescentes",2022,4,8,2212,361.663652802893,0,1132,0,8,1080,740.740740740741
36921,63,63190,121,Tasa de exámenes médico legales por presunto delito sexual cuando la víctima está entre 18 y 28 años,2022,5,1,4845,20.6398348813209,1,2366,42.2654268808115,0,2479,0
36922,63,63212,81,"Tasa de exámenes médico legales por presunto delito sexual contra niños, niñas y adolescentes",2022,3,3,491,610.997963340122,1,256,390625,2,235,851.063829787234
36923,63,63212,81,"Tasa de exámenes médico legales por presunto delito sexual contra niños, niñas y adolescentes",2022,4,3,477,628.930817610063,0,254,0,3,223,1345.29147982063
36924,63,63272,81,"Tasa de exámenes médico legales por presunto delito sexual contra niños, niñas y adolescentes",2022,2,1,678,147.492625368732,1,359,278.551532033426,0,319,0
36925,63,63272,81,"Tasa de exámenes médico legales por presunto delito sexual contra niños, niñas y adolescentes",2022,3,3,903,332.225913621262,0,475,0,3,428,700.934579439252
36926,63,63272,81,"Tasa de exámenes médico legales por presunto delito sexual contra niños, niñas y adolescentes",2022,4,3,973,308.324768756423,0,501,0,3,472,635.593220338983
36927,63,63272,121,Tasa de exámenes médico legales por presunto delito sexual cuando la víctima está entre 18 y 28 años,2022,5,2,1933,103.466114847387,1,961,104.058272632674,1,972,102.880658436214
36928,63,63302,81,"Tasa de exámenes médico legales por presunto delito sexual contra niños, niñas y adolescentes",2022,3,6,594,1010.10101010101,2,326,613.496932515337,4,268,1492.53731343284
36929,63,63302,81,"Tasa de exámenes médico legales por presunto delito sexual contra niños, niñas y adolescentes",2022,4,6,602,996.677740863787,0,340,0,6,262,2290.07633587786
36930,63,63401,81,"Tasa de exámenes médico legales por presunto delito sexual contra niños, niñas y adolescentes",2022,2,4,2268,176.36684303351,1,1156,86.5051903114187,3,1112,269.784172661871
36931,63,63401,81,"Tasa de exámenes médico legales por presunto delito sexual contra niños, niñas y adolescentes",2022,3,7,2846,245.959241040056,3,1476,203.252032520325,4,1370,291.970802919708
36932,63,63401,81,"Tasa de exámenes médico legales por presunto delito sexual contra niños, niñas y adolescentes",2022,4,21,3070,684.039087947883,1,1582,63.2111251580278,20,1488,1344.08602150538
36933,63,63401,121,Tasa de exámenes médico legales por presunto delito sexual cuando la víctima está entre 18 y 28 años,2022,5,3,6398,46.8896530165677,0,3204,0,3,3194,93.9261114589856
36934,63,63470,81,"Tasa de exámenes médico legales por presunto delito sexual contra niños, niñas y adolescentes",2022,2,7,2489,281.23744475693,1,1277,78.3085356303837,6,1212,495.049504950495
36935,63,63470,81,"Tasa de exámenes médico legales por presunto delito sexual contra niños, niñas y adolescentes",2022,3,9,3007,299.301629531094,2,1541,129.785853341986,7,1466,477.489768076398
36936,63,63470,81,"Tasa de exámenes médico legales por presunto delito sexual contra niños, niñas y adolescentes",2022,4,12,3096,387.596899224806,1,1578,63.3713561470215,11,1518,724.63768115942
36937,63,63470,121,Tasa de exámenes médico legales por presunto delito sexual cuando la víctima está entre 18 y 28 años,2022,5,1,6673,14.9857635246516,0,3341,0,1,3332,30.0120048019208
36938,63,63548,81,"Tasa de exámenes médico legales por presunto delito sexual contra niños, niñas y adolescentes",2022,2,1,355,281.69014084507,0,199,0,1,156,641.025641025641
36939,63,63548,81,"Tasa de exámenes médico legales por presunto delito sexual contra niños, niñas y adolescentes",2022,3,1,442,226.244343891403,0,244,0,1,198,505.050505050505
36940,63,63548,81,"Tasa de exámenes médico legales por presunto delito sexual contra niños, niñas y adolescentes",2022,4,1,434,230.414746543779,0,230,0,1,204,490.196078431373
36941,63,63548,121,Tasa de exámenes médico legales por presunto delito sexual cuando la víctima está entre 18 y 28 años,2022,5,2,800,250,1,413,242.130750605327,1,387,258.397932816537
36942,63,63594,81,"Tasa de exámenes médico legales por presunto delito sexual contra niños, niñas y adolescentes",2022,2,3,1952,153.688524590164,0,1004,0,3,948,316.455696202532
36943,63,63594,81,"Tasa de exámenes médico legales por presunto delito sexual contra niños, niñas y adolescentes",2022,3,11,2347,468.683425649766,2,1217,164.338537387017,9,1130,796.46017699115
36944,63,63594,81,"Tasa de exámenes médico legales por presunto delito sexual contra niños, niñas y adolescentes",2022,4,12,2409,498.13200498132,1,1239,80.7102502017756,11,1170,940.17094017094
36945,63,63594,121,Tasa de exámenes médico legales por presunto delito sexual cuando la víctima está entre 18 y 28 años,2022,5,3,5275,56.8720379146919,0,2564,0,3,2711,110.660272962007
36946,63,63690,81,"Tasa de exámenes médico legales por presunto delito sexual contra niños, niñas y adolescentes",2022,2,1,580,172.413793103448,0,304,0,1,276,362.31884057971
36947,63,63690,81,"Tasa de exámenes médico legales por presunto delito sexual contra niños, niñas y adolescentes",2022,4,5,711,703.23488045007,0,382,0,5,329,1519.75683890578
36948,63,63690,121,Tasa de exámenes médico legales por presunto delito sexual cuando la víctima está entre 18 y 28 años,2022,5,1,1495,66.8896321070234,0,774,0,1,721,138.69625520111
36949,66,66045,81,"Tasa de exámenes médico legales por presunto delito sexual contra niños, niñas y adolescentes",2022,2,3,795,377.358490566038,0,408,0,3,387,775.193798449612
36950,66,66045,81,"Tasa de exámenes médico legales por presunto delito sexual contra niños, niñas y adolescentes",2022,3,5,1079,463.39202965709,3,576,520.833333333333,2,503,397.614314115308
36951,66,66045,81,"Tasa de exámenes médico legales por presunto delito sexual contra niños, niñas y adolescentes",2022,4,7,1123,623.3303650935,0,614,0,7,509,1375.24557956778
36952,66,66045,121,Tasa de exámenes médico legales por presunto delito sexual cuando la víctima está entre 18 y 28 años,2022,5,3,1958,153.217568947906,0,1033,0,3,925,324.324324324324
36953,66,66075,81,"Tasa de exámenes médico legales por presunto delito sexual contra niños, niñas y adolescentes",2022,4,2,561,356.50623885918,0,297,0,2,264,757.575757575758
36954,66,66088,81,"Tasa de exámenes médico legales por presunto delito sexual contra niños, niñas y adolescentes",2022,2,1,1729,57.8368999421631,0,921,0,1,808,123.762376237624
36955,66,66088,81,"Tasa de exámenes médico legales por presunto delito sexual contra niños, niñas y adolescentes",2022,3,13,2291,567.437800087298,0,1195,0,13,1096,1186.13138686131
36956,66,66088,81,"Tasa de exámenes médico legales por presunto delito sexual contra niños, niñas y adolescentes",2022,4,9,2291,392.841553906591,2,1180,169.491525423729,7,1111,630.06300630063
36957,66,66088,121,Tasa de exámenes médico legales por presunto delito sexual cuando la víctima está entre 18 y 28 años,2022,5,2,3836,52.1376433785193,0,1924,0,2,1912,104.602510460251
36958,66,66170,81,"Tasa de exámenes médico legales por presunto delito sexual contra niños, niñas y adolescentes",2022,2,20,13618,146.864444118079,1,6826,14.6498681511866,19,6792,279.740871613663
36959,66,66170,81,"Tasa de exámenes médico legales por presunto delito sexual contra niños, niñas y adolescentes",2022,3,52,17038,305.200140861603,7,8625,81.1594202898551,45,8413,534.886485201474
36960,66,66170,81,"Tasa de exámenes médico legales por presunto delito sexual contra niños, niñas y adolescentes",2022,4,96,17866,537.333482592634,5,9075,55.0964187327824,91,8791,1035.14958480264
36961,66,66170,121,Tasa de exámenes médico legales por presunto delito sexual cuando la víctima está entre 18 y 28 años,2022,5,14,39222,35.6942532252307,2,19135,10.452051215051,12,20087,59.7401304326181
36962,66,66318,81,"Tasa de exámenes médico legales por presunto delito sexual contra niños, niñas y adolescentes",2022,2,2,783,255.427841634738,0,394,0,2,389,514.13881748072
36963,66,66318,81,"Tasa de exámenes médico legales por presunto delito sexual contra niños, niñas y adolescentes",2022,3,1,1084,92.2509225092251,1,554,180.505415162455,0,530,0
36964,66,66318,81,"Tasa de exámenes médico legales por presunto delito sexual contra niños, niñas y adolescentes",2022,4,3,1121,267.618198037467,0,576,0,3,545,550.45871559633
36965,66,66383,81,"Tasa de exámenes médico legales por presunto delito sexual contra niños, niñas y adolescentes",2022,3,1,631,158.478605388273,0,338,0,1,293,341.296928327645
36966,66,66383,81,"Tasa de exámenes médico legales por presunto delito sexual contra niños, niñas y adolescentes",2022,4,3,623,481.540930979133,0,331,0,3,292,1027.39726027397
36967,66,66400,81,"Tasa de exámenes médico legales por presunto delito sexual contra niños, niñas y adolescentes",2022,3,4,2359,169.563374311149,1,1184,84.4594594594595,3,1175,255.31914893617
36968,66,66400,81,"Tasa de exámenes médico legales por presunto delito sexual contra niños, niñas y adolescentes",2022,4,14,2553,548.37446141794,2,1294,154.559505409583,12,1259,953.137410643368
36969,66,66440,81,"Tasa de exámenes médico legales por presunto delito sexual contra niños, niñas y adolescentes",2022,2,2,1183,169.061707523246,1,601,166.389351081531,1,582,171.821305841924
36970,66,66440,81,"Tasa de exámenes médico legales por presunto delito sexual contra niños, niñas y adolescentes",2022,3,7,1531,457.217504898759,0,773,0,7,758,923.482849604222
36971,66,66440,81,"Tasa de exámenes médico legales por presunto delito sexual contra niños, niñas y adolescentes",2022,4,6,1524,393.700787401575,1,779,128.369704749679,5,745,671.140939597315
36972,66,66440,121,Tasa de exámenes médico legales por presunto delito sexual cuando la víctima está entre 18 y 28 años,2022,5,2,2599,76.9526741054252,0,1326,0,2,1273,157.109190887667
36973,66,66456,81,"Tasa de exámenes médico legales por presunto delito sexual contra niños, niñas y adolescentes",2022,4,3,1996,150.300601202405,0,1003,0,3,993,302.114803625378
36974,66,66001,81,"Tasa de exámenes médico legales por presunto delito sexual contra niños, niñas y adolescentes",2022,2,51,28250,180.530973451327,9,14488,62.1203754831585,42,13762,305.188199389624
36975,66,66001,81,"Tasa de exámenes médico legales por presunto delito sexual contra niños, niñas y adolescentes",2022,3,128,35306,362.544609981306,29,18053,160.638121087908,99,17253,573.813249869588
36976,66,66001,81,"Tasa de exámenes médico legales por presunto delito sexual contra niños, niñas y adolescentes",2022,4,238,37523,634.277643045599,18,19151,93.9898699806799,220,18372,1197.47441759199
36977,66,66001,121,Tasa de exámenes médico legales por presunto delito sexual cuando la víctima está entre 18 y 28 años,2022,5,51,84679,60.2274471828907,5,42206,11.8466568734303,46,42473,108.304099074706
36978,66,66001,81,"Tasa de exámenes médico legales por presunto delito sexual contra niños, niñas y adolescentes",2022,1,2,5106,39.1696043869957,0,2618,0,2,2488,80.3858520900322
36979,66,66572,81,"Tasa de exámenes médico legales por presunto delito sexual contra niños, niñas y adolescentes",2022,3,6,2721,220.507166482911,0,1428,0,6,1293,464.037122969838
36980,66,66572,81,"Tasa de exámenes médico legales por presunto delito sexual contra niños, niñas y adolescentes",2022,4,3,1882,159.404888416578,1,1000,100,2,882,226.757369614512
36981,66,66572,121,Tasa de exámenes médico legales por presunto delito sexual cuando la víctima está entre 18 y 28 años,2022,5,1,2668,37.4812593703148,0,1327,0,1,1341,74.5712155108128
36982,66,66594,81,"Tasa de exámenes médico legales por presunto delito sexual contra niños, niñas y adolescentes",2022,2,1,2206,45.3309156844968,0,1166,0,1,1040,96.1538461538462
36983,66,66594,81,"Tasa de exámenes médico legales por presunto delito sexual contra niños, niñas y adolescentes",2022,3,4,2703,147.983721790603,1,1402,71.3266761768902,3,1301,230.591852421214
36984,66,66594,81,"Tasa de exámenes médico legales por presunto delito sexual contra niños, niñas y adolescentes",2022,4,2,2607,76.7165324127349,0,1351,0,2,1256,159.235668789809
36985,66,66682,81,"Tasa de exámenes médico legales por presunto delito sexual contra niños, niñas y adolescentes",2022,2,3,4655,64.4468313641246,2,2400,83.3333333333333,1,2255,44.3458980044346
36986,66,66682,81,"Tasa de exámenes médico legales por presunto delito sexual contra niños, niñas y adolescentes",2022,3,15,6169,243.151240071324,2,3170,63.0914826498423,13,2999,433.477825941981
36987,66,66682,81,"Tasa de exámenes médico legales por presunto delito sexual contra niños, niñas y adolescentes",2022,4,16,6636,241.109101868596,2,3409,58.6682311528307,14,3227,433.839479392625
36988,66,66682,121,Tasa de exámenes médico legales por presunto delito sexual cuando la víctima está entre 18 y 28 años,2022,5,6,13465,44.5599702933531,0,6802,0,6,6663,90.049527239982
36989,66,66687,81,"Tasa de exámenes médico legales por presunto delito sexual contra niños, niñas y adolescentes",2022,2,2,781,256.081946222791,0,399,0,2,382,523.560209424084
36990,66,66687,81,"Tasa de exámenes médico legales por presunto delito sexual contra niños, niñas y adolescentes",2022,3,1,1125,88.8888888888889,1,580,172.413793103448,0,545,0
36991,66,66687,81,"Tasa de exámenes médico legales por presunto delito sexual contra niños, niñas y adolescentes",2022,4,2,1194,167.50418760469,0,625,0,2,569,351.493848857645
36992,66,66687,121,Tasa de exámenes médico legales por presunto delito sexual cuando la víctima está entre 18 y 28 años,2022,5,1,1875,53.3333333333333,0,948,0,1,927,107.874865156419
36993,68,68013,81,"Tasa de exámenes médico legales por presunto delito sexual contra niños, niñas y adolescentes",2022,4,1,144,694.444444444444,0,81,0,1,63,1587.30158730159
36994,68,68051,81,"Tasa de exámenes médico legales por presunto delito sexual contra niños, niñas y adolescentes",2022,4,4,823,486.026731470231,1,424,235.849056603774,3,399,751.87969924812
36995,68,68051,121,Tasa de exámenes médico legales por presunto delito sexual cuando la víctima está entre 18 y 28 años,2022,5,1,1441,69.3962526023595,0,747,0,1,694,144.092219020173
36996,68,68077,81,"Tasa de exámenes médico legales por presunto delito sexual contra niños, niñas y adolescentes",2022,2,1,2231,44.8229493500672,0,1187,0,1,1044,95.7854406130268
36997,68,68077,81,"Tasa de exámenes médico legales por presunto delito sexual contra niños, niñas y adolescentes",2022,3,6,2947,203.596878181201,2,1533,130.463144161774,4,1414,282.885431400283
36998,68,68077,81,"Tasa de exámenes médico legales por presunto delito sexual contra niños, niñas y adolescentes",2022,4,13,3100,419.354838709677,1,1589,62.9326620516048,12,1511,794.176042356056
36999,68,68077,121,Tasa de exámenes médico legales por presunto delito sexual cuando la víctima está entre 18 y 28 años,2022,5,3,5588,53.6864710093057,0,2757,0,3,2831,105.969622041681
37000,68,68079,81,"Tasa de exámenes médico legales por presunto delito sexual contra niños, niñas y adolescentes",2022,3,1,929,107.642626480086,1,459,217.864923747277,0,470,0
37001,68,68079,81,"Tasa de exámenes médico legales por presunto delito sexual contra niños, niñas y adolescentes",2022,4,2,903,221.483942414175,0,451,0,2,452,442.477876106195
37002,68,68081,81,"Tasa de exámenes médico legales por presunto delito sexual contra niños, niñas y adolescentes",2022,2,9,17344,51.8911439114391,2,8825,22.6628895184136,7,8519,82.1692686935086
37003,68,68081,81,"Tasa de exámenes médico legales por presunto delito sexual contra niños, niñas y adolescentes",2022,3,34,20820,163.304514889529,3,10623,28.2406099971759,31,10197,304.010983622634
37004,68,68081,81,"Tasa de exámenes médico legales por presunto delito sexual contra niños, niñas y adolescentes",2022,4,65,19871,327.109858587892,4,10225,39.119804400978,61,9646,632.386481443085
37005,68,68081,121,Tasa de exámenes médico legales por presunto delito sexual cuando la víctima está entre 18 y 28 años,2022,5,21,38271,54.8718350709414,0,19242,0,21,19029,110.357874822639
37006,68,68092,81,"Tasa de exámenes médico legales por presunto delito sexual contra niños, niñas y adolescentes",2022,3,1,648,154.320987654321,0,333,0,1,315,317.460317460317
37007,68,68092,81,"Tasa de exámenes médico legales por presunto delito sexual contra niños, niñas y adolescentes",2022,4,1,610,163.934426229508,0,319,0,1,291,343.642611683849
37008,68,68092,121,Tasa de exámenes médico legales por presunto delito sexual cuando la víctima está entre 18 y 28 años,2022,5,1,982,101.83299389002,1,529,189.035916824197,0,453,0
37009,68,68101,81,"Tasa de exámenes médico legales por presunto delito sexual contra niños, niñas y adolescentes",2022,3,1,1117,89.5255147717099,0,578,0,1,539,185.528756957328
37010,68,68101,81,"Tasa de exámenes médico legales por presunto delito sexual contra niños, niñas y adolescentes",2022,4,1,1189,84.1042893187552,0,611,0,1,578,173.010380622837
37011,68,68001,81,"Tasa de exámenes médico legales por presunto delito sexual contra niños, niñas y adolescentes",2022,2,29,36465,79.5283148224325,10,18650,53.6193029490617,19,17815,106.651698007297
37012,68,68001,81,"Tasa de exámenes médico legales por presunto delito sexual contra niños, niñas y adolescentes",2022,3,56,45650,122.672508214677,10,23241,43.0274084591885,46,22409,205.274666428667
37013,68,68001,81,"Tasa de exámenes médico legales por presunto delito sexual contra niños, niñas y adolescentes",2022,4,102,49354,206.670178708919,13,25110,51.7722023098367,89,24244,367.101138426002
37014,68,68001,121,Tasa de exámenes médico legales por presunto delito sexual cuando la víctima está entre 18 y 28 años,2022,5,26,116185,22.3781038860438,2,58609,3.41244518759917,24,57576,41.6840350145894
37015,68,68147,81,"Tasa de exámenes médico legales por presunto delito sexual contra niños, niñas y adolescentes",2022,3,1,490,204.081632653061,0,267,0,1,223,448.430493273543
37016,68,68147,81,"Tasa de exámenes médico legales por presunto delito sexual contra niños, niñas y adolescentes",2022,4,1,511,195.694716242661,1,276,362.31884057971,0,235,0
37017,68,68152,81,"Tasa de exámenes médico legales por presunto delito sexual contra niños, niñas y adolescentes",2022,4,1,452,221.238938053097,0,250,0,1,202,495.049504950495
37018,68,68162,121,Tasa de exámenes médico legales por presunto delito sexual cuando la víctima está entre 18 y 28 años,2022,5,1,1188,84.1750841750842,0,659,0,1,529,189.035916824197
37019,68,68167,81,"Tasa de exámenes médico legales por presunto delito sexual contra niños, niñas y adolescentes",2022,2,1,884,113.122171945701,0,443,0,1,441,226.757369614512
37020,68,68167,81,"Tasa de exámenes médico legales por presunto delito sexual contra niños, niñas y adolescentes",2022,3,3,1147,261.5518744551,2,594,336.700336700337,1,553,180.831826401447
37021,68,68167,81,"Tasa de exámenes médico legales por presunto delito sexual contra niños, niñas y adolescentes",2022,4,3,1134,264.550264550265,0,599,0,3,535,560.747663551402
37022,68,68167,121,Tasa de exámenes médico legales por presunto delito sexual cuando la víctima está entre 18 y 28 años,2022,5,2,1752,114.155251141553,1,886,112.866817155756,1,866,115.473441108545
37023,68,68169,81,"Tasa de exámenes médico legales por presunto delito sexual contra niños, niñas y adolescentes",2022,2,1,212,471.698113207547,1,107,934.579439252336,0,105,0
37024,68,68190,81,"Tasa de exámenes médico legales por presunto delito sexual contra niños, niñas y adolescentes",2022,2,2,2736,73.0994152046784,0,1395,0,2,1341,149.142431021626
37025,68,68190,81,"Tasa de exámenes médico legales por presunto delito sexual contra niños, niñas y adolescentes",2022,3,9,3616,248.893805309735,0,1818,0,9,1798,500.55617352614
37026,68,68190,81,"Tasa de exámenes médico legales por presunto delito sexual contra niños, niñas y adolescentes",2022,4,18,3643,494.098270656053,2,1808,110.619469026549,16,1835,871.934604904632
37027,68,68190,121,Tasa de exámenes médico legales por presunto delito sexual cuando la víctima está entre 18 y 28 años,2022,5,3,7012,42.7837992013691,0,3936,0,3,3076,97.5292587776333
37028,68,68207,81,"Tasa de exámenes médico legales por presunto delito sexual contra niños, niñas y adolescentes",2022,4,2,556,359.712230215827,0,274,0,2,282,709.219858156028
37029,68,68209,81,"Tasa de exámenes médico legales por presunto delito sexual contra niños, niñas y adolescentes",2022,3,1,327,305.810397553517,0,169,0,1,158,632.911392405063
37030,68,68209,81,"Tasa de exámenes médico legales por presunto delito sexual contra niños, niñas y adolescentes",2022,4,1,273,366.300366300366,0,144,0,1,129,775.193798449612
37031,68,68229,81,"Tasa de exámenes médico legales por presunto delito sexual contra niños, niñas y adolescentes",2022,2,2,958,208.768267223382,0,485,0,2,473,422.832980972516
37032,68,68229,81,"Tasa de exámenes médico legales por presunto delito sexual contra niños, niñas y adolescentes",2022,3,1,1208,82.7814569536424,1,600,166.666666666667,0,608,0
37033,68,68229,81,"Tasa de exámenes médico legales por presunto delito sexual contra niños, niñas y adolescentes",2022,4,5,1191,419.815281276238,0,591,0,5,600,833.333333333333
37034,68,68235,81,"Tasa de exámenes médico legales por presunto delito sexual contra niños, niñas y adolescentes",2022,2,8,1799,444.691495275153,4,896,446.428571428571,4,903,442.96788482835
37035,68,68235,81,"Tasa de exámenes médico legales por presunto delito sexual contra niños, niñas y adolescentes",2022,3,15,2356,636.672325976231,5,1175,425.531914893617,10,1181,846.740050804403
37036,68,68235,81,"Tasa de exámenes médico legales por presunto delito sexual contra niños, niñas y adolescentes",2022,4,11,2353,467.48831279218,2,1199,166.805671392827,9,1154,779.896013864818
37037,68,68235,121,Tasa de exámenes médico legales por presunto delito sexual cuando la víctima está entre 18 y 28 años,2022,5,1,3702,27.0124257158293,0,1914,0,1,1788,55.9284116331096
37038,68,68245,81,"Tasa de exámenes médico legales por presunto delito sexual contra niños, niñas y adolescentes",2022,2,1,139,719.424460431655,0,56,0,1,83,1204.81927710843
37039,68,68245,81,"Tasa de exámenes médico legales por presunto delito sexual contra niños, niñas y adolescentes",2022,3,1,209,478.468899521531,0,99,0,1,110,909.090909090909
37040,68,68245,81,"Tasa de exámenes médico legales por presunto delito sexual contra niños, niñas y adolescentes",2022,4,3,217,1382.48847926267,1,112,892.857142857143,2,105,1904.76190476191
37041,68,68250,121,Tasa de exámenes médico legales por presunto delito sexual cuando la víctima está entre 18 y 28 años,2022,5,1,903,110.741971207087,0,502,0,1,401,249.376558603491
37042,68,68255,81,"Tasa de exámenes médico legales por presunto delito sexual contra niños, niñas y adolescentes",2022,2,1,1136,88.0281690140845,1,579,172.711571675302,0,557,0
37043,68,68255,81,"Tasa de exámenes médico legales por presunto delito sexual contra niños, niñas y adolescentes",2022,3,8,1471,543.847722637661,6,765,784.313725490196,2,706,283.28611898017
37044,68,68255,81,"Tasa de exámenes médico legales por presunto delito sexual contra niños, niñas y adolescentes",2022,4,10,1495,668.896321070234,1,783,127.713920817369,9,712,1264.04494382022
37045,68,68255,121,Tasa de exámenes médico legales por presunto delito sexual cuando la víctima está entre 18 y 28 años,2022,5,2,2396,83.4724540901503,0,1232,0,2,1164,171.821305841924
37046,68,68266,81,"Tasa de exámenes médico legales por presunto delito sexual contra niños, niñas y adolescentes",2022,4,1,323,309.597523219814,0,175,0,1,148,675.675675675676
37047,68,68271,81,"Tasa de exámenes médico legales por presunto delito sexual contra niños, niñas y adolescentes",2022,2,2,385,519.480519480519,0,208,0,2,177,1129.94350282486
37048,68,68271,81,"Tasa de exámenes médico legales por presunto delito sexual contra niños, niñas y adolescentes",2022,3,2,607,329.489291598023,0,312,0,2,295,677.966101694915
37049,68,68271,81,"Tasa de exámenes médico legales por presunto delito sexual contra niños, niñas y adolescentes",2022,4,2,645,310.077519379845,0,327,0,2,318,628.930817610063
37050,68,68276,81,"Tasa de exámenes médico legales por presunto delito sexual contra niños, niñas y adolescentes",2022,2,8,20565,38.9010454655969,3,10609,28.2778772740126,5,9956,50.2209722780233
37051,68,68276,81,"Tasa de exámenes médico legales por presunto delito sexual contra niños, niñas y adolescentes",2022,3,17,25808,65.8710477371358,2,13220,15.1285930408472,15,12588,119.161105815062
37052,68,68276,81,"Tasa de exámenes médico legales por presunto delito sexual contra niños, niñas y adolescentes",2022,4,27,27440,98.3965014577259,2,13864,14.4258511252164,25,13576,184.148497348262
37053,68,68276,121,Tasa de exámenes médico legales por presunto delito sexual cuando la víctima está entre 18 y 28 años,2022,5,5,61585,8.11886011204027,0,30465,0,5,31120,16.0668380462725
37054,68,68298,81,"Tasa de exámenes médico legales por presunto delito sexual contra niños, niñas y adolescentes",2022,2,1,350,285.714285714286,0,165,0,1,185,540.540540540541
37055,68,68298,81,"Tasa de exámenes médico legales por presunto delito sexual contra niños, niñas y adolescentes",2022,3,3,435,689.655172413793,1,224,446.428571428571,2,211,947.867298578199
37056,68,68298,81,"Tasa de exámenes médico legales por presunto delito sexual contra niños, niñas y adolescentes",2022,4,5,405,1234.56790123457,0,219,0,5,186,2688.17204301075
37057,68,68307,81,"Tasa de exámenes médico legales por presunto delito sexual contra niños, niñas y adolescentes",2022,2,6,12292,48.8122356003905,2,6313,31.6806589577063,4,5979,66.9008195350393
37058,68,68307,81,"Tasa de exámenes médico legales por presunto delito sexual contra niños, niñas y adolescentes",2022,3,14,15141,92.464170134073,3,7719,38.8651379712398,11,7422,148.208030180544
37059,68,68307,81,"Tasa de exámenes médico legales por presunto delito sexual contra niños, niñas y adolescentes",2022,4,33,15433,213.827512473272,4,7792,51.3347022587269,29,7641,379.531474937835
37060,68,68307,121,Tasa de exámenes médico legales por presunto delito sexual cuando la víctima está entre 18 y 28 años,2022,5,8,33436,23.9263069745185,1,16755,5.96836765144733,7,16681,41.9639110365086
37061,68,68320,81,"Tasa de exámenes médico legales por presunto delito sexual contra niños, niñas y adolescentes",2022,3,1,418,239.234449760766,0,214,0,1,204,490.196078431373
37062,68,68320,81,"Tasa de exámenes médico legales por presunto delito sexual contra niños, niñas y adolescentes",2022,4,3,443,677.200902934537,0,223,0,3,220,1363.63636363636
37063,68,68322,81,"Tasa de exámenes médico legales por presunto delito sexual contra niños, niñas y adolescentes",2022,3,3,225,1333.33333333333,0,90,0,3,135,2222.22222222222
37064,68,68324,81,"Tasa de exámenes médico legales por presunto delito sexual contra niños, niñas y adolescentes",2022,3,2,308,649.350649350649,0,157,0,2,151,1324.50331125828
37065,68,68327,81,"Tasa de exámenes médico legales por presunto delito sexual contra niños, niñas y adolescentes",2022,2,1,347,288.184438040346,1,181,552.486187845304,0,166,0
37066,68,68327,81,"Tasa de exámenes médico legales por presunto delito sexual contra niños, niñas y adolescentes",2022,3,1,447,223.713646532438,0,233,0,1,214,467.289719626168
37067,68,68327,81,"Tasa de exámenes médico legales por presunto delito sexual contra niños, niñas y adolescentes",2022,4,2,489,408.997955010225,0,242,0,2,247,809.716599190283
37068,68,68327,121,Tasa de exámenes médico legales por presunto delito sexual cuando la víctima está entre 18 y 28 años,2022,5,1,894,111.856823266219,0,453,0,1,441,226.757369614512
37069,68,68344,81,"Tasa de exámenes médico legales por presunto delito sexual contra niños, niñas y adolescentes",2022,2,1,172,581.395348837209,0,103,0,1,69,1449.27536231884
37070,68,68344,81,"Tasa de exámenes médico legales por presunto delito sexual contra niños, niñas y adolescentes",2022,3,1,231,432.900432900433,1,124,806.451612903226,0,107,0
37071,68,68344,81,"Tasa de exámenes médico legales por presunto delito sexual contra niños, niñas y adolescentes",2022,4,1,223,448.430493273543,0,113,0,1,110,909.090909090909
37072,68,68344,121,Tasa de exámenes médico legales por presunto delito sexual cuando la víctima está entre 18 y 28 años,2022,5,1,348,287.35632183908,1,200,500,0,148,0
37073,68,68377,81,"Tasa de exámenes médico legales por presunto delito sexual contra niños, niñas y adolescentes",2022,2,1,436,229.357798165138,0,215,0,1,221,452.488687782805
37074,68,68377,81,"Tasa de exámenes médico legales por presunto delito sexual contra niños, niñas y adolescentes",2022,3,4,623,642.054574638844,1,313,319.488817891374,3,310,967.741935483871
37075,68,68385,81,"Tasa de exámenes médico legales por presunto delito sexual contra niños, niñas y adolescentes",2022,2,1,756,132.275132275132,0,404,0,1,352,284.090909090909
37076,68,68385,81,"Tasa de exámenes médico legales por presunto delito sexual contra niños, niñas y adolescentes",2022,3,8,1046,764.818355640535,1,540,185.185185185185,7,506,1383.39920948617
37077,68,68385,81,"Tasa de exámenes médico legales por presunto delito sexual contra niños, niñas y adolescentes",2022,4,11,1072,1026.11940298507,0,551,0,11,521,2111.32437619962
37078,68,68406,81,"Tasa de exámenes médico legales por presunto delito sexual contra niños, niñas y adolescentes",2022,2,1,3433,29.1290416545296,0,1734,0,1,1699,58.8581518540318
37079,68,68406,81,"Tasa de exámenes médico legales por presunto delito sexual contra niños, niñas y adolescentes",2022,3,2,4282,46.7071461933676,0,2153,0,2,2129,93.9408172851104
37080,68,68406,81,"Tasa de exámenes médico legales por presunto delito sexual contra niños, niñas y adolescentes",2022,4,5,4307,116.090085906664,1,2180,45.8715596330275,4,2127,188.058298072402
37081,68,68406,121,Tasa de exámenes médico legales por presunto delito sexual cuando la víctima está entre 18 y 28 años,2022,5,2,8587,23.2910213112845,0,4408,0,2,4179,47.8583393156257
37082,68,68418,81,"Tasa de exámenes médico legales por presunto delito sexual contra niños, niñas y adolescentes",2022,4,1,1488,67.2043010752688,0,748,0,1,740,135.135135135135
37083,68,68418,121,Tasa de exámenes médico legales por presunto delito sexual cuando la víctima está entre 18 y 28 años,2022,5,2,2514,79.5544948289578,0,1274,0,2,1240,161.290322580645
37084,68,68432,81,"Tasa de exámenes médico legales por presunto delito sexual contra niños, niñas y adolescentes",2022,3,1,1945,51.413881748072,0,1003,0,1,942,106.157112526539
37085,68,68432,81,"Tasa de exámenes médico legales por presunto delito sexual contra niños, niñas y adolescentes",2022,4,2,2133,93.7646507266761,0,1094,0,2,1039,192.492781520693
37086,68,68444,81,"Tasa de exámenes médico legales por presunto delito sexual contra niños, niñas y adolescentes",2022,3,1,445,224.719101123596,0,242,0,1,203,492.610837438424
37087,68,68444,121,Tasa de exámenes médico legales por presunto delito sexual cuando la víctima está entre 18 y 28 años,2022,5,1,730,136.986301369863,0,372,0,1,358,279.329608938547
37088,68,68464,81,"Tasa de exámenes médico legales por presunto delito sexual contra niños, niñas y adolescentes",2022,3,3,1132,265.017667844523,0,567,0,3,565,530.973451327434
37089,68,68464,81,"Tasa de exámenes médico legales por presunto delito sexual contra niños, niñas y adolescentes",2022,4,5,1077,464.252553389044,2,552,362.31884057971,3,525,571.428571428571
37090,68,68498,81,"Tasa de exámenes médico legales por presunto delito sexual contra niños, niñas y adolescentes",2022,3,1,581,172.117039586919,1,306,326.797385620915,0,275,0
37091,68,68498,81,"Tasa de exámenes médico legales por presunto delito sexual contra niños, niñas y adolescentes",2022,4,2,583,343.053173241853,0,304,0,2,279,716.845878136201
37092,68,68500,81,"Tasa de exámenes médico legales por presunto delito sexual contra niños, niñas y adolescentes",2022,3,2,996,200.803212851406,0,513,0,2,483,414.07867494824
37093,68,68500,81,"Tasa de exámenes médico legales por presunto delito sexual contra niños, niñas y adolescentes",2022,4,5,1024,488.28125,0,525,0,5,499,1002.00400801603
37094,68,68522,81,"Tasa de exámenes médico legales por presunto delito sexual contra niños, niñas y adolescentes",2022,4,1,140,714.285714285714,0,80,0,1,60,1666.66666666667
37095,68,68533,81,"Tasa de exámenes médico legales por presunto delito sexual contra niños, niñas y adolescentes",2022,3,1,474,210.970464135021,1,246,406.50406504065,0,228,0
37096,68,68547,81,"Tasa de exámenes médico legales por presunto delito sexual contra niños, niñas y adolescentes",2022,2,6,13217,45.3960808050238,0,6816,0,6,6401,93.7353538509608
37097,68,68547,81,"Tasa de exámenes médico legales por presunto delito sexual contra niños, niñas y adolescentes",2022,3,9,16452,54.7045951859956,2,8452,23.6630383341221,7,8000,87.5
37098,68,68547,81,"Tasa de exámenes médico legales por presunto delito sexual contra niños, niñas y adolescentes",2022,4,24,16839,142.526278282558,0,8619,0,24,8220,291.970802919708
37099,68,68547,121,Tasa de exámenes médico legales por presunto delito sexual cuando la víctima está entre 18 y 28 años,2022,5,2,35172,5.68634140793813,0,17592,0,2,17580,11.3765642775882
37100,68,68547,81,"Tasa de exámenes médico legales por presunto delito sexual contra niños, niñas y adolescentes",2022,1,1,2426,41.2201154163232,1,1249,80.0640512409928,0,1177,0
37101,68,68549,81,"Tasa de exámenes médico legales por presunto delito sexual contra niños, niñas y adolescentes",2022,4,2,474,421.940928270042,0,253,0,2,221,904.977375565611
37102,68,68549,121,Tasa de exámenes médico legales por presunto delito sexual cuando la víctima está entre 18 y 28 años,2022,5,1,824,121.359223300971,0,427,0,1,397,251.889168765743
37103,68,68572,81,"Tasa de exámenes médico legales por presunto delito sexual contra niños, niñas y adolescentes",2022,3,3,1251,239.808153477218,0,631,0,3,620,483.870967741935
37104,68,68572,81,"Tasa de exámenes médico legales por presunto delito sexual contra niños, niñas y adolescentes",2022,4,4,1391,287.562904385334,1,722,138.504155124654,3,669,448.430493273543
37105,68,68573,81,"Tasa de exámenes médico legales por presunto delito sexual contra niños, niñas y adolescentes",2022,2,5,832,600.961538461538,2,421,475.059382422803,3,411,729.92700729927
37106,68,68573,81,"Tasa de exámenes médico legales por presunto delito sexual contra niños, niñas y adolescentes",2022,3,4,935,427.807486631016,1,461,216.919739696312,3,474,632.911392405063
37107,68,68573,81,"Tasa de exámenes médico legales por presunto delito sexual contra niños, niñas y adolescentes",2022,4,2,790,253.164556962025,0,389,0,2,401,498.753117206983
37108,68,68573,121,Tasa de exámenes médico legales por presunto delito sexual cuando la víctima está entre 18 y 28 años,2022,5,1,1323,75.5857898715042,0,678,0,1,645,155.038759689922
37109,68,68575,81,"Tasa de exámenes médico legales por presunto delito sexual contra niños, niñas y adolescentes",2022,2,1,3403,29.385836027035,0,1758,0,1,1645,60.790273556231
37110,68,68575,81,"Tasa de exámenes médico legales por presunto delito sexual contra niños, niñas y adolescentes",2022,3,5,4102,121.891760117016,1,2119,47.192071731949,4,1983,201.714573877963
37111,68,68575,81,"Tasa de exámenes médico legales por presunto delito sexual contra niños, niñas y adolescentes",2022,4,6,3749,160.042678047479,3,1951,153.767298821117,3,1798,166.852057842047
37112,68,68575,121,Tasa de exámenes médico legales por presunto delito sexual cuando la víctima está entre 18 y 28 años,2022,5,3,6016,49.8670212765957,1,3036,32.9380764163373,2,2980,67.1140939597315
37113,68,68615,81,"Tasa de exámenes médico legales por presunto delito sexual contra niños, niñas y adolescentes",2022,2,1,2118,47.2143531633617,0,1101,0,1,1017,98.3284169124877
37114,68,68615,81,"Tasa de exámenes médico legales por presunto delito sexual contra niños, niñas y adolescentes",2022,3,9,2609,344.959754695286,0,1346,0,9,1263,712.589073634204
37115,68,68615,81,"Tasa de exámenes médico legales por presunto delito sexual contra niños, niñas y adolescentes",2022,4,13,2497,520.62474969964,2,1308,152.905198776758,11,1189,925.147182506308
37116,68,68615,121,Tasa de exámenes médico legales por presunto delito sexual cuando la víctima está entre 18 y 28 años,2022,5,1,4242,23.5737859500236,0,2225,0,1,2017,49.5785820525533
37117,68,68655,81,"Tasa de exámenes médico legales por presunto delito sexual contra niños, niñas y adolescentes",2022,3,14,3950,354.430379746835,0,2014,0,14,1936,723.140495867769
37118,68,68655,81,"Tasa de exámenes médico legales por presunto delito sexual contra niños, niñas y adolescentes",2022,4,16,3534,452.744765138653,3,1785,168.067226890756,13,1749,743.281875357347
37119,68,68669,81,"Tasa de exámenes médico legales por presunto delito sexual contra niños, niñas y adolescentes",2022,3,2,765,261.437908496732,0,405,0,2,360,555.555555555556
37120,68,68669,81,"Tasa de exámenes médico legales por presunto delito sexual contra niños, niñas y adolescentes",2022,4,4,772,518.134715025907,0,430,0,4,342,1169.59064327485
37121,68,68673,81,"Tasa de exámenes médico legales por presunto delito sexual contra niños, niñas y adolescentes",2022,3,1,238,420.168067226891,0,116,0,1,122,819.672131147541
37122,68,68673,81,"Tasa de exámenes médico legales por presunto delito sexual contra niños, niñas y adolescentes",2022,4,1,251,398.406374501992,0,131,0,1,120,833.333333333333
37123,68,68679,81,"Tasa de exámenes médico legales por presunto delito sexual contra niños, niñas y adolescentes",2022,2,3,4190,71.5990453460621,1,2135,46.8384074941452,2,2055,97.323600973236
37124,68,68679,81,"Tasa de exámenes médico legales por presunto delito sexual contra niños, niñas y adolescentes",2022,3,10,5253,190.367409099562,1,2667,37.4953130858643,9,2586,348.027842227378
37125,68,68679,81,"Tasa de exámenes médico legales por presunto delito sexual contra niños, niñas y adolescentes",2022,4,11,5327,206.495213065515,0,2680,0,11,2647,415.564790328674
37126,68,68679,121,Tasa de exámenes médico legales por presunto delito sexual cuando la víctima está entre 18 y 28 años,2022,5,4,10941,36.559729458002,1,5382,18.5804533630621,3,5559,53.9665407447383
37127,68,68684,81,"Tasa de exámenes médico legales por presunto delito sexual contra niños, niñas y adolescentes",2022,4,4,424,943.396226415094,0,221,0,4,203,1970.44334975369
37128,68,68689,81,"Tasa de exámenes médico legales por presunto delito sexual contra niños, niñas y adolescentes",2022,2,3,2620,114.503816793893,1,1351,74.019245003701,2,1269,157.604412923562
37129,68,68689,81,"Tasa de exámenes médico legales por presunto delito sexual contra niños, niñas y adolescentes",2022,3,8,3481,229.8190175237,1,1799,55.5864369093941,7,1682,416.171224732461
37130,68,68689,81,"Tasa de exámenes médico legales por presunto delito sexual contra niños, niñas y adolescentes",2022,4,12,3613,332.133960697481,1,1915,52.2193211488251,11,1698,647.820965842167
37131,68,68689,121,Tasa de exámenes médico legales por presunto delito sexual cuando la víctima está entre 18 y 28 años,2022,5,1,5972,16.7448091091762,0,3202,0,1,2770,36.101083032491
37132,68,68705,81,"Tasa de exámenes médico legales por presunto delito sexual contra niños, niñas y adolescentes",2022,4,1,220,454.545454545455,0,128,0,1,92,1086.95652173913
37133,68,68720,81,"Tasa de exámenes médico legales por presunto delito sexual contra niños, niñas y adolescentes",2022,4,1,380,263.157894736842,0,209,0,1,171,584.795321637427
37134,68,68745,81,"Tasa de exámenes médico legales por presunto delito sexual contra niños, niñas y adolescentes",2022,4,1,1037,96.4320154291225,1,539,185.528756957328,0,498,0
37135,68,68745,121,Tasa de exámenes médico legales por presunto delito sexual cuando la víctima está entre 18 y 28 años,2022,5,1,1569,63.7348629700446,0,895,0,1,674,148.367952522255
37136,68,68755,81,"Tasa de exámenes médico legales por presunto delito sexual contra niños, niñas y adolescentes",2022,2,1,2069,48.3325277912035,0,975,0,1,1094,91.4076782449726
37137,68,68755,81,"Tasa de exámenes médico legales por presunto delito sexual contra niños, niñas y adolescentes",2022,4,2,3228,61.9578686493185,0,1679,0,2,1549,129.11555842479
37138,68,68755,121,Tasa de exámenes médico legales por presunto delito sexual cuando la víctima está entre 18 y 28 años,2022,5,5,6512,76.7813267813268,2,3379,59.1891092039065,3,3133,95.7548675390999
37139,68,68770,81,"Tasa de exámenes médico legales por presunto delito sexual contra niños, niñas y adolescentes",2022,2,4,657,608.82800608828,2,335,597.014925373134,2,322,621.11801242236
37140,68,68770,81,"Tasa de exámenes médico legales por presunto delito sexual contra niños, niñas y adolescentes",2022,3,9,886,1015.80135440181,6,463,1295.89632829374,3,423,709.219858156028
37141,68,68770,81,"Tasa de exámenes médico legales por presunto delito sexual contra niños, niñas y adolescentes",2022,4,11,907,1212.78941565601,1,482,207.46887966805,10,425,2352.94117647059
37142,68,68770,81,"Tasa de exámenes médico legales por presunto delito sexual contra niños, niñas y adolescentes",2022,1,1,118,847.457627118644,0,59,0,1,59,1694.91525423729
37143,68,68773,81,"Tasa de exámenes médico legales por presunto delito sexual contra niños, niñas y adolescentes",2022,3,2,693,288.600288600289,0,376,0,2,317,630.914826498423
37144,68,68773,81,"Tasa de exámenes médico legales por presunto delito sexual contra niños, niñas y adolescentes",2022,4,3,722,415.512465373961,0,421,0,3,301,996.677740863787
37145,68,68780,81,"Tasa de exámenes médico legales por presunto delito sexual contra niños, niñas y adolescentes",2022,4,3,337,890.207715133531,0,185,0,3,152,1973.68421052632
37146,68,68820,81,"Tasa de exámenes médico legales por presunto delito sexual contra niños, niñas y adolescentes",2022,3,1,740,135.135135135135,0,378,0,1,362,276.243093922652
37147,68,68855,81,"Tasa de exámenes médico legales por presunto delito sexual contra niños, niñas y adolescentes",2022,4,1,604,165.562913907285,0,318,0,1,286,349.65034965035
37148,68,68861,81,"Tasa de exámenes médico legales por presunto delito sexual contra niños, niñas y adolescentes",2022,2,3,1259,238.284352660842,1,623,160.513643659711,2,636,314.465408805031
37149,68,68861,81,"Tasa de exámenes médico legales por presunto delito sexual contra niños, niñas y adolescentes",2022,3,8,1891,423.056583818086,2,942,212.314225053079,6,949,632.244467860906
37150,68,68861,81,"Tasa de exámenes médico legales por presunto delito sexual contra niños, niñas y adolescentes",2022,4,5,2200,227.272727272727,0,1117,0,5,1083,461.680517082179
37151,68,68872,81,"Tasa de exámenes médico legales por presunto delito sexual contra niños, niñas y adolescentes",2022,3,1,748,133.689839572193,0,393,0,1,355,281.69014084507
37152,68,68872,81,"Tasa de exámenes médico legales por presunto delito sexual contra niños, niñas y adolescentes",2022,4,1,776,128.865979381443,0,396,0,1,380,263.157894736842
37153,68,68895,81,"Tasa de exámenes médico legales por presunto delito sexual contra niños, niñas y adolescentes",2022,3,1,922,108.459869848156,0,476,0,1,446,224.215246636771
37154,68,68895,81,"Tasa de exámenes médico legales por presunto delito sexual contra niños, niñas y adolescentes",2022,4,1,887,112.739571589628,0,473,0,1,414,241.545893719807
37155,70,70110,81,"Tasa de exámenes médico legales por presunto delito sexual contra niños, niñas y adolescentes",2022,3,2,1180,169.491525423729,0,578,0,2,602,332.225913621262
37156,70,70110,81,"Tasa de exámenes médico legales por presunto delito sexual contra niños, niñas y adolescentes",2022,4,1,1196,83.6120401337793,0,576,0,1,620,161.290322580645
37157,70,70124,81,"Tasa de exámenes médico legales por presunto delito sexual contra niños, niñas y adolescentes",2022,3,1,1781,56.1482313307131,0,900,0,1,881,113.507377979569
37158,70,70124,81,"Tasa de exámenes médico legales por presunto delito sexual contra niños, niñas y adolescentes",2022,4,2,1928,103.734439834025,1,977,102.354145342886,1,951,105.15247108307
37159,70,70124,121,Tasa de exámenes médico legales por presunto delito sexual cuando la víctima está entre 18 y 28 años,2022,5,1,3273,30.5530094714329,0,1683,0,1,1590,62.8930817610063
37160,70,70230,81,"Tasa de exámenes médico legales por presunto delito sexual contra niños, niñas y adolescentes",2022,4,1,533,187.617260787993,0,275,0,1,258,387.596899224806
37161,70,70230,121,Tasa de exámenes médico legales por presunto delito sexual cuando la víctima está entre 18 y 28 años,2022,5,1,851,117.508813160987,0,468,0,1,383,261.096605744125
37162,70,70204,81,"Tasa de exámenes médico legales por presunto delito sexual contra niños, niñas y adolescentes",2022,4,2,941,212.539851222104,0,487,0,2,454,440.528634361234
37163,70,70215,81,"Tasa de exámenes médico legales por presunto delito sexual contra niños, niñas y adolescentes",2022,2,4,5014,79.7766254487435,1,2512,39.8089171974522,3,2502,119.904076738609
37164,70,70215,81,"Tasa de exámenes médico legales por presunto delito sexual contra niños, niñas y adolescentes",2022,3,8,6547,122.193371009623,0,3273,0,8,3274,244.349419670128
37165,70,70215,81,"Tasa de exámenes médico legales por presunto delito sexual contra niños, niñas y adolescentes",2022,4,16,7027,227.693183435321,0,3599,0,16,3428,466.744457409568
37166,70,70215,121,Tasa de exámenes médico legales por presunto delito sexual cuando la víctima está entre 18 y 28 años,2022,5,2,12695,15.7542339503742,1,6583,15.1906425641805,1,6112,16.3612565445026
37167,70,70221,81,"Tasa de exámenes médico legales por presunto delito sexual contra niños, niñas y adolescentes",2022,2,1,1522,65.7030223390276,0,799,0,1,723,138.312586445367
37168,70,70221,81,"Tasa de exámenes médico legales por presunto delito sexual contra niños, niñas y adolescentes",2022,3,6,1895,316.622691292876,0,991,0,6,904,663.716814159292
37169,70,70221,81,"Tasa de exámenes médico legales por presunto delito sexual contra niños, niñas y adolescentes",2022,4,11,1975,556.962025316456,1,1020,98.0392156862745,10,955,1047.12041884817
37170,70,70221,121,Tasa de exámenes médico legales por presunto delito sexual cuando la víctima está entre 18 y 28 años,2022,5,1,5984,16.7112299465241,1,4116,24.2954324586978,0,1868,0
37171,70,70233,81,"Tasa de exámenes médico legales por presunto delito sexual contra niños, niñas y adolescentes",2022,4,3,1080,277.777777777778,0,543,0,3,537,558.659217877095
37172,70,70235,81,"Tasa de exámenes médico legales por presunto delito sexual contra niños, niñas y adolescentes",2022,2,1,2084,47.9846449136276,0,1083,0,1,1001,99.9000999000999
37173,70,70235,81,"Tasa de exámenes médico legales por presunto delito sexual contra niños, niñas y adolescentes",2022,3,2,2639,75.7862826828344,0,1346,0,2,1293,154.679040989946
37174,70,70235,81,"Tasa de exámenes médico legales por presunto delito sexual contra niños, niñas y adolescentes",2022,4,4,2698,148.257968865827,1,1364,73.3137829912023,3,1334,224.887556221889
37175,70,70235,121,Tasa de exámenes médico legales por presunto delito sexual cuando la víctima está entre 18 y 28 años,2022,5,2,4434,45.10599909788,0,2258,0,2,2176,91.9117647058823
37176,70,70265,81,"Tasa de exámenes médico legales por presunto delito sexual contra niños, niñas y adolescentes",2022,4,1,2157,46.3606861381548,0,1095,0,1,1062,94.1619585687382
37177,70,70400,81,"Tasa de exámenes médico legales por presunto delito sexual contra niños, niñas y adolescentes",2022,3,1,1397,71.5819613457409,0,747,0,1,650,153.846153846154
37178,70,70400,81,"Tasa de exámenes médico legales por presunto delito sexual contra niños, niñas y adolescentes",2022,4,1,1519,65.8327847267939,0,781,0,1,738,135.50135501355
37179,70,70418,81,"Tasa de exámenes médico legales por presunto delito sexual contra niños, niñas y adolescentes",2022,3,2,2419,82.6787928896238,0,1255,0,2,1164,171.821305841924
37180,70,70418,81,"Tasa de exámenes médico legales por presunto delito sexual contra niños, niñas y adolescentes",2022,4,1,2374,42.12299915754,0,1216,0,1,1158,86.3557858376511
37181,70,70429,81,"Tasa de exámenes médico legales por presunto delito sexual contra niños, niñas y adolescentes",2022,3,1,4588,21.795989537925,1,2346,42.6257459505541,0,2242,0
37182,70,70429,81,"Tasa de exámenes médico legales por presunto delito sexual contra niños, niñas y adolescentes",2022,4,3,4377,68.5400959561343,0,2292,0,3,2085,143.884892086331
37183,70,70473,81,"Tasa de exámenes médico legales por presunto delito sexual contra niños, niñas y adolescentes",2022,2,2,1369,146.09203798393,1,711,140.646976090014,1,658,151.975683890577
37184,70,70473,81,"Tasa de exámenes médico legales por presunto delito sexual contra niños, niñas y adolescentes",2022,3,3,1639,183.038438071995,1,855,116.959064327485,2,784,255.102040816327
37185,70,70473,81,"Tasa de exámenes médico legales por presunto delito sexual contra niños, niñas y adolescentes",2022,4,9,1606,560.398505603985,0,818,0,9,788,1142.13197969543
37186,70,70508,81,"Tasa de exámenes médico legales por presunto delito sexual contra niños, niñas y adolescentes",2022,4,6,2346,255.754475703325,0,1233,0,6,1113,539.083557951482
37187,70,70523,81,"Tasa de exámenes médico legales por presunto delito sexual contra niños, niñas y adolescentes",2022,3,1,1816,55.0660792951542,0,926,0,1,890,112.359550561798
37188,70,70523,81,"Tasa de exámenes médico legales por presunto delito sexual contra niños, niñas y adolescentes",2022,4,3,1880,159.574468085106,0,968,0,3,912,328.947368421053
37189,70,70523,121,Tasa de exámenes médico legales por presunto delito sexual cuando la víctima está entre 18 y 28 años,2022,5,1,3430,29.1545189504373,0,1819,0,1,1611,62.0732464307883
37190,70,70670,81,"Tasa de exámenes médico legales por presunto delito sexual contra niños, niñas y adolescentes",2022,3,2,5536,36.1271676300578,0,2781,0,2,2755,72.5952813067151
37191,70,70670,81,"Tasa de exámenes médico legales por presunto delito sexual contra niños, niñas y adolescentes",2022,4,12,5580,215.05376344086,0,2894,0,12,2686,446.760982874162
37192,70,70678,81,"Tasa de exámenes médico legales por presunto delito sexual contra niños, niñas y adolescentes",2022,2,2,2519,79.3965859468043,1,1268,78.8643533123028,1,1251,79.9360511590727
37193,70,70678,81,"Tasa de exámenes médico legales por presunto delito sexual contra niños, niñas y adolescentes",2022,3,4,3313,120.73649260489,1,1677,59.6302921884317,3,1636,183.374083129584
37194,70,70678,81,"Tasa de exámenes médico legales por presunto delito sexual contra niños, niñas y adolescentes",2022,4,5,3469,144.133756125685,0,1786,0,5,1683,297.08853238265
37195,70,70678,121,Tasa de exámenes médico legales por presunto delito sexual cuando la víctima está entre 18 y 28 años,2022,5,2,5674,35.2485019386676,0,2987,0,2,2687,74.4324525493115
37196,70,70702,81,"Tasa de exámenes médico legales por presunto delito sexual contra niños, niñas y adolescentes",2022,3,1,1301,76.8639508070715,1,671,149.03129657228,0,630,0
37197,70,70702,81,"Tasa de exámenes médico legales por presunto delito sexual contra niños, niñas y adolescentes",2022,4,4,1410,283.687943262411,0,710,0,4,700,571.428571428571
37198,70,70702,121,Tasa de exámenes médico legales por presunto delito sexual cuando la víctima está entre 18 y 28 años,2022,5,1,2434,41.0846343467543,0,1223,0,1,1211,82.5763831544178
37199,70,70742,81,"Tasa de exámenes médico legales por presunto delito sexual contra niños, niñas y adolescentes",2022,2,1,2459,40.6669377795852,1,1264,79.1139240506329,0,1195,0
37200,70,70742,81,"Tasa de exámenes médico legales por presunto delito sexual contra niños, niñas y adolescentes",2022,3,1,3171,31.5357931251971,0,1604,0,1,1567,63.8162093171666
37201,70,70742,81,"Tasa de exámenes médico legales por presunto delito sexual contra niños, niñas y adolescentes",2022,4,5,3294,151.791135397693,2,1677,119.260584376863,3,1617,185.528756957328
37202,70,70708,81,"Tasa de exámenes médico legales por presunto delito sexual contra niños, niñas y adolescentes",2022,2,1,5294,18.8893086513034,0,2714,0,1,2580,38.7596899224806
37203,70,70708,81,"Tasa de exámenes médico legales por presunto delito sexual contra niños, niñas y adolescentes",2022,3,4,6840,58.4795321637427,0,3472,0,4,3368,118.764845605701
37204,70,70708,81,"Tasa de exámenes médico legales por presunto delito sexual contra niños, niñas y adolescentes",2022,4,5,6979,71.6435019343746,0,3516,0,5,3463,144.383482529599
37205,70,70708,121,Tasa de exámenes médico legales por presunto delito sexual cuando la víctima está entre 18 y 28 años,2022,5,1,10896,9.1776798825257,0,5347,0,1,5549,18.0212650928095
37206,70,70713,81,"Tasa de exámenes médico legales por presunto delito sexual contra niños, niñas y adolescentes",2022,3,4,6717,59.5503945213637,1,3507,28.5143997718848,3,3210,93.4579439252336
37207,70,70713,81,"Tasa de exámenes médico legales por presunto delito sexual contra niños, niñas y adolescentes",2022,4,10,6773,147.6450612727,0,3556,0,10,3217,310.848616723656
37208,70,70713,121,Tasa de exámenes médico legales por presunto delito sexual cuando la víctima está entre 18 y 28 años,2022,5,3,9692,30.9533635988444,0,4990,0,3,4702,63.8026371756699
37209,70,70717,81,"Tasa de exámenes médico legales por presunto delito sexual contra niños, niñas y adolescentes",2022,2,1,1562,64.0204865556978,1,773,129.366106080207,0,789,0
37210,70,70717,81,"Tasa de exámenes médico legales por presunto delito sexual contra niños, niñas y adolescentes",2022,3,4,1992,200.803212851406,1,1009,99.1080277502478,3,983,305.188199389624
37211,70,70717,81,"Tasa de exámenes médico legales por presunto delito sexual contra niños, niñas y adolescentes",2022,4,3,2028,147.92899408284,1,1045,95.6937799043062,2,983,203.458799593082
37212,70,70820,81,"Tasa de exámenes médico legales por presunto delito sexual contra niños, niñas y adolescentes",2022,3,6,3866,155.199172271081,2,1943,102.933607822954,4,1923,208.008320332813
37213,70,70820,81,"Tasa de exámenes médico legales por presunto delito sexual contra niños, niñas y adolescentes",2022,4,9,3895,231.065468549422,0,1973,0,9,1922,468.262226847034
37214,70,70820,121,Tasa de exámenes médico legales por presunto delito sexual cuando la víctima está entre 18 y 28 años,2022,5,3,6391,46.9410107964325,0,3173,0,3,3218,93.2256059664388
37215,70,70001,81,"Tasa de exámenes médico legales por presunto delito sexual contra niños, niñas y adolescentes",2022,2,11,23530,46.748831279218,3,12003,24.9937515621095,8,11527,69.4022729244383
37216,70,70001,81,"Tasa de exámenes médico legales por presunto delito sexual contra niños, niñas y adolescentes",2022,3,49,29741,164.755724420833,4,15203,26.3105965927777,45,14538,309.533635988444
37217,70,70001,81,"Tasa de exámenes médico legales por presunto delito sexual contra niños, niñas y adolescentes",2022,4,82,31128,263.428424569519,6,15876,37.7928949357521,76,15252,498.295305533701
37218,70,70001,121,Tasa de exámenes médico legales por presunto delito sexual cuando la víctima está entre 18 y 28 años,2022,5,12,59161,20.2836327986342,1,29171,3.42806211648555,11,29990,36.6788929643214
37219,70,70771,81,"Tasa de exámenes médico legales por presunto delito sexual contra niños, niñas y adolescentes",2022,3,1,3346,29.8864315600717,0,1787,0,1,1559,64.143681847338
37220,70,70771,81,"Tasa de exámenes médico legales por presunto delito sexual contra niños, niñas y adolescentes",2022,4,2,3214,62.2277535780958,0,1726,0,2,1488,134.408602150538
37221,70,70823,81,"Tasa de exámenes médico legales por presunto delito sexual contra niños, niñas y adolescentes",2022,2,1,1790,55.8659217877095,0,926,0,1,864,115.740740740741
37222,70,70823,81,"Tasa de exámenes médico legales por presunto delito sexual contra niños, niñas y adolescentes",2022,3,2,2308,86.6551126516464,0,1190,0,2,1118,178.890876565295
37223,70,70823,81,"Tasa de exámenes médico legales por presunto delito sexual contra niños, niñas y adolescentes",2022,4,8,2393,334.308399498537,0,1231,0,8,1162,688.468158347676
37224,73,73024,81,"Tasa de exámenes médico legales por presunto delito sexual contra niños, niñas y adolescentes",2022,2,2,270,740.740740740741,0,134,0,2,136,1470.58823529412
37225,73,73024,81,"Tasa de exámenes médico legales por presunto delito sexual contra niños, niñas y adolescentes",2022,4,6,443,1354.40180586907,2,242,826.446280991736,4,201,1990.04975124378
37226,73,73026,81,"Tasa de exámenes médico legales por presunto delito sexual contra niños, niñas y adolescentes",2022,4,10,839,1191.89511323004,0,434,0,10,405,2469.13580246914
37227,73,73026,121,Tasa de exámenes médico legales por presunto delito sexual cuando la víctima está entre 18 y 28 años,2022,5,1,1429,69.9790062981106,0,738,0,1,691,144.717800289436
37228,73,73030,81,"Tasa de exámenes médico legales por presunto delito sexual contra niños, niñas y adolescentes",2022,3,1,591,169.204737732656,0,306,0,1,285,350.877192982456
37229,73,73030,81,"Tasa de exámenes médico legales por presunto delito sexual contra niños, niñas y adolescentes",2022,4,6,646,928.792569659443,1,344,290.697674418605,5,302,1655.62913907285
37230,73,73043,81,"Tasa de exámenes médico legales por presunto delito sexual contra niños, niñas y adolescentes",2022,3,2,1119,178.731009830206,0,551,0,2,568,352.112676056338
37231,73,73043,81,"Tasa de exámenes médico legales por presunto delito sexual contra niños, niñas y adolescentes",2022,4,8,1145,698.689956331878,0,572,0,8,573,1396.16055846422
37232,73,73055,81,"Tasa de exámenes médico legales por presunto delito sexual contra niños, niñas y adolescentes",2022,3,3,1102,272.232304900181,0,599,0,3,503,596.421471172962
37233,73,73055,81,"Tasa de exámenes médico legales por presunto delito sexual contra niños, niñas y adolescentes",2022,4,7,1196,585.284280936455,0,634,0,7,562,1245.55160142349
37234,73,73067,81,"Tasa de exámenes médico legales por presunto delito sexual contra niños, niñas y adolescentes",2022,2,2,1905,104.98687664042,0,974,0,2,931,214.822771213749
37235,73,73067,81,"Tasa de exámenes médico legales por presunto delito sexual contra niños, niñas y adolescentes",2022,3,9,2365,380.549682875264,0,1185,0,9,1180,762.71186440678
37236,73,73067,81,"Tasa de exámenes médico legales por presunto delito sexual contra niños, niñas y adolescentes",2022,4,10,2241,446.229361892013,0,1134,0,10,1107,903.342366757001
37237,73,73067,121,Tasa de exámenes médico legales por presunto delito sexual cuando la víctima está entre 18 y 28 años,2022,5,1,3336,29.9760191846523,0,1791,0,1,1545,64.7249190938511
37238,73,73124,81,"Tasa de exámenes médico legales por presunto delito sexual contra niños, niñas y adolescentes",2022,2,2,1436,139.275766016713,0,763,0,2,673,297.176820208024
37239,73,73124,81,"Tasa de exámenes médico legales por presunto delito sexual contra niños, niñas y adolescentes",2022,3,4,1798,222.469410456062,0,938,0,4,860,465.116279069767
37240,73,73124,81,"Tasa de exámenes médico legales por presunto delito sexual contra niños, niñas y adolescentes",2022,4,16,1849,865.332612222823,0,954,0,16,895,1787.7094972067
37241,73,73124,121,Tasa de exámenes médico legales por presunto delito sexual cuando la víctima está entre 18 y 28 años,2022,5,4,3502,114.220445459737,0,1801,0,4,1701,235.155790711346
37242,73,73148,81,"Tasa de exámenes médico legales por presunto delito sexual contra niños, niñas y adolescentes",2022,2,2,656,304.878048780488,0,337,0,2,319,626.959247648903
37243,73,73148,81,"Tasa de exámenes médico legales por presunto delito sexual contra niños, niñas y adolescentes",2022,3,5,903,553.709856035437,2,466,429.184549356223,3,437,686.49885583524
37244,73,73148,81,"Tasa de exámenes médico legales por presunto delito sexual contra niños, niñas y adolescentes",2022,4,9,1028,875.486381322957,1,529,189.035916824197,8,499,1603.20641282565
37245,73,73148,121,Tasa de exámenes médico legales por presunto delito sexual cuando la víctima está entre 18 y 28 años,2022,5,2,1899,105.318588730911,0,971,0,2,928,215.51724137931
37246,73,73152,81,"Tasa de exámenes médico legales por presunto delito sexual contra niños, niñas y adolescentes",2022,2,2,486,411.522633744856,0,254,0,2,232,862.068965517241
37247,73,73152,81,"Tasa de exámenes médico legales por presunto delito sexual contra niños, niñas y adolescentes",2022,3,1,632,158.227848101266,0,320,0,1,312,320.51282051282
37248,73,73152,81,"Tasa de exámenes médico legales por presunto delito sexual contra niños, niñas y adolescentes",2022,4,1,628,159.235668789809,0,324,0,1,304,328.947368421053
37249,73,73168,81,"Tasa de exámenes médico legales por presunto delito sexual contra niños, niñas y adolescentes",2022,2,6,4353,137.835975189524,1,2280,43.859649122807,5,2073,241.196333815726
37250,73,73168,81,"Tasa de exámenes médico legales por presunto delito sexual contra niños, niñas y adolescentes",2022,3,16,5692,281.09627547435,3,2932,102.319236016371,13,2760,471.014492753623
37251,73,73168,81,"Tasa de exámenes médico legales por presunto delito sexual contra niños, niñas y adolescentes",2022,4,41,5862,699.41999317639,2,3023,66.1594442606682,39,2839,1373.72314195139
37252,73,73168,121,Tasa de exámenes médico legales por presunto delito sexual cuando la víctima está entre 18 y 28 años,2022,5,3,9513,31.5357931251971,1,4914,20.3500203500203,2,4599,43.4877147205914
37253,73,73200,81,"Tasa de exámenes médico legales por presunto delito sexual contra niños, niñas y adolescentes",2022,3,1,748,133.689839572193,0,378,0,1,370,270.27027027027
37254,73,73200,81,"Tasa de exámenes médico legales por presunto delito sexual contra niños, niñas y adolescentes",2022,4,2,747,267.737617135207,0,385,0,2,362,552.486187845304
37255,73,73217,81,"Tasa de exámenes médico legales por presunto delito sexual contra niños, niñas y adolescentes",2022,3,7,2442,286.650286650287,0,1228,0,7,1214,576.60626029654
37256,73,73217,81,"Tasa de exámenes médico legales por presunto delito sexual contra niños, niñas y adolescentes",2022,4,31,2423,1279.4056954189,2,1244,160.771704180064,29,1179,2459.71162001696
37257,73,73217,121,Tasa de exámenes médico legales por presunto delito sexual cuando la víctima está entre 18 y 28 años,2022,5,1,3564,28.0583613916947,0,1871,0,1,1693,59.0667454223272
37258,73,73226,81,"Tasa de exámenes médico legales por presunto delito sexual contra niños, niñas y adolescentes",2022,2,2,591,338.409475465313,0,295,0,2,296,675.675675675676
37259,73,73226,81,"Tasa de exámenes médico legales por presunto delito sexual contra niños, niñas y adolescentes",2022,3,3,814,368.550368550369,1,405,246.913580246914,2,409,488.997555012225
37260,73,73226,81,"Tasa de exámenes médico legales por presunto delito sexual contra niños, niñas y adolescentes",2022,4,4,809,494.437577255871,0,415,0,4,394,1015.22842639594
37261,73,73226,121,Tasa de exámenes médico legales por presunto delito sexual cuando la víctima está entre 18 y 28 años,2022,5,1,1083,92.3361034164358,0,561,0,1,522,191.570881226054
37262,73,73236,81,"Tasa de exámenes médico legales por presunto delito sexual contra niños, niñas y adolescentes",2022,3,3,753,398.406374501992,1,396,252.525252525253,2,357,560.224089635854
37263,73,73236,81,"Tasa de exámenes médico legales por presunto delito sexual contra niños, niñas y adolescentes",2022,4,8,779,1026.95763799743,3,414,724.63768115942,5,365,1369.86301369863
37264,73,73268,81,"Tasa de exámenes médico legales por presunto delito sexual contra niños, niñas y adolescentes",2022,2,3,4342,69.092584062644,0,2237,0,3,2105,142.517814726841
37265,73,73268,81,"Tasa de exámenes médico legales por presunto delito sexual contra niños, niñas y adolescentes",2022,3,13,5836,222.755311857437,4,2994,133.600534402138,9,2842,316.678395496129
37266,73,73268,81,"Tasa de exámenes médico legales por presunto delito sexual contra niños, niñas y adolescentes",2022,4,40,6669,599.790073474284,3,3472,86.4055299539171,37,3197,1157.33500156397
37267,73,73268,121,Tasa de exámenes médico legales por presunto delito sexual cuando la víctima está entre 18 y 28 años,2022,5,8,13343,59.9565315146519,0,7003,0,8,6340,126.182965299685
37268,73,73268,81,"Tasa de exámenes médico legales por presunto delito sexual contra niños, niñas y adolescentes",2022,1,1,792,126.262626262626,1,408,245.098039215686,0,384,0
37269,73,73270,81,"Tasa de exámenes médico legales por presunto delito sexual contra niños, niñas y adolescentes",2022,4,5,725,689.655172413793,2,364,549.450549450549,3,361,831.024930747922
37270,73,73275,81,"Tasa de exámenes médico legales por presunto delito sexual contra niños, niñas y adolescentes",2022,2,3,1917,156.494522691706,1,992,100.806451612903,2,925,216.216216216216
37271,73,73275,81,"Tasa de exámenes médico legales por presunto delito sexual contra niños, niñas y adolescentes",2022,3,4,2528,158.227848101266,3,1317,227.790432801822,1,1211,82.5763831544178
37272,73,73275,81,"Tasa de exámenes médico legales por presunto delito sexual contra niños, niñas y adolescentes",2022,4,11,2731,402.782863419993,1,1427,70.0770847932726,10,1304,766.871165644172
37273,73,73275,121,Tasa de exámenes médico legales por presunto delito sexual cuando la víctima está entre 18 y 28 años,2022,5,2,5110,39.1389432485323,0,2563,0,2,2547,78.5237534354142
37274,73,73283,81,"Tasa de exámenes médico legales por presunto delito sexual contra niños, niñas y adolescentes",2022,2,2,2093,95.5566172957477,0,1118,0,2,975,205.128205128205
37275,73,73283,81,"Tasa de exámenes médico legales por presunto delito sexual contra niños, niñas y adolescentes",2022,3,7,2880,243.055555555556,0,1486,0,7,1394,502.152080344333
37276,73,73283,81,"Tasa de exámenes médico legales por presunto delito sexual contra niños, niñas y adolescentes",2022,4,17,3082,551.589876703439,2,1560,128.205128205128,15,1522,985.545335085414
37277,73,73283,121,Tasa de exámenes médico legales por presunto delito sexual cuando la víctima está entre 18 y 28 años,2022,5,3,5241,57.2409845449342,1,2658,37.6222723852521,2,2583,77.4293457220286
37278,73,73319,81,"Tasa de exámenes médico legales por presunto delito sexual contra niños, niñas y adolescentes",2022,2,3,2109,142.247510668563,0,1098,0,3,1011,296.73590504451
37279,73,73319,81,"Tasa de exámenes médico legales por presunto delito sexual contra niños, niñas y adolescentes",2022,3,7,2874,243.562978427279,1,1470,68.0272108843537,6,1404,427.350427350427
37280,73,73319,81,"Tasa de exámenes médico legales por presunto delito sexual contra niños, niñas y adolescentes",2022,4,16,3092,517.464424320828,4,1575,253.968253968254,12,1517,791.034937376401
37281,73,73319,121,Tasa de exámenes médico legales por presunto delito sexual cuando la víctima está entre 18 y 28 años,2022,5,2,5146,38.8651379712398,0,2654,0,2,2492,80.2568218298555
37282,73,73347,81,"Tasa de exámenes médico legales por presunto delito sexual contra niños, niñas y adolescentes",2022,3,2,707,282.885431400283,0,370,0,2,337,593.471810089021
37283,73,73347,81,"Tasa de exámenes médico legales por presunto delito sexual contra niños, niñas y adolescentes",2022,4,1,730,136.986301369863,0,374,0,1,356,280.898876404494
37284,73,73349,81,"Tasa de exámenes médico legales por presunto delito sexual contra niños, niñas y adolescentes",2022,2,3,1368,219.298245614035,1,686,145.772594752187,2,682,293.255131964809
37285,73,73349,81,"Tasa de exámenes médico legales por presunto delito sexual contra niños, niñas y adolescentes",2022,3,13,1899,684.570826750921,2,961,208.116545265349,11,938,1172.7078891258
37286,73,73349,81,"Tasa de exámenes médico legales por presunto delito sexual contra niños, niñas y adolescentes",2022,4,11,2241,490.852298081214,1,1186,84.3170320404722,10,1055,947.867298578199
37287,73,73349,121,Tasa de exámenes médico legales por presunto delito sexual cuando la víctima está entre 18 y 28 años,2022,5,5,4252,117.591721542803,0,2338,0,5,1914,261.233019853709
37288,73,73001,81,"Tasa de exámenes médico legales por presunto delito sexual contra niños, niñas y adolescentes",2022,2,45,29814,150.935801972228,11,15281,71.9848177475296,34,14533,233.950319961467
37289,73,73001,81,"Tasa de exámenes médico legales por presunto delito sexual contra niños, niñas y adolescentes",2022,3,115,40932,280.953776995993,25,20759,120.429693145142,90,20173,446.140881376097
37290,73,73001,81,"Tasa de exámenes médico legales por presunto delito sexual contra niños, niñas y adolescentes",2022,4,202,48682,414.9377593361,15,24619,60.9285511190544,187,24063,777.126709055396
37291,73,73001,121,Tasa de exámenes médico legales por presunto delito sexual cuando la víctima está entre 18 y 28 años,2022,5,70,103171,67.8485233253531,9,52145,17.2595646754243,61,51026,119.546897660016
37292,73,73001,81,"Tasa de exámenes médico legales por presunto delito sexual contra niños, niñas y adolescentes",2022,1,2,5407,36.9890882189754,0,2770,0,2,2637,75.8437618505878
37293,73,73352,81,"Tasa de exámenes médico legales por presunto delito sexual contra niños, niñas y adolescentes",2022,3,3,1101,272.479564032698,0,580,0,3,521,575.815738963532
37294,73,73352,81,"Tasa de exámenes médico legales por presunto delito sexual contra niños, niñas y adolescentes",2022,4,9,1118,805.008944543828,2,574,348.432055749129,7,544,1286.76470588235
37295,73,73352,121,Tasa de exámenes médico legales por presunto delito sexual cuando la víctima está entre 18 y 28 años,2022,5,1,1790,55.8659217877095,0,906,0,1,884,113.122171945701
37296,73,73408,81,"Tasa de exámenes médico legales por presunto delito sexual contra niños, niñas y adolescentes",2022,2,3,1182,253.807106598985,1,630,158.730158730159,2,552,362.31884057971
37297,73,73408,81,"Tasa de exámenes médico legales por presunto delito sexual contra niños, niñas y adolescentes",2022,3,7,1556,449.87146529563,0,804,0,7,752,930.851063829787
37298,73,73408,81,"Tasa de exámenes médico legales por presunto delito sexual contra niños, niñas y adolescentes",2022,4,2,1643,121.728545343883,0,827,0,2,816,245.098039215686
37299,73,73408,121,Tasa de exámenes médico legales por presunto delito sexual cuando la víctima está entre 18 y 28 años,2022,5,3,3032,98.9445910290238,0,1525,0,3,1507,199.07100199071
37300,73,73411,81,"Tasa de exámenes médico legales por presunto delito sexual contra niños, niñas y adolescentes",2022,2,2,2229,89.7263346792283,1,1147,87.1839581517001,1,1082,92.4214417744917
37301,73,73411,81,"Tasa de exámenes médico legales por presunto delito sexual contra niños, niñas y adolescentes",2022,3,2,3187,62.7549419516787,0,1645,0,2,1542,129.70168612192
37302,73,73411,81,"Tasa de exámenes médico legales por presunto delito sexual contra niños, niñas y adolescentes",2022,4,12,3510,341.880341880342,0,1798,0,12,1712,700.934579439252
37303,73,73411,121,Tasa de exámenes médico legales por presunto delito sexual cuando la víctima está entre 18 y 28 años,2022,5,1,5614,17.8126113288208,0,2770,0,1,2844,35.1617440225035
37304,73,73449,81,"Tasa de exámenes médico legales por presunto delito sexual contra niños, niñas y adolescentes",2022,2,7,2567,272.691858200234,2,1299,153.964588144727,5,1268,394.321766561514
37305,73,73449,81,"Tasa de exámenes médico legales por presunto delito sexual contra niños, niñas y adolescentes",2022,3,22,3242,678.59346082665,2,1657,120.70006035003,20,1585,1261.82965299685
37306,73,73449,81,"Tasa de exámenes médico legales por presunto delito sexual contra niños, niñas y adolescentes",2022,4,30,3415,878.477306002928,2,1793,111.54489682097,28,1622,1726.26387176326
37307,73,73449,121,Tasa de exámenes médico legales por presunto delito sexual cuando la víctima está entre 18 y 28 años,2022,5,5,7182,69.6184906711222,1,3723,26.86005909213,4,3459,115.640358485111
37308,73,73461,81,"Tasa de exámenes médico legales por presunto delito sexual contra niños, niñas y adolescentes",2022,4,1,483,207.03933747412,0,238,0,1,245,408.163265306122
37309,73,73483,81,"Tasa de exámenes médico legales por presunto delito sexual contra niños, niñas y adolescentes",2022,3,5,1219,410.172272354389,0,612,0,5,607,823.723228995058
37310,73,73483,81,"Tasa de exámenes médico legales por presunto delito sexual contra niños, niñas y adolescentes",2022,4,5,1355,369.0036900369,0,707,0,5,648,771.604938271605
37311,73,73483,121,Tasa de exámenes médico legales por presunto delito sexual cuando la víctima está entre 18 y 28 años,2022,5,2,2128,93.984962406015,0,1105,0,2,1023,195.503421309873
37312,73,73504,81,"Tasa de exámenes médico legales por presunto delito sexual contra niños, niñas y adolescentes",2022,2,2,2785,71.8132854578097,0,1415,0,2,1370,145.985401459854
37313,73,73504,81,"Tasa de exámenes médico legales por presunto delito sexual contra niños, niñas y adolescentes",2022,3,5,3590,139.275766016713,0,1856,0,5,1734,288.350634371396
37314,73,73504,81,"Tasa de exámenes médico legales por presunto delito sexual contra niños, niñas y adolescentes",2022,4,31,3597,861.829302196275,1,1899,52.6592943654555,30,1698,1766.78445229682
37315,73,73504,121,Tasa de exámenes médico legales por presunto delito sexual cuando la víctima está entre 18 y 28 años,2022,5,4,6034,66.2910175671197,1,3191,31.3381385145722,3,2843,105.522335561027
37316,73,73520,81,"Tasa de exámenes médico legales por presunto delito sexual contra niños, niñas y adolescentes",2022,4,1,954,104.82180293501,0,480,0,1,474,210.970464135021
37317,73,73520,121,Tasa de exámenes médico legales por presunto delito sexual cuando la víctima está entre 18 y 28 años,2022,5,1,1510,66.2251655629139,0,769,0,1,741,134.952766531714
37318,73,73547,81,"Tasa de exámenes médico legales por presunto delito sexual contra niños, niñas y adolescentes",2022,2,1,409,244.498777506112,1,206,485.436893203883,0,203,0
37319,73,73547,81,"Tasa de exámenes médico legales por presunto delito sexual contra niños, niñas y adolescentes",2022,3,1,562,177.935943060498,0,280,0,1,282,354.609929078014
37320,73,73547,81,"Tasa de exámenes médico legales por presunto delito sexual contra niños, niñas y adolescentes",2022,4,1,655,152.671755725191,0,358,0,1,297,336.700336700337
37321,73,73555,81,"Tasa de exámenes médico legales por presunto delito sexual contra niños, niñas y adolescentes",2022,2,3,2840,105.633802816901,0,1463,0,3,1377,217.864923747277
37322,73,73555,81,"Tasa de exámenes médico legales por presunto delito sexual contra niños, niñas y adolescentes",2022,3,13,3377,384.957062481492,3,1753,171.135196805476,10,1624,615.76354679803
37323,73,73555,81,"Tasa de exámenes médico legales por presunto delito sexual contra niños, niñas y adolescentes",2022,4,17,3153,539.169045353631,0,1661,0,17,1492,1139.41018766756
37324,73,73555,121,Tasa de exámenes médico legales por presunto delito sexual cuando la víctima está entre 18 y 28 años,2022,5,3,4998,60.0240096038415,0,2590,0,3,2408,124.584717607973
37325,73,73563,81,"Tasa de exámenes médico legales por presunto delito sexual contra niños, niñas y adolescentes",2022,2,1,616,162.337662337662,0,318,0,1,298,335.570469798658
37326,73,73563,81,"Tasa de exámenes médico legales por presunto delito sexual contra niños, niñas y adolescentes",2022,3,2,793,252.206809583859,0,399,0,2,394,507.614213197969
37327,73,73563,81,"Tasa de exámenes médico legales por presunto delito sexual contra niños, niñas y adolescentes",2022,4,7,802,872.817955112219,0,410,0,7,392,1785.71428571429
37328,73,73585,81,"Tasa de exámenes médico legales por presunto delito sexual contra niños, niñas y adolescentes",2022,3,3,2001,149.925037481259,1,1021,97.9431929480901,2,980,204.081632653061
37329,73,73585,81,"Tasa de exámenes médico legales por presunto delito sexual contra niños, niñas y adolescentes",2022,4,9,2039,441.392839627268,0,1057,0,9,982,916.496945010183
37330,73,73585,121,Tasa de exámenes médico legales por presunto delito sexual cuando la víctima está entre 18 y 28 años,2022,5,4,3479,114.975567691865,0,1726,0,4,1753,228.180262407302
37331,73,73616,81,"Tasa de exámenes médico legales por presunto delito sexual contra niños, niñas y adolescentes",2022,2,3,2578,116.369278510473,0,1315,0,3,1263,237.529691211401
37332,73,73616,81,"Tasa de exámenes médico legales por presunto delito sexual contra niños, niñas y adolescentes",2022,3,7,2979,234.978180597516,0,1527,0,7,1452,482.093663911846
37333,73,73616,81,"Tasa de exámenes médico legales por presunto delito sexual contra niños, niñas y adolescentes",2022,4,17,2642,643.451930355791,0,1382,0,17,1260,1349.20634920635
37334,73,73616,121,Tasa de exámenes médico legales por presunto delito sexual cuando la víctima está entre 18 y 28 años,2022,5,2,4193,47.6985451943716,0,2206,0,2,1987,100.654252642174
37335,73,73622,81,"Tasa de exámenes médico legales por presunto delito sexual contra niños, niñas y adolescentes",2022,4,2,635,314.96062992126,0,333,0,2,302,662.251655629139
37336,73,73624,81,"Tasa de exámenes médico legales por presunto delito sexual contra niños, niñas y adolescentes",2022,2,3,1715,174.927113702624,1,856,116.822429906542,2,859,232.828870779977
37337,73,73624,81,"Tasa de exámenes médico legales por presunto delito sexual contra niños, niñas y adolescentes",2022,3,12,2362,508.044030482642,2,1187,168.49199663016,10,1175,851.063829787234
37338,73,73624,81,"Tasa de exámenes médico legales por presunto delito sexual contra niños, niñas y adolescentes",2022,4,28,2483,1127.66814337495,1,1269,78.8022064617809,27,1214,2224.05271828666
37339,73,73624,121,Tasa de exámenes médico legales por presunto delito sexual cuando la víctima está entre 18 y 28 años,2022,5,2,3838,52.1104742053153,0,2019,0,2,1819,109.950522264981
37340,73,73671,81,"Tasa de exámenes médico legales por presunto delito sexual contra niños, niñas y adolescentes",2022,3,6,1277,469.851213782302,1,661,151.285930408472,5,616,811.688311688312
37341,73,73671,81,"Tasa de exámenes médico legales por presunto delito sexual contra niños, niñas y adolescentes",2022,4,13,1413,920.02830856334,0,748,0,13,665,1954.88721804511
37342,73,73671,121,Tasa de exámenes médico legales por presunto delito sexual cuando la víctima está entre 18 y 28 años,2022,5,2,2318,86.2812769628991,0,1181,0,2,1137,175.901495162709
37343,73,73675,81,"Tasa de exámenes médico legales por presunto delito sexual contra niños, niñas y adolescentes",2022,2,1,1106,90.4159132007233,1,570,175.438596491228,0,536,0
37344,73,73675,81,"Tasa de exámenes médico legales por presunto delito sexual contra niños, niñas y adolescentes",2022,3,4,1484,269.541778975741,0,752,0,4,732,546.448087431694
37345,73,73675,81,"Tasa de exámenes médico legales por presunto delito sexual contra niños, niñas y adolescentes",2022,4,14,1507,928.99800928998,0,775,0,14,732,1912.56830601093
37346,73,73675,121,Tasa de exámenes médico legales por presunto delito sexual cuando la víctima está entre 18 y 28 años,2022,5,2,2186,91.4913083257091,0,1161,0,2,1025,195.121951219512
37347,73,73678,81,"Tasa de exámenes médico legales por presunto delito sexual contra niños, niñas y adolescentes",2022,2,3,787,381.194409148666,0,395,0,3,392,765.30612244898
37348,73,73678,81,"Tasa de exámenes médico legales por presunto delito sexual contra niños, niñas y adolescentes",2022,3,3,1121,267.618198037467,1,580,172.413793103448,2,541,369.685767097967
37349,73,73678,81,"Tasa de exámenes médico legales por presunto delito sexual contra niños, niñas y adolescentes",2022,4,3,1204,249.169435215947,0,633,0,3,571,525.394045534151
37350,73,73678,121,Tasa de exámenes médico legales por presunto delito sexual cuando la víctima está entre 18 y 28 años,2022,5,1,1910,52.3560209424084,0,981,0,1,929,107.642626480086
37351,73,73443,81,"Tasa de exámenes médico legales por presunto delito sexual contra niños, niñas y adolescentes",2022,2,4,2482,161.16035455278,3,1265,237.154150197628,1,1217,82.1692686935086
37352,73,73443,81,"Tasa de exámenes médico legales por presunto delito sexual contra niños, niñas y adolescentes",2022,3,13,3355,387.481371087928,5,1700,294.117647058824,8,1655,483.383685800604
37353,73,73443,81,"Tasa de exámenes médico legales por presunto delito sexual contra niños, niñas y adolescentes",2022,4,12,3598,333.518621456365,0,1823,0,12,1775,676.056338028169
37354,73,73443,121,Tasa de exámenes médico legales por presunto delito sexual cuando la víctima está entre 18 y 28 años,2022,5,5,6459,77.4113639882335,0,3215,0,5,3244,154.130702836005
37355,73,73443,81,"Tasa de exámenes médico legales por presunto delito sexual contra niños, niñas y adolescentes",2022,1,1,454,220.264317180617,0,231,0,1,223,448.430493273543
37356,73,73686,81,"Tasa de exámenes médico legales por presunto delito sexual contra niños, niñas y adolescentes",2022,4,1,605,165.289256198347,0,322,0,1,283,353.356890459364
37357,73,73854,81,"Tasa de exámenes médico legales por presunto delito sexual contra niños, niñas y adolescentes",2022,2,1,352,284.090909090909,0,164,0,1,188,531.914893617021
37358,73,73854,81,"Tasa de exámenes médico legales por presunto delito sexual contra niños, niñas y adolescentes",2022,4,2,520,384.615384615385,0,256,0,2,264,757.575757575758
37359,73,73861,81,"Tasa de exámenes médico legales por presunto delito sexual contra niños, niñas y adolescentes",2022,2,2,857,233.372228704784,0,434,0,2,423,472.813238770686
37360,73,73861,81,"Tasa de exámenes médico legales por presunto delito sexual contra niños, niñas y adolescentes",2022,3,1,1187,84.24599831508,1,637,156.985871271586,0,550,0
37361,73,73861,81,"Tasa de exámenes médico legales por presunto delito sexual contra niños, niñas y adolescentes",2022,4,2,1239,161.420500403551,0,681,0,2,558,358.4229390681
37362,73,73870,81,"Tasa de exámenes médico legales por presunto delito sexual contra niños, niñas y adolescentes",2022,4,1,936,106.837606837607,0,474,0,1,462,216.450216450216
37363,73,73873,81,"Tasa de exámenes médico legales por presunto delito sexual contra niños, niñas y adolescentes",2022,2,1,367,272.479564032698,0,184,0,1,183,546.448087431694
37364,73,73873,81,"Tasa de exámenes médico legales por presunto delito sexual contra niños, niñas y adolescentes",2022,3,2,447,447.427293064877,0,225,0,2,222,900.900900900901
37365,73,73873,81,"Tasa de exámenes médico legales por presunto delito sexual contra niños, niñas y adolescentes",2022,4,6,432,1388.88888888889,1,220,454.545454545455,5,212,2358.49056603774
37366,76,76020,81,"Tasa de exámenes médico legales por presunto delito sexual contra niños, niñas y adolescentes",2022,3,2,1436,139.275766016713,0,742,0,2,694,288.184438040346
37367,76,76020,81,"Tasa de exámenes médico legales por presunto delito sexual contra niños, niñas y adolescentes",2022,4,4,1501,266.489007328448,0,763,0,4,738,542.0054200542
37368,76,76020,121,Tasa de exámenes médico legales por presunto delito sexual cuando la víctima está entre 18 y 28 años,2022,5,1,2401,41.649312786339,0,1207,0,1,1194,83.7520938023451
37369,76,76036,81,"Tasa de exámenes médico legales por presunto delito sexual contra niños, niñas y adolescentes",2022,2,2,1631,122.624156958921,0,828,0,2,803,249.06600249066
37370,76,76036,81,"Tasa de exámenes médico legales por presunto delito sexual contra niños, niñas y adolescentes",2022,3,2,2099,95.2834683182468,0,1083,0,2,1016,196.850393700787
37371,76,76036,81,"Tasa de exámenes médico legales por presunto delito sexual contra niños, niñas y adolescentes",2022,4,2,2163,92.464170134073,1,1116,89.6057347670251,1,1047,95.5109837631328
37372,76,76036,121,Tasa de exámenes médico legales por presunto delito sexual cuando la víctima está entre 18 y 28 años,2022,5,2,3705,53.9811066126856,0,1838,0,2,1867,107.123727905731
37373,76,76041,81,"Tasa de exámenes médico legales por presunto delito sexual contra niños, niñas y adolescentes",2022,2,1,1545,64.7249190938511,1,821,121.802679658952,0,724,0
37374,76,76041,81,"Tasa de exámenes médico legales por presunto delito sexual contra niños, niñas y adolescentes",2022,3,1,1915,52.2193211488251,1,997,100.300902708124,0,918,0
37375,76,76041,81,"Tasa de exámenes médico legales por presunto delito sexual contra niños, niñas y adolescentes",2022,4,2,1905,104.98687664042,0,977,0,2,928,215.51724137931
37376,76,76041,121,Tasa de exámenes médico legales por presunto delito sexual cuando la víctima está entre 18 y 28 años,2022,5,2,2990,66.8896321070234,0,1507,0,2,1483,134.861766689144
37377,76,76054,81,"Tasa de exámenes médico legales por presunto delito sexual contra niños, niñas y adolescentes",2022,4,6,620,967.741935483871,1,320,312.5,5,300,1666.66666666667
37378,76,76054,121,Tasa de exámenes médico legales por presunto delito sexual cuando la víctima está entre 18 y 28 años,2022,5,1,842,118.764845605701,0,454,0,1,388,257.731958762887
37379,76,76100,81,"Tasa de exámenes médico legales por presunto delito sexual contra niños, niñas y adolescentes",2022,2,1,1404,71.2250712250712,0,696,0,1,708,141.242937853107
37380,76,76100,81,"Tasa de exámenes médico legales por presunto delito sexual contra niños, niñas y adolescentes",2022,4,5,1683,297.08853238265,1,854,117.096018735363,4,829,482.509047044632
37381,76,76109,81,"Tasa de exámenes médico legales por presunto delito sexual contra niños, niñas y adolescentes",2022,2,7,36977,18.9306866430484,1,18722,5.34130968913578,6,18255,32.8677074774034
37382,76,76109,81,"Tasa de exámenes médico legales por presunto delito sexual contra niños, niñas y adolescentes",2022,3,21,43605,48.1596147230822,3,22144,13.5476878612717,18,21461,83.8730720842458
37383,76,76109,81,"Tasa de exámenes médico legales por presunto delito sexual contra niños, niñas y adolescentes",2022,4,32,39692,80.6207800060466,4,20135,19.865905140303,28,19557,143.171243033185
37384,76,76109,121,Tasa de exámenes médico legales por presunto delito sexual cuando la víctima está entre 18 y 28 años,2022,5,14,59802,23.4105882746396,3,28848,10.3993344425957,11,30954,35.5366027007818
37385,76,76113,81,"Tasa de exámenes médico legales por presunto delito sexual contra niños, niñas y adolescentes",2022,2,1,1746,57.2737686139748,0,907,0,1,839,119.189511323004
37386,76,76113,81,"Tasa de exámenes médico legales por presunto delito sexual contra niños, niñas y adolescentes",2022,3,1,2350,42.5531914893617,0,1208,0,1,1142,87.5656742556918
37387,76,76113,81,"Tasa de exámenes médico legales por presunto delito sexual contra niños, niñas y adolescentes",2022,4,5,2513,198.965380023876,0,1290,0,5,1223,408.830744071954
37388,76,76113,121,Tasa de exámenes médico legales por presunto delito sexual cuando la víctima está entre 18 y 28 años,2022,5,1,4165,24.0096038415366,0,2150,0,1,2015,49.6277915632754
37389,76,76122,81,"Tasa de exámenes médico legales por presunto delito sexual contra niños, niñas y adolescentes",2022,2,1,1908,52.4109014675052,1,1005,99.502487562189,0,903,0
37390,76,76122,81,"Tasa de exámenes médico legales por presunto delito sexual contra niños, niñas y adolescentes",2022,3,3,2602,115.29592621060701,0,1341,0,3,1261,237.906423473434
37391,76,76122,81,"Tasa de exámenes médico legales por presunto delito sexual contra niños, niñas y adolescentes",2022,4,4,2823,141.693234148069,0,1406,0,4,1417,282.286520818631
37392,76,76122,121,Tasa de exámenes médico legales por presunto delito sexual cuando la víctima está entre 18 y 28 años,2022,5,1,4846,20.6355757325629,0,2394,0,1,2452,40.7830342577488
37393,76,76001,81,"Tasa de exámenes médico legales por presunto delito sexual contra niños, niñas y adolescentes",2022,2,87,152838,56.9230165273034,23,77921,29.517074986204,64,74917,85.4278735133548
37394,76,76001,81,"Tasa de exámenes médico legales por presunto delito sexual contra niños, niñas y adolescentes",2022,3,164,189365,86.6052332796451,29,95884,30.2448792290685,135,93481,144.414372974187
37395,76,76001,81,"Tasa de exámenes médico legales por presunto delito sexual contra niños, niñas y adolescentes",2022,4,351,198886,176.483010367748,30,99521,30.1443916359361,321,99365,323.051376239118
37396,76,76001,121,Tasa de exámenes médico legales por presunto delito sexual cuando la víctima está entre 18 y 28 años,2022,5,134,408018,32.8416883568862,6,199771,3.00343893758353,128,208247,61.4654712913031
37397,76,76126,81,"Tasa de exámenes médico legales por presunto delito sexual contra niños, niñas y adolescentes",2022,3,2,1814,110.253583241455,1,923,108.342361863489,1,891,112.233445566779
37398,76,76126,81,"Tasa de exámenes médico legales por presunto delito sexual contra niños, niñas y adolescentes",2022,4,5,1895,263.852242744063,0,967,0,5,928,538.793103448276
37399,76,76126,121,Tasa de exámenes médico legales por presunto delito sexual cuando la víctima está entre 18 y 28 años,2022,5,5,3162,158.127767235927,0,1563,0,5,1599,312.695434646654
37400,76,76130,81,"Tasa de exámenes médico legales por presunto delito sexual contra niños, niñas y adolescentes",2022,3,6,9366,64.0614990390775,1,4880,20.4918032786885,5,4486,111.457868925546
37401,76,76130,81,"Tasa de exámenes médico legales por presunto delito sexual contra niños, niñas y adolescentes",2022,4,14,9143,153.122607459258,0,4705,0,14,4438,315.457413249211
37402,76,76130,121,Tasa de exámenes médico legales por presunto delito sexual cuando la víctima está entre 18 y 28 años,2022,5,4,16524,24.2072137496974,0,8207,0,4,8317,48.0942647589275
37403,76,76130,81,"Tasa de exámenes médico legales por presunto delito sexual contra niños, niñas y adolescentes",2022,1,1,1456,68.6813186813187,0,760,0,1,696,143.67816091954
37404,76,76147,81,"Tasa de exámenes médico legales por presunto delito sexual contra niños, niñas y adolescentes",2022,2,11,8990,122.358175750834,2,4517,44.2771751162276,9,4473,201.207243460765
37405,76,76147,81,"Tasa de exámenes médico legales por presunto delito sexual contra niños, niñas y adolescentes",2022,3,10,12032,83.1117021276596,3,6045,49.6277915632754,7,5987,116.919993318858
37406,76,76147,81,"Tasa de exámenes médico legales por presunto delito sexual contra niños, niñas y adolescentes",2022,4,25,13056,191.482843137255,2,6602,30.2938503483793,23,6454,356.368143786799
37407,76,76147,121,Tasa de exámenes médico legales por presunto delito sexual cuando la víctima está entre 18 y 28 años,2022,5,7,23852,29.3476438034546,0,11993,0,7,11859,59.0268994012986
37408,76,76233,81,"Tasa de exámenes médico legales por presunto delito sexual contra niños, niñas y adolescentes",2022,2,6,3932,152.594099694812,1,2020,49.5049504950495,5,1912,261.506276150628
37409,76,76233,81,"Tasa de exámenes médico legales por presunto delito sexual contra niños, niñas y adolescentes",2022,3,6,4902,122.399020807834,0,2524,0,6,2378,252.312867956266
37410,76,76233,81,"Tasa de exámenes médico legales por presunto delito sexual contra niños, niñas y adolescentes",2022,4,9,4859,185.223296974686,1,2497,40.048057669203,8,2362,338.696020321761
37411,76,76233,121,Tasa de exámenes médico legales por presunto delito sexual cuando la víctima está entre 18 y 28 años,2022,5,7,7969,87.8403814782281,0,4067,0,7,3902,179.39518195797
37412,76,76243,81,"Tasa de exámenes médico legales por presunto delito sexual contra niños, niñas y adolescentes",2022,2,1,734,136.239782016349,0,351,0,1,383,261.096605744125
37413,76,76243,81,"Tasa de exámenes médico legales por presunto delito sexual contra niños, niñas y adolescentes",2022,3,1,985,101.522842639594,0,505,0,1,480,208.333333333333
37414,76,76246,81,"Tasa de exámenes médico legales por presunto delito sexual contra niños, niñas y adolescentes",2022,2,1,570,175.438596491228,1,291,343.642611683849,0,279,0
37415,76,76246,81,"Tasa de exámenes médico legales por presunto delito sexual contra niños, niñas y adolescentes",2022,3,1,720,138.888888888889,0,374,0,1,346,289.017341040462
37416,76,76248,81,"Tasa de exámenes médico legales por presunto delito sexual contra niños, niñas y adolescentes",2022,2,2,4248,47.0809792843691,0,2171,0,2,2077,96.2927298988926
37417,76,76248,81,"Tasa de exámenes médico legales por presunto delito sexual contra niños, niñas y adolescentes",2022,3,5,5378,92.9713648196356,0,2726,0,5,2652,188.536953242836
37418,76,76248,81,"Tasa de exámenes médico legales por presunto delito sexual contra niños, niñas y adolescentes",2022,4,8,5513,145.111554507528,0,2745,0,8,2768,289.017341040462
37419,76,76250,81,"Tasa de exámenes médico legales por presunto delito sexual contra niños, niñas y adolescentes",2022,2,1,835,119.760479041916,0,432,0,1,403,248.138957816377
37420,76,76250,81,"Tasa de exámenes médico legales por presunto delito sexual contra niños, niñas y adolescentes",2022,4,2,993,201.409869083585,0,511,0,2,482,414.9377593361
37421,76,76250,121,Tasa de exámenes médico legales por presunto delito sexual cuando la víctima está entre 18 y 28 años,2022,5,1,1480,67.5675675675676,0,737,0,1,743,134.589502018843
37422,76,76275,81,"Tasa de exámenes médico legales por presunto delito sexual contra niños, niñas y adolescentes",2022,2,2,4513,44.3164192333259,0,2379,0,2,2134,93.7207122774133
37423,76,76275,81,"Tasa de exámenes médico legales por presunto delito sexual contra niños, niñas y adolescentes",2022,3,1,5818,17.1880371261602,0,3017,0,1,2801,35.7015351660121
37424,76,76275,81,"Tasa de exámenes médico legales por presunto delito sexual contra niños, niñas y adolescentes",2022,4,4,6057,66.0392933795608,0,3077,0,4,2980,134.228187919463
37425,76,76275,121,Tasa de exámenes médico legales por presunto delito sexual cuando la víctima está entre 18 y 28 años,2022,5,1,10525,9.50118764845606,0,5174,0,1,5351,18.6880956830499
37426,76,76306,81,"Tasa de exámenes médico legales por presunto delito sexual contra niños, niñas y adolescentes",2022,2,2,1689,118.413262285376,0,888,0,2,801,249.687890137328
37427,76,76306,81,"Tasa de exámenes médico legales por presunto delito sexual contra niños, niñas y adolescentes",2022,3,3,2273,131.984161900572,0,1190,0,3,1083,277.008310249307
37428,76,76306,81,"Tasa de exámenes médico legales por presunto delito sexual contra niños, niñas y adolescentes",2022,4,9,2400,375,0,1233,0,9,1167,771.20822622108
37429,76,76306,121,Tasa de exámenes médico legales por presunto delito sexual cuando la víctima está entre 18 y 28 años,2022,5,3,4061,73.8734301896085,0,2000,0,3,2061,145.560407569141
37430,76,76318,81,"Tasa de exámenes médico legales por presunto delito sexual contra niños, niñas y adolescentes",2022,2,2,2669,74.9344323716748,0,1354,0,2,1315,152.091254752852
37431,76,76318,81,"Tasa de exámenes médico legales por presunto delito sexual contra niños, niñas y adolescentes",2022,3,7,3407,205.459348400352,0,1761,0,7,1646,425.273390036452
37432,76,76318,81,"Tasa de exámenes médico legales por presunto delito sexual contra niños, niñas y adolescentes",2022,4,8,3484,229.621125143513,1,1807,55.3403431101273,7,1677,417.412045319022
37433,76,76318,121,Tasa de exámenes médico legales por presunto delito sexual cuando la víctima está entre 18 y 28 años,2022,5,1,6015,16.6251039068994,0,2959,0,1,3056,32.7225130890052
37434,76,76111,81,"Tasa de exámenes médico legales por presunto delito sexual contra niños, niñas y adolescentes",2022,2,7,9264,75.5613126079447,3,4672,64.2123287671233,4,4592,87.1080139372822
37435,76,76111,81,"Tasa de exámenes médico legales por presunto delito sexual contra niños, niñas y adolescentes",2022,3,16,11691,136.857411684202,3,5887,50.9597418039749,13,5804,223.983459682977
37436,76,76111,81,"Tasa de exámenes médico legales por presunto delito sexual contra niños, niñas y adolescentes",2022,4,27,11977,225.432078149787,2,6090,32.8407224958949,25,5887,424.664515033124
37437,76,76111,121,Tasa de exámenes médico legales por presunto delito sexual cuando la víctima está entre 18 y 28 años,2022,5,6,22228,26.9929818247256,0,11345,0,6,10883,55.1318570247175
37438,76,76364,81,"Tasa de exámenes médico legales por presunto delito sexual contra niños, niñas y adolescentes",2022,2,12,12984,92.4214417744917,4,6707,59.6391829431937,8,6277,127.449418512028
37439,76,76364,81,"Tasa de exámenes médico legales por presunto delito sexual contra niños, niñas y adolescentes",2022,3,16,16601,96.3797361604723,3,8561,35.0426352061675,13,8040,161.691542288557
37440,76,76364,81,"Tasa de exámenes médico legales por presunto delito sexual contra niños, niñas y adolescentes",2022,4,42,17208,244.072524407252,5,8796,56.844020009095,37,8412,439.847836424156
37441,76,76364,121,Tasa de exámenes médico legales por presunto delito sexual cuando la víctima está entre 18 y 28 años,2022,5,6,31616,18.9777327935223,0,16004,0,6,15612,38.4319754035357
37442,76,76377,81,"Tasa de exámenes médico legales por presunto delito sexual contra niños, niñas y adolescentes",2022,3,4,1414,282.885431400283,0,741,0,4,673,594.353640416047
37443,76,76377,81,"Tasa de exámenes médico legales por presunto delito sexual contra niños, niñas y adolescentes",2022,4,7,1492,469.16890080429,1,750,133.333333333333,6,742,808.625336927224
37444,76,76377,121,Tasa de exámenes médico legales por presunto delito sexual cuando la víctima está entre 18 y 28 años,2022,5,1,2481,40.3063280935107,0,1256,0,1,1225,81.6326530612245
37445,76,76400,81,"Tasa de exámenes médico legales por presunto delito sexual contra niños, niñas y adolescentes",2022,2,2,2403,83.2292967124428,1,1205,82.9875518672199,1,1198,83.4724540901503
37446,76,76400,81,"Tasa de exámenes médico legales por presunto delito sexual contra niños, niñas y adolescentes",2022,3,6,3244,184.956843403206,1,1652,60.5326876513317,5,1592,314.070351758794
37447,76,76400,81,"Tasa de exámenes médico legales por presunto delito sexual contra niños, niñas y adolescentes",2022,4,2,3411,58.633831720903,0,1733,0,2,1678,119.189511323004
37448,76,76403,81,"Tasa de exámenes médico legales por presunto delito sexual contra niños, niñas y adolescentes",2022,3,2,1061,188.501413760603,0,516,0,2,545,366.97247706422
37449,76,76403,81,"Tasa de exámenes médico legales por presunto delito sexual contra niños, niñas y adolescentes",2022,4,4,1110,360.36036036036,0,552,0,4,558,716.845878136201
37450,76,76497,81,"Tasa de exámenes médico legales por presunto delito sexual contra niños, niñas y adolescentes",2022,2,1,930,107.52688172043,0,455,0,1,475,210.526315789474
37451,76,76497,81,"Tasa de exámenes médico legales por presunto delito sexual contra niños, niñas y adolescentes",2022,3,3,1246,240.770465489567,0,653,0,3,593,505.902192242833
37452,76,76497,81,"Tasa de exámenes médico legales por presunto delito sexual contra niños, niñas y adolescentes",2022,4,3,1293,232.018561484919,0,686,0,3,607,494.233937397035
37453,76,76520,81,"Tasa de exámenes médico legales por presunto delito sexual contra niños, niñas y adolescentes",2022,2,15,24964,60.0865245954174,5,12776,39.1358797745773,10,12188,82.047915982934
37454,76,76520,81,"Tasa de exámenes médico legales por presunto delito sexual contra niños, niñas y adolescentes",2022,3,40,30812,129.819550824354,8,15728,50.8646998982706,32,15084,212.145319543888
37455,76,76520,81,"Tasa de exámenes médico legales por presunto delito sexual contra niños, niñas y adolescentes",2022,4,58,31623,183.410808588685,0,16049,0,58,15574,372.415564402209
37456,76,76520,121,Tasa de exámenes médico legales por presunto delito sexual cuando la víctima está entre 18 y 28 años,2022,5,17,61194,27.7805013563421,5,30609,16.3350648502075,12,30585,39.2349190779794
37457,76,76563,81,"Tasa de exámenes médico legales por presunto delito sexual contra niños, niñas y adolescentes",2022,2,1,3692,27.0855904658722,0,1877,0,1,1815,55.0964187327824
37458,76,76563,81,"Tasa de exámenes médico legales por presunto delito sexual contra niños, niñas y adolescentes",2022,3,5,5061,98.7947046038332,2,2537,78.8332676389436,3,2524,118.858954041204
37459,76,76563,81,"Tasa de exámenes médico legales por presunto delito sexual contra niños, niñas y adolescentes",2022,4,5,5438,91.9455682236116,0,2690,0,5,2748,181.950509461426
37460,76,76563,121,Tasa de exámenes médico legales por presunto delito sexual cuando la víctima está entre 18 y 28 años,2022,5,1,8950,11.1731843575419,0,4343,0,1,4607,21.7060994139353
37461,76,76606,81,"Tasa de exámenes médico legales por presunto delito sexual contra niños, niñas y adolescentes",2022,3,6,1615,371.517027863777,0,832,0,6,783,766.283524904215
37462,76,76606,81,"Tasa de exámenes médico legales por presunto delito sexual contra niños, niñas y adolescentes",2022,4,10,1624,615.76354679803,0,846,0,10,778,1285.3470437018
37463,76,76606,121,Tasa de exámenes médico legales por presunto delito sexual cuando la víctima está entre 18 y 28 años,2022,5,1,2688,37.2023809523809,0,1389,0,1,1299,76.9822940723633
37464,76,76616,81,"Tasa de exámenes médico legales por presunto delito sexual contra niños, niñas y adolescentes",2022,2,2,1264,158.227848101266,0,656,0,2,608,328.947368421053
37465,76,76616,81,"Tasa de exámenes médico legales por presunto delito sexual contra niños, niñas y adolescentes",2022,3,1,1593,62.7746390458255,0,830,0,1,763,131.061598951507
37466,76,76622,81,"Tasa de exámenes médico legales por presunto delito sexual contra niños, niñas y adolescentes",2022,2,1,2482,40.290088638195,1,1281,78.064012490242,0,1201,0
37467,76,76622,81,"Tasa de exámenes médico legales por presunto delito sexual contra niños, niñas y adolescentes",2022,3,5,3400,147.058823529412,0,1747,0,5,1653,302.480338777979
37468,76,76622,81,"Tasa de exámenes médico legales por presunto delito sexual contra niños, niñas y adolescentes",2022,4,11,3621,303.783485225076,1,1846,54.1711809317443,10,1775,563.380281690141
37469,76,76622,121,Tasa de exámenes médico legales por presunto delito sexual cuando la víctima está entre 18 y 28 años,2022,5,1,6032,16.57824933687,0,2990,0,1,3042,32.8731097961867
37470,76,76670,81,"Tasa de exámenes médico legales por presunto delito sexual contra niños, niñas y adolescentes",2022,2,3,1373,218.49963583394,1,742,134.770889487871,2,631,316.957210776545
37471,76,76670,81,"Tasa de exámenes médico legales por presunto delito sexual contra niños, niñas y adolescentes",2022,3,2,1747,114.481969089868,0,924,0,2,823,243.013365735115
37472,76,76670,81,"Tasa de exámenes médico legales por presunto delito sexual contra niños, niñas y adolescentes",2022,4,3,1777,168.823860438942,0,906,0,3,871,344.43168771527
37473,76,76736,81,"Tasa de exámenes médico legales por presunto delito sexual contra niños, niñas y adolescentes",2022,2,4,2722,146.95077149155,1,1409,70.97232079489,3,1313,228.484386900229
37474,76,76736,81,"Tasa de exámenes médico legales por presunto delito sexual contra niños, niñas y adolescentes",2022,3,6,3826,156.821745948772,0,1977,0,6,1849,324.499729583559
37475,76,76736,81,"Tasa de exámenes médico legales por presunto delito sexual contra niños, niñas y adolescentes",2022,4,14,4136,338.491295938104,1,2133,46.882325363338,13,2003,649.026460309536
37476,76,76736,121,Tasa de exámenes médico legales por presunto delito sexual cuando la víctima está entre 18 y 28 años,2022,5,1,6748,14.819205690575,0,3407,0,1,3341,29.9311583358276
37477,76,76823,81,"Tasa de exámenes médico legales por presunto delito sexual contra niños, niñas y adolescentes",2022,3,1,1531,65.3167864141084,0,772,0,1,759,131.752305665349
37478,76,76823,81,"Tasa de exámenes médico legales por presunto delito sexual contra niños, niñas y adolescentes",2022,4,2,1571,127.307447485678,0,794,0,2,777,257.400257400257
37479,76,76828,81,"Tasa de exámenes médico legales por presunto delito sexual contra niños, niñas y adolescentes",2022,2,2,1541,129.785853341986,0,769,0,2,772,259.067357512953
37480,76,76828,81,"Tasa de exámenes médico legales por presunto delito sexual contra niños, niñas y adolescentes",2022,3,1,2077,48.1463649494463,0,1080,0,1,997,100.300902708124
37481,76,76828,81,"Tasa de exámenes médico legales por presunto delito sexual contra niños, niñas y adolescentes",2022,4,3,2109,142.247510668563,0,1110,0,3,999,300.3003003003
37482,76,76828,121,Tasa de exámenes médico legales por presunto delito sexual cuando la víctima está entre 18 y 28 años,2022,5,1,3002,33.311125916056,0,1493,0,1,1509,66.2690523525514
37483,76,76834,81,"Tasa de exámenes médico legales por presunto delito sexual contra niños, niñas y adolescentes",2022,2,9,16085,55.952751010258,2,8249,24.245363074312,7,7836,89.3312914752425
37484,76,76834,81,"Tasa de exámenes médico legales por presunto delito sexual contra niños, niñas y adolescentes",2022,3,16,21180,75.5429650613787,8,10803,74.0535036563917,8,10377,77.0935723234075
37485,76,76834,81,"Tasa de exámenes médico legales por presunto delito sexual contra niños, niñas y adolescentes",2022,4,30,22447,133.648148973137,2,11418,17.5162024873008,28,11029,253.876144709402
37486,76,76834,121,Tasa de exámenes médico legales por presunto delito sexual cuando la víctima está entre 18 y 28 años,2022,5,15,40199,37.3143610537576,1,19989,5.00275151333233,14,20210,69.2726373082632
37487,76,76845,81,"Tasa de exámenes médico legales por presunto delito sexual contra niños, niñas y adolescentes",2022,3,1,569,175.746924428822,0,309,0,1,260,384.615384615385
37488,76,76845,81,"Tasa de exámenes médico legales por presunto delito sexual contra niños, niñas y adolescentes",2022,4,3,580,517.241379310345,0,318,0,3,262,1145.03816793893
37489,76,76863,81,"Tasa de exámenes médico legales por presunto delito sexual contra niños, niñas y adolescentes",2022,3,2,688,290.697674418605,0,345,0,2,343,583.090379008746
37490,76,76863,81,"Tasa de exámenes médico legales por presunto delito sexual contra niños, niñas y adolescentes",2022,4,2,692,289.017341040462,0,345,0,2,347,576.368876080692
37491,76,76869,81,"Tasa de exámenes médico legales por presunto delito sexual contra niños, niñas y adolescentes",2022,2,1,935,106.951871657754,0,502,0,1,433,230.94688221709
37492,76,76869,81,"Tasa de exámenes médico legales por presunto delito sexual contra niños, niñas y adolescentes",2022,3,3,1196,250.836120401338,0,623,0,3,573,523.560209424084
37493,76,76869,81,"Tasa de exámenes médico legales por presunto delito sexual contra niños, niñas y adolescentes",2022,4,3,1215,246.913580246914,0,619,0,3,596,503.355704697987
37494,76,76890,81,"Tasa de exámenes médico legales por presunto delito sexual contra niños, niñas y adolescentes",2022,2,1,1160,86.2068965517241,0,608,0,1,552,181.159420289855
37495,76,76890,81,"Tasa de exámenes médico legales por presunto delito sexual contra niños, niñas y adolescentes",2022,3,3,1523,196.979645436638,0,775,0,3,748,401.069518716578
37496,76,76890,81,"Tasa de exámenes médico legales por presunto delito sexual contra niños, niñas y adolescentes",2022,4,6,1589,377.595972309629,1,796,125.628140703518,5,793,630.517023959647
37497,76,76890,121,Tasa de exámenes médico legales por presunto delito sexual cuando la víctima está entre 18 y 28 años,2022,5,1,2714,36.8459837877671,0,1400,0,1,1314,76.103500761035
37498,76,76892,81,"Tasa de exámenes médico legales por presunto delito sexual contra niños, niñas y adolescentes",2022,2,12,7977,150.432493418578,2,4166,48.0076812289966,10,3811,262.398320650748
37499,76,76892,81,"Tasa de exámenes médico legales por presunto delito sexual contra niños, niñas y adolescentes",2022,3,22,10208,215.51724137931,3,5185,57.8592092574735,19,5023,378.260003981684
37500,76,76892,81,"Tasa de exámenes médico legales por presunto delito sexual contra niños, niñas y adolescentes",2022,4,30,10677,280.977802753582,2,5284,37.8501135503407,28,5393,519.191544594845
37501,76,76892,121,Tasa de exámenes médico legales por presunto delito sexual cuando la víctima está entre 18 y 28 años,2022,5,5,19918,25.1029219801185,1,9823,10.1801893515219,4,10095,39.6235760277365
37502,76,76895,81,"Tasa de exámenes médico legales por presunto delito sexual contra niños, niñas y adolescentes",2022,2,2,3140,63.6942675159236,2,1568,127.551020408163,0,1572,0
37503,76,76895,81,"Tasa de exámenes médico legales por presunto delito sexual contra niños, niñas y adolescentes",2022,4,5,4378,114.207400639561,0,2188,0,5,2190,228.310502283105
37504,76,76895,121,Tasa de exámenes médico legales por presunto delito sexual cuando la víctima está entre 18 y 28 años,2022,5,3,7432,40.3659849300323,0,3668,0,3,3764,79.7024442082891
37505,97,97001,81,"Tasa de exámenes médico legales por presunto delito sexual contra niños, niñas y adolescentes",2022,2,1,4303,23.2396002788752,0,2214,0,1,2089,47.8697941598851
37506,97,97001,81,"Tasa de exámenes médico legales por presunto delito sexual contra niños, niñas y adolescentes",2022,3,2,5590,35.778175313059,0,2802,0,2,2788,71.7360114777618
37507,97,97001,81,"Tasa de exámenes médico legales por presunto delito sexual contra niños, niñas y adolescentes",2022,4,4,5486,72.9128691213999,0,2743,0,4,2743,145.8257382428
37508,97,97001,121,Tasa de exámenes médico legales por presunto delito sexual cuando la víctima está entre 18 y 28 años,2022,5,5,7073,70.6913615156228,1,3903,25.6213169356905,4,3170,126.182965299685
37509,99,99773,81,"Tasa de exámenes médico legales por presunto delito sexual contra niños, niñas y adolescentes",2022,2,1,10533,9.49397132820659,0,5345,0,1,5188,19.2752505782575
37510,99,99773,81,"Tasa de exámenes médico legales por presunto delito sexual contra niños, niñas y adolescentes",2022,3,1,12909,7.74653342629173,0,6608,0,1,6301,15.8704967465482
37511,99,99773,81,"Tasa de exámenes médico legales por presunto delito sexual contra niños, niñas y adolescentes",2022,4,2,12326,16.2258640272595,0,6369,0,2,5957,33.5739466174249
37512,99,99524,81,"Tasa de exámenes médico legales por presunto delito sexual contra niños, niñas y adolescentes",2022,3,1,1316,75.9878419452887,1,669,149.476831091181,0,647,0
37513,99,99524,81,"Tasa de exámenes médico legales por presunto delito sexual contra niños, niñas y adolescentes",2022,4,3,1390,215.827338129496,1,727,137.551581843191,2,663,301.659125188537
37514,99,99001,81,"Tasa de exámenes médico legales por presunto delito sexual contra niños, niñas y adolescentes",2022,4,7,2407,290.818446198587,0,1257,0,7,1150,608.695652173913
37515,99,99001,121,Tasa de exámenes médico legales por presunto delito sexual cuando la víctima está entre 18 y 28 años,2022,5,1,4862,20.5676676264912,0,2569,0,1,2293,43.6109899694723
37516,99,99624,81,"Tasa de exámenes médico legales por presunto delito sexual contra niños, niñas y adolescentes",2022,4,2,589,339.55857385399,0,296,0,2,293,682.59385665529
