id,cdep,cmun,cindica,nomind,periodo,edadR,casos,poblacion,tasa,casosh,poblacionh,tasah,casosm,poblacionm,tasam
32443,91,91263,81,"Tasa de exámenes médico legales por presunto delito sexual contra niños, niñas y adolescentes",2021,3,1,331,302.114803625378,0,174,0,1,157,636.942675159236
32444,91,91405,81,"Tasa de exámenes médico legales por presunto delito sexual contra niños, niñas y adolescentes",2021,4,3,540,555.555555555556,0,295,0,3,245,1224.48979591837
32445,91,91001,81,"Tasa de exámenes médico legales por presunto delito sexual contra niños, niñas y adolescentes",2021,2,13,5711,227.630887760462,4,2926,136.705399863295,9,2785,323.159784560144
32446,91,91001,81,"Tasa de exámenes médico legales por presunto delito sexual contra niños, niñas y adolescentes",2021,3,21,6788,309.36947554508,5,3447,145.053669857847,16,3341,478.898533373242
32447,91,91001,81,"Tasa de exámenes médico legales por presunto delito sexual contra niños, niñas y adolescentes",2021,4,30,6395,469.116497263487,3,3266,91.8554807103491,27,3129,862.895493767977
32448,91,91001,121,Tasa de exámenes médico legales por presunto delito sexual cuando la víctima está entre 18 y 28 años,2021,5,4,9868,40.5350628293474,1,5282,18.9322226429383,3,4586,65.4164849542085
32449,91,91536,81,"Tasa de exámenes médico legales por presunto delito sexual contra niños, niñas y adolescentes",2021,3,1,148,675.675675675676,0,73,0,1,75,1333.33333333333
32450,91,91536,81,"Tasa de exámenes médico legales por presunto delito sexual contra niños, niñas y adolescentes",2021,4,1,116,862.068965517241,0,48,0,1,68,1470.58823529412
32451,5,5002,81,"Tasa de exámenes médico legales por presunto delito sexual contra niños, niñas y adolescentes",2021,2,3,1296,231.481481481481,1,656,152.439024390244,2,640,312.5
32452,5,5002,81,"Tasa de exámenes médico legales por presunto delito sexual contra niños, niñas y adolescentes",2021,3,5,1804,277.161862527716,0,945,0,5,859,582.072176949942
32453,5,5002,81,"Tasa de exámenes médico legales por presunto delito sexual contra niños, niñas y adolescentes",2021,4,12,1968,609.756097560976,3,1062,282.485875706215,9,906,993.377483443709
32454,5,5004,81,"Tasa de exámenes médico legales por presunto delito sexual contra niños, niñas y adolescentes",2021,3,1,257,389.105058365759,0,138,0,1,119,840.336134453782
32455,5,5004,81,"Tasa de exámenes médico legales por presunto delito sexual contra niños, niñas y adolescentes",2021,4,1,265,377.358490566038,0,151,0,1,114,877.19298245614
32456,5,5030,81,"Tasa de exámenes médico legales por presunto delito sexual contra niños, niñas y adolescentes",2021,2,3,2034,147.492625368732,2,1043,191.754554170662,1,991,100.908173562059
32457,5,5030,81,"Tasa de exámenes médico legales por presunto delito sexual contra niños, niñas y adolescentes",2021,3,9,2543,353.912701533622,3,1293,232.018561484919,6,1250,480
32458,5,5030,81,"Tasa de exámenes médico legales por presunto delito sexual contra niños, niñas y adolescentes",2021,4,10,2762,362.056480811007,2,1405,142.348754448399,8,1357,589.535740604274
32459,5,5030,121,Tasa de exámenes médico legales por presunto delito sexual cuando la víctima está entre 18 y 28 años,2021,5,2,5694,35.1246926589392,0,2919,0,2,2775,72.0720720720721
32460,5,5031,81,"Tasa de exámenes médico legales por presunto delito sexual contra niños, niñas y adolescentes",2021,2,2,2205,90.702947845805,0,1135,0,2,1070,186.915887850467
32461,5,5031,81,"Tasa de exámenes médico legales por presunto delito sexual contra niños, niñas y adolescentes",2021,3,5,2921,171.174255391989,0,1488,0,5,1433,348.918353105373
32462,5,5031,81,"Tasa de exámenes médico legales por presunto delito sexual contra niños, niñas y adolescentes",2021,4,9,3057,294.406280667321,0,1556,0,9,1501,599.600266489007
32463,5,5034,81,"Tasa de exámenes médico legales por presunto delito sexual contra niños, niñas y adolescentes",2021,2,7,3149,222.292791362337,1,1659,60.2772754671489,6,1490,402.684563758389
32464,5,5034,81,"Tasa de exámenes médico legales por presunto delito sexual contra niños, niñas y adolescentes",2021,3,5,3897,128.303823453939,1,2047,48.8519785051295,4,1850,216.216216216216
32465,5,5034,81,"Tasa de exámenes médico legales por presunto delito sexual contra niños, niñas y adolescentes",2021,4,12,4064,295.275590551181,1,2128,46.9924812030075,11,1936,568.181818181818
32466,5,5034,121,Tasa de exámenes médico legales por presunto delito sexual cuando la víctima está entre 18 y 28 años,2021,5,2,7942,25.182573659028,0,4386,0,2,3556,56.2429696287964
32467,5,5036,81,"Tasa de exámenes médico legales por presunto delito sexual contra niños, niñas y adolescentes",2021,2,1,404,247.524752475248,0,224,0,1,180,555.555555555556
32468,5,5038,81,"Tasa de exámenes médico legales por presunto delito sexual contra niños, niñas y adolescentes",2021,4,3,1274,235.478806907378,0,655,0,3,619,484.652665589661
32469,5,5038,121,Tasa de exámenes médico legales por presunto delito sexual cuando la víctima está entre 18 y 28 años,2021,5,1,2072,48.2625482625483,0,1079,0,1,993,100.704934541793
32470,5,5040,81,"Tasa de exámenes médico legales por presunto delito sexual contra niños, niñas y adolescentes",2021,3,6,2341,256.300726185391,1,1216,82.2368421052632,5,1125,444.444444444444
32471,5,5040,81,"Tasa de exámenes médico legales por presunto delito sexual contra niños, niñas y adolescentes",2021,4,7,2237,312.919088064372,0,1190,0,7,1047,668.576886341929
32472,5,5040,121,Tasa de exámenes médico legales por presunto delito sexual cuando la víctima está entre 18 y 28 años,2021,5,3,3774,79.4912559618442,0,1998,0,3,1776,168.918918918919
32473,5,5044,81,"Tasa de exámenes médico legales por presunto delito sexual contra niños, niñas y adolescentes",2021,2,3,623,481.540930979133,0,337,0,3,286,1048.95104895105
32474,5,5044,81,"Tasa de exámenes médico legales por presunto delito sexual contra niños, niñas y adolescentes",2021,3,1,779,128.369704749679,1,407,245.700245700246,0,372,0
32475,5,5044,81,"Tasa de exámenes médico legales por presunto delito sexual contra niños, niñas y adolescentes",2021,4,1,784,127.551020408163,0,406,0,1,378,264.550264550265
32476,5,5045,81,"Tasa de exámenes médico legales por presunto delito sexual contra niños, niñas y adolescentes",2021,2,5,11702,42.7277388480602,1,6041,16.553550736633,4,5661,70.658894188306
32477,5,5045,81,"Tasa de exámenes médico legales por presunto delito sexual contra niños, niñas y adolescentes",2021,3,22,14345,153.36354130359,4,7344,54.4662309368192,18,7001,257.106127696043
32478,5,5045,81,"Tasa de exámenes médico legales por presunto delito sexual contra niños, niñas y adolescentes",2021,4,22,14344,153.374233128834,1,7225,13.840830449827,21,7119,294.985250737463
32479,5,5045,121,Tasa de exámenes médico legales por presunto delito sexual cuando la víctima está entre 18 y 28 años,2021,5,6,26144,22.9498164014688,0,12829,0,6,13315,45.0619601952685
32480,5,5051,81,"Tasa de exámenes médico legales por presunto delito sexual contra niños, niñas y adolescentes",2021,4,1,3705,26.9905533063428,0,2007,0,1,1698,58.8928150765607
32481,5,5055,81,"Tasa de exámenes médico legales por presunto delito sexual contra niños, niñas y adolescentes",2021,2,1,668,149.700598802395,0,358,0,1,310,322.58064516129
32482,5,5055,81,"Tasa de exámenes médico legales por presunto delito sexual contra niños, niñas y adolescentes",2021,3,2,847,236.127508854782,0,464,0,2,383,522.193211488251
32483,5,5059,81,"Tasa de exámenes médico legales por presunto delito sexual contra niños, niñas y adolescentes",2021,4,1,406,246.305418719212,0,208,0,1,198,505.050505050505
32484,5,5079,81,"Tasa de exámenes médico legales por presunto delito sexual contra niños, niñas y adolescentes",2021,3,3,4279,70.1098387473709,1,2177,45.9347726228755,2,2102,95.1474785918173
32485,5,5079,81,"Tasa de exámenes médico legales por presunto delito sexual contra niños, niñas y adolescentes",2021,4,16,4752,336.700336700337,3,2442,122.850122850123,13,2310,562.770562770563
32486,5,5079,121,Tasa de exámenes médico legales por presunto delito sexual cuando la víctima está entre 18 y 28 años,2021,5,7,9699,72.1723889060728,0,4982,0,7,4717,148.399406402374
32487,5,5088,81,"Tasa de exámenes médico legales por presunto delito sexual contra niños, niñas y adolescentes",2021,2,20,35645,56.1088511712723,5,18322,27.2895972055452,15,17323,86.590082549212
32488,5,5088,81,"Tasa de exámenes médico legales por presunto delito sexual contra niños, niñas y adolescentes",2021,3,35,42775,81.8234950321449,6,21815,27.5040110016044,29,20960,138.358778625954
32489,5,5088,81,"Tasa de exámenes médico legales por presunto delito sexual contra niños, niñas y adolescentes",2021,4,39,46382,84.0843430641197,4,23345,17.1342899978582,35,23037,151.929504709815
32490,5,5088,121,Tasa de exámenes médico legales por presunto delito sexual cuando la víctima está entre 18 y 28 años,2021,5,9,112879,7.9731393793354,1,57090,1.75162024873008,8,55789,14.3397443940562
32491,5,5091,81,"Tasa de exámenes médico legales por presunto delito sexual contra niños, niñas y adolescentes",2021,3,2,1073,186.393289841566,0,541,0,2,532,375.93984962406
32492,5,5091,81,"Tasa de exámenes médico legales por presunto delito sexual contra niños, niñas y adolescentes",2021,4,3,1126,266.429840142096,0,569,0,3,557,538.599640933573
32493,5,5091,121,Tasa de exámenes médico legales por presunto delito sexual cuando la víctima está entre 18 y 28 años,2021,5,1,1723,58.0383052814858,0,896,0,1,827,120.918984280532
32494,5,5093,81,"Tasa de exámenes médico legales por presunto delito sexual contra niños, niñas y adolescentes",2021,2,4,1378,290.275761973875,1,714,140.056022408964,3,664,451.807228915663
32495,5,5093,81,"Tasa de exámenes médico legales por presunto delito sexual contra niños, niñas y adolescentes",2021,3,4,1760,227.272727272727,0,913,0,4,847,472.255017709563
32496,5,5093,81,"Tasa de exámenes médico legales por presunto delito sexual contra niños, niñas y adolescentes",2021,4,1,1802,55.4938956714761,0,934,0,1,868,115.207373271889
32497,5,5107,81,"Tasa de exámenes médico legales por presunto delito sexual contra niños, niñas y adolescentes",2021,2,1,840,119.047619047619,0,422,0,1,418,239.234449760766
32498,5,5107,81,"Tasa de exámenes médico legales por presunto delito sexual contra niños, niñas y adolescentes",2021,4,3,971,308.959835221421,0,528,0,3,443,677.200902934537
32499,5,5113,81,"Tasa de exámenes médico legales por presunto delito sexual contra niños, niñas y adolescentes",2021,3,1,1089,91.8273645546373,0,531,0,1,558,179.21146953405
32500,5,5113,121,Tasa de exámenes médico legales por presunto delito sexual cuando la víctima está entre 18 y 28 años,2021,5,1,1789,55.8971492453885,0,976,0,1,813,123.0012300123
32501,5,5120,81,"Tasa de exámenes médico legales por presunto delito sexual contra niños, niñas y adolescentes",2021,2,1,3749,26.6737796745799,0,1946,0,1,1803,55.4631170271769
32502,5,5120,81,"Tasa de exámenes médico legales por presunto delito sexual contra niños, niñas y adolescentes",2021,3,2,4313,46.3714351959193,2,2286,87.4890638670166,0,2027,0
32503,5,5120,81,"Tasa de exámenes médico legales por presunto delito sexual contra niños, niñas y adolescentes",2021,4,3,3905,76.8245838668374,0,2125,0,3,1780,168.539325842697
32504,5,5120,121,Tasa de exámenes médico legales por presunto delito sexual cuando la víctima está entre 18 y 28 años,2021,5,1,5234,19.105846388995,0,2739,0,1,2495,40.0801603206413
32505,5,5125,81,"Tasa de exámenes médico legales por presunto delito sexual contra niños, niñas y adolescentes",2021,4,1,932,107.296137339056,0,456,0,1,476,210.084033613445
32506,5,5129,81,"Tasa de exámenes médico legales por presunto delito sexual contra niños, niñas y adolescentes",2021,2,13,4494,289.274588340009,2,2296,87.1080139372822,11,2198,500.454959053685
32507,5,5129,81,"Tasa de exámenes médico legales por presunto delito sexual contra niños, niñas y adolescentes",2021,3,14,5631,248.623690285917,6,2847,210.748155953635,8,2784,287.35632183908
32508,5,5129,81,"Tasa de exámenes médico legales por presunto delito sexual contra niños, niñas y adolescentes",2021,4,18,6367,282.707711638134,0,3181,0,18,3186,564.971751412429
32509,5,5129,121,Tasa de exámenes médico legales por presunto delito sexual cuando la víctima está entre 18 y 28 años,2021,5,3,15449,19.418732604052,0,7682,0,3,7767,38.6249517188104
32510,5,5134,81,"Tasa de exámenes médico legales por presunto delito sexual contra niños, niñas y adolescentes",2021,2,1,822,121.654501216545,0,413,0,1,409,244.498777506112
32511,5,5134,81,"Tasa de exámenes médico legales por presunto delito sexual contra niños, niñas y adolescentes",2021,3,4,1128,354.609929078014,0,601,0,4,527,759.013282732448
32512,5,5134,81,"Tasa de exámenes médico legales por presunto delito sexual contra niños, niñas y adolescentes",2021,4,5,1152,434.027777777778,0,624,0,5,528,946.969696969697
32513,5,5138,81,"Tasa de exámenes médico legales por presunto delito sexual contra niños, niñas y adolescentes",2021,2,1,1248,80.1282051282051,1,630,158.730158730159,0,618,0
32514,5,5138,81,"Tasa de exámenes médico legales por presunto delito sexual contra niños, niñas y adolescentes",2021,3,10,1594,627.352572145546,2,794,251.889168765743,8,800,1000
32515,5,5138,81,"Tasa de exámenes médico legales por presunto delito sexual contra niños, niñas y adolescentes",2021,4,6,1638,366.300366300366,1,816,122.549019607843,5,822,608.272506082725
32516,5,5147,81,"Tasa de exámenes médico legales por presunto delito sexual contra niños, niñas y adolescentes",2021,3,3,6249,48.0076812289966,2,3180,62.8930817610063,1,3069,32.5839035516455
32517,5,5147,121,Tasa de exámenes médico legales por presunto delito sexual cuando la víctima está entre 18 y 28 años,2021,5,1,10536,9.49126803340927,0,5375,0,1,5161,19.3760899050572
32518,5,5150,81,"Tasa de exámenes médico legales por presunto delito sexual contra niños, niñas y adolescentes",2021,3,1,265,377.358490566038,0,138,0,1,127,787.40157480315
32519,5,5150,81,"Tasa de exámenes médico legales por presunto delito sexual contra niños, niñas y adolescentes",2021,4,2,321,623.052959501558,1,164,609.756097560976,1,157,636.942675159236
32520,5,5154,81,"Tasa de exámenes médico legales por presunto delito sexual contra niños, niñas y adolescentes",2021,2,1,9653,10.3594737387341,0,4956,0,1,4697,21.2901852246115
32521,5,5154,81,"Tasa de exámenes médico legales por presunto delito sexual contra niños, niñas y adolescentes",2021,3,4,11433,34.986442753433,0,5823,0,4,5610,71.301247771836
32522,5,5154,81,"Tasa de exámenes médico legales por presunto delito sexual contra niños, niñas y adolescentes",2021,4,15,10792,138.991845811712,3,5401,55.5452693945566,12,5391,222.593210907067
32523,5,5154,121,Tasa de exámenes médico legales por presunto delito sexual cuando la víctima está entre 18 y 28 años,2021,5,3,17786,16.8671989204993,0,8607,0,3,9179,32.6832988342957
32524,5,5172,81,"Tasa de exámenes médico legales por presunto delito sexual contra niños, niñas y adolescentes",2021,2,1,5863,17.0561146170902,0,3033,0,1,2830,35.3356890459364
32525,5,5172,81,"Tasa de exámenes médico legales por presunto delito sexual contra niños, niñas y adolescentes",2021,3,6,7359,81.5328169588259,1,3764,26.567481402763,5,3595,139.082058414465
32526,5,5172,81,"Tasa de exámenes médico legales por presunto delito sexual contra niños, niñas y adolescentes",2021,4,3,7338,40.8830744071954,0,3683,0,3,3655,82.0793433652531
32527,5,5172,121,Tasa de exámenes médico legales por presunto delito sexual cuando la víctima está entre 18 y 28 años,2021,5,4,11949,33.475604653109,0,5764,0,4,6185,64.6725949878739
32528,5,5190,81,"Tasa de exámenes médico legales por presunto delito sexual contra niños, niñas y adolescentes",2021,2,3,652,460.122699386503,1,331,302.114803625378,2,321,623.052959501558
32529,5,5190,81,"Tasa de exámenes médico legales por presunto delito sexual contra niños, niñas y adolescentes",2021,3,4,841,475.624256837099,1,421,237.529691211401,3,420,714.285714285714
32530,5,5190,81,"Tasa de exámenes médico legales por presunto delito sexual contra niños, niñas y adolescentes",2021,4,5,865,578.034682080925,0,430,0,5,435,1149.42528735632
32531,5,5101,81,"Tasa de exámenes médico legales por presunto delito sexual contra niños, niñas y adolescentes",2021,2,4,1863,214.707461084273,1,969,103.199174406605,3,894,335.570469798658
32532,5,5101,81,"Tasa de exámenes médico legales por presunto delito sexual contra niños, niñas y adolescentes",2021,3,3,2447,122.599100939926,1,1278,78.2472613458529,2,1169,171.086398631309
32533,5,5101,81,"Tasa de exámenes médico legales por presunto delito sexual contra niños, niñas y adolescentes",2021,4,3,2540,118.110236220472,0,1320,0,3,1220,245.901639344262
32534,5,5197,81,"Tasa de exámenes médico legales por presunto delito sexual contra niños, niñas y adolescentes",2021,2,1,1326,75.4147812971342,0,684,0,1,642,155.763239875389
32535,5,5197,81,"Tasa de exámenes médico legales por presunto delito sexual contra niños, niñas y adolescentes",2021,3,1,1500,66.6666666666667,0,753,0,1,747,133.868808567604
32536,5,5197,81,"Tasa de exámenes médico legales por presunto delito sexual contra niños, niñas y adolescentes",2021,4,1,1410,70.9219858156028,0,696,0,1,714,140.056022408964
32537,5,5206,81,"Tasa de exámenes médico legales por presunto delito sexual contra niños, niñas y adolescentes",2021,4,2,424,471.698113207547,0,236,0,2,188,1063.82978723404
32538,5,5209,81,"Tasa de exámenes médico legales por presunto delito sexual contra niños, niñas y adolescentes",2021,2,3,1497,200.400801603206,2,773,258.732212160414,1,724,138.121546961326
32539,5,5209,81,"Tasa de exámenes médico legales por presunto delito sexual contra niños, niñas y adolescentes",2021,3,3,2064,145.348837209302,1,1062,94.1619585687382,2,1002,199.600798403194
32540,5,5209,81,"Tasa de exámenes médico legales por presunto delito sexual contra niños, niñas y adolescentes",2021,4,7,2244,311.942959001783,0,1145,0,7,1099,636.942675159236
32541,5,5209,121,Tasa de exámenes médico legales por presunto delito sexual cuando la víctima está entre 18 y 28 años,2021,5,1,3607,27.7238702522872,0,1817,0,1,1790,55.8659217877095
32542,5,5212,81,"Tasa de exámenes médico legales por presunto delito sexual contra niños, niñas y adolescentes",2021,2,8,4426,180.75011296882101,2,2258,88.5739592559788,6,2168,276.752767527675
32543,5,5212,81,"Tasa de exámenes médico legales por presunto delito sexual contra niños, niñas y adolescentes",2021,3,12,5644,212.615166548547,6,2899,206.967919972404,6,2745,218.579234972678
32544,5,5212,81,"Tasa de exámenes médico legales por presunto delito sexual contra niños, niñas y adolescentes",2021,4,17,6515,260.936300844206,2,3326,60.1322910402886,15,3189,470.366886171214
32545,5,5212,121,Tasa de exámenes médico legales por presunto delito sexual cuando la víctima está entre 18 y 28 años,2021,5,7,15371,45.540303168304,0,7796,0,7,7575,92.4092409240924
32546,5,5234,81,"Tasa de exámenes médico legales por presunto delito sexual contra niños, niñas y adolescentes",2021,2,9,3078,292.397660818713,1,1603,62.3830318153462,8,1475,542.372881355932
32547,5,5234,81,"Tasa de exámenes médico legales por presunto delito sexual contra niños, niñas y adolescentes",2021,3,15,3310,453.172205438067,3,1710,175.438596491228,12,1600,750
32548,5,5234,81,"Tasa de exámenes médico legales por presunto delito sexual contra niños, niñas y adolescentes",2021,4,6,2794,214.745884037223,1,1425,70.1754385964912,5,1369,365.230094959825
32549,5,5237,81,"Tasa de exámenes médico legales por presunto delito sexual contra niños, niñas y adolescentes",2021,2,2,1490,134.228187919463,0,818,0,2,672,297.619047619048
32550,5,5237,81,"Tasa de exámenes médico legales por presunto delito sexual contra niños, niñas y adolescentes",2021,3,6,1862,322.234156820623,3,941,318.809776833156,3,921,325.732899022801
32551,5,5237,81,"Tasa de exámenes médico legales por presunto delito sexual contra niños, niñas y adolescentes",2021,4,3,1963,152.827305145186,0,932,0,3,1031,290.9796314258
32552,5,5237,121,Tasa de exámenes médico legales por presunto delito sexual cuando la víctima está entre 18 y 28 años,2021,5,1,3653,27.3747604708459,0,1719,0,1,1934,51.7063081695967
32553,5,5240,81,"Tasa de exámenes médico legales por presunto delito sexual contra niños, niñas y adolescentes",2021,4,2,1054,189.753320683112,1,573,174.520069808028,1,481,207.900207900208
32554,5,5250,81,"Tasa de exámenes médico legales por presunto delito sexual contra niños, niñas y adolescentes",2021,3,1,7444,13.4336378291241,0,3771,0,1,3673,27.2257010618023
32555,5,5148,81,"Tasa de exámenes médico legales por presunto delito sexual contra niños, niñas y adolescentes",2021,2,9,5022,179.21146953405,1,2575,38.8349514563107,8,2447,326.930935839804
32556,5,5148,81,"Tasa de exámenes médico legales por presunto delito sexual contra niños, niñas y adolescentes",2021,3,6,5767,104.040228888504,2,2913,68.6577411603158,4,2854,140.154169586545
32557,5,5148,81,"Tasa de exámenes médico legales por presunto delito sexual contra niños, niñas y adolescentes",2021,4,12,5774,207.828195358504,1,2880,34.7222222222222,11,2894,380.096751900484
32558,5,5148,121,Tasa de exámenes médico legales por presunto delito sexual cuando la víctima está entre 18 y 28 años,2021,5,4,11936,33.5120643431635,0,6024,0,4,5912,67.65899864682
32559,5,5697,81,"Tasa de exámenes médico legales por presunto delito sexual contra niños, niñas y adolescentes",2021,4,5,3615,138.312586445367,0,1818,0,5,1797,278.241513633834
32560,5,5697,121,Tasa de exámenes médico legales por presunto delito sexual cuando la víctima está entre 18 y 28 años,2021,5,1,6371,15.6961230576048,1,3049,32.797638570023,0,3322,0
32561,5,5264,81,"Tasa de exámenes médico legales por presunto delito sexual contra niños, niñas y adolescentes",2021,3,2,1163,171.969045571797,0,557,0,2,606,330.03300330033
32562,5,5264,121,Tasa de exámenes médico legales por presunto delito sexual cuando la víctima está entre 18 y 28 años,2021,5,1,2159,46.3177396943029,0,1115,0,1,1044,95.7854406130268
32563,5,5266,81,"Tasa de exámenes médico legales por presunto delito sexual contra niños, niñas y adolescentes",2021,2,3,10802,27.7726346972783,2,5508,36.3108206245461,1,5294,18.8893086513034
32564,5,5266,81,"Tasa de exámenes médico legales por presunto delito sexual contra niños, niñas y adolescentes",2021,3,7,13345,52.4541026601724,2,6913,28.930999566035,5,6432,77.7363184079602
32565,5,5266,81,"Tasa de exámenes médico legales por presunto delito sexual contra niños, niñas y adolescentes",2021,4,9,15080,59.6816976127321,2,7774,25.7267815796244,7,7306,95.8116616479606
32566,5,5266,121,Tasa de exámenes médico legales por presunto delito sexual cuando la víctima está entre 18 y 28 años,2021,5,7,38759,18.0603214737222,0,19045,0,7,19714,35.5077609820432
32567,5,5282,81,"Tasa de exámenes médico legales por presunto delito sexual contra niños, niñas y adolescentes",2021,4,4,2132,187.617260787993,0,1099,0,4,1033,387.221684414327
32568,5,5282,121,Tasa de exámenes médico legales por presunto delito sexual cuando la víctima está entre 18 y 28 años,2021,5,4,3634,110.071546505228,2,1922,104.058272632674,2,1712,116.822429906542
32569,5,5284,81,"Tasa de exámenes médico legales por presunto delito sexual contra niños, niñas y adolescentes",2021,3,1,2566,38.971161340608,0,1318,0,1,1248,80.1282051282051
32570,5,5306,81,"Tasa de exámenes médico legales por presunto delito sexual contra niños, niñas y adolescentes",2021,2,1,534,187.265917602996,0,282,0,1,252,396.825396825397
32571,5,5306,81,"Tasa de exámenes médico legales por presunto delito sexual contra niños, niñas y adolescentes",2021,3,5,638,783.699059561129,0,321,0,5,317,1577.28706624606
32572,5,5308,81,"Tasa de exámenes médico legales por presunto delito sexual contra niños, niñas y adolescentes",2021,2,1,3323,30.0932891965092,0,1757,0,1,1566,63.8569604086846
32573,5,5308,81,"Tasa de exámenes médico legales por presunto delito sexual contra niños, niñas y adolescentes",2021,3,6,4123,145.525103080281,0,2136,0,6,1987,301.962757926522
32574,5,5308,81,"Tasa de exámenes médico legales por presunto delito sexual contra niños, niñas y adolescentes",2021,4,14,4507,310.627912136676,0,2294,0,14,2213,632.625395390872
32575,5,5308,121,Tasa de exámenes médico legales por presunto delito sexual cuando la víctima está entre 18 y 28 años,2021,5,2,10099,19.8039409842559,0,5139,0,2,4960,40.3225806451613
32576,5,5310,81,"Tasa de exámenes médico legales por presunto delito sexual contra niños, niñas y adolescentes",2021,2,1,624,160.25641025641,0,297,0,1,327,305.810397553517
32577,5,5310,81,"Tasa de exámenes médico legales por presunto delito sexual contra niños, niñas y adolescentes",2021,4,2,901,221.975582685905,1,490,204.081632653061,1,411,243.30900243309
32578,5,5310,121,Tasa de exámenes médico legales por presunto delito sexual cuando la víctima está entre 18 y 28 años,2021,5,1,1403,71.2758374910905,0,720,0,1,683,146.412884333821
32579,5,5313,81,"Tasa de exámenes médico legales por presunto delito sexual contra niños, niñas y adolescentes",2021,3,1,1088,91.9117647058824,0,582,0,1,506,197.628458498024
32580,5,5315,81,"Tasa de exámenes médico legales por presunto delito sexual contra niños, niñas y adolescentes",2021,3,1,664,150.602409638554,0,346,0,1,318,314.465408805032
32581,5,5315,121,Tasa de exámenes médico legales por presunto delito sexual cuando la víctima está entre 18 y 28 años,2021,5,1,1164,85.9106529209622,0,585,0,1,579,172.711571675302
32582,5,5318,81,"Tasa de exámenes médico legales por presunto delito sexual contra niños, niñas y adolescentes",2021,2,5,3848,129.93762993763,1,2050,48.7804878048781,4,1798,222.469410456062
32583,5,5318,81,"Tasa de exámenes médico legales por presunto delito sexual contra niños, niñas y adolescentes",2021,3,14,4460,313.90134529148,4,2357,169.707254985151,10,2103,475.511174512601
32584,5,5318,81,"Tasa de exámenes médico legales por presunto delito sexual contra niños, niñas y adolescentes",2021,4,8,4684,170.794192997438,1,2462,40.6173842404549,7,2222,315.031503150315
32585,5,5321,81,"Tasa de exámenes médico legales por presunto delito sexual contra niños, niñas y adolescentes",2021,2,2,598,334.448160535117,0,299,0,2,299,668.896321070234
32586,5,5321,81,"Tasa de exámenes médico legales por presunto delito sexual contra niños, niñas y adolescentes",2021,3,1,711,140.646976090014,0,355,0,1,356,280.898876404494
32587,5,5321,81,"Tasa de exámenes médico legales por presunto delito sexual contra niños, niñas y adolescentes",2021,4,3,725,413.793103448276,0,369,0,3,356,842.696629213483
32588,5,5321,121,Tasa de exámenes médico legales por presunto delito sexual cuando la víctima está entre 18 y 28 años,2021,5,3,1505,199.335548172757,0,763,0,3,742,404.312668463612
32589,5,5347,121,Tasa de exámenes médico legales por presunto delito sexual cuando la víctima está entre 18 y 28 años,2021,5,1,785,127.388535031847,0,417,0,1,368,271.739130434783
32590,5,5353,81,"Tasa de exámenes médico legales por presunto delito sexual contra niños, niñas y adolescentes",2021,2,1,410,243.90243902439,0,204,0,1,206,485.436893203883
32591,5,5360,81,"Tasa de exámenes médico legales por presunto delito sexual contra niños, niñas y adolescentes",2021,2,7,16233,43.122035360069,2,8365,23.9091452480574,5,7868,63.5485510930351
32592,5,5360,81,"Tasa de exámenes médico legales por presunto delito sexual contra niños, niñas y adolescentes",2021,3,21,19444,108.002468627854,6,9985,60.0901352028042,15,9459,158.579130986362
32593,5,5360,81,"Tasa de exámenes médico legales por presunto delito sexual contra niños, niñas y adolescentes",2021,4,40,21457,186.419350328564,4,10907,36.6736957916934,36,10550,341.232227488152
32594,5,5360,121,Tasa de exámenes médico legales por presunto delito sexual cuando la víctima está entre 18 y 28 años,2021,5,7,55271,12.6648694613812,1,27774,3.60048966659466,6,27497,21.8205622431538
32595,5,5361,81,"Tasa de exámenes médico legales por presunto delito sexual contra niños, niñas y adolescentes",2021,3,7,2684,260.80476900149,1,1399,71.4796283059328,6,1285,466.926070038911
32596,5,5361,81,"Tasa de exámenes médico legales por presunto delito sexual contra niños, niñas y adolescentes",2021,4,3,2736,109.649122807018,0,1478,0,3,1258,238.473767885533
32597,5,5364,81,"Tasa de exámenes médico legales por presunto delito sexual contra niños, niñas y adolescentes",2021,3,5,1243,402.252614641995,1,641,156.00624024961,4,602,664.451827242525
32598,5,5364,81,"Tasa de exámenes médico legales por presunto delito sexual contra niños, niñas y adolescentes",2021,4,3,1315,228.136882129278,1,699,143.061516452074,2,616,324.675324675325
32599,5,5368,81,"Tasa de exámenes médico legales por presunto delito sexual contra niños, niñas y adolescentes",2021,2,2,799,250.312891113892,0,409,0,2,390,512.820512820513
32600,5,5368,81,"Tasa de exámenes médico legales por presunto delito sexual contra niños, niñas y adolescentes",2021,3,7,1057,662.251655629139,1,545,183.48623853211,6,512,1171875
32601,5,5368,81,"Tasa de exámenes médico legales por presunto delito sexual contra niños, niñas y adolescentes",2021,4,11,1138,966.608084358524,2,576,347.222222222222,9,562,1601.42348754448
32602,5,5376,81,"Tasa de exámenes médico legales por presunto delito sexual contra niños, niñas y adolescentes",2021,2,7,4182,167.384026781444,1,2081,48.0538202787122,6,2101,285.5782960495
32603,5,5376,81,"Tasa de exámenes médico legales por presunto delito sexual contra niños, niñas y adolescentes",2021,3,3,5316,56.4334085778781,0,2692,0,3,2624,114.329268292683
32604,5,5376,81,"Tasa de exámenes médico legales por presunto delito sexual contra niños, niñas y adolescentes",2021,4,17,5867,289.756263848645,1,2997,33.3667000333667,16,2870,557.491289198606
32605,5,5376,121,Tasa de exámenes médico legales por presunto delito sexual cuando la víctima está entre 18 y 28 años,2021,5,8,12567,63.6587888915413,1,6354,15.7381177211206,7,6213,112.666988572348
32606,5,5376,81,"Tasa de exámenes médico legales por presunto delito sexual contra niños, niñas y adolescentes",2021,1,1,812,123.152709359606,0,403,0,1,409,244.498777506112
32607,5,5380,81,"Tasa de exámenes médico legales por presunto delito sexual contra niños, niñas y adolescentes",2021,2,2,4306,46.4468183929401,0,2205,0,2,2101,95.1927653498334
32608,5,5380,81,"Tasa de exámenes médico legales por presunto delito sexual contra niños, niñas y adolescentes",2021,3,6,5253,114.220445459737,0,2730,0,6,2523,237.812128418549
32609,5,5380,81,"Tasa de exámenes médico legales por presunto delito sexual contra niños, niñas y adolescentes",2021,4,7,5792,120.85635359116,2,3012,66.4010624169987,5,2780,179.856115107914
32610,5,5380,121,Tasa de exámenes médico legales por presunto delito sexual cuando la víctima está entre 18 y 28 años,2021,5,2,14078,14.2065634323057,0,7129,0,2,6949,28.7811195855519
32611,5,5390,81,"Tasa de exámenes médico legales por presunto delito sexual contra niños, niñas y adolescentes",2021,3,2,763,262.123197903014,0,398,0,2,365,547.945205479452
32612,5,5390,81,"Tasa de exámenes médico legales por presunto delito sexual contra niños, niñas y adolescentes",2021,4,2,847,236.127508854782,0,443,0,2,404,495.049504950495
32613,5,5390,121,Tasa de exámenes médico legales por presunto delito sexual cuando la víctima está entre 18 y 28 años,2021,5,2,1697,117.855038302887,0,867,0,2,830,240.963855421687
32614,5,5400,81,"Tasa de exámenes médico legales por presunto delito sexual contra niños, niñas y adolescentes",2021,3,1,2046,48.8758553274682,0,1053,0,1,993,100.704934541793
32615,5,5400,81,"Tasa de exámenes médico legales por presunto delito sexual contra niños, niñas y adolescentes",2021,4,2,2199,90.9504320145521,0,1130,0,2,1069,187.090739008419
32616,5,5411,81,"Tasa de exámenes médico legales por presunto delito sexual contra niños, niñas y adolescentes",2021,3,1,987,101.317122593718,1,524,190.839694656489,0,463,0
32617,5,5440,81,"Tasa de exámenes médico legales por presunto delito sexual contra niños, niñas y adolescentes",2021,2,1,5216,19.1717791411043,0,2755,0,1,2461,40.6338886631451
32618,5,5440,81,"Tasa de exámenes médico legales por presunto delito sexual contra niños, niñas y adolescentes",2021,3,1,6102,16.3880694854146,0,3175,0,1,2927,34.1646737273659
32619,5,5440,81,"Tasa de exámenes médico legales por presunto delito sexual contra niños, niñas y adolescentes",2021,4,2,6241,32.0461464508893,0,3178,0,2,3063,65.2954619653934
32620,5,5001,81,"Tasa de exámenes médico legales por presunto delito sexual contra niños, niñas y adolescentes",2021,2,137,149605,91.5744794625848,48,76400,62.8272251308901,89,73205,121.576395054983
32621,5,5001,81,"Tasa de exámenes médico legales por presunto delito sexual contra niños, niñas y adolescentes",2021,3,182,182877,99.5204427019254,58,93079,62.312659139011,124,89798,138.08770796677
32622,5,5001,81,"Tasa de exámenes médico legales por presunto delito sexual contra niños, niñas y adolescentes",2021,4,305,203368,149.974430588883,33,102887,32.0740229572249,272,100481,270.697942894677
32623,5,5001,121,Tasa de exámenes médico legales por presunto delito sexual cuando la víctima está entre 18 y 28 años,2021,5,107,497111,21.5243677971318,10,250015,3.99976001439914,97,247096,39.2559976689222
32624,5,5001,81,"Tasa de exámenes médico legales por presunto delito sexual contra niños, niñas y adolescentes",2021,1,2,29140,6.86341798215511,0,14906,0,2,14234,14.0508641281439
32625,5,5467,81,"Tasa de exámenes médico legales por presunto delito sexual contra niños, niñas y adolescentes",2021,2,2,428,467.289719626168,1,204,490.196078431373,1,224,446.428571428571
32626,5,5467,81,"Tasa de exámenes médico legales por presunto delito sexual contra niños, niñas y adolescentes",2021,3,2,575,347.826086956522,1,285,350.877192982456,1,290,344.827586206897
32627,5,5467,81,"Tasa de exámenes médico legales por presunto delito sexual contra niños, niñas y adolescentes",2021,4,1,592,168.918918918919,0,308,0,1,284,352.112676056338
32628,5,5480,81,"Tasa de exámenes médico legales por presunto delito sexual contra niños, niñas y adolescentes",2021,2,1,1845,54.2005420054201,1,928,107.758620689655,0,917,0
32629,5,5480,81,"Tasa de exámenes médico legales por presunto delito sexual contra niños, niñas y adolescentes",2021,3,4,2055,194.647201946472,1,1058,94.5179584120983,3,997,300.902708124373
32630,5,5480,81,"Tasa de exámenes médico legales por presunto delito sexual contra niños, niñas y adolescentes",2021,4,4,1794,222.965440356745,0,941,0,4,853,468.933177022274
32631,5,5495,81,"Tasa de exámenes médico legales por presunto delito sexual contra niños, niñas y adolescentes",2021,3,1,3851,25.9672812256557,0,1952,0,1,1899,52.6592943654555
32632,5,5490,81,"Tasa de exámenes médico legales por presunto delito sexual contra niños, niñas y adolescentes",2021,2,3,5157,58.173356602676,1,2630,38.0228136882129,2,2527,79.1452314998021
32633,5,5490,81,"Tasa de exámenes médico legales por presunto delito sexual contra niños, niñas y adolescentes",2021,3,5,6247,80.0384184408516,1,3222,31.0366232153942,4,3025,132.231404958678
32634,5,5490,81,"Tasa de exámenes médico legales por presunto delito sexual contra niños, niñas y adolescentes",2021,4,8,5808,137.741046831956,0,3000,0,8,2808,284.900284900285
32635,5,5541,81,"Tasa de exámenes médico legales por presunto delito sexual contra niños, niñas y adolescentes",2021,3,2,1935,103.359173126615,1,970,103.092783505155,1,965,103.626943005181
32636,5,5543,81,"Tasa de exámenes médico legales por presunto delito sexual contra niños, niñas y adolescentes",2021,4,2,948,210.970464135021,0,520,0,2,428,467.289719626168
32637,5,5576,121,Tasa de exámenes médico legales por presunto delito sexual cuando la víctima está entre 18 y 28 años,2021,5,1,1342,74.5156482861401,0,692,0,1,650,153.846153846154
32638,5,5579,81,"Tasa de exámenes médico legales por presunto delito sexual contra niños, niñas y adolescentes",2021,2,7,3123,224.143451809158,0,1595,0,7,1528,458.115183246073
32639,5,5579,81,"Tasa de exámenes médico legales por presunto delito sexual contra niños, niñas y adolescentes",2021,3,5,3888,128.600823045268,1,1987,50.3271263210871,4,1901,210.415570752236
32640,5,5579,81,"Tasa de exámenes médico legales por presunto delito sexual contra niños, niñas y adolescentes",2021,4,10,3915,255.427841634738,0,1991,0,10,1924,519.75051975052
32641,5,5579,121,Tasa de exámenes médico legales por presunto delito sexual cuando la víctima está entre 18 y 28 años,2021,5,3,7498,40.0106695118698,1,3899,25.6476019492177,2,3599,55.5709919422062
32642,5,5585,81,"Tasa de exámenes médico legales por presunto delito sexual contra niños, niñas y adolescentes",2021,3,1,1454,68.7757909215956,0,739,0,1,715,139.86013986014
32643,5,5585,81,"Tasa de exámenes médico legales por presunto delito sexual contra niños, niñas y adolescentes",2021,4,2,1420,140.845070422535,0,731,0,2,689,290.275761973875
32644,5,5585,121,Tasa de exámenes médico legales por presunto delito sexual cuando la víctima está entre 18 y 28 años,2021,5,1,2049,48.8042947779405,0,1036,0,1,1013,98.7166831194472
32645,5,5591,81,"Tasa de exámenes médico legales por presunto delito sexual contra niños, niñas y adolescentes",2021,3,4,1899,210.637177461822,0,977,0,4,922,433.839479392625
32646,5,5591,81,"Tasa de exámenes médico legales por presunto delito sexual contra niños, niñas y adolescentes",2021,4,4,1839,217.509516041327,0,959,0,4,880,454.545454545455
32647,5,5591,121,Tasa de exámenes médico legales por presunto delito sexual cuando la víctima está entre 18 y 28 años,2021,5,2,3970,50.3778337531486,0,2374,0,2,1596,125.31328320802
32648,5,5604,81,"Tasa de exámenes médico legales por presunto delito sexual contra niños, niñas y adolescentes",2021,4,3,3373,88.9415950192707,1,1727,57.9038795599305,2,1646,121.506682867558
32649,5,5604,121,Tasa de exámenes médico legales por presunto delito sexual cuando la víctima está entre 18 y 28 años,2021,5,1,5623,17.7841010136938,0,2800,0,1,2823,35.4233085370174
32650,5,5607,81,"Tasa de exámenes médico legales por presunto delito sexual contra niños, niñas y adolescentes",2021,2,4,1514,264.200792602378,1,802,124.688279301746,3,712,421.348314606742
32651,5,5607,81,"Tasa de exámenes médico legales por presunto delito sexual contra niños, niñas y adolescentes",2021,3,2,1843,108.51871947911,0,961,0,2,882,226.757369614512
32652,5,5607,81,"Tasa de exámenes médico legales por presunto delito sexual contra niños, niñas y adolescentes",2021,4,1,1911,52.3286237571952,0,993,0,1,918,108.932461873638
32653,5,5607,121,Tasa de exámenes médico legales por presunto delito sexual cuando la víctima está entre 18 y 28 años,2021,5,2,3949,50.6457330969866,0,1999,0,2,1950,102.564102564103
32654,5,5615,81,"Tasa de exámenes médico legales por presunto delito sexual contra niños, niñas y adolescentes",2021,2,10,8456,118.259224219489,1,4302,23.2450023245002,9,4154,216.658642272508
32655,5,5615,81,"Tasa de exámenes médico legales por presunto delito sexual contra niños, niñas y adolescentes",2021,3,7,10404,67.281814686659,2,5342,37.4391613627855,5,5062,98.7751876728566
32656,5,5615,81,"Tasa de exámenes médico legales por presunto delito sexual contra niños, niñas y adolescentes",2021,4,22,11631,189.149686183475,1,6086,16.4311534669734,21,5545,378.719567177638
32657,5,5615,121,Tasa de exámenes médico legales por presunto delito sexual cuando la víctima está entre 18 y 28 años,2021,5,5,27000,18.5185185185185,0,14082,0,5,12918,38.7056819941167
32658,5,5631,81,"Tasa de exámenes médico legales por presunto delito sexual contra niños, niñas y adolescentes",2021,2,2,4981,40.1525798032524,0,2576,0,2,2405,83.1600831600832
32659,5,5631,81,"Tasa de exámenes médico legales por presunto delito sexual contra niños, niñas y adolescentes",2021,3,6,5251,114.263949723862,1,2717,36.8052999631947,5,2534,197.316495659037
32660,5,5631,81,"Tasa de exámenes médico legales por presunto delito sexual contra niños, niñas y adolescentes",2021,4,6,5233,114.656984521307,0,2649,0,6,2584,232.198142414861
32661,5,5631,121,Tasa de exámenes médico legales por presunto delito sexual cuando la víctima está entre 18 y 28 años,2021,5,5,15623,32.0040965243551,0,7518,0,5,8105,61.6903146206046
32662,5,5642,81,"Tasa de exámenes médico legales por presunto delito sexual contra niños, niñas y adolescentes",2021,2,8,1391,575.125808770669,0,694,0,8,697,1147.77618364419
32663,5,5642,81,"Tasa de exámenes médico legales por presunto delito sexual contra niños, niñas y adolescentes",2021,3,6,1749,343.053173241853,1,865,115.606936416185,5,884,565.610859728507
32664,5,5642,81,"Tasa de exámenes médico legales por presunto delito sexual contra niños, niñas y adolescentes",2021,4,10,1819,549.752611324904,1,906,110.37527593819,9,913,985.761226725082
32665,5,5642,121,Tasa de exámenes médico legales por presunto delito sexual cuando la víctima está entre 18 y 28 años,2021,5,1,3115,32.1027287319422,0,1594,0,1,1521,65.7462195923734
32666,5,5647,81,"Tasa de exámenes médico legales por presunto delito sexual contra niños, niñas y adolescentes",2021,2,1,730,136.986301369863,0,376,0,1,354,282.485875706215
32667,5,5647,81,"Tasa de exámenes médico legales por presunto delito sexual contra niños, niñas y adolescentes",2021,3,1,853,117.233294255569,0,441,0,1,412,242.718446601942
32668,5,5647,81,"Tasa de exámenes médico legales por presunto delito sexual contra niños, niñas y adolescentes",2021,4,2,812,246.305418719212,0,424,0,2,388,515.463917525773
32669,5,5647,121,Tasa de exámenes médico legales por presunto delito sexual cuando la víctima está entre 18 y 28 años,2021,5,1,1289,77.5795190069822,0,656,0,1,633,157.977883096367
32670,5,5647,81,"Tasa de exámenes médico legales por presunto delito sexual contra niños, niñas y adolescentes",2021,1,1,147,680.272108843537,1,76,1315.78947368421,0,71,0
32671,5,5649,81,"Tasa de exámenes médico legales por presunto delito sexual contra niños, niñas y adolescentes",2021,4,3,1581,189.753320683112,0,841,0,3,740,405.405405405405
32672,5,5649,121,Tasa de exámenes médico legales por presunto delito sexual cuando la víctima está entre 18 y 28 años,2021,5,1,2462,40.6173842404549,0,1312,0,1,1150,86.9565217391304
32673,5,5652,81,"Tasa de exámenes médico legales por presunto delito sexual contra niños, niñas y adolescentes",2021,4,1,633,157.977883096367,0,322,0,1,311,321.543408360129
32674,5,5656,81,"Tasa de exámenes médico legales por presunto delito sexual contra niños, niñas y adolescentes",2021,2,4,1145,349.344978165939,0,528,0,4,617,648.298217179903
32675,5,5656,81,"Tasa de exámenes médico legales por presunto delito sexual contra niños, niñas y adolescentes",2021,3,4,1448,276.243093922652,2,713,280.504908835905,2,735,272.108843537415
32676,5,5656,81,"Tasa de exámenes médico legales por presunto delito sexual contra niños, niñas y adolescentes",2021,4,4,1502,266.311584553928,0,770,0,4,732,546.448087431694
32677,5,5656,121,Tasa de exámenes médico legales por presunto delito sexual cuando la víctima está entre 18 y 28 años,2021,5,1,2780,35.9712230215827,0,1417,0,1,1363,73.3675715333823
32678,5,5660,81,"Tasa de exámenes médico legales por presunto delito sexual contra niños, niñas y adolescentes",2021,2,1,1344,74.4047619047619,1,684,146.198830409357,0,660,0
32679,5,5660,81,"Tasa de exámenes médico legales por presunto delito sexual contra niños, niñas y adolescentes",2021,3,4,1540,259.74025974026,1,790,126.582278481013,3,750,400
32680,5,5660,81,"Tasa de exámenes médico legales por presunto delito sexual contra niños, niñas y adolescentes",2021,4,9,1385,649.819494584838,0,716,0,9,669,1345.29147982063
32681,5,5664,81,"Tasa de exámenes médico legales por presunto delito sexual contra niños, niñas y adolescentes",2021,2,5,1726,289.687137891078,1,866,115.473441108545,4,860,465.116279069767
32682,5,5664,81,"Tasa de exámenes médico legales por presunto delito sexual contra niños, niñas y adolescentes",2021,3,3,2149,139.599813866915,1,1086,92.0810313075507,2,1063,188.146754468485
32683,5,5664,81,"Tasa de exámenes médico legales por presunto delito sexual contra niños, niñas y adolescentes",2021,4,4,2264,176.678445229682,1,1137,87.9507475813545,3,1127,266.193433895297
32684,5,5664,81,"Tasa de exámenes médico legales por presunto delito sexual contra niños, niñas y adolescentes",2021,1,1,341,293.255131964809,0,171,0,1,170,588.235294117647
32685,5,5665,81,"Tasa de exámenes médico legales por presunto delito sexual contra niños, niñas y adolescentes",2021,3,1,4093,24.4319569997557,0,2134,0,1,1959,51.0464522715671
32686,5,5665,81,"Tasa de exámenes médico legales por presunto delito sexual contra niños, niñas y adolescentes",2021,4,2,4015,49.813200498132,0,2154,0,2,1861,107.469102632993
32687,5,5665,121,Tasa de exámenes médico legales por presunto delito sexual cuando la víctima está entre 18 y 28 años,2021,5,1,5679,17.6087339320303,0,3036,0,1,2643,37.8357926598562
32688,5,5667,81,"Tasa de exámenes médico legales por presunto delito sexual contra niños, niñas y adolescentes",2021,3,6,1453,412.938747419133,1,776,128.865979381443,5,677,738.552437223043
32689,5,5667,81,"Tasa de exámenes médico legales por presunto delito sexual contra niños, niñas y adolescentes",2021,4,1,1465,68.259385665529,0,781,0,1,684,146.198830409357
32690,5,5667,121,Tasa de exámenes médico legales por presunto delito sexual cuando la víctima está entre 18 y 28 años,2021,5,1,2550,39.2156862745098,0,1273,0,1,1277,78.3085356303837
32691,5,5670,81,"Tasa de exámenes médico legales por presunto delito sexual contra niños, niñas y adolescentes",2021,2,1,1730,57.8034682080925,0,857,0,1,873,114.54753722795
32692,5,5670,81,"Tasa de exámenes médico legales por presunto delito sexual contra niños, niñas y adolescentes",2021,3,2,2185,91.5331807780321,1,1108,90.2527075812274,1,1077,92.8505106778087
32693,5,5670,81,"Tasa de exámenes médico legales por presunto delito sexual contra niños, niñas y adolescentes",2021,4,2,2194,91.1577028258888,0,1136,0,2,1058,189.035916824197
32694,5,5674,81,"Tasa de exámenes médico legales por presunto delito sexual contra niños, niñas y adolescentes",2021,3,1,2047,48.8519785051295,0,1078,0,1,969,103.199174406605
32695,5,5674,81,"Tasa de exámenes médico legales por presunto delito sexual contra niños, niñas y adolescentes",2021,4,1,2121,47.1475719000472,0,1160,0,1,961,104.058272632674
32696,5,5679,81,"Tasa de exámenes médico legales por presunto delito sexual contra niños, niñas y adolescentes",2021,2,3,1529,196.206671026815,0,796,0,3,733,409.276944065484
32697,5,5679,81,"Tasa de exámenes médico legales por presunto delito sexual contra niños, niñas y adolescentes",2021,3,2,2163,92.464170134073,0,1140,0,2,1023,195.503421309873
32698,5,5679,81,"Tasa de exámenes médico legales por presunto delito sexual contra niños, niñas y adolescentes",2021,4,7,2413,290.095317032739,0,1278,0,7,1135,616.740088105727
32699,5,5679,121,Tasa de exámenes médico legales por presunto delito sexual cuando la víctima está entre 18 y 28 años,2021,5,1,4144,24.1312741312741,0,2168,0,1,1976,50.6072874493927
32700,5,5042,81,"Tasa de exámenes médico legales por presunto delito sexual contra niños, niñas y adolescentes",2021,2,3,1971,152.20700152207,0,1003,0,3,968,309.917355371901
32701,5,5042,81,"Tasa de exámenes médico legales por presunto delito sexual contra niños, niñas y adolescentes",2021,3,8,2528,316.455696202532,1,1303,76.7459708365311,7,1225,571.428571428571
32702,5,5042,81,"Tasa de exámenes médico legales por presunto delito sexual contra niños, niñas y adolescentes",2021,4,6,2644,226.928895612708,0,1369,0,6,1275,470.588235294118
32703,5,5042,121,Tasa de exámenes médico legales por presunto delito sexual cuando la víctima está entre 18 y 28 años,2021,5,1,4867,20.5465379083624,0,2459,0,1,2408,41.5282392026578
32704,5,5686,81,"Tasa de exámenes médico legales por presunto delito sexual contra niños, niñas y adolescentes",2021,4,4,3956,101.112234580384,0,1984,0,4,1972,202.839756592292
32705,5,5686,121,Tasa de exámenes médico legales por presunto delito sexual cuando la víctima está entre 18 y 28 años,2021,5,3,7347,40.8329930583912,0,3800,0,3,3547,84.5785170566676
32706,5,5690,81,"Tasa de exámenes médico legales por presunto delito sexual contra niños, niñas y adolescentes",2021,4,1,1170,85.4700854700855,0,620,0,1,550,181.818181818182
32707,5,5736,81,"Tasa de exámenes médico legales por presunto delito sexual contra niños, niñas y adolescentes",2021,2,1,3798,26.3296471827278,0,1954,0,1,1844,54.2299349240781
32708,5,5736,81,"Tasa de exámenes médico legales por presunto delito sexual contra niños, niñas y adolescentes",2021,3,8,4438,180.261378999549,1,2282,43.8212094653812,7,2156,324.675324675325
32709,5,5736,81,"Tasa de exámenes médico legales por presunto delito sexual contra niños, niñas y adolescentes",2021,4,8,4350,183.908045977011,1,2243,44.5831475702185,7,2107,332.225913621262
32710,5,5736,121,Tasa de exámenes médico legales por presunto delito sexual cuando la víctima está entre 18 y 28 años,2021,5,2,8060,24.8138957816377,0,4088,0,2,3972,50.3524672708963
32711,5,5756,81,"Tasa de exámenes médico legales por presunto delito sexual contra niños, niñas y adolescentes",2021,2,3,2720,110.294117647059,2,1425,140.350877192982,1,1295,77.2200772200772
32712,5,5756,81,"Tasa de exámenes médico legales por presunto delito sexual contra niños, niñas y adolescentes",2021,3,3,3538,84.7936687394008,0,1825,0,3,1713,175.131348511384
32713,5,5756,81,"Tasa de exámenes médico legales por presunto delito sexual contra niños, niñas y adolescentes",2021,4,8,3753,213.162803090861,0,1927,0,8,1826,438.116100766703
32714,5,5756,121,Tasa de exámenes médico legales por presunto delito sexual cuando la víctima está entre 18 y 28 años,2021,5,4,6336,63.1313131313131,0,3322,0,4,3014,132.71400132714
32715,5,5761,81,"Tasa de exámenes médico legales por presunto delito sexual contra niños, niñas y adolescentes",2021,2,1,1097,91.1577028258888,1,527,189.753320683112,0,570,0
32716,5,5761,81,"Tasa de exámenes médico legales por presunto delito sexual contra niños, niñas y adolescentes",2021,4,4,1377,290.486564996369,0,702,0,4,675,592.592592592593
32717,5,5761,121,Tasa de exámenes médico legales por presunto delito sexual cuando la víctima está entre 18 y 28 años,2021,5,1,2569,38.9256520046711,0,1320,0,1,1249,80.0640512409928
32718,5,5789,81,"Tasa de exámenes médico legales por presunto delito sexual contra niños, niñas y adolescentes",2021,3,1,1316,75.9878419452888,0,678,0,1,638,156.739811912226
32719,5,5790,81,"Tasa de exámenes médico legales por presunto delito sexual contra niños, niñas y adolescentes",2021,3,7,3849,181.865419589504,2,1968,101.626016260163,5,1881,265.81605528974
32720,5,5790,81,"Tasa de exámenes médico legales por presunto delito sexual contra niños, niñas y adolescentes",2021,4,3,3633,82.5763831544178,0,1851,0,3,1782,168.350168350168
32721,5,5790,121,Tasa de exámenes médico legales por presunto delito sexual cuando la víctima está entre 18 y 28 años,2021,5,1,4820,20.746887966805,0,2380,0,1,2440,40.9836065573771
32722,5,5792,81,"Tasa de exámenes médico legales por presunto delito sexual contra niños, niñas y adolescentes",2021,2,1,416,240.384615384615,0,199,0,1,217,460.829493087558
32723,5,5792,81,"Tasa de exámenes médico legales por presunto delito sexual contra niños, niñas y adolescentes",2021,4,1,618,161.812297734628,0,326,0,1,292,342.465753424658
32724,5,5809,81,"Tasa de exámenes médico legales por presunto delito sexual contra niños, niñas y adolescentes",2021,2,1,574,174.216027874564,0,290,0,1,284,352.112676056338
32725,5,5809,81,"Tasa de exámenes médico legales por presunto delito sexual contra niños, niñas y adolescentes",2021,4,2,923,216.684723726977,0,463,0,2,460,434.782608695652
32726,5,5837,81,"Tasa de exámenes médico legales por presunto delito sexual contra niños, niñas y adolescentes",2021,2,1,15137,6.6063288630508,0,7639,0,1,7498,13.3368898372899
32727,5,5837,81,"Tasa de exámenes médico legales por presunto delito sexual contra niños, niñas y adolescentes",2021,3,11,17596,62.5142077744942,3,8993,33.3592794395641,8,8603,92.9908171568058
32728,5,5837,81,"Tasa de exámenes médico legales por presunto delito sexual contra niños, niñas y adolescentes",2021,4,11,16356,67.2536072389337,0,8325,0,11,8031,136.969244178807
32729,5,5837,121,Tasa de exámenes médico legales por presunto delito sexual cuando la víctima está entre 18 y 28 años,2021,5,3,25154,11.9265325594339,0,12043,0,3,13111,22.8815498436427
32730,5,5842,81,"Tasa de exámenes médico legales por presunto delito sexual contra niños, niñas y adolescentes",2021,2,1,688,145.348837209302,1,357,280.112044817927,0,331,0
32731,5,5842,81,"Tasa de exámenes médico legales por presunto delito sexual contra niños, niñas y adolescentes",2021,3,3,806,372.208436724566,0,418,0,3,388,773.19587628866
32732,5,5842,81,"Tasa de exámenes médico legales por presunto delito sexual contra niños, niñas y adolescentes",2021,4,6,748,802.139037433155,1,391,255.754475703325,5,357,1400.56022408964
32733,5,5847,81,"Tasa de exámenes médico legales por presunto delito sexual contra niños, niñas y adolescentes",2021,2,7,3023,231.558054912339,2,1528,130.890052356021,5,1495,334.448160535117
32734,5,5847,81,"Tasa de exámenes médico legales por presunto delito sexual contra niños, niñas y adolescentes",2021,3,3,3562,84.2223469960696,0,1799,0,3,1763,170.164492342598
32735,5,5847,81,"Tasa de exámenes médico legales por presunto delito sexual contra niños, niñas y adolescentes",2021,4,10,3380,295.85798816568,3,1737,172.711571675302,7,1643,426.049908703591
32736,5,5847,121,Tasa de exámenes médico legales por presunto delito sexual cuando la víctima está entre 18 y 28 años,2021,5,4,5331,75.032826861752,1,2706,36.9549150036955,3,2625,114.285714285714
32737,5,5854,81,"Tasa de exámenes médico legales por presunto delito sexual contra niños, niñas y adolescentes",2021,3,2,1776,112.612612612613,0,918,0,2,858,233.100233100233
32738,5,5854,81,"Tasa de exámenes médico legales por presunto delito sexual contra niños, niñas y adolescentes",2021,4,5,1723,290.191526407429,1,889,112.485939257593,4,834,479.616306954436
32739,5,5856,81,"Tasa de exámenes médico legales por presunto delito sexual contra niños, niñas y adolescentes",2021,3,1,517,193.423597678917,0,279,0,1,238,420.168067226891
32740,5,5858,81,"Tasa de exámenes médico legales por presunto delito sexual contra niños, niñas y adolescentes",2021,2,3,943,318.13361611877,2,496,403.225806451613,1,447,223.713646532438
32741,5,5858,81,"Tasa de exámenes médico legales por presunto delito sexual contra niños, niñas y adolescentes",2021,3,2,1295,154.440154440154,1,695,143.884892086331,1,600,166.666666666667
32742,5,5858,81,"Tasa de exámenes médico legales por presunto delito sexual contra niños, niñas y adolescentes",2021,4,2,1349,148.257968865827,0,717,0,2,632,316.455696202532
32743,5,5861,81,"Tasa de exámenes médico legales por presunto delito sexual contra niños, niñas y adolescentes",2021,2,1,555,180.18018018018,0,295,0,1,260,384.615384615385
32744,5,5861,81,"Tasa de exámenes médico legales por presunto delito sexual contra niños, niñas y adolescentes",2021,3,1,867,115.340253748558,0,440,0,1,427,234.192037470726
32745,5,5861,81,"Tasa de exámenes médico legales por presunto delito sexual contra niños, niñas y adolescentes",2021,4,1,1023,97.7517106549365,0,515,0,1,508,196.850393700787
32746,5,5861,121,Tasa de exámenes médico legales por presunto delito sexual cuando la víctima está entre 18 y 28 años,2021,5,1,1756,56.9476082004556,0,901,0,1,855,116.959064327485
32747,5,5885,81,"Tasa de exámenes médico legales por presunto delito sexual contra niños, niñas y adolescentes",2021,3,2,802,249.376558603491,1,413,242.130750605327,1,389,257.06940874036
32748,5,5887,81,"Tasa de exámenes médico legales por presunto delito sexual contra niños, niñas y adolescentes",2021,2,4,3295,121.396054628225,1,1648,60.6796116504854,3,1647,182.149362477231
32749,5,5887,81,"Tasa de exámenes médico legales por presunto delito sexual contra niños, niñas y adolescentes",2021,3,6,4469,134.258223316178,2,2241,89.2458723784025,4,2228,179.533213644524
32750,5,5887,81,"Tasa de exámenes médico legales por presunto delito sexual contra niños, niñas y adolescentes",2021,4,12,4738,253.271422541157,0,2403,0,12,2335,513.918629550321
32751,5,5887,121,Tasa de exámenes médico legales por presunto delito sexual cuando la víctima está entre 18 y 28 años,2021,5,2,7851,25.4744618519934,0,4027,0,2,3824,52.3012552301255
32752,5,5890,81,"Tasa de exámenes médico legales por presunto delito sexual contra niños, niñas y adolescentes",2021,2,3,1758,170.648464163823,0,910,0,3,848,353.77358490566
32753,5,5890,81,"Tasa de exámenes médico legales por presunto delito sexual contra niños, niñas y adolescentes",2021,3,4,2398,166.805671392827,1,1251,79.9360511590728,3,1147,261.5518744551
32754,5,5890,81,"Tasa de exámenes médico legales por presunto delito sexual contra niños, niñas y adolescentes",2021,4,4,2494,160.384923817161,0,1304,0,4,1190,336.134453781513
32755,5,5890,121,Tasa de exámenes médico legales por presunto delito sexual cuando la víctima está entre 18 y 28 años,2021,5,1,3657,27.3448181569593,0,1849,0,1,1808,55.3097345132743
32756,5,5893,81,"Tasa de exámenes médico legales por presunto delito sexual contra niños, niñas y adolescentes",2021,3,3,2591,115.785411038209,0,1310,0,3,1281,234.192037470726
32757,5,5893,81,"Tasa de exámenes médico legales por presunto delito sexual contra niños, niñas y adolescentes",2021,4,5,2135,234.192037470726,0,1087,0,5,1048,477.099236641221
32758,5,5895,81,"Tasa de exámenes médico legales por presunto delito sexual contra niños, niñas y adolescentes",2021,3,2,3571,56.0067208064968,0,1842,0,2,1729,115.673799884326
32759,5,5895,81,"Tasa de exámenes médico legales por presunto delito sexual contra niños, niñas y adolescentes",2021,4,3,3111,96.4320154291225,0,1577,0,3,1534,195.567144719687
32760,81,81001,81,"Tasa de exámenes médico legales por presunto delito sexual contra niños, niñas y adolescentes",2021,2,9,9067,99.2610565788022,1,4576,21.8531468531469,8,4491,178.134045869517
32761,81,81001,81,"Tasa de exámenes médico legales por presunto delito sexual contra niños, niñas y adolescentes",2021,3,32,10279,311.314330187761,5,5197,96.2093515489706,27,5082,531.286894923259
32762,81,81001,81,"Tasa de exámenes médico legales por presunto delito sexual contra niños, niñas y adolescentes",2021,4,48,10108,474.871388998813,4,5135,77.8967867575463,44,4973,884.777800120652
32763,81,81001,121,Tasa de exámenes médico legales por presunto delito sexual cuando la víctima está entre 18 y 28 años,2021,5,13,20795,62.5150276508776,1,10528,9.49848024316109,12,10267,116.879322099932
32764,81,81001,81,"Tasa de exámenes médico legales por presunto delito sexual contra niños, niñas y adolescentes",2021,1,1,1780,56.1797752808989,0,901,0,1,879,113.765642775882
32765,81,81065,81,"Tasa de exámenes médico legales por presunto delito sexual contra niños, niñas y adolescentes",2021,2,5,6259,79.8849656494648,2,3268,61.1995104039168,3,2991,100.300902708124
32766,81,81065,81,"Tasa de exámenes médico legales por presunto delito sexual contra niños, niñas y adolescentes",2021,3,18,7067,254.704966746852,3,3690,81.3008130081301,15,3377,444.181225940184
32767,81,81065,81,"Tasa de exámenes médico legales por presunto delito sexual contra niños, niñas y adolescentes",2021,4,22,6656,330.528846153846,0,3489,0,22,3167,694.663719608462
32768,81,81065,121,Tasa de exámenes médico legales por presunto delito sexual cuando la víctima está entre 18 y 28 años,2021,5,2,11288,17.7179305457123,0,5848,0,2,5440,36.7647058823529
32769,81,81220,121,Tasa de exámenes médico legales por presunto delito sexual cuando la víctima está entre 18 y 28 años,2021,5,1,845,118.343195266272,0,426,0,1,419,238.663484486874
32770,81,81300,81,"Tasa de exámenes médico legales por presunto delito sexual contra niños, niñas y adolescentes",2021,2,5,2292,218.150087260035,0,1166,0,5,1126,444.04973357016
32771,81,81300,81,"Tasa de exámenes médico legales por presunto delito sexual contra niños, niñas y adolescentes",2021,3,9,2597,346.553715825953,1,1294,77.2797527047914,8,1303,613.967766692249
32772,81,81300,81,"Tasa de exámenes médico legales por presunto delito sexual contra niños, niñas y adolescentes",2021,4,4,2412,165.837479270315,0,1178,0,4,1234,324.149108589951
32773,81,81591,81,"Tasa de exámenes médico legales por presunto delito sexual contra niños, niñas y adolescentes",2021,3,1,546,183.150183150183,0,276,0,1,270,370.37037037037
32774,81,81591,81,"Tasa de exámenes médico legales por presunto delito sexual contra niños, niñas y adolescentes",2021,4,2,518,386.100386100386,0,252,0,2,266,751.87969924812
32775,81,81736,81,"Tasa de exámenes médico legales por presunto delito sexual contra niños, niñas y adolescentes",2021,2,7,6411,109.187334269225,2,3188,62.7352572145546,5,3223,155.134967421657
32776,81,81736,81,"Tasa de exámenes médico legales por presunto delito sexual contra niños, niñas y adolescentes",2021,3,12,7326,163.800163800164,0,3657,0,12,3669,327.064595257563
32777,81,81736,81,"Tasa de exámenes médico legales por presunto delito sexual contra niños, niñas y adolescentes",2021,4,25,7085,352.858151023289,1,3538,28.2645562464669,24,3547,676.628136453341
32778,81,81736,121,Tasa de exámenes médico legales por presunto delito sexual cuando la víctima está entre 18 y 28 años,2021,5,2,12875,15.5339805825243,0,6303,0,2,6572,30.4321363359708
32779,81,81794,81,"Tasa de exámenes médico legales por presunto delito sexual contra niños, niñas y adolescentes",2021,2,10,5390,185.528756957328,3,2767,108.420672208168,7,2623,266.869996187572
32780,81,81794,81,"Tasa de exámenes médico legales por presunto delito sexual contra niños, niñas y adolescentes",2021,3,10,6092,164.149704530532,0,3129,0,10,2963,337.495781302734
32781,81,81794,81,"Tasa de exámenes médico legales por presunto delito sexual contra niños, niñas y adolescentes",2021,4,12,5722,209.716882209018,1,2928,34.1530054644809,11,2794,393.700787401575
32782,81,81794,121,Tasa de exámenes médico legales por presunto delito sexual cuando la víctima está entre 18 y 28 años,2021,5,5,9991,50.0450405364828,1,5026,19.8965380023876,4,4965,80.563947633434
32783,88,88564,81,"Tasa de exámenes médico legales por presunto delito sexual contra niños, niñas y adolescentes",2021,4,2,601,332.778702163062,0,314,0,2,287,696.864111498258
32784,88,88001,81,"Tasa de exámenes médico legales por presunto delito sexual contra niños, niñas y adolescentes",2021,2,3,4501,66.6518551433015,1,2317,43.1592576607682,2,2184,91.5750915750916
32785,88,88001,81,"Tasa de exámenes médico legales por presunto delito sexual contra niños, niñas y adolescentes",2021,3,5,5086,98.3090837593394,1,2591,38.5951370127364,4,2495,160.320641282565
32786,88,88001,81,"Tasa de exámenes médico legales por presunto delito sexual contra niños, niñas y adolescentes",2021,4,11,4957,221.908412346177,0,2487,0,11,2470,445.344129554656
32787,88,88001,121,Tasa de exámenes médico legales por presunto delito sexual cuando la víctima está entre 18 y 28 años,2021,5,5,9498,52.6426616129712,1,4913,20.3541624262162,4,4585,87.2410032715376
32788,8,8078,81,"Tasa de exámenes médico legales por presunto delito sexual contra niños, niñas y adolescentes",2021,2,3,5605,53.5236396074933,0,2875,0,3,2730,109.89010989011
32789,8,8078,81,"Tasa de exámenes médico legales por presunto delito sexual contra niños, niñas y adolescentes",2021,3,11,6846,160.677768039731,1,3489,28.6615075952995,10,3357,297.885016383676
32790,8,8078,81,"Tasa de exámenes médico legales por presunto delito sexual contra niños, niñas y adolescentes",2021,4,13,6878,189.00843268392,0,3494,0,13,3384,384.160756501182
32791,8,8078,121,Tasa de exámenes médico legales por presunto delito sexual cuando la víctima está entre 18 y 28 años,2021,5,2,12199,16.3947864579064,0,6198,0,2,6001,33.3277787035494
32792,8,8001,81,"Tasa de exámenes médico legales por presunto delito sexual contra niños, niñas y adolescentes",2021,2,73,98635,74.0102397729001,17,49694,34.2093612911015,56,48941,114.423489507775
32793,8,8001,81,"Tasa de exámenes médico legales por presunto delito sexual contra niños, niñas y adolescentes",2021,3,135,118163,114.248961180742,19,59661,31.8465999564204,116,58502,198.283819356603
32794,8,8001,81,"Tasa de exámenes médico legales por presunto delito sexual contra niños, niñas y adolescentes",2021,4,227,121199,187.295274713488,18,61219,29.4026364364005,209,59980,348.449483161054
32795,8,8001,121,Tasa de exámenes médico legales por presunto delito sexual cuando la víctima está entre 18 y 28 años,2021,5,67,239870,27.9317963897111,7,119591,5.85328327382495,60,120279,49.8840196543037
32796,8,8001,81,"Tasa de exámenes médico legales por presunto delito sexual contra niños, niñas y adolescentes",2021,1,1,19248,5.19534497090607,0,9721,0,1,9527,10.4964836779679
32797,8,8137,81,"Tasa de exámenes médico legales por presunto delito sexual contra niños, niñas y adolescentes",2021,2,1,2375,42.1052631578947,0,1212,0,1,1163,85.9845227858985
32798,8,8137,81,"Tasa de exámenes médico legales por presunto delito sexual contra niños, niñas y adolescentes",2021,3,1,2775,36.036036036036,0,1428,0,1,1347,74.2390497401633
32799,8,8137,81,"Tasa de exámenes médico legales por presunto delito sexual contra niños, niñas y adolescentes",2021,4,3,2607,115.074798619102,0,1346,0,3,1261,237.906423473434
32800,8,8137,121,Tasa de exámenes médico legales por presunto delito sexual cuando la víctima está entre 18 y 28 años,2021,5,2,4308,46.4252553389044,1,2196,45.5373406193078,1,2112,47.3484848484849
32801,8,8141,81,"Tasa de exámenes médico legales por presunto delito sexual contra niños, niñas y adolescentes",2021,2,1,1778,56.2429696287964,0,907,0,1,871,114.810562571757
32802,8,8141,81,"Tasa de exámenes médico legales por presunto delito sexual contra niños, niñas y adolescentes",2021,3,3,2046,146.627565982405,2,1070,186.915887850467,1,976,102.459016393443
32803,8,8141,81,"Tasa de exámenes médico legales por presunto delito sexual contra niños, niñas y adolescentes",2021,4,5,1903,262.743037309511,0,1000,0,5,903,553.709856035438
32804,8,8296,81,"Tasa de exámenes médico legales por presunto delito sexual contra niños, niñas y adolescentes",2021,2,1,6449,15.5062800434176,1,3374,29.63841138115,0,3075,0
32805,8,8296,81,"Tasa de exámenes médico legales por presunto delito sexual contra niños, niñas y adolescentes",2021,3,7,7644,91.5750915750916,2,3987,50.1630298470028,5,3657,136.724090784796
32806,8,8296,81,"Tasa de exámenes médico legales por presunto delito sexual contra niños, niñas y adolescentes",2021,4,15,7347,204.164965291956,4,3807,105.069608615708,11,3540,310.734463276836
32807,8,8296,121,Tasa de exámenes médico legales por presunto delito sexual cuando la víctima está entre 18 y 28 años,2021,5,5,12741,39.2433874892081,0,6386,0,5,6355,78.6782061369001
32808,8,8372,81,"Tasa de exámenes médico legales por presunto delito sexual contra niños, niñas y adolescentes",2021,3,2,2336,85.6164383561644,0,1244,0,2,1092,183.150183150183
32809,8,8372,81,"Tasa de exámenes médico legales por presunto delito sexual contra niños, niñas y adolescentes",2021,4,3,2322,129.198966408269,0,1207,0,3,1115,269.058295964126
32810,8,8421,81,"Tasa de exámenes médico legales por presunto delito sexual contra niños, niñas y adolescentes",2021,3,1,3573,27.9876854184159,0,1806,0,1,1767,56.5930956423316
32811,8,8421,81,"Tasa de exámenes médico legales por presunto delito sexual contra niños, niñas y adolescentes",2021,4,2,3421,58.4624378836597,0,1724,0,2,1697,117.855038302887
32812,8,8433,81,"Tasa de exámenes médico legales por presunto delito sexual contra niños, niñas y adolescentes",2021,2,9,12983,69.3214203188785,1,6532,15.3092467850582,8,6451,124.011781119206
32813,8,8433,81,"Tasa de exámenes médico legales por presunto delito sexual contra niños, niñas y adolescentes",2021,3,15,15632,95.957011258956,1,7888,12.6774847870183,14,7744,180.785123966942
32814,8,8433,81,"Tasa de exámenes médico legales por presunto delito sexual contra niños, niñas y adolescentes",2021,4,11,15533,70.8169703212515,0,7907,0,11,7626,144.24337791765
32815,8,8433,121,Tasa de exámenes médico legales por presunto delito sexual cuando la víctima está entre 18 y 28 años,2021,5,7,27767,25.2097813951813,0,14206,0,7,13561,51.6186121967407
32816,8,8436,81,"Tasa de exámenes médico legales por presunto delito sexual contra niños, niñas y adolescentes",2021,2,1,2317,43.1592576607682,1,1246,80.2568218298555,0,1071,0
32817,8,8436,81,"Tasa de exámenes médico legales por presunto delito sexual contra niños, niñas y adolescentes",2021,3,2,2695,74.2115027829314,0,1418,0,2,1277,156.617071260767
32818,8,8436,81,"Tasa de exámenes médico legales por presunto delito sexual contra niños, niñas y adolescentes",2021,4,3,2561,117.141741507224,0,1320,0,3,1241,241.74053182917
32819,8,8520,81,"Tasa de exámenes médico legales por presunto delito sexual contra niños, niñas y adolescentes",2021,2,2,2710,73.8007380073801,0,1391,0,2,1319,151.630022744503
32820,8,8520,81,"Tasa de exámenes médico legales por presunto delito sexual contra niños, niñas y adolescentes",2021,3,5,3209,155.81177937052,1,1624,61.576354679803,4,1585,252.365930599369
32821,8,8520,81,"Tasa de exámenes médico legales por presunto delito sexual contra niños, niñas y adolescentes",2021,4,3,3150,95.2380952380952,0,1572,0,3,1578,190.114068441065
32822,8,8520,121,Tasa de exámenes médico legales por presunto delito sexual cuando la víctima está entre 18 y 28 años,2021,5,1,5673,17.6273576590869,0,2913,0,1,2760,36.231884057971
32823,8,8549,81,"Tasa de exámenes médico legales por presunto delito sexual contra niños, niñas y adolescentes",2021,3,1,721,138.69625520111,0,375,0,1,346,289.017341040462
32824,8,8549,81,"Tasa de exámenes médico legales por presunto delito sexual contra niños, niñas y adolescentes",2021,4,1,711,140.646976090014,0,379,0,1,332,301.204819277108
32825,8,8549,121,Tasa de exámenes médico legales por presunto delito sexual cuando la víctima está entre 18 y 28 años,2021,5,1,1297,77.1010023130301,0,670,0,1,627,159.489633173844
32826,8,8558,81,"Tasa de exámenes médico legales por presunto delito sexual contra niños, niñas y adolescentes",2021,2,3,1659,180.831826401447,0,874,0,3,785,382.165605095541
32827,8,8558,81,"Tasa de exámenes médico legales por presunto delito sexual contra niños, niñas y adolescentes",2021,3,4,2134,187.441424554827,0,1088,0,4,1046,382.409177820268
32828,8,8558,81,"Tasa de exámenes médico legales por presunto delito sexual contra niños, niñas y adolescentes",2021,4,3,2185,137.299771167048,0,1089,0,3,1096,273.722627737226
32829,8,8558,121,Tasa de exámenes médico legales por presunto delito sexual cuando la víctima está entre 18 y 28 años,2021,5,1,3453,28.9603243556328,0,1743,0,1,1710,58.4795321637427
32830,8,8560,81,"Tasa de exámenes médico legales por presunto delito sexual contra niños, niñas y adolescentes",2021,2,1,2619,38.1825124093165,0,1365,0,1,1254,79.7448165869219
32831,8,8560,81,"Tasa de exámenes médico legales por presunto delito sexual contra niños, niñas y adolescentes",2021,3,4,3063,130.590923930787,0,1586,0,4,1477,270.8192281652
32832,8,8560,81,"Tasa de exámenes médico legales por presunto delito sexual contra niños, niñas y adolescentes",2021,4,2,2923,68.4228532329798,0,1500,0,2,1423,140.548137737175
32833,8,8560,121,Tasa de exámenes médico legales por presunto delito sexual cuando la víctima está entre 18 y 28 años,2021,5,1,4873,20.5212394828648,0,2503,0,1,2370,42.1940928270042
32834,8,8573,81,"Tasa de exámenes médico legales por presunto delito sexual contra niños, niñas y adolescentes",2021,2,1,4216,23.719165085389,0,2161,0,1,2055,48.661800486618
32835,8,8573,81,"Tasa de exámenes médico legales por presunto delito sexual contra niños, niñas y adolescentes",2021,3,3,5114,58.6624951114587,1,2625,38.0952380952381,2,2489,80.3535556448373
32836,8,8573,81,"Tasa de exámenes médico legales por presunto delito sexual contra niños, niñas y adolescentes",2021,4,6,5264,113.981762917933,1,2689,37.1885459278542,5,2575,194.174757281553
32837,8,8573,121,Tasa de exámenes médico legales por presunto delito sexual cuando la víctima está entre 18 y 28 años,2021,5,1,9615,10.4004160166407,0,4730,0,1,4885,20.4708290685773
32838,8,8606,81,"Tasa de exámenes médico legales por presunto delito sexual contra niños, niñas y adolescentes",2021,4,3,3200,93.75,0,1633,0,3,1567,191.4486279515
32839,8,8634,81,"Tasa de exámenes médico legales por presunto delito sexual contra niños, niñas y adolescentes",2021,2,2,3167,63.1512472371329,1,1581,63.2511068943707,1,1586,63.0517023959647
32840,8,8634,81,"Tasa de exámenes médico legales por presunto delito sexual contra niños, niñas y adolescentes",2021,4,4,3717,107.613666935701,0,1860,0,4,1857,215.401184706516
32841,8,8638,81,"Tasa de exámenes médico legales por presunto delito sexual contra niños, niñas y adolescentes",2021,2,3,9423,31.8369945877109,1,4803,20.8203206329377,2,4620,43.2900432900433
32842,8,8638,81,"Tasa de exámenes médico legales por presunto delito sexual contra niños, niñas y adolescentes",2021,3,6,11027,54.4118980683776,2,5650,35.3982300884956,4,5377,74.3909243072345
32843,8,8638,81,"Tasa de exámenes médico legales por presunto delito sexual contra niños, niñas y adolescentes",2021,4,19,10528,180.471124620061,1,5372,18.6150409530901,18,5156,349.10783553142
32844,8,8638,121,Tasa de exámenes médico legales por presunto delito sexual cuando la víctima está entre 18 y 28 años,2021,5,2,18360,10.8932461873638,0,9171,0,2,9189,21.7651539884645
32845,8,8675,81,"Tasa de exámenes médico legales por presunto delito sexual contra niños, niñas y adolescentes",2021,2,1,1693,59.0667454223272,0,880,0,1,813,123.0012300123
32846,8,8685,81,"Tasa de exámenes médico legales por presunto delito sexual contra niños, niñas y adolescentes",2021,2,2,2564,78.003120124805,1,1316,75.9878419452888,1,1248,80.1282051282051
32847,8,8685,81,"Tasa de exámenes médico legales por presunto delito sexual contra niños, niñas y adolescentes",2021,3,2,3101,64.4953240890036,0,1565,0,2,1536,130.208333333333
32848,8,8685,81,"Tasa de exámenes médico legales por presunto delito sexual contra niños, niñas y adolescentes",2021,4,6,3158,189.993666877771,0,1575,0,6,1583,379.027163613392
32849,8,8758,81,"Tasa de exámenes médico legales por presunto delito sexual contra niños, niñas y adolescentes",2021,2,40,58786,68.0434116966625,8,30449,26.2734408354954,32,28337,112.92656244486
32850,8,8758,81,"Tasa de exámenes médico legales por presunto delito sexual contra niños, niñas y adolescentes",2021,3,59,68980,85.5320382719629,11,35455,31.025243266112,48,33525,143.176733780761
32851,8,8758,81,"Tasa de exámenes médico legales por presunto delito sexual contra niños, niñas y adolescentes",2021,4,68,68473,99.3092167715742,5,34610,14.446691707599,63,33863,186.043764580811
32852,8,8758,121,Tasa de exámenes médico legales por presunto delito sexual cuando la víctima está entre 18 y 28 años,2021,5,23,133265,17.2588451581435,2,65786,3.04016052047548,21,67479,31.1207931356422
32853,8,8770,81,"Tasa de exámenes médico legales por presunto delito sexual contra niños, niñas y adolescentes",2021,2,1,1254,79.7448165869219,0,621,0,1,633,157.977883096367
32854,8,8770,81,"Tasa de exámenes médico legales por presunto delito sexual contra niños, niñas y adolescentes",2021,3,2,1447,138.217000691085,0,709,0,2,738,271.0027100271
32855,8,8770,81,"Tasa de exámenes médico legales por presunto delito sexual contra niños, niñas y adolescentes",2021,4,2,1374,145.560407569141,0,680,0,2,694,288.184438040346
32856,8,8832,81,"Tasa de exámenes médico legales por presunto delito sexual contra niños, niñas y adolescentes",2021,2,1,1666,60.0240096038415,0,862,0,1,804,124.378109452736
32857,8,8832,81,"Tasa de exámenes médico legales por presunto delito sexual contra niños, niñas y adolescentes",2021,4,2,1820,109.89010989011,0,899,0,2,921,217.155266015201
32858,8,8832,121,Tasa de exámenes médico legales por presunto delito sexual cuando la víctima está entre 18 y 28 años,2021,5,1,3481,28.7273771904625,0,1764,0,1,1717,58.24111822947
32859,8,8849,81,"Tasa de exámenes médico legales por presunto delito sexual contra niños, niñas y adolescentes",2021,3,1,1298,77.0416024653313,0,657,0,1,641,156.00624024961
32860,8,8849,81,"Tasa de exámenes médico legales por presunto delito sexual contra niños, niñas y adolescentes",2021,4,3,1303,230.237912509593,1,658,151.975683890578,2,645,310.077519379845
32861,11,11001,81,"Tasa de exámenes médico legales por presunto delito sexual contra niños, niñas y adolescentes",2021,2,424,488543,86.7886757153413,114,249211,45.7443692292876,310,239332,129.527183995454
32862,11,11001,81,"Tasa de exámenes médico legales por presunto delito sexual contra niños, niñas y adolescentes",2021,3,919,578825,158.769921824386,175,295069,59.3081618197777,744,283756,262.19709891597
32863,11,11001,81,"Tasa de exámenes médico legales por presunto delito sexual contra niños, niñas y adolescentes",2021,4,1985,604719,328.251634230114,183,306357,59.7342316317238,1802,298362,603.964311809145
32864,11,11001,121,Tasa de exámenes médico legales por presunto delito sexual cuando la víctima está entre 18 y 28 años,2021,5,544,1534051,35.4616632693437,43,766011,5.61349641193142,501,768040,65.2309775532524
32865,11,11001,81,"Tasa de exámenes médico legales por presunto delito sexual contra niños, niñas y adolescentes",2021,1,7,98058,7.13863223806319,2,50107,3.99145827928234,5,47951,10.4273112135305
32866,13,13006,81,"Tasa de exámenes médico legales por presunto delito sexual contra niños, niñas y adolescentes",2021,2,1,2635,37.9506641366224,0,1355,0,1,1280,78125
32867,13,13030,81,"Tasa de exámenes médico legales por presunto delito sexual contra niños, niñas y adolescentes",2021,3,1,1606,62.266500622665,0,809,0,1,797,125.470514429109
32868,13,13030,81,"Tasa de exámenes médico legales por presunto delito sexual contra niños, niñas y adolescentes",2021,4,1,1521,65.7462195923734,0,792,0,1,729,137.174211248285
32869,13,13030,121,Tasa de exámenes médico legales por presunto delito sexual cuando la víctima está entre 18 y 28 años,2021,5,1,2149,46.5332712889716,0,1131,0,1,1018,98.2318271119843
32870,13,13042,81,"Tasa de exámenes médico legales por presunto delito sexual contra niños, niñas y adolescentes",2021,3,2,991,201.816347124117,0,513,0,2,478,418.410041841004
32871,13,13042,81,"Tasa de exámenes médico legales por presunto delito sexual contra niños, niñas y adolescentes",2021,4,3,977,307.062436028659,0,511,0,3,466,643.776824034335
32872,13,13052,81,"Tasa de exámenes médico legales por presunto delito sexual contra niños, niñas y adolescentes",2021,2,2,6842,29.2312189418299,0,3466,0,2,3376,59.2417061611374
32873,13,13052,81,"Tasa de exámenes médico legales por presunto delito sexual contra niños, niñas y adolescentes",2021,3,3,8094,37.0644922164566,0,4087,0,3,4007,74.8689792862491
32874,13,13052,81,"Tasa de exámenes médico legales por presunto delito sexual contra niños, niñas y adolescentes",2021,4,12,8018,149.663257670242,3,4028,74.4786494538232,9,3990,225.563909774436
32875,13,13052,121,Tasa de exámenes médico legales por presunto delito sexual cuando la víctima está entre 18 y 28 años,2021,5,1,14099,7.09270161004327,0,7106,0,1,6993,14.3000143000143
32876,13,13052,81,"Tasa de exámenes médico legales por presunto delito sexual contra niños, niñas y adolescentes",2021,1,1,1340,74.6268656716418,1,681,146.842878120411,0,659,0
32877,13,13062,81,"Tasa de exámenes médico legales por presunto delito sexual contra niños, niñas y adolescentes",2021,3,1,978,102.249488752556,0,513,0,1,465,215.05376344086
32878,13,13074,81,"Tasa de exámenes médico legales por presunto delito sexual contra niños, niñas y adolescentes",2021,3,1,2067,48.3792936623125,0,1048,0,1,1019,98.135426889107
32879,13,13074,81,"Tasa de exámenes médico legales por presunto delito sexual contra niños, niñas y adolescentes",2021,4,3,1950,153.846153846154,0,1011,0,3,939,319.488817891374
32880,13,13074,121,Tasa de exámenes médico legales por presunto delito sexual cuando la víctima está entre 18 y 28 años,2021,5,1,2729,36.6434591425431,0,1374,0,1,1355,73.8007380073801
32881,13,13140,81,"Tasa de exámenes médico legales por presunto delito sexual contra niños, niñas y adolescentes",2021,3,1,2671,37.4391613627855,1,1379,72.5163161711385,0,1292,0
32882,13,13140,81,"Tasa de exámenes médico legales por presunto delito sexual contra niños, niñas y adolescentes",2021,4,4,2619,152.730049637266,0,1355,0,4,1264,316.455696202532
32883,13,13160,81,"Tasa de exámenes médico legales por presunto delito sexual contra niños, niñas y adolescentes",2021,2,1,861,116.144018583043,0,443,0,1,418,239.234449760766
32884,13,13001,81,"Tasa de exámenes médico legales por presunto delito sexual contra niños, niñas y adolescentes",2021,2,31,87145,35.5728957484652,13,44592,29.1532113383567,18,42553,42.3001903508566
32885,13,13001,81,"Tasa de exámenes médico legales por presunto delito sexual contra niños, niñas y adolescentes",2021,3,120,101193,118.585277637781,25,51855,48.2113585960852,95,49338,192.54935343954
32886,13,13001,81,"Tasa de exámenes médico legales por presunto delito sexual contra niños, niñas y adolescentes",2021,4,202,101359,199.291626791898,12,51575,23.2670867668444,190,49784,381.648722481118
32887,13,13001,121,Tasa de exámenes médico legales por presunto delito sexual cuando la víctima está entre 18 y 28 años,2021,5,50,201049,24.8695591621943,2,99274,2.01462618611117,48,101775,47.1628592483419
32888,13,13188,81,"Tasa de exámenes médico legales por presunto delito sexual contra niños, niñas y adolescentes",2021,2,2,1563,127.959053103007,0,820,0,2,743,269.179004037685
32889,13,13188,81,"Tasa de exámenes médico legales por presunto delito sexual contra niños, niñas y adolescentes",2021,3,1,1852,53.9956803455724,0,955,0,1,897,111.482720178372
32890,13,13188,81,"Tasa de exámenes médico legales por presunto delito sexual contra niños, niñas y adolescentes",2021,4,1,1745,57.3065902578797,0,878,0,1,867,115.340253748558
32891,13,13222,81,"Tasa de exámenes médico legales por presunto delito sexual contra niños, niñas y adolescentes",2021,2,1,1646,60.7533414337789,0,833,0,1,813,123.0012300123
32892,13,13222,81,"Tasa de exámenes médico legales por presunto delito sexual contra niños, niñas y adolescentes",2021,3,3,1858,161.463939720129,0,938,0,3,920,326.086956521739
32893,13,13212,81,"Tasa de exámenes médico legales por presunto delito sexual contra niños, niñas y adolescentes",2021,3,2,1820,109.89010989011,0,950,0,2,870,229.885057471264
32894,13,13212,121,Tasa de exámenes médico legales por presunto delito sexual cuando la víctima está entre 18 y 28 años,2021,5,1,2999,33.3444481493831,0,1517,0,1,1482,67.476383265857
32895,13,13244,81,"Tasa de exámenes médico legales por presunto delito sexual contra niños, niñas y adolescentes",2021,2,2,7068,28.2965478211658,0,3596,0,2,3472,57.6036866359447
32896,13,13244,81,"Tasa de exámenes médico legales por presunto delito sexual contra niños, niñas y adolescentes",2021,3,15,8219,182.503954252342,3,4230,70.9219858156028,12,3989,300.827275006267
32897,13,13244,81,"Tasa de exámenes médico legales por presunto delito sexual contra niños, niñas y adolescentes",2021,4,24,7962,301.431801055011,3,4155,72.202166064982,21,3807,551.615445232467
32898,13,13244,121,Tasa de exámenes médico legales por presunto delito sexual cuando la víctima está entre 18 y 28 años,2021,5,4,13543,29.5355534224323,0,7037,0,4,6506,61.4817091915155
32899,13,13268,81,"Tasa de exámenes médico legales por presunto delito sexual contra niños, niñas y adolescentes",2021,3,2,1062,188.323917137476,0,561,0,2,501,399.201596806387
32900,13,13268,81,"Tasa de exámenes médico legales por presunto delito sexual contra niños, niñas y adolescentes",2021,4,2,1015,197.044334975369,0,553,0,2,462,432.900432900433
32901,13,13300,81,"Tasa de exámenes médico legales por presunto delito sexual contra niños, niñas y adolescentes",2021,4,1,1697,58.9275191514437,0,880,0,1,817,122.399020807834
32902,13,13430,81,"Tasa de exámenes médico legales por presunto delito sexual contra niños, niñas y adolescentes",2021,2,6,13184,45.5097087378641,0,6845,0,6,6339,94.6521533364884
32903,13,13430,81,"Tasa de exámenes médico legales por presunto delito sexual contra niños, niñas y adolescentes",2021,3,18,16052,112.135559431847,5,8302,60.2264514574801,13,7750,167.741935483871
32904,13,13430,81,"Tasa de exámenes médico legales por presunto delito sexual contra niños, niñas y adolescentes",2021,4,31,15971,194.101809529773,1,8206,12.1862052156958,30,7765,386.349001931745
32905,13,13430,121,Tasa de exámenes médico legales por presunto delito sexual cuando la víctima está entre 18 y 28 años,2021,5,5,25719,19.4408802830592,1,12896,7.75434243176179,4,12823,31.1939483740154
32906,13,13433,81,"Tasa de exámenes médico legales por presunto delito sexual contra niños, niñas y adolescentes",2021,2,1,2644,37.821482602118,1,1322,75.642965204236,0,1322,0
32907,13,13433,81,"Tasa de exámenes médico legales por presunto delito sexual contra niños, niñas y adolescentes",2021,3,4,3197,125.117297466375,0,1623,0,4,1574,254.129606099111
32908,13,13433,81,"Tasa de exámenes médico legales por presunto delito sexual contra niños, niñas y adolescentes",2021,4,3,3304,90.7990314769976,0,1747,0,3,1557,192.678227360308
32909,13,13433,121,Tasa de exámenes médico legales por presunto delito sexual cuando la víctima está entre 18 y 28 años,2021,5,1,5650,17.6991150442478,0,3049,0,1,2601,38.4467512495194
32910,13,13440,81,"Tasa de exámenes médico legales por presunto delito sexual contra niños, niñas y adolescentes",2021,4,1,1231,81.2347684809098,1,650,153.846153846154,0,581,0
32911,13,13442,81,"Tasa de exámenes médico legales por presunto delito sexual contra niños, niñas y adolescentes",2021,2,3,5049,59.41770647653,0,2572,0,3,2477,121.114251110214
32912,13,13442,81,"Tasa de exámenes médico legales por presunto delito sexual contra niños, niñas y adolescentes",2021,3,7,6012,116.43379906853,1,3115,32.1027287319422,6,2897,207.11080428029
32913,13,13442,81,"Tasa de exámenes médico legales por presunto delito sexual contra niños, niñas y adolescentes",2021,4,12,5894,203.596878181201,0,3114,0,12,2780,431.654676258993
32914,13,13442,121,Tasa de exámenes médico legales por presunto delito sexual cuando la víctima está entre 18 y 28 años,2021,5,3,9196,32.6228795128317,0,4690,0,3,4506,66.577896138482
32915,13,13468,81,"Tasa de exámenes médico legales por presunto delito sexual contra niños, niñas y adolescentes",2021,2,2,4539,44.0625688477638,0,2301,0,2,2238,89.3655049151028
32916,13,13468,81,"Tasa de exámenes médico legales por presunto delito sexual contra niños, niñas y adolescentes",2021,3,3,5524,54.308472121651,0,2808,0,3,2716,110.456553755523
32917,13,13468,81,"Tasa de exámenes médico legales por presunto delito sexual contra niños, niñas y adolescentes",2021,4,6,5439,110.314396028682,0,2761,0,6,2678,224.047796863331
32918,13,13468,121,Tasa de exámenes médico legales por presunto delito sexual cuando la víctima está entre 18 y 28 años,2021,5,1,8148,12.2729504172803,0,4077,0,1,4071,24.5639891918448
32919,13,13458,81,"Tasa de exámenes médico legales por presunto delito sexual contra niños, niñas y adolescentes",2021,2,1,2236,44.7227191413238,0,1164,0,1,1072,93.2835820895522
32920,13,13458,81,"Tasa de exámenes médico legales por presunto delito sexual contra niños, niñas y adolescentes",2021,3,3,2310,129.87012987013,0,1218,0,3,1092,274.725274725275
32921,13,13473,81,"Tasa de exámenes médico legales por presunto delito sexual contra niños, niñas y adolescentes",2021,4,1,2675,37.3831775700935,0,1440,0,1,1235,80.9716599190283
32922,13,13490,81,"Tasa de exámenes médico legales por presunto delito sexual contra niños, niñas y adolescentes",2021,3,1,1333,75.0187546886722,0,685,0,1,648,154.320987654321
32923,13,13549,81,"Tasa de exámenes médico legales por presunto delito sexual contra niños, niñas y adolescentes",2021,3,1,3171,31.5357931251971,0,1624,0,1,1547,64.6412411118293
32924,13,13549,81,"Tasa de exámenes médico legales por presunto delito sexual contra niños, niñas y adolescentes",2021,4,1,3173,31.5159155373464,0,1624,0,1,1549,64.5577792123951
32925,13,13580,81,"Tasa de exámenes médico legales por presunto delito sexual contra niños, niñas y adolescentes",2021,4,1,842,118.764845605701,0,415,0,1,427,234.192037470726
32926,13,13620,81,"Tasa de exámenes médico legales por presunto delito sexual contra niños, niñas y adolescentes",2021,4,4,931,429.645542427497,0,509,0,4,422,947.867298578199
32927,13,13647,81,"Tasa de exámenes médico legales por presunto delito sexual contra niños, niñas y adolescentes",2021,2,1,1682,59.4530321046373,0,843,0,1,839,119.189511323004
32928,13,13647,81,"Tasa de exámenes médico legales por presunto delito sexual contra niños, niñas y adolescentes",2021,3,2,2069,96.665055582407,0,1049,0,2,1020,196.078431372549
32929,13,13647,81,"Tasa de exámenes médico legales por presunto delito sexual contra niños, niñas y adolescentes",2021,4,2,2072,96.5250965250965,0,1073,0,2,999,200.2002002002
32930,13,13650,81,"Tasa de exámenes médico legales por presunto delito sexual contra niños, niñas y adolescentes",2021,3,1,1633,61.2369871402327,0,860,0,1,773,129.366106080207
32931,13,13650,81,"Tasa de exámenes médico legales por presunto delito sexual contra niños, niñas y adolescentes",2021,4,2,1612,124.069478908189,0,849,0,2,763,262.123197903014
32932,13,13655,81,"Tasa de exámenes médico legales por presunto delito sexual contra niños, niñas y adolescentes",2021,2,1,1046,95.6022944550669,0,509,0,1,537,186.219739292365
32933,13,13655,81,"Tasa de exámenes médico legales por presunto delito sexual contra niños, niñas y adolescentes",2021,3,1,1341,74.5712155108128,0,685,0,1,656,152.439024390244
32934,13,13654,81,"Tasa de exámenes médico legales por presunto delito sexual contra niños, niñas y adolescentes",2021,2,1,2108,47.438330170778,0,1041,0,1,1067,93.7207122774133
32935,13,13654,81,"Tasa de exámenes médico legales por presunto delito sexual contra niños, niñas y adolescentes",2021,3,2,2612,76.5696784073507,0,1316,0,2,1296,154.320987654321
32936,13,13654,81,"Tasa de exámenes médico legales por presunto delito sexual contra niños, niñas y adolescentes",2021,4,4,2663,150.206533984228,0,1379,0,4,1284,311.526479750779
32937,13,13657,81,"Tasa de exámenes médico legales por presunto delito sexual contra niños, niñas y adolescentes",2021,3,3,3856,77.8008298755187,1,1965,50.8905852417303,2,1891,105.764145954521
32938,13,13657,81,"Tasa de exámenes médico legales por presunto delito sexual contra niños, niñas y adolescentes",2021,4,7,3970,176.32241813602,0,2065,0,7,1905,367.45406824147
32939,13,13667,81,"Tasa de exámenes médico legales por presunto delito sexual contra niños, niñas y adolescentes",2021,2,1,1646,60.7533414337789,0,885,0,1,761,131.406044678055
32940,13,13667,81,"Tasa de exámenes médico legales por presunto delito sexual contra niños, niñas y adolescentes",2021,3,2,1957,102.197240674502,1,1056,94.6969696969697,1,901,110.987791342952
32941,13,13667,81,"Tasa de exámenes médico legales por presunto delito sexual contra niños, niñas y adolescentes",2021,4,2,1839,108.754758020663,0,986,0,2,853,234.466588511137
32942,13,13667,121,Tasa de exámenes médico legales por presunto delito sexual cuando la víctima está entre 18 y 28 años,2021,5,1,2584,38.6996904024768,0,1337,0,1,1247,80.1924619085806
32943,13,13670,81,"Tasa de exámenes médico legales por presunto delito sexual contra niños, niñas y adolescentes",2021,3,2,3801,52.6177321757432,1,1929,51.8403317781234,1,1872,53.4188034188034
32944,13,13673,81,"Tasa de exámenes médico legales por presunto delito sexual contra niños, niñas y adolescentes",2021,3,2,1691,118.273211117682,1,872,114.678899082569,1,819,122.100122100122
32945,13,13673,81,"Tasa de exámenes médico legales por presunto delito sexual contra niños, niñas y adolescentes",2021,4,4,1689,236.826524570752,0,857,0,4,832,480.769230769231
32946,13,13688,81,"Tasa de exámenes médico legales por presunto delito sexual contra niños, niñas y adolescentes",2021,3,1,4352,22.9779411764706,0,2207,0,1,2145,46.6200466200466
32947,13,13688,81,"Tasa de exámenes médico legales por presunto delito sexual contra niños, niñas y adolescentes",2021,4,3,4312,69.5732838589981,0,2202,0,3,2110,142.18009478673
32948,13,13688,121,Tasa de exámenes médico legales por presunto delito sexual cuando la víctima está entre 18 y 28 años,2021,5,2,7512,26.6240681576145,1,3922,25.4971953085161,1,3590,27.8551532033426
32949,13,13683,81,"Tasa de exámenes médico legales por presunto delito sexual contra niños, niñas y adolescentes",2021,3,2,2545,78.5854616895874,0,1273,0,2,1272,157.232704402516
32950,13,13683,81,"Tasa de exámenes médico legales por presunto delito sexual contra niños, niñas y adolescentes",2021,4,2,2526,79.1765637371338,0,1264,0,2,1262,158.478605388273
32951,13,13683,81,"Tasa de exámenes médico legales por presunto delito sexual contra niños, niñas y adolescentes",2021,1,1,415,240.963855421687,0,207,0,1,208,480.769230769231
32952,13,13744,81,"Tasa de exámenes médico legales por presunto delito sexual contra niños, niñas y adolescentes",2021,3,1,2305,43.3839479392625,0,1209,0,1,1096,91.2408759124088
32953,13,13744,81,"Tasa de exámenes médico legales por presunto delito sexual contra niños, niñas y adolescentes",2021,4,1,2232,44.8028673835125,0,1172,0,1,1060,94.3396226415094
32954,13,13744,121,Tasa de exámenes médico legales por presunto delito sexual cuando la víctima está entre 18 y 28 años,2021,5,1,3571,28.0033604032484,0,1841,0,1,1730,57.8034682080925
32955,13,13760,81,"Tasa de exámenes médico legales por presunto delito sexual contra niños, niñas y adolescentes",2021,3,1,1070,93.4579439252337,0,523,0,1,547,182.815356489945
32956,13,13780,81,"Tasa de exámenes médico legales por presunto delito sexual contra niños, niñas y adolescentes",2021,2,1,1445,69.204152249135,0,693,0,1,752,132.978723404255
32957,13,13780,81,"Tasa de exámenes médico legales por presunto delito sexual contra niños, niñas y adolescentes",2021,3,2,1671,119.688809096349,2,830,240.963855421687,0,841,0
32958,13,13780,81,"Tasa de exámenes médico legales por presunto delito sexual contra niños, niñas y adolescentes",2021,4,3,1551,193.423597678917,0,800,0,3,751,399.467376830892
32959,13,13810,81,"Tasa de exámenes médico legales por presunto delito sexual contra niños, niñas y adolescentes",2021,2,2,2510,79.6812749003984,0,1271,0,2,1239,161.420500403551
32960,13,13810,81,"Tasa de exámenes médico legales por presunto delito sexual contra niños, niñas y adolescentes",2021,4,4,2441,163.867267513314,0,1286,0,4,1155,346.320346320346
32961,13,13836,81,"Tasa de exámenes médico legales por presunto delito sexual contra niños, niñas y adolescentes",2021,2,1,9572,10.4471374843293,0,4938,0,1,4634,21.5796288303841
32962,13,13836,81,"Tasa de exámenes médico legales por presunto delito sexual contra niños, niñas y adolescentes",2021,3,8,11597,68.9833577649392,2,5957,33.5739466174249,6,5640,106.382978723404
32963,13,13836,81,"Tasa de exámenes médico legales por presunto delito sexual contra niños, niñas y adolescentes",2021,4,10,11741,85.1716208159441,1,5998,16.6722240746916,9,5743,156.712519589065
32964,13,13838,81,"Tasa de exámenes médico legales por presunto delito sexual contra niños, niñas y adolescentes",2021,4,1,1765,56.657223796034,0,898,0,1,867,115.340253748558
32965,13,13838,121,Tasa de exámenes médico legales por presunto delito sexual cuando la víctima está entre 18 y 28 años,2021,5,1,3193,31.3185092389602,0,1626,0,1,1567,63.8162093171666
32966,13,13873,81,"Tasa de exámenes médico legales por presunto delito sexual contra niños, niñas y adolescentes",2021,2,2,2480,80.6451612903226,0,1254,0,2,1226,163.132137030995
32967,13,13873,81,"Tasa de exámenes médico legales por presunto delito sexual contra niños, niñas y adolescentes",2021,3,3,3002,99.9333777481679,0,1529,0,3,1473,203.665987780041
32968,13,13873,81,"Tasa de exámenes médico legales por presunto delito sexual contra niños, niñas y adolescentes",2021,4,3,2927,102.494021182098,0,1504,0,3,1423,210.822206605762
32969,13,13894,81,"Tasa de exámenes médico legales por presunto delito sexual contra niños, niñas y adolescentes",2021,2,1,1170,85.4700854700855,1,620,161.290322580645,0,550,0
32970,13,13894,81,"Tasa de exámenes médico legales por presunto delito sexual contra niños, niñas y adolescentes",2021,3,2,1384,144.508670520231,0,741,0,2,643,311.04199066874
32971,13,13894,81,"Tasa de exámenes médico legales por presunto delito sexual contra niños, niñas y adolescentes",2021,4,1,1375,72.7272727272727,0,739,0,1,636,157.232704402516
32972,15,15047,81,"Tasa de exámenes médico legales por presunto delito sexual contra niños, niñas y adolescentes",2021,4,3,1591,188.560653676933,0,806,0,3,785,382.165605095541
32973,15,15047,121,Tasa de exámenes médico legales por presunto delito sexual cuando la víctima está entre 18 y 28 años,2021,5,1,2450,40.8163265306122,0,1277,0,1,1173,85.2514919011083
32974,15,15051,81,"Tasa de exámenes médico legales por presunto delito sexual contra niños, niñas y adolescentes",2021,4,2,604,331.12582781457,0,312,0,2,292,684.931506849315
32975,15,15087,81,"Tasa de exámenes médico legales por presunto delito sexual contra niños, niñas y adolescentes",2021,3,1,711,140.646976090014,0,353,0,1,358,279.329608938548
32976,15,15087,81,"Tasa de exámenes médico legales por presunto delito sexual contra niños, niñas y adolescentes",2021,4,2,738,271.0027100271,0,378,0,2,360,555.555555555556
32977,15,15092,81,"Tasa de exámenes médico legales por presunto delito sexual contra niños, niñas y adolescentes",2021,3,1,150,666.666666666667,0,74,0,1,76,1315.78947368421
32978,15,15104,81,"Tasa de exámenes médico legales por presunto delito sexual contra niños, niñas y adolescentes",2021,4,4,523,764.818355640535,0,277,0,4,246,1626.0162601626
32979,15,15109,81,"Tasa de exámenes médico legales por presunto delito sexual contra niños, niñas y adolescentes",2021,3,1,416,240.384615384615,0,224,0,1,192,520.833333333333
32980,15,15131,81,"Tasa de exámenes médico legales por presunto delito sexual contra niños, niñas y adolescentes",2021,4,1,308,324.675324675325,0,154,0,1,154,649.350649350649
32981,15,15162,81,"Tasa de exámenes médico legales por presunto delito sexual contra niños, niñas y adolescentes",2021,4,1,330,303.030303030303,0,177,0,1,153,653.59477124183
32982,15,15176,81,"Tasa de exámenes médico legales por presunto delito sexual contra niños, niñas y adolescentes",2021,2,4,4190,95.4653937947494,1,2117,47.2366556447804,3,2073,144.717800289436
32983,15,15176,81,"Tasa de exámenes médico legales por presunto delito sexual contra niños, niñas y adolescentes",2021,3,3,5638,53.2103582830791,1,2866,34.8918353105373,2,2772,72.1500721500722
32984,15,15176,81,"Tasa de exámenes médico legales por presunto delito sexual contra niños, niñas y adolescentes",2021,4,15,6191,242.287191083831,0,3205,0,15,2986,502.344273275285
32985,15,15176,121,Tasa de exámenes médico legales por presunto delito sexual cuando la víctima está entre 18 y 28 años,2021,5,4,10489,38.1351892458766,0,5326,0,4,5163,77.4743366259926
32986,15,15232,81,"Tasa de exámenes médico legales por presunto delito sexual contra niños, niñas y adolescentes",2021,3,1,510,196.078431372549,0,267,0,1,243,411.522633744856
32987,15,15232,121,Tasa de exámenes médico legales por presunto delito sexual cuando la víctima está entre 18 y 28 años,2021,5,1,714,140.056022408964,0,362,0,1,352,284.090909090909
32988,15,15185,81,"Tasa de exámenes médico legales por presunto delito sexual contra niños, niñas y adolescentes",2021,3,3,621,483.091787439614,0,311,0,3,310,967.741935483871
32989,15,15185,81,"Tasa de exámenes médico legales por presunto delito sexual contra niños, niñas y adolescentes",2021,4,5,565,884.955752212389,0,277,0,5,288,1736.11111111111
32990,15,15187,81,"Tasa de exámenes médico legales por presunto delito sexual contra niños, niñas y adolescentes",2021,4,1,278,359.712230215827,0,149,0,1,129,775.193798449612
32991,15,15236,81,"Tasa de exámenes médico legales por presunto delito sexual contra niños, niñas y adolescentes",2021,4,1,241,414.9377593361,0,134,0,1,107,934.579439252336
32992,15,15189,81,"Tasa de exámenes médico legales por presunto delito sexual contra niños, niñas y adolescentes",2021,4,4,453,883.002207505519,1,230,434.782608695652,3,223,1345.29147982063
32993,15,15189,121,Tasa de exámenes médico legales por presunto delito sexual cuando la víctima está entre 18 y 28 años,2021,5,2,668,299.40119760479,0,318,0,2,350,571.428571428571
32994,15,15204,81,"Tasa de exámenes médico legales por presunto delito sexual contra niños, niñas y adolescentes",2021,3,3,962,311.850311850312,1,504,198.412698412698,2,458,436.681222707424
32995,15,15204,81,"Tasa de exámenes médico legales por presunto delito sexual contra niños, niñas y adolescentes",2021,4,2,963,207.684319833853,0,507,0,2,456,438.59649122807
32996,15,15212,81,"Tasa de exámenes médico legales por presunto delito sexual contra niños, niñas y adolescentes",2021,4,1,333,300.3003003003,0,185,0,1,148,675.675675675676
32997,15,15215,81,"Tasa de exámenes médico legales por presunto delito sexual contra niños, niñas y adolescentes",2021,3,2,209,956.937799043062,2,128,1562.5,0,81,0
32998,15,15224,81,"Tasa de exámenes médico legales por presunto delito sexual contra niños, niñas y adolescentes",2021,2,1,347,288.184438040346,0,174,0,1,173,578.034682080925
32999,15,15224,81,"Tasa de exámenes médico legales por presunto delito sexual contra niños, niñas y adolescentes",2021,3,1,384,260.416666666667,0,190,0,1,194,515.463917525773
33000,15,15224,81,"Tasa de exámenes médico legales por presunto delito sexual contra niños, niñas y adolescentes",2021,4,1,375,266.666666666667,1,195,512.820512820513,0,180,0
33001,15,15226,81,"Tasa de exámenes médico legales por presunto delito sexual contra niños, niñas y adolescentes",2021,3,1,203,492.610837438424,0,105,0,1,98,1020.40816326531
33002,15,15238,81,"Tasa de exámenes médico legales por presunto delito sexual contra niños, niñas y adolescentes",2021,2,10,8289,120.641814452889,3,4297,69.8161508028857,7,3992,175.350701402806
33003,15,15238,81,"Tasa de exámenes médico legales por presunto delito sexual contra niños, niñas y adolescentes",2021,3,13,10813,120.225654305003,2,5565,35.9389038634322,11,5248,209.603658536585
33004,15,15238,81,"Tasa de exámenes médico legales por presunto delito sexual contra niños, niñas y adolescentes",2021,4,21,11744,178.814713896458,2,6053,33.0414670411366,19,5691,333.860481461958
33005,15,15238,121,Tasa de exámenes médico legales por presunto delito sexual cuando la víctima está entre 18 y 28 años,2021,5,13,22171,58.6351540300392,0,11139,0,13,11032,117.8390137781
33006,15,15272,81,"Tasa de exámenes médico legales por presunto delito sexual contra niños, niñas y adolescentes",2021,4,1,583,171.526586620926,1,321,311.526479750779,0,262,0
33007,15,15276,121,Tasa de exámenes médico legales por presunto delito sexual cuando la víctima está entre 18 y 28 años,2021,5,3,468,641.025641025641,1,244,409.836065573771,2,224,892.857142857143
33008,15,15293,81,"Tasa de exámenes médico legales por presunto delito sexual contra niños, niñas y adolescentes",2021,4,2,262,763.358778625954,0,139,0,2,123,1626.0162601626
33009,15,15296,81,"Tasa de exámenes médico legales por presunto delito sexual contra niños, niñas y adolescentes",2021,2,1,483,207.03933747412,1,262,381.679389312977,0,221,0
33010,15,15296,81,"Tasa de exámenes médico legales por presunto delito sexual contra niños, niñas y adolescentes",2021,3,1,529,189.035916824197,0,285,0,1,244,409.836065573771
33011,15,15296,81,"Tasa de exámenes médico legales por presunto delito sexual contra niños, niñas y adolescentes",2021,4,1,473,211.416490486258,0,252,0,1,221,452.488687782805
33012,15,15296,121,Tasa de exámenes médico legales por presunto delito sexual cuando la víctima está entre 18 y 28 años,2021,5,1,737,135.685210312076,0,393,0,1,344,290.697674418605
33013,15,15299,81,"Tasa de exámenes médico legales por presunto delito sexual contra niños, niñas y adolescentes",2021,2,3,1269,236.406619385343,0,650,0,3,619,484.652665589661
33014,15,15299,81,"Tasa de exámenes médico legales por presunto delito sexual contra niños, niñas y adolescentes",2021,3,3,1546,194.049159120311,1,781,128.040973111396,2,765,261.437908496732
33015,15,15299,81,"Tasa de exámenes médico legales por presunto delito sexual contra niños, niñas y adolescentes",2021,4,6,1524,393.700787401575,0,769,0,6,755,794.701986754967
33016,15,15299,121,Tasa de exámenes médico legales por presunto delito sexual cuando la víctima está entre 18 y 28 años,2021,5,1,2546,39.2772977219167,0,1259,0,1,1287,77.7000777000777
33017,15,15322,81,"Tasa de exámenes médico legales por presunto delito sexual contra niños, niñas y adolescentes",2021,4,1,912,109.649122807018,0,473,0,1,439,227.790432801822
33018,15,15322,121,Tasa de exámenes médico legales por presunto delito sexual cuando la víctima está entre 18 y 28 años,2021,5,1,1411,70.871722182849,0,725,0,1,686,145.772594752187
33019,15,15362,81,"Tasa de exámenes médico legales por presunto delito sexual contra niños, niñas y adolescentes",2021,3,2,185,1081.08108108108,0,101,0,2,84,2380.95238095238
33020,15,15367,81,"Tasa de exámenes médico legales por presunto delito sexual contra niños, niñas y adolescentes",2021,3,2,743,269.179004037685,0,363,0,2,380,526.315789473684
33021,15,15367,81,"Tasa de exámenes médico legales por presunto delito sexual contra niños, niñas y adolescentes",2021,4,1,712,140.449438202247,0,359,0,1,353,283.28611898017
33022,15,15403,81,"Tasa de exámenes médico legales por presunto delito sexual contra niños, niñas y adolescentes",2021,2,1,193,518.134715025907,1,99,1010.10101010101,0,94,0
33023,15,15403,81,"Tasa de exámenes médico legales por presunto delito sexual contra niños, niñas y adolescentes",2021,3,1,218,458.715596330275,1,106,943.396226415094,0,112,0
33024,15,15403,81,"Tasa de exámenes médico legales por presunto delito sexual contra niños, niñas y adolescentes",2021,4,1,223,448.430493273543,0,113,0,1,110,909.090909090909
33025,15,15425,81,"Tasa de exámenes médico legales por presunto delito sexual contra niños, niñas y adolescentes",2021,3,2,428,467.289719626168,0,216,0,2,212,943.396226415094
33026,15,15425,81,"Tasa de exámenes médico legales por presunto delito sexual contra niños, niñas y adolescentes",2021,4,1,435,229.885057471264,0,234,0,1,201,497.512437810945
33027,15,15425,121,Tasa de exámenes médico legales por presunto delito sexual cuando la víctima está entre 18 y 28 años,2021,5,1,656,152.439024390244,0,363,0,1,293,341.296928327645
33028,15,15442,81,"Tasa de exámenes médico legales por presunto delito sexual contra niños, niñas y adolescentes",2021,2,1,403,248.138957816377,0,216,0,1,187,534.75935828877
33029,15,15442,81,"Tasa de exámenes médico legales por presunto delito sexual contra niños, niñas y adolescentes",2021,4,1,603,165.837479270315,0,330,0,1,273,366.300366300366
33030,15,15455,81,"Tasa de exámenes médico legales por presunto delito sexual contra niños, niñas y adolescentes",2021,3,2,776,257.731958762887,0,438,0,2,338,591.715976331361
33031,15,15455,81,"Tasa de exámenes médico legales por presunto delito sexual contra niños, niñas y adolescentes",2021,4,3,793,378.310214375788,0,430,0,3,363,826.446280991736
33032,15,15466,81,"Tasa de exámenes médico legales por presunto delito sexual contra niños, niñas y adolescentes",2021,3,1,450,222.222222222222,0,221,0,1,229,436.681222707424
33033,15,15469,81,"Tasa de exámenes médico legales por presunto delito sexual contra niños, niñas y adolescentes",2021,3,2,2055,97.323600973236,2,1066,187.617260787993,0,989,0
33034,15,15469,81,"Tasa de exámenes médico legales por presunto delito sexual contra niños, niñas y adolescentes",2021,4,7,2100,333.333333333333,1,1093,91.4913083257091,6,1007,595.829195630586
33035,15,15469,121,Tasa de exámenes médico legales por presunto delito sexual cuando la víctima está entre 18 y 28 años,2021,5,4,3391,117.959304040106,0,1693,0,4,1698,235.571260306243
33036,15,15476,81,"Tasa de exámenes médico legales por presunto delito sexual contra niños, niñas y adolescentes",2021,3,2,667,299.850074962519,0,331,0,2,336,595.238095238095
33037,15,15476,81,"Tasa de exámenes médico legales por presunto delito sexual contra niños, niñas y adolescentes",2021,4,6,604,993.377483443709,1,298,335.570469798658,5,306,1633.98692810458
33038,15,15480,81,"Tasa de exámenes médico legales por presunto delito sexual contra niños, niñas y adolescentes",2021,3,1,807,123.915737298637,0,407,0,1,400,250
33039,15,15480,81,"Tasa de exámenes médico legales por presunto delito sexual contra niños, niñas y adolescentes",2021,4,2,828,241.545893719807,1,435,229.885057471264,1,393,254.452926208651
33040,15,15480,121,Tasa de exámenes médico legales por presunto delito sexual cuando la víctima está entre 18 y 28 años,2021,5,1,1447,69.1085003455425,0,757,0,1,690,144.927536231884
33041,15,15491,81,"Tasa de exámenes médico legales por presunto delito sexual contra niños, niñas y adolescentes",2021,3,5,1511,330.90668431502303,1,781,128.040973111396,4,730,547.945205479452
33042,15,15491,81,"Tasa de exámenes médico legales por presunto delito sexual contra niños, niñas y adolescentes",2021,4,1,1570,63.6942675159236,0,797,0,1,773,129.366106080207
33043,15,15494,81,"Tasa de exámenes médico legales por presunto delito sexual contra niños, niñas y adolescentes",2021,3,1,503,198.807157057654,0,265,0,1,238,420.168067226891
33044,15,15494,81,"Tasa de exámenes médico legales por presunto delito sexual contra niños, niñas y adolescentes",2021,4,2,516,387.596899224806,0,278,0,2,238,840.336134453782
33045,15,15500,81,"Tasa de exámenes médico legales por presunto delito sexual contra niños, niñas y adolescentes",2021,3,1,285,350.877192982456,1,162,617.283950617284,0,123,0
33046,15,15500,81,"Tasa de exámenes médico legales por presunto delito sexual contra niños, niñas y adolescentes",2021,4,1,297,336.700336700337,0,166,0,1,131,763.358778625954
33047,15,15500,121,Tasa de exámenes médico legales por presunto delito sexual cuando la víctima está entre 18 y 28 años,2021,5,2,483,414.07867494824,0,249,0,2,234,854.700854700855
33048,15,15507,81,"Tasa de exámenes médico legales por presunto delito sexual contra niños, niñas y adolescentes",2021,3,1,859,116.414435389988,1,443,225.733634311512,0,416,0
33049,15,15507,81,"Tasa de exámenes médico legales por presunto delito sexual contra niños, niñas y adolescentes",2021,4,1,867,115.340253748558,0,466,0,1,401,249.376558603491
33050,15,15507,121,Tasa de exámenes médico legales por presunto delito sexual cuando la víctima está entre 18 y 28 años,2021,5,3,1252,239.61661341853,0,618,0,3,634,473.186119873817
33051,15,15511,81,"Tasa de exámenes médico legales por presunto delito sexual contra niños, niñas y adolescentes",2021,3,1,189,529.100529100529,0,94,0,1,95,1052.63157894737
33052,15,15511,81,"Tasa de exámenes médico legales por presunto delito sexual contra niños, niñas y adolescentes",2021,4,1,200,500,0,108,0,1,92,1086.95652173913
33053,15,15516,81,"Tasa de exámenes médico legales por presunto delito sexual contra niños, niñas y adolescentes",2021,2,2,2453,81.5328169588259,0,1280,0,2,1173,170.502983802217
33054,15,15516,81,"Tasa de exámenes médico legales por presunto delito sexual contra niños, niñas y adolescentes",2021,3,3,3166,94.7567909033481,0,1641,0,3,1525,196.72131147541
33055,15,15516,81,"Tasa de exámenes médico legales por presunto delito sexual contra niños, niñas y adolescentes",2021,4,10,3357,297.885016383676,0,1725,0,10,1632,612.745098039216
33056,15,15516,121,Tasa de exámenes médico legales por presunto delito sexual cuando la víctima está entre 18 y 28 años,2021,5,2,5718,34.9772647778944,0,2826,0,2,2892,69.1562932226833
33057,15,15518,81,"Tasa de exámenes médico legales por presunto delito sexual contra niños, niñas y adolescentes",2021,4,1,224,446.428571428571,0,121,0,1,103,970.873786407767
33058,15,15531,81,"Tasa de exámenes médico legales por presunto delito sexual contra niños, niñas y adolescentes",2021,2,1,410,243.90243902439,0,204,0,1,206,485.436893203883
33059,15,15531,81,"Tasa de exámenes médico legales por presunto delito sexual contra niños, niñas y adolescentes",2021,3,1,667,149.925037481259,0,342,0,1,325,307.692307692308
33060,15,15531,81,"Tasa de exámenes médico legales por presunto delito sexual contra niños, niñas y adolescentes",2021,4,1,746,134.048257372654,0,396,0,1,350,285.714285714286
33061,15,15537,81,"Tasa de exámenes médico legales por presunto delito sexual contra niños, niñas y adolescentes",2021,4,1,366,273.224043715847,0,198,0,1,168,595.238095238095
33062,15,15542,81,"Tasa de exámenes médico legales por presunto delito sexual contra niños, niñas y adolescentes",2021,3,1,726,137.741046831956,0,389,0,1,337,296.73590504451
33063,15,15572,81,"Tasa de exámenes médico legales por presunto delito sexual contra niños, niñas y adolescentes",2021,2,4,4253,94.0512579355749,1,2104,47.5285171102662,3,2149,139.599813866915
33064,15,15572,81,"Tasa de exámenes médico legales por presunto delito sexual contra niños, niñas y adolescentes",2021,3,9,5029,178.962020282362,1,2520,39.6825396825397,8,2509,318.852132323635
33065,15,15572,81,"Tasa de exámenes médico legales por presunto delito sexual contra niños, niñas y adolescentes",2021,4,14,4796,291.909924937448,0,2475,0,14,2321,603.188280913399
33066,15,15572,121,Tasa de exámenes médico legales por presunto delito sexual cuando la víctima está entre 18 y 28 años,2021,5,7,8290,84.4390832328106,1,4228,23.6518448438978,6,4062,147.710487444609
33067,15,15599,81,"Tasa de exámenes médico legales por presunto delito sexual contra niños, niñas y adolescentes",2021,2,2,768,260.416666666667,1,364,274.725274725275,1,404,247.524752475248
33068,15,15599,81,"Tasa de exámenes médico legales por presunto delito sexual contra niños, niñas y adolescentes",2021,3,2,1030,194.174757281553,1,500,200,1,530,188.679245283019
33069,15,15599,81,"Tasa de exámenes médico legales por presunto delito sexual contra niños, niñas y adolescentes",2021,4,2,1086,184.162062615101,0,559,0,2,527,379.506641366224
33070,15,15600,81,"Tasa de exámenes médico legales por presunto delito sexual contra niños, niñas y adolescentes",2021,4,4,771,518.806744487678,0,431,0,4,340,1176.47058823529
33071,15,15632,81,"Tasa de exámenes médico legales por presunto delito sexual contra niños, niñas y adolescentes",2021,4,5,1465,341.296928327645,0,735,0,5,730,684.931506849315
33072,15,15632,121,Tasa de exámenes médico legales por presunto delito sexual cuando la víctima está entre 18 y 28 años,2021,5,2,2188,91.4076782449726,0,1113,0,2,1075,186.046511627907
33073,15,15638,81,"Tasa de exámenes médico legales por presunto delito sexual contra niños, niñas y adolescentes",2021,4,1,581,172.117039586919,0,299,0,1,282,354.609929078014
33074,15,15646,81,"Tasa de exámenes médico legales por presunto delito sexual contra niños, niñas y adolescentes",2021,3,2,2118,94.4287063267233,0,1076,0,2,1042,191.938579654511
33075,15,15646,81,"Tasa de exámenes médico legales por presunto delito sexual contra niños, niñas y adolescentes",2021,4,8,1978,404.448938321537,0,1010,0,8,968,826.446280991736
33076,15,15646,121,Tasa de exámenes médico legales por presunto delito sexual cuando la víctima está entre 18 y 28 años,2021,5,1,3520,28.4090909090909,0,1800,0,1,1720,58.1395348837209
33077,15,15664,81,"Tasa de exámenes médico legales por presunto delito sexual contra niños, niñas y adolescentes",2021,3,4,443,902.93453724605,2,232,862.068965517241,2,211,947.867298578199
33078,15,15664,81,"Tasa de exámenes médico legales por presunto delito sexual contra niños, niñas y adolescentes",2021,4,1,409,244.498777506112,0,216,0,1,193,518.134715025907
33079,15,15667,81,"Tasa de exámenes médico legales por presunto delito sexual contra niños, niñas y adolescentes",2021,3,1,520,192.307692307692,0,273,0,1,247,404.858299595142
33080,15,15667,81,"Tasa de exámenes médico legales por presunto delito sexual contra niños, niñas y adolescentes",2021,4,1,523,191.204588910134,0,280,0,1,243,411.522633744856
33081,15,15681,121,Tasa de exámenes médico legales por presunto delito sexual cuando la víctima está entre 18 y 28 años,2021,5,2,968,206.611570247934,0,526,0,2,442,452.488687782805
33082,15,15693,81,"Tasa de exámenes médico legales por presunto delito sexual contra niños, niñas y adolescentes",2021,3,4,1060,377.358490566038,1,544,183.823529411765,3,516,581.395348837209
33083,15,15693,81,"Tasa de exámenes médico legales por presunto delito sexual contra niños, niñas y adolescentes",2021,4,3,1118,268.336314847943,0,571,0,3,547,548.446069469836
33084,15,15693,121,Tasa de exámenes médico legales por presunto delito sexual cuando la víctima está entre 18 y 28 años,2021,5,1,2618,38.1970970206264,0,1682,0,1,936,106.837606837607
33085,15,15696,81,"Tasa de exámenes médico legales por presunto delito sexual contra niños, niñas y adolescentes",2021,3,1,310,322.58064516129,0,167,0,1,143,699.300699300699
33086,15,15696,81,"Tasa de exámenes médico legales por presunto delito sexual contra niños, niñas y adolescentes",2021,4,1,269,371.747211895911,0,140,0,1,129,775.193798449612
33087,15,15686,81,"Tasa de exámenes médico legales por presunto delito sexual contra niños, niñas y adolescentes",2021,2,1,598,167.224080267559,1,319,313.479623824451,0,279,0
33088,15,15686,81,"Tasa de exámenes médico legales por presunto delito sexual contra niños, niñas y adolescentes",2021,3,3,734,408.719346049046,0,381,0,3,353,849.85835694051
33089,15,15686,81,"Tasa de exámenes médico legales por presunto delito sexual contra niños, niñas y adolescentes",2021,4,5,756,661.375661375661,0,391,0,5,365,1369.86301369863
33090,15,15723,81,"Tasa de exámenes médico legales por presunto delito sexual contra niños, niñas y adolescentes",2021,2,1,86,1162.79069767442,1,39,2564.10256410256,0,47,0
33091,15,15723,81,"Tasa de exámenes médico legales por presunto delito sexual contra niños, niñas y adolescentes",2021,3,1,95,1052.63157894737,0,46,0,1,49,2040.81632653061
33092,15,15740,81,"Tasa de exámenes médico legales por presunto delito sexual contra niños, niñas y adolescentes",2021,3,1,825,121.212121212121,0,424,0,1,401,249.376558603491
33093,15,15740,81,"Tasa de exámenes médico legales por presunto delito sexual contra niños, niñas y adolescentes",2021,4,4,736,543.478260869565,0,372,0,4,364,1098.9010989011
33094,15,15757,81,"Tasa de exámenes médico legales por presunto delito sexual contra niños, niñas y adolescentes",2021,4,2,782,255.754475703325,0,389,0,2,393,508.905852417303
33095,15,15757,121,Tasa de exámenes médico legales por presunto delito sexual cuando la víctima está entre 18 y 28 años,2021,5,1,1302,76.8049155145929,0,660,0,1,642,155.763239875389
33096,15,15759,81,"Tasa de exámenes médico legales por presunto delito sexual contra niños, niñas y adolescentes",2021,2,2,8802,22.7221086116792,0,4475,0,2,4327,46.2214005084354
33097,15,15759,81,"Tasa de exámenes médico legales por presunto delito sexual contra niños, niñas y adolescentes",2021,3,10,11070,90.3342366757001,2,5725,34.9344978165939,8,5345,149.672591206735
33098,15,15759,81,"Tasa de exámenes médico legales por presunto delito sexual contra niños, niñas y adolescentes",2021,4,24,11733,204.551265660956,2,6138,32.5839035516455,22,5595,393.208221626452
33099,15,15759,121,Tasa de exámenes médico legales por presunto delito sexual cuando la víctima está entre 18 y 28 años,2021,5,3,22737,13.1943528169943,0,11413,0,3,11324,26.4924055104203
33100,15,15761,81,"Tasa de exámenes médico legales por presunto delito sexual contra niños, niñas y adolescentes",2021,3,2,189,1058.20105820106,1,86,1162.79069767442,1,103,970.873786407767
33101,15,15764,81,"Tasa de exámenes médico legales por presunto delito sexual contra niños, niñas y adolescentes",2021,4,1,694,144.092219020173,0,350,0,1,344,290.697674418605
33102,15,15763,81,"Tasa de exámenes médico legales por presunto delito sexual contra niños, niñas y adolescentes",2021,2,2,773,258.732212160414,0,388,0,2,385,519.480519480519
33103,15,15763,81,"Tasa de exámenes médico legales por presunto delito sexual contra niños, niñas y adolescentes",2021,3,3,893,335.946248600224,0,465,0,3,428,700.934579439252
33104,15,15763,121,Tasa de exámenes médico legales por presunto delito sexual cuando la víctima está entre 18 y 28 años,2021,5,2,1299,153.964588144727,0,682,0,2,617,324.149108589951
33105,15,15776,81,"Tasa de exámenes médico legales por presunto delito sexual contra niños, niñas y adolescentes",2021,2,2,466,429.184549356223,0,224,0,2,242,826.446280991736
33106,15,15776,81,"Tasa de exámenes médico legales por presunto delito sexual contra niños, niñas y adolescentes",2021,3,2,596,335.570469798658,0,306,0,2,290,689.655172413793
33107,15,15776,81,"Tasa de exámenes médico legales por presunto delito sexual contra niños, niñas y adolescentes",2021,4,2,611,327.332242225859,0,334,0,2,277,722.02166064982
33108,15,15778,81,"Tasa de exámenes médico legales por presunto delito sexual contra niños, niñas y adolescentes",2021,3,1,338,295.85798816568,0,178,0,1,160,625
33109,15,15778,81,"Tasa de exámenes médico legales por presunto delito sexual contra niños, niñas y adolescentes",2021,4,1,358,279.329608938548,0,182,0,1,176,568.181818181818
33110,15,15790,81,"Tasa de exámenes médico legales por presunto delito sexual contra niños, niñas y adolescentes",2021,3,1,600,166.666666666667,0,318,0,1,282,354.609929078014
33111,15,15790,81,"Tasa de exámenes médico legales por presunto delito sexual contra niños, niñas y adolescentes",2021,4,1,581,172.117039586919,0,296,0,1,285,350.877192982456
33112,15,15804,81,"Tasa de exámenes médico legales por presunto delito sexual contra niños, niñas y adolescentes",2021,3,2,875,228.571428571429,0,459,0,2,416,480.769230769231
33113,15,15804,81,"Tasa de exámenes médico legales por presunto delito sexual contra niños, niñas y adolescentes",2021,4,5,841,594.530321046373,0,434,0,5,407,1228.50122850123
33114,15,15806,81,"Tasa de exámenes médico legales por presunto delito sexual contra niños, niñas y adolescentes",2021,2,1,994,100.603621730382,0,529,0,1,465,215.05376344086
33115,15,15806,81,"Tasa de exámenes médico legales por presunto delito sexual contra niños, niñas y adolescentes",2021,3,2,1190,168.067226890756,0,627,0,2,563,355.239786856128
33116,15,15806,81,"Tasa de exámenes médico legales por presunto delito sexual contra niños, niñas y adolescentes",2021,4,1,1239,80.7102502017756,0,644,0,1,595,168.067226890756
33117,15,15806,121,Tasa de exámenes médico legales por presunto delito sexual cuando la víctima está entre 18 y 28 años,2021,5,2,2340,85.4700854700855,0,1207,0,2,1133,176.522506619594
33118,15,15808,81,"Tasa de exámenes médico legales por presunto delito sexual contra niños, niñas y adolescentes",2021,2,1,276,362.31884057971,0,135,0,1,141,709.219858156028
33119,15,15808,81,"Tasa de exámenes médico legales por presunto delito sexual contra niños, niñas y adolescentes",2021,3,1,308,324.675324675325,0,156,0,1,152,657.894736842105
33120,15,15808,81,"Tasa de exámenes médico legales por presunto delito sexual contra niños, niñas y adolescentes",2021,4,1,289,346.020761245675,0,155,0,1,134,746.268656716418
33121,15,15814,81,"Tasa de exámenes médico legales por presunto delito sexual contra niños, niñas y adolescentes",2021,3,1,994,100.603621730382,0,523,0,1,471,212.314225053079
33122,15,15814,81,"Tasa de exámenes médico legales por presunto delito sexual contra niños, niñas y adolescentes",2021,4,1,915,109.289617486339,0,472,0,1,443,225.733634311512
33123,15,15816,81,"Tasa de exámenes médico legales por presunto delito sexual contra niños, niñas y adolescentes",2021,3,2,496,403.225806451613,0,255,0,2,241,829.875518672199
33124,15,15816,81,"Tasa de exámenes médico legales por presunto delito sexual contra niños, niñas y adolescentes",2021,4,2,444,450.45045045045,0,231,0,2,213,938.967136150235
33125,15,15816,121,Tasa de exámenes médico legales por presunto delito sexual cuando la víctima está entre 18 y 28 años,2021,5,1,539,185.528756957328,0,266,0,1,273,366.300366300366
33126,15,15820,121,Tasa de exámenes médico legales por presunto delito sexual cuando la víctima está entre 18 y 28 años,2021,5,1,643,155.52099533437,0,315,0,1,328,304.878048780488
33127,15,15001,81,"Tasa de exámenes médico legales por presunto delito sexual contra niños, niñas y adolescentes",2021,2,10,12167,82.1895290539985,1,6167,16.215339711367,9,6000,150
33128,15,15001,81,"Tasa de exámenes médico legales por presunto delito sexual contra niños, niñas y adolescentes",2021,3,29,15400,188.311688311688,4,7875,50.7936507936508,25,7525,332.225913621262
33129,15,15001,81,"Tasa de exámenes médico legales por presunto delito sexual contra niños, niñas y adolescentes",2021,4,53,17053,310.795754412713,2,8767,22.8128208052926,51,8286,615.496017378711
33130,15,15001,121,Tasa de exámenes médico legales por presunto delito sexual cuando la víctima está entre 18 y 28 años,2021,5,26,35484,73.2724608274152,1,17580,5.68828213879408,25,17904,139.633601429848
33131,15,15832,81,"Tasa de exámenes médico legales por presunto delito sexual contra niños, niñas y adolescentes",2021,3,1,160,625,0,91,0,1,69,1449.27536231884
33132,15,15832,81,"Tasa de exámenes médico legales por presunto delito sexual contra niños, niñas y adolescentes",2021,4,1,139,719.424460431655,0,74,0,1,65,1538.46153846154
33133,15,15835,81,"Tasa de exámenes médico legales por presunto delito sexual contra niños, niñas y adolescentes",2021,4,2,578,346.020761245675,0,299,0,2,279,716.845878136201
33134,15,15835,121,Tasa de exámenes médico legales por presunto delito sexual cuando la víctima está entre 18 y 28 años,2021,5,1,727,137.551581843191,0,370,0,1,357,280.112044817927
33135,15,15837,81,"Tasa de exámenes médico legales por presunto delito sexual contra niños, niñas y adolescentes",2021,4,1,832,120.192307692308,0,413,0,1,419,238.663484486874
33136,15,15837,121,Tasa de exámenes médico legales por presunto delito sexual cuando la víctima está entre 18 y 28 años,2021,5,1,1340,74.6268656716418,0,666,0,1,674,148.367952522255
33137,15,15842,81,"Tasa de exámenes médico legales por presunto delito sexual contra niños, niñas y adolescentes",2021,3,1,774,129.198966408269,0,390,0,1,384,260.416666666667
33138,15,15861,81,"Tasa de exámenes médico legales por presunto delito sexual contra niños, niñas y adolescentes",2021,3,1,1747,57.2409845449342,0,924,0,1,823,121.506682867558
33139,15,15861,81,"Tasa de exámenes médico legales por presunto delito sexual contra niños, niñas y adolescentes",2021,4,4,1687,237.1072910492,0,881,0,4,806,496.277915632754
33140,15,15861,121,Tasa de exámenes médico legales por presunto delito sexual cuando la víctima está entre 18 y 28 años,2021,5,2,2668,74.9625187406297,0,1310,0,2,1358,147.275405007364
33141,15,15407,81,"Tasa de exámenes médico legales por presunto delito sexual contra niños, niñas y adolescentes",2021,2,2,1292,154.798761609907,1,654,152.905198776758,1,638,156.739811912226
33142,15,15407,81,"Tasa de exámenes médico legales por presunto delito sexual contra niños, niñas y adolescentes",2021,4,1,1516,65.9630606860158,0,786,0,1,730,136.986301369863
33143,15,15407,121,Tasa de exámenes médico legales por presunto delito sexual cuando la víctima está entre 18 y 28 años,2021,5,2,3018,66.2690523525514,0,1525,0,2,1493,133.958472873409
33144,15,15879,81,"Tasa de exámenes médico legales por presunto delito sexual contra niños, niñas y adolescentes",2021,4,1,300,333.333333333333,0,171,0,1,129,775.193798449612
33145,15,15879,121,Tasa de exámenes médico legales por presunto delito sexual cuando la víctima está entre 18 y 28 años,2021,5,1,383,261.096605744125,0,220,0,1,163,613.496932515337
33146,15,15897,81,"Tasa de exámenes médico legales por presunto delito sexual contra niños, niñas y adolescentes",2021,4,1,459,217.864923747277,0,242,0,1,217,460.829493087558
33147,17,17013,81,"Tasa de exámenes médico legales por presunto delito sexual contra niños, niñas y adolescentes",2021,2,1,1685,59.3471810089021,0,890,0,1,795,125.786163522013
33148,17,17013,81,"Tasa de exámenes médico legales por presunto delito sexual contra niños, niñas y adolescentes",2021,3,6,1993,301.053687907677,2,1020,196.078431372549,4,973,411.099691675231
33149,17,17013,121,Tasa de exámenes médico legales por presunto delito sexual cuando la víctima está entre 18 y 28 años,2021,5,1,3365,29.7176820208024,0,1716,0,1,1649,60.6428138265616
33150,17,17042,81,"Tasa de exámenes médico legales por presunto delito sexual contra niños, niñas y adolescentes",2021,2,4,2424,165.016501650165,0,1248,0,4,1176,340.136054421769
33151,17,17042,81,"Tasa de exámenes médico legales por presunto delito sexual contra niños, niñas y adolescentes",2021,3,8,3031,263.939293962389,2,1567,127.632418634333,6,1464,409.836065573771
33152,17,17042,81,"Tasa de exámenes médico legales por presunto delito sexual contra niños, niñas y adolescentes",2021,4,2,3152,63.4517766497462,1,1633,61.2369871402327,1,1519,65.832784726794
33153,17,17042,121,Tasa de exámenes médico legales por presunto delito sexual cuando la víctima está entre 18 y 28 años,2021,5,2,5606,35.6760613628255,0,2867,0,2,2739,73.0193501277839
33154,17,17050,81,"Tasa de exámenes médico legales por presunto delito sexual contra niños, niñas y adolescentes",2021,2,1,788,126.903553299492,0,412,0,1,376,265.957446808511
33155,17,17050,81,"Tasa de exámenes médico legales por presunto delito sexual contra niños, niñas y adolescentes",2021,3,1,956,104.602510460251,0,484,0,1,472,211.864406779661
33156,17,17050,81,"Tasa de exámenes médico legales por presunto delito sexual contra niños, niñas y adolescentes",2021,4,1,956,104.602510460251,0,461,0,1,495,202.020202020202
33157,17,17050,121,Tasa de exámenes médico legales por presunto delito sexual cuando la víctima está entre 18 y 28 años,2021,5,1,1426,70.1262272089762,0,652,0,1,774,129.198966408269
33158,17,17088,81,"Tasa de exámenes médico legales por presunto delito sexual contra niños, niñas y adolescentes",2021,2,1,973,102.774922918808,0,523,0,1,450,222.222222222222
33159,17,17088,81,"Tasa de exámenes médico legales por presunto delito sexual contra niños, niñas y adolescentes",2021,3,1,1066,93.8086303939963,0,568,0,1,498,200.803212851406
33160,17,17088,81,"Tasa de exámenes médico legales por presunto delito sexual contra niños, niñas y adolescentes",2021,4,2,996,200.803212851406,0,511,0,2,485,412.371134020619
33161,17,17174,81,"Tasa de exámenes médico legales por presunto delito sexual contra niños, niñas y adolescentes",2021,2,2,3188,62.7352572145546,1,1671,59.8444045481747,1,1517,65.9195781147001
33162,17,17174,81,"Tasa de exámenes médico legales por presunto delito sexual contra niños, niñas y adolescentes",2021,3,1,4046,24.7157686604053,0,2055,0,1,1991,50.2260170768458
33163,17,17174,81,"Tasa de exámenes médico legales por presunto delito sexual contra niños, niñas y adolescentes",2021,4,4,4405,90.8059023836549,1,2182,45.8295142071494,3,2223,134.952766531714
33164,17,17174,121,Tasa de exámenes médico legales por presunto delito sexual cuando la víctima está entre 18 y 28 años,2021,5,1,8800,11.3636363636364,0,4294,0,1,4506,22.1926320461607
33165,17,17272,81,"Tasa de exámenes médico legales por presunto delito sexual contra niños, niñas y adolescentes",2021,3,1,992,100.806451612903,0,500,0,1,492,203.252032520325
33166,17,17272,81,"Tasa de exámenes médico legales por presunto delito sexual contra niños, niñas y adolescentes",2021,4,1,1016,98.4251968503937,0,526,0,1,490,204.081632653061
33167,17,17380,81,"Tasa de exámenes médico legales por presunto delito sexual contra niños, niñas y adolescentes",2021,2,8,5658,141.392718275009,1,2869,34.8553502962705,7,2789,250.986016493367
33168,17,17380,81,"Tasa de exámenes médico legales por presunto delito sexual contra niños, niñas y adolescentes",2021,3,18,6758,266.350991417579,3,3401,88.2093501911203,15,3357,446.827524575514
33169,17,17380,81,"Tasa de exámenes médico legales por presunto delito sexual contra niños, niñas y adolescentes",2021,4,21,6701,313.386061781824,3,3333,90.00900090009,18,3368,534.441805225653
33170,17,17380,121,Tasa de exámenes médico legales por presunto delito sexual cuando la víctima está entre 18 y 28 años,2021,5,5,12100,41.3223140495868,2,5985,33.4168755221387,3,6115,49.0596892886345
33171,17,17388,81,"Tasa de exámenes médico legales por presunto delito sexual contra niños, niñas y adolescentes",2021,2,1,364,274.725274725275,1,192,520.833333333333,0,172,0
33172,17,17388,81,"Tasa de exámenes médico legales por presunto delito sexual contra niños, niñas y adolescentes",2021,3,2,468,427.350427350427,0,239,0,2,229,873.362445414847
33173,17,17388,81,"Tasa de exámenes médico legales por presunto delito sexual contra niños, niñas y adolescentes",2021,4,1,500,200,0,255,0,1,245,408.163265306122
33174,17,17001,81,"Tasa de exámenes médico legales por presunto delito sexual contra niños, niñas y adolescentes",2021,2,25,23975,104.275286757039,7,12076,57.9662139781385,18,11899,151.273216236659
33175,17,17001,81,"Tasa de exámenes médico legales por presunto delito sexual contra niños, niñas y adolescentes",2021,3,60,29394,204.123290467442,13,14903,87.2307589076025,47,14491,324.339245048651
33176,17,17001,81,"Tasa de exámenes médico legales por presunto delito sexual contra niños, niñas y adolescentes",2021,4,108,33714,320.341697810998,18,17106,105.226236408278,90,16608,541.907514450867
33177,17,17001,121,Tasa de exámenes médico legales por presunto delito sexual cuando la víctima está entre 18 y 28 años,2021,5,34,78860,43.1143799137712,4,39333,10.1695777082857,30,39527,75.897487793154
33178,17,17433,81,"Tasa de exámenes médico legales por presunto delito sexual contra niños, niñas y adolescentes",2021,2,1,1354,73.8552437223043,0,688,0,1,666,150.15015015015
33179,17,17433,81,"Tasa de exámenes médico legales por presunto delito sexual contra niños, niñas y adolescentes",2021,3,1,1602,62.4219725343321,0,821,0,1,781,128.040973111396
33180,17,17442,81,"Tasa de exámenes médico legales por presunto delito sexual contra niños, niñas y adolescentes",2021,3,1,969,103.199174406605,0,507,0,1,462,216.450216450216
33181,17,17442,121,Tasa de exámenes médico legales por presunto delito sexual cuando la víctima está entre 18 y 28 años,2021,5,1,1688,59.2417061611374,0,871,0,1,817,122.399020807834
33182,17,17444,81,"Tasa de exámenes médico legales por presunto delito sexual contra niños, niñas y adolescentes",2021,2,1,1102,90.7441016333938,0,543,0,1,559,178.890876565295
33183,17,17444,81,"Tasa de exámenes médico legales por presunto delito sexual contra niños, niñas y adolescentes",2021,3,2,1320,151.515151515152,1,684,146.198830409357,1,636,157.232704402516
33184,17,17444,81,"Tasa de exámenes médico legales por presunto delito sexual contra niños, niñas y adolescentes",2021,4,3,1265,237.154150197628,0,673,0,3,592,506.756756756757
33185,17,17486,81,"Tasa de exámenes médico legales por presunto delito sexual contra niños, niñas y adolescentes",2021,2,1,1524,65.6167979002625,0,795,0,1,729,137.174211248285
33186,17,17486,81,"Tasa de exámenes médico legales por presunto delito sexual contra niños, niñas y adolescentes",2021,3,6,1848,324.675324675325,2,985,203.045685279188,4,863,463.499420625724
33187,17,17486,81,"Tasa de exámenes médico legales por presunto delito sexual contra niños, niñas y adolescentes",2021,4,7,1871,374.131480491716,1,1000,100,6,871,688.86337543054
33188,17,17486,121,Tasa de exámenes médico legales por presunto delito sexual cuando la víctima está entre 18 y 28 años,2021,5,1,3228,30.9789343246592,0,1597,0,1,1631,61.3120784794605
33189,17,17495,81,"Tasa de exámenes médico legales por presunto delito sexual contra niños, niñas y adolescentes",2021,2,1,531,188.323917137476,0,283,0,1,248,403.225806451613
33190,17,17495,81,"Tasa de exámenes médico legales por presunto delito sexual contra niños, niñas y adolescentes",2021,4,1,650,153.846153846154,0,331,0,1,319,313.479623824451
33191,17,17513,81,"Tasa de exámenes médico legales por presunto delito sexual contra niños, niñas y adolescentes",2021,3,1,1155,86.5800865800866,0,586,0,1,569,175.746924428823
33192,17,17513,81,"Tasa de exámenes médico legales por presunto delito sexual contra niños, niñas y adolescentes",2021,4,2,1208,165.562913907285,0,639,0,2,569,351.493848857645
33193,17,17524,81,"Tasa de exámenes médico legales por presunto delito sexual contra niños, niñas y adolescentes",2021,3,1,1386,72.1500721500722,0,702,0,1,684,146.198830409357
33194,17,17541,81,"Tasa de exámenes médico legales por presunto delito sexual contra niños, niñas y adolescentes",2021,3,1,1854,53.9374325782093,0,941,0,1,913,109.529025191676
33195,17,17541,81,"Tasa de exámenes médico legales por presunto delito sexual contra niños, niñas y adolescentes",2021,4,1,1833,54.5553737043099,0,931,0,1,902,110.864745011086
33196,17,17614,81,"Tasa de exámenes médico legales por presunto delito sexual contra niños, niñas y adolescentes",2021,2,2,4042,49.480455220188,0,2043,0,2,1999,100.050025012506
33197,17,17614,81,"Tasa de exámenes médico legales por presunto delito sexual contra niños, niñas y adolescentes",2021,3,7,4626,151.318633808906,1,2380,42.0168067226891,6,2246,267.141585040071
33198,17,17614,81,"Tasa de exámenes médico legales por presunto delito sexual contra niños, niñas y adolescentes",2021,4,9,4583,196.377918394065,0,2404,0,9,2179,413.033501606241
33199,17,17614,121,Tasa de exámenes médico legales por presunto delito sexual cuando la víctima está entre 18 y 28 años,2021,5,2,8261,24.2101440503571,0,4239,0,2,4022,49.7265042267529
33200,17,17616,81,"Tasa de exámenes médico legales por presunto delito sexual contra niños, niñas y adolescentes",2021,2,2,737,271.370420624152,1,378,264.550264550265,1,359,278.551532033426
33201,17,17616,81,"Tasa de exámenes médico legales por presunto delito sexual contra niños, niñas y adolescentes",2021,3,1,892,112.107623318386,0,476,0,1,416,240.384615384615
33202,17,17616,81,"Tasa de exámenes médico legales por presunto delito sexual contra niños, niñas y adolescentes",2021,4,1,932,107.296137339056,0,507,0,1,425,235.294117647059
33203,17,17616,121,Tasa de exámenes médico legales por presunto delito sexual cuando la víctima está entre 18 y 28 años,2021,5,1,1625,61.5384615384615,1,858,116.550116550117,0,767,0
33204,17,17653,81,"Tasa de exámenes médico legales por presunto delito sexual contra niños, niñas y adolescentes",2021,2,2,1181,169.348010160881,0,611,0,2,570,350.877192982456
33205,17,17653,81,"Tasa de exámenes médico legales por presunto delito sexual contra niños, niñas y adolescentes",2021,3,3,1535,195.439739413681,0,800,0,3,735,408.163265306122
33206,17,17653,81,"Tasa de exámenes médico legales por presunto delito sexual contra niños, niñas y adolescentes",2021,4,12,1602,749.063670411985,3,843,355.871886120996,9,759,1185.77075098814
33207,17,17662,81,"Tasa de exámenes médico legales por presunto delito sexual contra niños, niñas y adolescentes",2021,2,1,1713,58.3771161704612,0,884,0,1,829,120.627261761158
33208,17,17662,81,"Tasa de exámenes médico legales por presunto delito sexual contra niños, niñas y adolescentes",2021,3,6,2025,296.296296296296,1,1040,96.1538461538462,5,985,507.61421319797
33209,17,17662,81,"Tasa de exámenes médico legales por presunto delito sexual contra niños, niñas y adolescentes",2021,4,4,1902,210.304942166141,1,991,100.908173562059,3,911,329.308452250274
33210,17,17777,81,"Tasa de exámenes médico legales por presunto delito sexual contra niños, niñas y adolescentes",2021,2,2,2323,86.095566078347,0,1243,0,2,1080,185.185185185185
33211,17,17777,81,"Tasa de exámenes médico legales por presunto delito sexual contra niños, niñas y adolescentes",2021,3,9,2627,342.596117244005,0,1374,0,9,1253,718.276137270551
33212,17,17777,81,"Tasa de exámenes médico legales por presunto delito sexual contra niños, niñas y adolescentes",2021,4,4,2601,153.787004998078,1,1328,75.3012048192771,3,1273,235.6637863315
33213,17,17777,121,Tasa de exámenes médico legales por presunto delito sexual cuando la víctima está entre 18 y 28 años,2021,5,1,5040,19.8412698412698,0,2489,0,1,2551,39.2003136025088
33214,17,17867,81,"Tasa de exámenes médico legales por presunto delito sexual contra niños, niñas y adolescentes",2021,3,2,1004,199.203187250996,0,500,0,2,504,396.825396825397
33215,17,17867,81,"Tasa de exámenes médico legales por presunto delito sexual contra niños, niñas y adolescentes",2021,4,2,984,203.252032520325,0,507,0,2,477,419.287211740042
33216,17,17867,121,Tasa de exámenes médico legales por presunto delito sexual cuando la víctima está entre 18 y 28 años,2021,5,1,1514,66.0501981505945,0,749,0,1,765,130.718954248366
33217,17,17873,81,"Tasa de exámenes médico legales por presunto delito sexual contra niños, niñas y adolescentes",2021,2,6,4441,135.104706147264,1,2270,44.0528634361234,5,2171,230.308613542146
33218,17,17873,81,"Tasa de exámenes médico legales por presunto delito sexual contra niños, niñas y adolescentes",2021,3,12,5291,226.800226800227,4,2749,145.507457257184,8,2542,314.7128245476
33219,17,17873,81,"Tasa de exámenes médico legales por presunto delito sexual contra niños, niñas y adolescentes",2021,4,9,5555,162.016201620162,0,2878,0,9,2677,336.197235711617
33220,17,17873,121,Tasa de exámenes médico legales por presunto delito sexual cuando la víctima está entre 18 y 28 años,2021,5,2,11454,17.4611489436005,1,5671,17.6335743255158,1,5783,17.2920629431091
33221,17,17877,81,"Tasa de exámenes médico legales por presunto delito sexual contra niños, niñas y adolescentes",2021,3,2,1007,198.609731876862,0,516,0,2,491,407.331975560081
33222,18,18094,81,"Tasa de exámenes médico legales por presunto delito sexual contra niños, niñas y adolescentes",2021,3,1,1423,70.2740688685875,0,748,0,1,675,148.148148148148
33223,18,18094,81,"Tasa de exámenes médico legales por presunto delito sexual contra niños, niñas y adolescentes",2021,4,2,1572,127.226463104326,0,746,0,2,826,242.130750605327
33224,18,18094,121,Tasa de exámenes médico legales por presunto delito sexual cuando la víctima está entre 18 y 28 años,2021,5,1,2026,49.3583415597236,0,1016,0,1,1010,99.009900990099
33225,18,18150,81,"Tasa de exámenes médico legales por presunto delito sexual contra niños, niñas y adolescentes",2021,2,1,3758,26.6098988823842,0,1883,0,1,1875,53.3333333333333
33226,18,18150,81,"Tasa de exámenes médico legales por presunto delito sexual contra niños, niñas y adolescentes",2021,3,6,4389,136.705399863295,1,2238,44.6827524575514,5,2151,232.450023245002
33227,18,18150,81,"Tasa de exámenes médico legales por presunto delito sexual contra niños, niñas y adolescentes",2021,4,12,4017,298.730395817775,1,2057,48.6144871171609,11,1960,561.224489795918
33228,18,18150,121,Tasa de exámenes médico legales por presunto delito sexual cuando la víctima está entre 18 y 28 años,2021,5,1,5612,17.8189593727726,0,2748,0,1,2864,34.9162011173184
33229,18,18205,81,"Tasa de exámenes médico legales por presunto delito sexual contra niños, niñas y adolescentes",2021,2,2,870,229.885057471264,0,412,0,2,458,436.681222707424
33230,18,18205,81,"Tasa de exámenes médico legales por presunto delito sexual contra niños, niñas y adolescentes",2021,4,2,991,201.816347124117,0,524,0,2,467,428.265524625268
33231,18,18205,121,Tasa de exámenes médico legales por presunto delito sexual cuando la víctima está entre 18 y 28 años,2021,5,1,1356,73.7463126843658,0,692,0,1,664,150.602409638554
33232,18,18247,81,"Tasa de exámenes médico legales por presunto delito sexual contra niños, niñas y adolescentes",2021,2,1,1789,55.8971492453885,1,922,108.459869848156,0,867,0
33233,18,18247,81,"Tasa de exámenes médico legales por presunto delito sexual contra niños, niñas y adolescentes",2021,3,3,2270,132.15859030837,1,1173,85.2514919011083,2,1097,182.315405651778
33234,18,18247,81,"Tasa de exámenes médico legales por presunto delito sexual contra niños, niñas y adolescentes",2021,4,5,2259,221.336874723329,0,1163,0,5,1096,456.204379562044
33235,18,18256,81,"Tasa de exámenes médico legales por presunto delito sexual contra niños, niñas y adolescentes",2021,2,1,1941,51.5198351365276,0,1002,0,1,939,106.496272630458
33236,18,18256,81,"Tasa de exámenes médico legales por presunto delito sexual contra niños, niñas y adolescentes",2021,3,4,2317,172.637030643073,1,1194,83.7520938023451,3,1123,267.141585040071
33237,18,18256,81,"Tasa de exámenes médico legales por presunto delito sexual contra niños, niñas y adolescentes",2021,4,1,2216,45.1263537906137,0,1151,0,1,1065,93.8967136150235
33238,18,18256,121,Tasa de exámenes médico legales por presunto delito sexual cuando la víctima está entre 18 y 28 años,2021,5,1,3379,29.5945546019532,0,1748,0,1,1631,61.3120784794605
33239,18,18001,81,"Tasa de exámenes médico legales por presunto delito sexual contra niños, niñas y adolescentes",2021,2,19,14753,128.787365281638,6,7623,78.7091696182605,13,7130,182.328190743338
33240,18,18001,81,"Tasa de exámenes médico legales por presunto delito sexual contra niños, niñas y adolescentes",2021,3,54,17745,304.311073541843,4,9106,43.9270810454645,50,8639,578.770691052205
33241,18,18001,81,"Tasa de exámenes médico legales por presunto delito sexual contra niños, niñas y adolescentes",2021,4,99,18475,535.859269282815,7,9411,74.3810434597811,92,9064,1015.00441306267
33242,18,18001,121,Tasa de exámenes médico legales por presunto delito sexual cuando la víctima está entre 18 y 28 años,2021,5,27,36440,74.0944017563117,1,18800,5.31914893617021,26,17640,147.392290249433
33243,18,18410,81,"Tasa de exámenes médico legales por presunto delito sexual contra niños, niñas y adolescentes",2021,3,5,2026,246.791707798618,0,1045,0,5,981,509.683995922528
33244,18,18410,81,"Tasa de exámenes médico legales por presunto delito sexual contra niños, niñas y adolescentes",2021,4,1,1974,50.6585612968592,0,1019,0,1,955,104.712041884817
33245,18,18460,81,"Tasa de exámenes médico legales por presunto delito sexual contra niños, niñas y adolescentes",2021,3,5,1540,324.675324675325,0,786,0,5,754,663.129973474801
33246,18,18460,81,"Tasa de exámenes médico legales por presunto delito sexual contra niños, niñas y adolescentes",2021,4,5,1437,347.94711203897,2,777,257.400257400257,3,660,454.545454545455
33247,18,18460,121,Tasa de exámenes médico legales por presunto delito sexual cuando la víctima está entre 18 y 28 años,2021,5,2,1715,116.618075801749,0,910,0,2,805,248.447204968944
33248,18,18479,81,"Tasa de exámenes médico legales por presunto delito sexual contra niños, niñas y adolescentes",2021,2,1,372,268.817204301075,0,176,0,1,196,510.204081632653
33249,18,18592,81,"Tasa de exámenes médico legales por presunto delito sexual contra niños, niñas y adolescentes",2021,2,1,2603,38.4172109104879,1,1302,76.8049155145929,0,1301,0
33250,18,18592,81,"Tasa de exámenes médico legales por presunto delito sexual contra niños, niñas y adolescentes",2021,3,5,3384,147.754137115839,2,1713,116.754232340922,3,1671,179.533213644524
33251,18,18592,81,"Tasa de exámenes médico legales por presunto delito sexual contra niños, niñas y adolescentes",2021,4,14,3458,404.858299595142,1,1793,55.7724484104852,13,1665,780.780780780781
33252,18,18592,121,Tasa de exámenes médico legales por presunto delito sexual cuando la víctima está entre 18 y 28 años,2021,5,3,4851,61.8429189857761,0,2532,0,3,2319,129.366106080207
33253,18,18610,81,"Tasa de exámenes médico legales por presunto delito sexual contra niños, niñas y adolescentes",2021,3,1,1800,55.5555555555556,0,910,0,1,890,112.359550561798
33254,18,18610,81,"Tasa de exámenes médico legales por presunto delito sexual contra niños, niñas y adolescentes",2021,4,2,1816,110.132158590308,0,914,0,2,902,221.729490022173
33255,18,18610,121,Tasa de exámenes médico legales por presunto delito sexual cuando la víctima está entre 18 y 28 años,2021,5,1,2385,41.9287211740042,0,1207,0,1,1178,84.8896434634975
33256,18,18753,81,"Tasa de exámenes médico legales por presunto delito sexual contra niños, niñas y adolescentes",2021,2,3,6049,49.5949743759299,0,3103,0,3,2946,101.83299389002
33257,18,18753,81,"Tasa de exámenes médico legales por presunto delito sexual contra niños, niñas y adolescentes",2021,3,12,6917,173.485615151077,1,3527,28.3527076835838,11,3390,324.483775811209
33258,18,18753,81,"Tasa de exámenes médico legales por presunto delito sexual contra niños, niñas y adolescentes",2021,4,18,6421,280.33016664071,1,3333,30.00300030003,17,3088,550.518134715026
33259,18,18753,121,Tasa de exámenes médico legales por presunto delito sexual cuando la víctima está entre 18 y 28 años,2021,5,6,10040,59.7609561752988,0,5386,0,6,4654,128.921357971637
33260,18,18756,81,"Tasa de exámenes médico legales por presunto delito sexual contra niños, niñas y adolescentes",2021,3,1,1665,60.0600600600601,0,857,0,1,808,123.762376237624
33261,18,18756,81,"Tasa de exámenes médico legales por presunto delito sexual contra niños, niñas y adolescentes",2021,4,7,1567,446.713465220166,0,835,0,7,732,956.284153005465
33262,18,18756,121,Tasa de exámenes médico legales por presunto delito sexual cuando la víctima está entre 18 y 28 años,2021,5,1,2362,42.3370025402202,0,1382,0,1,980,102.040816326531
33263,18,18785,81,"Tasa de exámenes médico legales por presunto delito sexual contra niños, niñas y adolescentes",2021,3,2,836,239.234449760766,0,413,0,2,423,472.813238770686
33264,18,18785,81,"Tasa de exámenes médico legales por presunto delito sexual contra niños, niñas y adolescentes",2021,4,3,847,354.191263282172,0,427,0,3,420,714.285714285714
33265,85,85010,81,"Tasa de exámenes médico legales por presunto delito sexual contra niños, niñas y adolescentes",2021,2,9,3329,270.351456893962,4,1742,229.621125143513,5,1587,315.059861373661
33266,85,85010,81,"Tasa de exámenes médico legales por presunto delito sexual contra niños, niñas y adolescentes",2021,3,16,3960,404.040404040404,0,2052,0,16,1908,838.574423480084
33267,85,85010,81,"Tasa de exámenes médico legales por presunto delito sexual contra niños, niñas y adolescentes",2021,4,18,4006,449.326010983525,4,2042,195.88638589618,14,1964,712.830957230143
33268,85,85010,121,Tasa de exámenes médico legales por presunto delito sexual cuando la víctima está entre 18 y 28 años,2021,5,6,7362,81.4995925020375,0,3735,0,6,3627,165.425971877585
33269,85,85015,81,"Tasa de exámenes médico legales por presunto delito sexual contra niños, niñas y adolescentes",2021,2,1,239,418.410041841004,0,130,0,1,109,917.431192660551
33270,85,85015,81,"Tasa de exámenes médico legales por presunto delito sexual contra niños, niñas y adolescentes",2021,4,1,285,350.877192982456,1,148,675.675675675676,0,137,0
33271,85,85015,121,Tasa de exámenes médico legales por presunto delito sexual cuando la víctima está entre 18 y 28 años,2021,5,1,471,212.314225053079,0,224,0,1,247,404.858299595142
33272,85,85125,81,"Tasa de exámenes médico legales por presunto delito sexual contra niños, niñas y adolescentes",2021,2,1,1352,73.9644970414201,0,669,0,1,683,146.412884333821
33273,85,85125,81,"Tasa de exámenes médico legales por presunto delito sexual contra niños, niñas y adolescentes",2021,3,4,1654,241.837968561064,0,839,0,4,815,490.79754601227
33274,85,85125,81,"Tasa de exámenes médico legales por presunto delito sexual contra niños, niñas y adolescentes",2021,4,3,1574,190.597204574333,0,820,0,3,754,397.877984084881
33275,85,85139,81,"Tasa de exámenes médico legales por presunto delito sexual contra niños, niñas y adolescentes",2021,2,2,1705,117.302052785924,0,875,0,2,830,240.963855421687
33276,85,85139,81,"Tasa de exámenes médico legales por presunto delito sexual contra niños, niñas y adolescentes",2021,3,5,1932,258.79917184265,1,1024,97.65625,4,908,440.528634361234
33277,85,85139,81,"Tasa de exámenes médico legales por presunto delito sexual contra niños, niñas y adolescentes",2021,4,6,1817,330.214639515685,0,969,0,6,848,707.547169811321
33278,85,85139,121,Tasa de exámenes médico legales por presunto delito sexual cuando la víctima está entre 18 y 28 años,2021,5,1,3184,31.4070351758794,0,1621,0,1,1563,63.9795265515035
33279,85,85162,81,"Tasa de exámenes médico legales por presunto delito sexual contra niños, niñas y adolescentes",2021,2,2,1613,123.992560446373,0,811,0,2,802,249.376558603491
33280,85,85162,81,"Tasa de exámenes médico legales por presunto delito sexual contra niños, niñas y adolescentes",2021,3,4,1869,214.018191546281,1,939,106.496272630458,3,930,322.58064516129
33281,85,85162,81,"Tasa de exámenes médico legales por presunto delito sexual contra niños, niñas y adolescentes",2021,4,9,1834,490.730643402399,2,916,218.340611353712,7,918,762.527233115468
33282,85,85162,121,Tasa de exámenes médico legales por presunto delito sexual cuando la víctima está entre 18 y 28 años,2021,5,2,3373,59.2943966795138,0,1671,0,2,1702,117.508813160987
33283,85,85225,81,"Tasa de exámenes médico legales por presunto delito sexual contra niños, niñas y adolescentes",2021,2,1,853,117.233294255569,0,443,0,1,410,243.90243902439
33284,85,85225,81,"Tasa de exámenes médico legales por presunto delito sexual contra niños, niñas y adolescentes",2021,4,1,911,109.769484083425,0,479,0,1,432,231.481481481481
33285,85,85225,121,Tasa de exámenes médico legales por presunto delito sexual cuando la víctima está entre 18 y 28 años,2021,5,1,1607,62.2277535780958,0,884,0,1,723,138.312586445367
33286,85,85230,81,"Tasa de exámenes médico legales por presunto delito sexual contra niños, niñas y adolescentes",2021,2,1,1412,70.8215297450425,0,695,0,1,717,139.470013947001
33287,85,85230,81,"Tasa de exámenes médico legales por presunto delito sexual contra niños, niñas y adolescentes",2021,3,1,1710,58.4795321637427,0,866,0,1,844,118.483412322275
33288,85,85230,81,"Tasa de exámenes médico legales por presunto delito sexual contra niños, niñas y adolescentes",2021,4,2,1613,123.992560446373,0,838,0,2,775,258.064516129032
33289,85,85230,121,Tasa de exámenes médico legales por presunto delito sexual cuando la víctima está entre 18 y 28 años,2021,5,2,2290,87.3362445414847,0,1146,0,2,1144,174.825174825175
33290,85,85250,81,"Tasa de exámenes médico legales por presunto delito sexual contra niños, niñas y adolescentes",2021,2,10,3941,253.742704897234,0,1992,0,10,1949,513.083632632119
33291,85,85250,81,"Tasa de exámenes médico legales por presunto delito sexual contra niños, niñas y adolescentes",2021,3,13,4475,290.502793296089,2,2293,87.2219799389446,11,2182,504.124656278644
33292,85,85250,81,"Tasa de exámenes médico legales por presunto delito sexual contra niños, niñas y adolescentes",2021,4,34,4153,818.6852877438,1,2133,46.882325363338,33,2020,1633.66336633663
33293,85,85250,121,Tasa de exámenes médico legales por presunto delito sexual cuando la víctima está entre 18 y 28 años,2021,5,6,6959,86.2192843799397,1,3538,28.2645562464669,5,3421,146.156094709149
33294,85,85263,81,"Tasa de exámenes médico legales por presunto delito sexual contra niños, niñas y adolescentes",2021,3,1,1474,67.842605156038,0,764,0,1,710,140.845070422535
33295,85,85263,81,"Tasa de exámenes médico legales por presunto delito sexual contra niños, niñas y adolescentes",2021,4,3,1407,213.219616204691,0,723,0,3,684,438.59649122807
33296,85,85263,121,Tasa de exámenes médico legales por presunto delito sexual cuando la víctima está entre 18 y 28 años,2021,5,1,2263,44.1891294741494,0,1153,0,1,1110,90.0900900900901
33297,85,85300,81,"Tasa de exámenes médico legales por presunto delito sexual contra niños, niñas y adolescentes",2021,3,1,343,291.545189504373,1,190,526.315789473684,0,153,0
33298,85,85300,81,"Tasa de exámenes médico legales por presunto delito sexual contra niños, niñas y adolescentes",2021,4,3,373,804.289544235925,1,205,487.804878048781,2,168,1190.47619047619
33299,85,85315,81,"Tasa de exámenes médico legales por presunto delito sexual contra niños, niñas y adolescentes",2021,4,1,236,423.728813559322,0,118,0,1,118,847.457627118644
33300,85,85325,81,"Tasa de exámenes médico legales por presunto delito sexual contra niños, niñas y adolescentes",2021,4,1,895,111.731843575419,0,444,0,1,451,221.729490022173
33301,85,85325,121,Tasa de exámenes médico legales por presunto delito sexual cuando la víctima está entre 18 y 28 años,2021,5,1,1456,68.6813186813187,0,713,0,1,743,134.589502018843
33302,85,85410,81,"Tasa de exámenes médico legales por presunto delito sexual contra niños, niñas y adolescentes",2021,2,5,2335,214.132762312634,0,1180,0,5,1155,432.900432900433
33303,85,85410,81,"Tasa de exámenes médico legales por presunto delito sexual contra niños, niñas y adolescentes",2021,3,10,2831,353.232073472271,1,1438,69.5410292072323,9,1393,646.087580760948
33304,85,85410,81,"Tasa de exámenes médico legales por presunto delito sexual contra niños, niñas y adolescentes",2021,4,7,2893,241.963359834082,2,1511,132.362673726009,5,1382,361.794500723589
33305,85,85430,81,"Tasa de exámenes médico legales por presunto delito sexual contra niños, niñas y adolescentes",2021,4,4,1503,266.134397870925,0,777,0,4,726,550.964187327824
33306,85,85440,81,"Tasa de exámenes médico legales por presunto delito sexual contra niños, niñas y adolescentes",2021,2,5,3287,152.114390021296,1,1738,57.5373993095512,4,1549,258.23111684958
33307,85,85440,81,"Tasa de exámenes médico legales por presunto delito sexual contra niños, niñas y adolescentes",2021,3,4,3865,103.492884864166,1,1991,50.2260170768458,3,1874,160.08537886873
33308,85,85440,81,"Tasa de exámenes médico legales por presunto delito sexual contra niños, niñas y adolescentes",2021,4,3,3857,77.780658542909,0,1908,0,3,1949,153.925089789636
33309,85,85001,81,"Tasa de exámenes médico legales por presunto delito sexual contra niños, niñas y adolescentes",2021,2,19,15145,125.453945196434,4,7630,52.4246395806029,15,7515,199.600798403194
33310,85,85001,81,"Tasa de exámenes médico legales por presunto delito sexual contra niños, niñas y adolescentes",2021,3,55,17689,310.927695177794,10,8942,111.831804965332,45,8747,514.462101291872
33311,85,85001,81,"Tasa de exámenes médico legales por presunto delito sexual contra niños, niñas y adolescentes",2021,4,75,18024,416.111850865513,4,9093,43.9898823270648,71,8931,794.983764416079
33312,85,85001,121,Tasa de exámenes médico legales por presunto delito sexual cuando la víctima está entre 18 y 28 años,2021,5,26,36309,71.6075904045829,3,18082,16.5910850569627,23,18227,126.186426729577
33313,19,19050,81,"Tasa de exámenes médico legales por presunto delito sexual contra niños, niñas y adolescentes",2021,4,1,2846,35.1370344342937,0,1500,0,1,1346,74.2942050520059
33314,19,19075,81,"Tasa de exámenes médico legales por presunto delito sexual contra niños, niñas y adolescentes",2021,3,2,2013,99.3541977148535,0,1030,0,2,983,203.458799593082
33315,19,19075,81,"Tasa de exámenes médico legales por presunto delito sexual contra niños, niñas y adolescentes",2021,4,2,2260,88.4955752212389,0,1180,0,2,1080,185.185185185185
33316,19,19100,81,"Tasa de exámenes médico legales por presunto delito sexual contra niños, niñas y adolescentes",2021,3,1,3001,33.3222259246918,0,1558,0,1,1443,69.3000693000693
33317,19,19100,81,"Tasa de exámenes médico legales por presunto delito sexual contra niños, niñas y adolescentes",2021,4,3,3439,87.2346612387322,0,1820,0,3,1619,185.299567634342
33318,19,19100,121,Tasa de exámenes médico legales por presunto delito sexual cuando la víctima está entre 18 y 28 años,2021,5,3,6690,44.8430493273543,0,3570,0,3,3120,96.1538461538462
33319,19,19110,81,"Tasa de exámenes médico legales por presunto delito sexual contra niños, niñas y adolescentes",2021,2,1,2869,34.8553502962705,0,1483,0,1,1386,72.1500721500722
33320,19,19110,81,"Tasa de exámenes médico legales por presunto delito sexual contra niños, niñas y adolescentes",2021,3,2,3476,57.5373993095512,0,1794,0,2,1682,118.906064209275
33321,19,19110,81,"Tasa de exámenes médico legales por presunto delito sexual contra niños, niñas y adolescentes",2021,4,2,3590,55.7103064066852,0,1831,0,2,1759,113.700966458215
33322,19,19110,121,Tasa de exámenes médico legales por presunto delito sexual cuando la víctima está entre 18 y 28 años,2021,5,2,6659,30.0345397206788,0,3266,0,2,3393,58.9448865310934
33323,19,19130,81,"Tasa de exámenes médico legales por presunto delito sexual contra niños, niñas y adolescentes",2021,2,2,3370,59.3471810089021,0,1752,0,2,1618,123.609394313968
33324,19,19130,81,"Tasa de exámenes médico legales por presunto delito sexual contra niños, niñas y adolescentes",2021,3,1,4360,22.9357798165138,0,2256,0,1,2104,47.5285171102662
33325,19,19130,81,"Tasa de exámenes médico legales por presunto delito sexual contra niños, niñas y adolescentes",2021,4,7,4708,148.683092608326,0,2434,0,7,2274,307.827616534741
33326,19,19130,121,Tasa de exámenes médico legales por presunto delito sexual cuando la víctima está entre 18 y 28 años,2021,5,2,8171,24.4768082242076,0,4184,0,2,3987,50.1630298470028
33327,19,19137,81,"Tasa de exámenes médico legales por presunto delito sexual contra niños, niñas y adolescentes",2021,3,1,5231,19.1168036704263,0,2648,0,1,2583,38.7146728610143
33328,19,19137,81,"Tasa de exámenes médico legales por presunto delito sexual contra niños, niñas y adolescentes",2021,4,2,4970,40.2414486921529,0,2535,0,2,2435,82.135523613963
33329,19,19142,81,"Tasa de exámenes médico legales por presunto delito sexual contra niños, niñas y adolescentes",2021,3,1,3052,32.7653997378768,0,1579,0,1,1473,67.8886625933469
33330,19,19142,81,"Tasa de exámenes médico legales por presunto delito sexual contra niños, niñas y adolescentes",2021,4,3,3266,91.8554807103491,0,1654,0,3,1612,186.104218362283
33331,19,19212,81,"Tasa de exámenes médico legales por presunto delito sexual contra niños, niñas y adolescentes",2021,3,1,2418,41.3564929693962,0,1221,0,1,1197,83.5421888053467
33332,19,19212,81,"Tasa de exámenes médico legales por presunto delito sexual contra niños, niñas y adolescentes",2021,4,2,2814,71.0732054015636,0,1474,0,2,1340,149.253731343284
33333,19,19256,81,"Tasa de exámenes médico legales por presunto delito sexual contra niños, niñas y adolescentes",2021,2,1,3779,26.4620269912675,0,1934,0,1,1845,54.2005420054201
33334,19,19256,81,"Tasa de exámenes médico legales por presunto delito sexual contra niños, niñas y adolescentes",2021,3,2,4856,41.1861614497529,0,2474,0,2,2382,83.9630562552477
33335,19,19256,81,"Tasa de exámenes médico legales por presunto delito sexual contra niños, niñas y adolescentes",2021,4,3,5248,57.1646341463415,0,2689,0,3,2559,117.233294255569
33336,19,19290,81,"Tasa de exámenes médico legales por presunto delito sexual contra niños, niñas y adolescentes",2021,4,3,520,576.923076923077,0,279,0,3,241,1244.8132780083
33337,19,19290,121,Tasa de exámenes médico legales por presunto delito sexual cuando la víctima está entre 18 y 28 años,2021,5,2,1046,191.204588910134,0,531,0,2,515,388.349514563107
33338,19,19300,81,"Tasa de exámenes médico legales por presunto delito sexual contra niños, niñas y adolescentes",2021,3,1,1892,52.8541226215645,0,952,0,1,940,106.382978723404
33339,19,19300,81,"Tasa de exámenes médico legales por presunto delito sexual contra niños, niñas y adolescentes",2021,4,1,2128,46.9924812030075,0,1061,0,1,1067,93.7207122774133
33340,19,19300,121,Tasa de exámenes médico legales por presunto delito sexual cuando la víctima está entre 18 y 28 años,2021,5,2,4107,48.6973459946433,0,1916,0,2,2191,91.2825193975354
33341,19,19318,81,"Tasa de exámenes médico legales por presunto delito sexual contra niños, niñas y adolescentes",2021,2,1,3057,32.7118089630357,0,1519,0,1,1538,65.0195058517555
33342,19,19318,81,"Tasa de exámenes médico legales por presunto delito sexual contra niños, niñas y adolescentes",2021,3,1,3752,26.6524520255864,0,1922,0,1,1830,54.6448087431694
33343,19,19318,81,"Tasa de exámenes médico legales por presunto delito sexual contra niños, niñas y adolescentes",2021,4,3,3662,81.9224467504096,0,1947,0,3,1715,174.927113702624
33344,19,19355,81,"Tasa de exámenes médico legales por presunto delito sexual contra niños, niñas y adolescentes",2021,2,1,3095,32.3101777059774,0,1599,0,1,1496,66.8449197860963
33345,19,19355,81,"Tasa de exámenes médico legales por presunto delito sexual contra niños, niñas y adolescentes",2021,4,1,3479,28.7438919229664,0,1717,0,1,1762,56.7536889897843
33346,19,19355,121,Tasa de exámenes médico legales por presunto delito sexual cuando la víctima está entre 18 y 28 años,2021,5,1,5761,17.3580975525082,0,2879,0,1,2882,34.6981263011797
33347,19,19364,81,"Tasa de exámenes médico legales por presunto delito sexual contra niños, niñas y adolescentes",2021,2,1,1996,50.1002004008016,0,997,0,1,999,100.1001001001
33348,19,19397,81,"Tasa de exámenes médico legales por presunto delito sexual contra niños, niñas y adolescentes",2021,2,1,1720,58.1395348837209,0,904,0,1,816,122.549019607843
33349,19,19397,81,"Tasa de exámenes médico legales por presunto delito sexual contra niños, niñas y adolescentes",2021,4,1,2389,41.8585182084554,0,1194,0,1,1195,83.6820083682008
33350,19,19418,81,"Tasa de exámenes médico legales por presunto delito sexual contra niños, niñas y adolescentes",2021,4,1,2523,39.6353547364249,0,1307,0,1,1216,82.2368421052632
33351,19,19450,81,"Tasa de exámenes médico legales por presunto delito sexual contra niños, niñas y adolescentes",2021,2,2,1409,141.94464158978,0,738,0,2,671,298.06259314456
33352,19,19450,81,"Tasa de exámenes médico legales por presunto delito sexual contra niños, niñas y adolescentes",2021,3,1,1971,50.7356671740233,0,1021,0,1,950,105.263157894737
33353,19,19450,81,"Tasa de exámenes médico legales por presunto delito sexual contra niños, niñas y adolescentes",2021,4,1,2208,45.2898550724638,1,1142,87.5656742556918,0,1066,0
33354,19,19455,81,"Tasa de exámenes médico legales por presunto delito sexual contra niños, niñas y adolescentes",2021,2,1,2279,43.8788942518649,0,1156,0,1,1123,89.0471950133571
33355,19,19455,81,"Tasa de exámenes médico legales por presunto delito sexual contra niños, niñas y adolescentes",2021,3,2,2905,68.8468158347677,1,1466,68.2128240109141,1,1439,69.4927032661571
33356,19,19455,81,"Tasa de exámenes médico legales por presunto delito sexual contra niños, niñas y adolescentes",2021,4,4,3165,126.382306477093,0,1595,0,4,1570,254.777070063694
33357,19,19473,81,"Tasa de exámenes médico legales por presunto delito sexual contra niños, niñas y adolescentes",2021,3,1,4536,22.0458553791887,0,2286,0,1,2250,44.4444444444445
33358,19,19473,81,"Tasa de exámenes médico legales por presunto delito sexual contra niños, niñas y adolescentes",2021,4,2,4379,45.6725279744234,0,2194,0,2,2185,91.5331807780321
33359,19,19513,121,Tasa de exámenes médico legales por presunto delito sexual cuando la víctima está entre 18 y 28 años,2021,5,1,1990,50.251256281407,0,956,0,1,1034,96.7117988394584
33360,19,19517,81,"Tasa de exámenes médico legales por presunto delito sexual contra niños, niñas y adolescentes",2021,3,4,6526,61.2932883849219,0,3308,0,4,3218,124.300807955252
33361,19,19517,81,"Tasa de exámenes médico legales por presunto delito sexual contra niños, niñas y adolescentes",2021,4,2,5818,34.3760742523204,0,2911,0,2,2907,68.7994496044032
33362,19,19517,121,Tasa de exámenes médico legales por presunto delito sexual cuando la víctima está entre 18 y 28 años,2021,5,1,9320,10.7296137339056,0,4726,0,1,4594,21.767522855899
33363,19,19532,81,"Tasa de exámenes médico legales por presunto delito sexual contra niños, niñas y adolescentes",2021,2,4,2539,157.542339503742,0,1228,0,4,1311,305.11060259344
33364,19,19532,81,"Tasa de exámenes médico legales por presunto delito sexual contra niños, niñas y adolescentes",2021,3,2,3464,57.7367205542725,0,1742,0,2,1722,116.144018583043
33365,19,19532,81,"Tasa de exámenes médico legales por presunto delito sexual contra niños, niñas y adolescentes",2021,4,6,3911,153.413449245717,0,2026,0,6,1885,318.302387267905
33366,19,19532,121,Tasa de exámenes médico legales por presunto delito sexual cuando la víctima está entre 18 y 28 años,2021,5,3,6787,44.202151171357,0,3406,0,3,3381,88.7311446317658
33367,19,19548,81,"Tasa de exámenes médico legales por presunto delito sexual contra niños, niñas y adolescentes",2021,3,4,3892,102.774922918808,1,1973,50.6842372022301,3,1919,156.331422615946
33368,19,19548,81,"Tasa de exámenes médico legales por presunto delito sexual contra niños, niñas y adolescentes",2021,4,1,4139,24.1604252234839,0,2089,0,1,2050,48.7804878048781
33369,19,19548,121,Tasa de exámenes médico legales por presunto delito sexual cuando la víctima está entre 18 y 28 años,2021,5,1,7892,12.6710593005575,0,3902,0,1,3990,25.062656641604
33370,19,19001,81,"Tasa de exámenes médico legales por presunto delito sexual contra niños, niñas y adolescentes",2021,2,14,20402,68.6207234584845,5,10471,47.7509311431573,9,9931,90.6253146712315
33371,19,19001,81,"Tasa de exámenes médico legales por presunto delito sexual contra niños, niñas y adolescentes",2021,3,34,25018,135.902150451675,7,12794,54.7131467875567,27,12224,220.876963350785
33372,19,19001,81,"Tasa de exámenes médico legales por presunto delito sexual contra niños, niñas y adolescentes",2021,4,74,27157,272.4895975255,4,13823,28.9372784489619,70,13334,524.973751312434
33373,19,19001,121,Tasa de exámenes médico legales por presunto delito sexual cuando la víctima está entre 18 y 28 años,2021,5,30,60576,49.5245641838352,2,30920,6.46830530401035,28,29656,94.4159697868897
33374,19,19001,81,"Tasa de exámenes médico legales por presunto delito sexual contra niños, niñas y adolescentes",2021,1,1,3925,25.4777070063694,0,2023,0,1,1902,52.5762355415352
33375,19,19573,81,"Tasa de exámenes médico legales por presunto delito sexual contra niños, niñas y adolescentes",2021,2,3,3171,94.6073793755913,0,1648,0,3,1523,196.979645436638
33376,19,19573,81,"Tasa de exámenes médico legales por presunto delito sexual contra niños, niñas y adolescentes",2021,3,3,3908,76.7656090071648,0,2004,0,3,1904,157.563025210084
33377,19,19573,81,"Tasa de exámenes médico legales por presunto delito sexual contra niños, niñas y adolescentes",2021,4,4,4042,98.9609104403761,0,2019,0,4,2023,197.726149283243
33378,19,19573,121,Tasa de exámenes médico legales por presunto delito sexual cuando la víctima está entre 18 y 28 años,2021,5,5,8066,61.9885940986858,0,3839,0,5,4227,118.287201324817
33379,19,19585,81,"Tasa de exámenes médico legales por presunto delito sexual contra niños, niñas y adolescentes",2021,4,2,1838,108.813928182807,0,941,0,2,897,222.965440356745
33380,19,19585,121,Tasa de exámenes médico legales por presunto delito sexual cuando la víctima está entre 18 y 28 años,2021,5,1,3776,26.4830508474576,0,1920,0,1,1856,53.8793103448276
33381,19,19622,81,"Tasa de exámenes médico legales por presunto delito sexual contra niños, niñas y adolescentes",2021,3,1,866,115.473441108545,1,441,226.757369614512,0,425,0
33382,19,19622,81,"Tasa de exámenes médico legales por presunto delito sexual contra niños, niñas y adolescentes",2021,4,1,991,100.908173562059,0,513,0,1,478,209.205020920502
33383,19,19698,81,"Tasa de exámenes médico legales por presunto delito sexual contra niños, niñas y adolescentes",2021,2,1,8794,11.3713895838071,0,4563,0,1,4231,23.6350744504845
33384,19,19698,81,"Tasa de exámenes médico legales por presunto delito sexual contra niños, niñas y adolescentes",2021,3,10,10538,94.8946669197191,2,5450,36.697247706422,8,5088,157.232704402516
33385,19,19698,81,"Tasa de exámenes médico legales por presunto delito sexual contra niños, niñas y adolescentes",2021,4,12,10904,110.051357300073,0,5596,0,12,5308,226.073850791258
33386,19,19698,121,Tasa de exámenes médico legales por presunto delito sexual cuando la víctima está entre 18 y 28 años,2021,5,9,22322,40.3189678344234,3,11196,26.7952840300107,6,11126,53.9277368326443
33387,19,19743,81,"Tasa de exámenes médico legales por presunto delito sexual contra niños, niñas y adolescentes",2021,3,4,4168,95.9692898272553,2,2118,94.4287063267233,2,2050,97.5609756097561
33388,19,19743,81,"Tasa de exámenes médico legales por presunto delito sexual contra niños, niñas y adolescentes",2021,4,3,4143,72.4112961622013,0,2113,0,3,2030,147.783251231527
33389,19,19743,121,Tasa de exámenes médico legales por presunto delito sexual cuando la víctima está entre 18 y 28 años,2021,5,1,8047,12.4269914253759,1,4047,24.7096614776378,0,4000,0
33390,19,19760,81,"Tasa de exámenes médico legales por presunto delito sexual contra niños, niñas y adolescentes",2021,3,1,1201,83.2639467110741,0,595,0,1,606,165.016501650165
33391,19,19780,81,"Tasa de exámenes médico legales por presunto delito sexual contra niños, niñas y adolescentes",2021,4,3,3609,83.1255195344971,0,1816,0,3,1793,167.317345231456
33392,19,19785,81,"Tasa de exámenes médico legales por presunto delito sexual contra niños, niñas y adolescentes",2021,2,1,545,183.48623853211,0,305,0,1,240,416.666666666667
33393,19,19807,81,"Tasa de exámenes médico legales por presunto delito sexual contra niños, niñas y adolescentes",2021,2,1,2400,41.6666666666667,0,1242,0,1,1158,86.3557858376511
33394,19,19807,81,"Tasa de exámenes médico legales por presunto delito sexual contra niños, niñas y adolescentes",2021,3,3,3057,98.135426889107,0,1559,0,3,1498,200.267022696929
33395,19,19807,81,"Tasa de exámenes médico legales por presunto delito sexual contra niños, niñas y adolescentes",2021,4,4,3320,120.481927710843,0,1680,0,4,1640,243.90243902439
33396,19,19807,121,Tasa de exámenes médico legales por presunto delito sexual cuando la víctima está entre 18 y 28 años,2021,5,2,6491,30.8118933908489,0,3240,0,2,3251,61.5195324515534
33397,19,19821,81,"Tasa de exámenes médico legales por presunto delito sexual contra niños, niñas y adolescentes",2021,3,2,4166,48.0076812289966,0,2110,0,2,2056,97.2762645914397
33398,19,19821,81,"Tasa de exámenes médico legales por presunto delito sexual contra niños, niñas y adolescentes",2021,4,1,4474,22.3513634331694,0,2233,0,1,2241,44.6229361892013
33399,19,19824,81,"Tasa de exámenes médico legales por presunto delito sexual contra niños, niñas y adolescentes",2021,3,1,3007,33.255736614566,0,1533,0,1,1474,67.842605156038
33400,19,19824,81,"Tasa de exámenes médico legales por presunto delito sexual contra niños, niñas y adolescentes",2021,4,2,2964,67.476383265857,0,1461,0,2,1503,133.067198935462
33401,19,19845,81,"Tasa de exámenes médico legales por presunto delito sexual contra niños, niñas y adolescentes",2021,3,1,2001,49.9750124937531,0,1006,0,1,995,100.502512562814
33402,19,19845,81,"Tasa de exámenes médico legales por presunto delito sexual contra niños, niñas y adolescentes",2021,4,1,2061,48.5201358563804,0,1001,0,1,1060,94.3396226415094
33403,20,20011,81,"Tasa de exámenes médico legales por presunto delito sexual contra niños, niñas y adolescentes",2021,2,2,10990,18.1983621474067,0,5597,0,2,5393,37.0851103282032
33404,20,20011,81,"Tasa de exámenes médico legales por presunto delito sexual contra niños, niñas y adolescentes",2021,3,8,13202,60.5968792607181,2,6733,29.7044408139017,6,6469,92.7500386458494
33405,20,20011,81,"Tasa de exámenes médico legales por presunto delito sexual contra niños, niñas y adolescentes",2021,4,14,13063,107.172931179668,0,6613,0,14,6450,217.054263565891
33406,20,20011,121,Tasa de exámenes médico legales por presunto delito sexual cuando la víctima está entre 18 y 28 años,2021,5,5,23465,21.308331557639,0,11512,0,5,11953,41.8305028026437
33407,20,20013,81,"Tasa de exámenes médico legales por presunto delito sexual contra niños, niñas y adolescentes",2021,2,5,6670,74.9625187406297,2,3364,59.4530321046373,3,3306,90.7441016333938
33408,20,20013,81,"Tasa de exámenes médico legales por presunto delito sexual contra niños, niñas y adolescentes",2021,3,7,7858,89.0811911427844,0,3977,0,7,3881,180.365885081165
33409,20,20013,81,"Tasa de exámenes médico legales por presunto delito sexual contra niños, niñas y adolescentes",2021,4,23,7451,308.683398201584,2,3777,52.952078369076,21,3674,571.584104518236
33410,20,20013,121,Tasa de exámenes médico legales por presunto delito sexual cuando la víctima está entre 18 y 28 años,2021,5,8,12389,64.5734118976511,0,6148,0,8,6241,128.184585803557
33411,20,20032,81,"Tasa de exámenes médico legales por presunto delito sexual contra niños, niñas y adolescentes",2021,3,1,2790,35.84229390681,0,1438,0,1,1352,73.9644970414201
33412,20,20032,81,"Tasa de exámenes médico legales por presunto delito sexual contra niños, niñas y adolescentes",2021,4,7,2621,267.073636016788,1,1356,73.7463126843658,6,1265,474.308300395257
33413,20,20060,81,"Tasa de exámenes médico legales por presunto delito sexual contra niños, niñas y adolescentes",2021,2,4,4486,89.1662951404369,3,2266,132.391879964696,1,2220,45.045045045045
33414,20,20060,81,"Tasa de exámenes médico legales por presunto delito sexual contra niños, niñas y adolescentes",2021,3,7,5554,126.035289881167,1,2845,35.1493848857645,6,2709,221.483942414175
33415,20,20060,81,"Tasa de exámenes médico legales por presunto delito sexual contra niños, niñas y adolescentes",2021,4,13,5467,237.790378635449,0,2825,0,13,2642,492.051476154429
33416,20,20060,121,Tasa de exámenes médico legales por presunto delito sexual cuando la víctima está entre 18 y 28 años,2021,5,1,8688,11.5101289134438,0,4354,0,1,4334,23.0733733271804
33417,20,20178,81,"Tasa de exámenes médico legales por presunto delito sexual contra niños, niñas y adolescentes",2021,2,2,3243,61.6712920135677,0,1675,0,2,1568,127.551020408163
33418,20,20178,81,"Tasa de exámenes médico legales por presunto delito sexual contra niños, niñas y adolescentes",2021,3,3,3746,80.0854244527496,1,1907,52.4383848977452,2,1839,108.754758020663
33419,20,20178,81,"Tasa de exámenes médico legales por presunto delito sexual contra niños, niñas y adolescentes",2021,4,17,3455,492.040520984081,0,1738,0,17,1717,990.09900990099
33420,20,20178,121,Tasa de exámenes médico legales por presunto delito sexual cuando la víctima está entre 18 y 28 años,2021,5,4,5511,72.5821085102522,0,2737,0,4,2774,144.196106705119
33421,20,20228,81,"Tasa de exámenes médico legales por presunto delito sexual contra niños, niñas y adolescentes",2021,2,3,3977,75.4337440281619,1,2046,48.8758553274682,2,1931,103.573278094252
33422,20,20228,81,"Tasa de exámenes médico legales por presunto delito sexual contra niños, niñas y adolescentes",2021,3,3,4957,60.5204760944119,0,2542,0,3,2415,124.223602484472
33423,20,20228,81,"Tasa de exámenes médico legales por presunto delito sexual contra niños, niñas y adolescentes",2021,4,5,4886,102.333196889071,1,2488,40.1929260450161,4,2398,166.805671392827
33424,20,20228,121,Tasa de exámenes médico legales por presunto delito sexual cuando la víctima está entre 18 y 28 años,2021,5,2,7450,26.8456375838926,0,3733,0,2,3717,53.8068334678504
33425,20,20238,81,"Tasa de exámenes médico legales por presunto delito sexual contra niños, niñas y adolescentes",2021,2,1,3320,30.1204819277108,0,1661,0,1,1659,60.2772754671489
33426,20,20238,81,"Tasa de exámenes médico legales por presunto delito sexual contra niños, niñas y adolescentes",2021,3,1,3992,25.0501002004008,0,2016,0,1,1976,50.6072874493927
33427,20,20238,81,"Tasa de exámenes médico legales por presunto delito sexual contra niños, niñas y adolescentes",2021,4,3,3821,78.5134781470819,0,1947,0,3,1874,160.08537886873
33428,20,20238,121,Tasa de exámenes médico legales por presunto delito sexual cuando la víctima está entre 18 y 28 años,2021,5,1,5973,16.7420056922819,0,2962,0,1,3011,33.2115576220525
33429,20,20250,81,"Tasa de exámenes médico legales por presunto delito sexual contra niños, niñas y adolescentes",2021,3,1,5670,17.636684303351,0,2897,0,1,2773,36.0620266858998
33430,20,20250,81,"Tasa de exámenes médico legales por presunto delito sexual contra niños, niñas y adolescentes",2021,4,5,5147,97.143967359627,0,2577,0,5,2570,194.552529182879
33431,20,20250,121,Tasa de exámenes médico legales por presunto delito sexual cuando la víctima está entre 18 y 28 años,2021,5,1,8207,12.1847203606677,0,3995,0,1,4212,23.7416904083571
33432,20,20295,81,"Tasa de exámenes médico legales por presunto delito sexual contra niños, niñas y adolescentes",2021,2,1,1373,72.8332119446468,1,667,149.925037481259,0,706,0
33433,20,20295,81,"Tasa de exámenes médico legales por presunto delito sexual contra niños, niñas y adolescentes",2021,3,1,1705,58.6510263929619,0,837,0,1,868,115.207373271889
33434,20,20383,81,"Tasa de exámenes médico legales por presunto delito sexual contra niños, niñas y adolescentes",2021,4,2,2111,94.7418285172904,0,1152,0,2,959,208.550573514077
33435,20,20400,81,"Tasa de exámenes médico legales por presunto delito sexual contra niños, niñas y adolescentes",2021,2,1,5731,17.4489617867737,0,2885,0,1,2846,35.1370344342937
33436,20,20400,81,"Tasa de exámenes médico legales por presunto delito sexual contra niños, niñas y adolescentes",2021,4,5,6228,80.2825947334618,0,3191,0,5,3037,164.63615409944
33437,20,20400,121,Tasa de exámenes médico legales por presunto delito sexual cuando la víctima está entre 18 y 28 años,2021,5,1,10676,9.36680404645935,0,5259,0,1,5417,18.4604024367731
33438,20,20621,81,"Tasa de exámenes médico legales por presunto delito sexual contra niños, niñas y adolescentes",2021,3,6,3691,162.557572473584,0,1885,0,6,1806,332.225913621262
33439,20,20621,81,"Tasa de exámenes médico legales por presunto delito sexual contra niños, niñas y adolescentes",2021,4,6,3525,170.212765957447,0,1818,0,6,1707,351.493848857645
33440,20,20621,121,Tasa de exámenes médico legales por presunto delito sexual cuando la víctima está entre 18 y 28 años,2021,5,2,5692,35.1370344342937,0,2832,0,2,2860,69.9300699300699
33441,20,20443,81,"Tasa de exámenes médico legales por presunto delito sexual contra niños, niñas y adolescentes",2021,2,1,983,101.729399796541,0,487,0,1,496,201.612903225806
33442,20,20443,81,"Tasa de exámenes médico legales por presunto delito sexual contra niños, niñas y adolescentes",2021,3,2,1250,160,0,632,0,2,618,323.624595469256
33443,20,20443,81,"Tasa de exámenes médico legales por presunto delito sexual contra niños, niñas y adolescentes",2021,4,6,1293,464.037122969838,0,663,0,6,630,952.380952380953
33444,20,20443,121,Tasa de exámenes médico legales por presunto delito sexual cuando la víctima está entre 18 y 28 años,2021,5,1,2122,47.1253534401508,0,1052,0,1,1070,93.4579439252337
33445,20,20517,81,"Tasa de exámenes médico legales por presunto delito sexual contra niños, niñas y adolescentes",2021,2,1,1823,54.8546352166758,0,925,0,1,898,111.358574610245
33446,20,20517,81,"Tasa de exámenes médico legales por presunto delito sexual contra niños, niñas y adolescentes",2021,4,1,2367,42.247570764681,0,1193,0,1,1174,85.1788756388416
33447,20,20550,81,"Tasa de exámenes médico legales por presunto delito sexual contra niños, niñas y adolescentes",2021,3,1,2794,35.7909806728704,0,1466,0,1,1328,75.3012048192771
33448,20,20550,81,"Tasa de exámenes médico legales por presunto delito sexual contra niños, niñas y adolescentes",2021,4,2,2697,74.1564701520208,0,1402,0,2,1295,154.440154440154
33449,20,20570,81,"Tasa de exámenes médico legales por presunto delito sexual contra niños, niñas y adolescentes",2021,3,2,4842,41.3052457662123,0,2411,0,2,2431,82.2706705059646
33450,20,20570,81,"Tasa de exámenes médico legales por presunto delito sexual contra niños, niñas y adolescentes",2021,4,1,4065,24.60024600246,0,2046,0,1,2019,49.5294700346706
33451,20,20570,121,Tasa de exámenes médico legales por presunto delito sexual cuando la víctima está entre 18 y 28 años,2021,5,2,5649,35.4044963710391,0,2859,0,2,2790,71.6845878136201
33452,20,20614,81,"Tasa de exámenes médico legales por presunto delito sexual contra niños, niñas y adolescentes",2021,3,2,1801,111.049416990561,0,924,0,2,877,228.050171037628
33453,20,20710,81,"Tasa de exámenes médico legales por presunto delito sexual contra niños, niñas y adolescentes",2021,3,2,3284,60.9013398294762,0,1641,0,2,1643,121.728545343883
33454,20,20710,81,"Tasa de exámenes médico legales por presunto delito sexual contra niños, niñas y adolescentes",2021,4,3,3088,97.1502590673575,0,1529,0,3,1559,192.431045542014
33455,20,20750,81,"Tasa de exámenes médico legales por presunto delito sexual contra niños, niñas y adolescentes",2021,3,1,2468,40.5186385737439,0,1273,0,1,1195,83.6820083682008
33456,20,20750,81,"Tasa de exámenes médico legales por presunto delito sexual contra niños, niñas y adolescentes",2021,4,1,2298,43.5161009573542,0,1171,0,1,1127,88.7311446317658
33457,20,20770,81,"Tasa de exámenes médico legales por presunto delito sexual contra niños, niñas y adolescentes",2021,3,1,3387,29.5246530853263,0,1703,0,1,1684,59.3824228028504
33458,20,20787,81,"Tasa de exámenes médico legales por presunto delito sexual contra niños, niñas y adolescentes",2021,4,3,2027,148.001973359645,0,1046,0,3,981,305.810397553517
33459,20,20001,81,"Tasa de exámenes médico legales por presunto delito sexual contra niños, niñas y adolescentes",2021,2,26,51093,50.887597126808,4,26225,15.2526215443279,22,24868,88.4671063213769
33460,20,20001,81,"Tasa de exámenes médico legales por presunto delito sexual contra niños, niñas y adolescentes",2021,3,68,59776,113.758029978587,15,30647,48.9444317551473,53,29129,181.949260187442
33461,20,20001,81,"Tasa de exámenes médico legales por presunto delito sexual contra niños, niñas y adolescentes",2021,4,114,58211,195.839274363952,10,29716,33.6519046978059,104,28495,364.97631163362
33462,20,20001,121,Tasa de exámenes médico legales por presunto delito sexual cuando la víctima está entre 18 y 28 años,2021,5,33,107384,30.7308351337257,6,53490,11.2170499158721,27,53894,50.0983411882584
33463,20,20001,81,"Tasa de exámenes médico legales por presunto delito sexual contra niños, niñas y adolescentes",2021,1,1,10045,9.95520159283226,1,5177,19.3162062970833,0,4868,0
33464,27,27006,81,"Tasa de exámenes médico legales por presunto delito sexual contra niños, niñas y adolescentes",2021,4,2,1727,115.807759119861,0,878,0,2,849,235.571260306243
33465,27,27006,121,Tasa de exámenes médico legales por presunto delito sexual cuando la víctima está entre 18 y 28 años,2021,5,1,2517,39.7298371076679,0,1235,0,1,1282,78.003120124805
33466,27,27025,81,"Tasa de exámenes médico legales por presunto delito sexual contra niños, niñas y adolescentes",2021,2,1,3362,29.7441998810232,0,1684,0,1,1678,59.5947556615018
33467,27,27025,81,"Tasa de exámenes médico legales por presunto delito sexual contra niños, niñas y adolescentes",2021,4,3,4132,72.6040658276864,0,2158,0,3,1974,151.975683890578
33468,27,27050,81,"Tasa de exámenes médico legales por presunto delito sexual contra niños, niñas y adolescentes",2021,2,1,568,176.056338028169,1,302,331.12582781457,0,266,0
33469,27,27050,81,"Tasa de exámenes médico legales por presunto delito sexual contra niños, niñas y adolescentes",2021,4,1,787,127.064803049555,0,452,0,1,335,298.507462686567
33470,27,27050,121,Tasa de exámenes médico legales por presunto delito sexual cuando la víctima está entre 18 y 28 años,2021,5,2,1195,167.364016736402,0,634,0,2,561,356.50623885918
33471,27,27073,81,"Tasa de exámenes médico legales por presunto delito sexual contra niños, niñas y adolescentes",2021,3,1,1826,54.7645125958379,0,897,0,1,929,107.642626480086
33472,27,27075,121,Tasa de exámenes médico legales por presunto delito sexual cuando la víctima está entre 18 y 28 años,2021,5,1,1997,50.0751126690035,1,1107,90.3342366757001,0,890,0
33473,27,27077,81,"Tasa de exámenes médico legales por presunto delito sexual contra niños, niñas y adolescentes",2021,2,1,3554,28.137310073157,0,1794,0,1,1760,56.8181818181818
33474,27,27077,81,"Tasa de exámenes médico legales por presunto delito sexual contra niños, niñas y adolescentes",2021,4,1,4612,21.6825672159584,0,2392,0,1,2220,45.045045045045
33475,27,27099,81,"Tasa de exámenes médico legales por presunto delito sexual contra niños, niñas y adolescentes",2021,2,1,1697,58.9275191514437,0,887,0,1,810,123.456790123457
33476,27,27205,81,"Tasa de exámenes médico legales por presunto delito sexual contra niños, niñas y adolescentes",2021,2,2,1173,170.502983802217,0,598,0,2,575,347.826086956522
33477,27,27205,81,"Tasa de exámenes médico legales por presunto delito sexual contra niños, niñas y adolescentes",2021,3,2,1555,128.617363344051,0,806,0,2,749,267.022696929239
33478,27,27205,81,"Tasa de exámenes médico legales por presunto delito sexual contra niños, niñas y adolescentes",2021,4,2,1554,128.700128700129,0,816,0,2,738,271.0027100271
33479,27,27245,81,"Tasa de exámenes médico legales por presunto delito sexual contra niños, niñas y adolescentes",2021,3,2,945,211.640211640212,0,480,0,2,465,430.10752688172
33480,27,27245,81,"Tasa de exámenes médico legales por presunto delito sexual contra niños, niñas y adolescentes",2021,4,1,963,103.842159916926,0,477,0,1,486,205.761316872428
33481,27,27245,121,Tasa de exámenes médico legales por presunto delito sexual cuando la víctima está entre 18 y 28 años,2021,5,1,1503,66.5335994677312,0,768,0,1,735,136.054421768707
33482,27,27250,81,"Tasa de exámenes médico legales por presunto delito sexual contra niños, niñas y adolescentes",2021,4,1,3427,29.1800408520572,0,1752,0,1,1675,59.7014925373134
33483,27,27361,81,"Tasa de exámenes médico legales por presunto delito sexual contra niños, niñas y adolescentes",2021,2,1,3076,32.5097529258778,0,1563,0,1,1513,66.0938532716457
33484,27,27372,81,"Tasa de exámenes médico legales por presunto delito sexual contra niños, niñas y adolescentes",2021,4,1,952,105.042016806723,0,507,0,1,445,224.719101123596
33485,27,27413,81,"Tasa de exámenes médico legales por presunto delito sexual contra niños, niñas y adolescentes",2021,4,1,1116,89.6057347670251,0,588,0,1,528,189.393939393939
33486,27,27425,81,"Tasa de exámenes médico legales por presunto delito sexual contra niños, niñas y adolescentes",2021,2,1,956,104.602510460251,0,506,0,1,450,222.222222222222
33487,27,27430,121,Tasa de exámenes médico legales por presunto delito sexual cuando la víctima está entre 18 y 28 años,2021,5,1,2774,36.0490266762797,0,1417,0,1,1357,73.6919675755343
33488,27,27001,81,"Tasa de exámenes médico legales por presunto delito sexual contra niños, niñas y adolescentes",2021,2,12,13757,87.2283201279349,0,7072,0,12,6685,179.506357516829
33489,27,27001,81,"Tasa de exámenes médico legales por presunto delito sexual contra niños, niñas y adolescentes",2021,3,24,16311,147.139966893507,3,8140,36.8550368550369,21,8171,257.006486354179
33490,27,27001,81,"Tasa de exámenes médico legales por presunto delito sexual contra niños, niñas y adolescentes",2021,4,25,15401,162.32712161548,1,7435,13.4498991257566,24,7966,301.280441877981
33491,27,27001,121,Tasa de exámenes médico legales por presunto delito sexual cuando la víctima está entre 18 y 28 años,2021,5,7,26220,26.697177726926,0,12338,0,7,13882,50.4250108053595
33492,27,27580,121,Tasa de exámenes médico legales por presunto delito sexual cuando la víctima está entre 18 y 28 años,2021,5,1,913,109.529025191676,0,480,0,1,433,230.94688221709
33493,27,27615,81,"Tasa de exámenes médico legales por presunto delito sexual contra niños, niñas y adolescentes",2021,4,2,6785,29.4767870302137,1,3545,28.2087447108604,1,3240,30.8641975308642
33494,27,27787,81,"Tasa de exámenes médico legales por presunto delito sexual contra niños, niñas y adolescentes",2021,2,1,1873,53.3902829684997,0,946,0,1,927,107.874865156419
33495,27,27787,81,"Tasa de exámenes médico legales por presunto delito sexual contra niños, niñas y adolescentes",2021,3,2,2327,85.9475719810915,1,1167,85.6898029134533,1,1160,86.2068965517241
33496,27,27787,81,"Tasa de exámenes médico legales por presunto delito sexual contra niños, niñas y adolescentes",2021,4,4,2196,182.149362477231,0,1098,0,4,1098,364.298724954463
33497,27,27800,81,"Tasa de exámenes médico legales por presunto delito sexual contra niños, niñas y adolescentes",2021,3,1,1733,57.7034045008655,0,901,0,1,832,120.192307692308
33498,27,27800,81,"Tasa de exámenes médico legales por presunto delito sexual contra niños, niñas y adolescentes",2021,4,1,1728,57.8703703703704,0,889,0,1,839,119.189511323004
33499,27,27810,81,"Tasa de exámenes médico legales por presunto delito sexual contra niños, niñas y adolescentes",2021,4,1,794,125.944584382872,0,406,0,1,388,257.731958762887
33500,27,27810,121,Tasa de exámenes médico legales por presunto delito sexual cuando la víctima está entre 18 y 28 años,2021,5,1,1368,73.0994152046784,0,705,0,1,663,150.829562594268
33501,23,23068,81,"Tasa de exámenes médico legales por presunto delito sexual contra niños, niñas y adolescentes",2021,3,1,5870,17.0357751277683,0,3010,0,1,2860,34.965034965035
33502,23,23068,81,"Tasa de exámenes médico legales por presunto delito sexual contra niños, niñas y adolescentes",2021,4,1,5604,17.8443968593862,0,2926,0,1,2678,37.3412994772218
33503,23,23079,81,"Tasa de exámenes médico legales por presunto delito sexual contra niños, niñas y adolescentes",2021,2,1,2025,49.3827160493827,0,1021,0,1,1004,99.601593625498
33504,23,23090,81,"Tasa de exámenes médico legales por presunto delito sexual contra niños, niñas y adolescentes",2021,4,3,1814,165.380374862183,0,953,0,3,861,348.432055749129
33505,23,23090,121,Tasa de exámenes médico legales por presunto delito sexual cuando la víctima está entre 18 y 28 años,2021,5,1,2606,38.3729854182655,0,1307,0,1,1299,76.9822940723634
33506,23,23162,81,"Tasa de exámenes médico legales por presunto delito sexual contra niños, niñas y adolescentes",2021,2,2,8489,23.5599010484156,0,4312,0,2,4177,47.8812544888676
33507,23,23162,81,"Tasa de exámenes médico legales por presunto delito sexual contra niños, niñas y adolescentes",2021,3,11,10075,109.181141439206,4,5123,78.0792504391958,7,4952,141.357027463651
33508,23,23162,81,"Tasa de exámenes médico legales por presunto delito sexual contra niños, niñas y adolescentes",2021,4,12,10158,118.133490844654,0,5149,0,12,5009,239.568776202835
33509,23,23162,121,Tasa de exámenes médico legales por presunto delito sexual cuando la víctima está entre 18 y 28 años,2021,5,2,19352,10.334849111203,0,9608,0,2,9744,20.5254515599343
33510,23,23168,81,"Tasa de exámenes médico legales por presunto delito sexual contra niños, niñas y adolescentes",2021,2,1,1339,74.6825989544436,0,700,0,1,639,156.494522691706
33511,23,23182,81,"Tasa de exámenes médico legales por presunto delito sexual contra niños, niñas y adolescentes",2021,3,4,4500,88.8888888888889,1,2300,43.4782608695652,3,2200,136.363636363636
33512,23,23182,81,"Tasa de exámenes médico legales por presunto delito sexual contra niños, niñas y adolescentes",2021,4,14,4493,311.595815713332,2,2299,86.9943453675511,12,2194,546.946216955333
33513,23,23182,121,Tasa de exámenes médico legales por presunto delito sexual cuando la víctima está entre 18 y 28 años,2021,5,1,8437,11.8525542254356,0,4304,0,1,4133,24.1954996370675
33514,23,23189,81,"Tasa de exámenes médico legales por presunto delito sexual contra niños, niñas y adolescentes",2021,2,1,4932,20.2757502027575,0,2520,0,1,2412,41.4593698175788
33515,23,23189,81,"Tasa de exámenes médico legales por presunto delito sexual contra niños, niñas y adolescentes",2021,4,5,6157,81.2083807048888,0,3154,0,5,3003,166.500166500167
33516,23,23189,121,Tasa de exámenes médico legales por presunto delito sexual cuando la víctima está entre 18 y 28 años,2021,5,3,10613,28.267219447847,1,5393,18.5425551641016,2,5220,38.3141762452107
33517,23,23300,81,"Tasa de exámenes médico legales por presunto delito sexual contra niños, niñas y adolescentes",2021,3,1,1844,54.2299349240781,0,982,0,1,862,116.009280742459
33518,23,23300,81,"Tasa de exámenes médico legales por presunto delito sexual contra niños, niñas y adolescentes",2021,4,2,1911,104.65724751439,0,985,0,2,926,215.982721382289
33519,23,23350,81,"Tasa de exámenes médico legales por presunto delito sexual contra niños, niñas y adolescentes",2021,2,2,1449,138.026224982747,0,742,0,2,707,282.885431400283
33520,23,23350,81,"Tasa de exámenes médico legales por presunto delito sexual contra niños, niñas y adolescentes",2021,3,8,1722,464.576074332172,0,887,0,8,835,958.083832335329
33521,23,23350,81,"Tasa de exámenes médico legales por presunto delito sexual contra niños, niñas y adolescentes",2021,4,3,1695,176.991150442478,0,876,0,3,819,366.300366300366
33522,23,23350,121,Tasa de exámenes médico legales por presunto delito sexual cuando la víctima está entre 18 y 28 años,2021,5,1,2759,36.2450163102573,0,1358,0,1,1401,71.3775874375446
33523,23,23417,81,"Tasa de exámenes médico legales por presunto delito sexual contra niños, niñas y adolescentes",2021,2,2,9746,20.5212394828648,0,4925,0,2,4821,41.4851690520639
33524,23,23417,81,"Tasa de exámenes médico legales por presunto delito sexual contra niños, niñas y adolescentes",2021,3,7,11635,60.1633003867641,3,5901,50.8388408744281,4,5734,69.759330310429
33525,23,23417,81,"Tasa de exámenes médico legales por presunto delito sexual contra niños, niñas y adolescentes",2021,4,21,11519,182.307491969789,0,5826,0,21,5693,368.874055858071
33526,23,23417,121,Tasa de exámenes médico legales por presunto delito sexual cuando la víctima está entre 18 y 28 años,2021,5,3,20026,14.9805253170878,1,9947,10.0532823967025,2,10079,19.8432384165096
33527,23,23419,81,"Tasa de exámenes médico legales por presunto delito sexual contra niños, niñas y adolescentes",2021,3,4,2272,176.056338028169,0,1150,0,4,1122,356.50623885918
33528,23,23419,81,"Tasa de exámenes médico legales por presunto delito sexual contra niños, niñas y adolescentes",2021,4,5,2250,222.222222222222,0,1161,0,5,1089,459.136822773186
33529,23,23419,121,Tasa de exámenes médico legales por presunto delito sexual cuando la víctima está entre 18 y 28 años,2021,5,1,3302,30.2846759539673,0,1683,0,1,1619,61.7665225447807
33530,23,23464,81,"Tasa de exámenes médico legales por presunto delito sexual contra niños, niñas y adolescentes",2021,3,1,2013,49.6770988574267,0,1011,0,1,1002,99.8003992015968
33531,23,23464,81,"Tasa de exámenes médico legales por presunto delito sexual contra niños, niñas y adolescentes",2021,4,1,2110,47.39336492891,0,1043,0,1,1067,93.7207122774133
33532,23,23466,81,"Tasa de exámenes médico legales por presunto delito sexual contra niños, niñas y adolescentes",2021,2,2,8447,23.6770451047709,0,4342,0,2,4105,48.721071863581
33533,23,23466,81,"Tasa de exámenes médico legales por presunto delito sexual contra niños, niñas y adolescentes",2021,3,11,10268,107.128944292949,2,5221,38.306837770542,9,5047,178.323756687141
33534,23,23466,81,"Tasa de exámenes médico legales por presunto delito sexual contra niños, niñas y adolescentes",2021,4,30,9983,300.51086847641,0,5011,0,30,4972,603.378921962993
33535,23,23466,121,Tasa de exámenes médico legales por presunto delito sexual cuando la víctima está entre 18 y 28 años,2021,5,7,15387,45.4929485929681,1,7433,13.4535180949818,6,7954,75.4337440281619
33536,23,23001,81,"Tasa de exámenes médico legales por presunto delito sexual contra niños, niñas y adolescentes",2021,2,16,41837,38.2436599182542,3,21521,13.9398726824962,13,20316,63.9889742075212
33537,23,23001,81,"Tasa de exámenes médico legales por presunto delito sexual contra niños, niñas y adolescentes",2021,3,57,49254,115.726641491046,7,25201,27.7766755287489,50,24053,207.874277636885
33538,23,23001,81,"Tasa de exámenes médico legales por presunto delito sexual contra niños, niñas y adolescentes",2021,4,145,49267,294.314652810198,5,24887,20.0908104632941,140,24380,574.241181296144
33539,23,23001,121,Tasa de exámenes médico legales por presunto delito sexual cuando la víctima está entre 18 y 28 años,2021,5,26,94450,27.5277924827951,2,46635,4.28862442371609,24,47815,50.193453937049
33540,23,23500,81,"Tasa de exámenes médico legales por presunto delito sexual contra niños, niñas y adolescentes",2021,3,6,3693,162.46953696182,0,1924,0,6,1769,339.174674957603
33541,23,23500,81,"Tasa de exámenes médico legales por presunto delito sexual contra niños, niñas y adolescentes",2021,4,6,3670,163.487738419619,0,1867,0,6,1803,332.778702163062
33542,23,23555,81,"Tasa de exámenes médico legales por presunto delito sexual contra niños, niñas y adolescentes",2021,3,5,6909,72.3693732812274,1,3541,28.2406099971759,4,3368,118.764845605701
33543,23,23555,81,"Tasa de exámenes médico legales por presunto delito sexual contra niños, niñas y adolescentes",2021,4,10,6938,144.133756125685,2,3542,56.4652738565782,8,3396,235.571260306243
33544,23,23555,121,Tasa de exámenes médico legales por presunto delito sexual cuando la víctima está entre 18 y 28 años,2021,5,1,11131,8.98391878537418,0,5485,0,1,5646,17.7116542685087
33545,23,23570,81,"Tasa de exámenes médico legales por presunto delito sexual contra niños, niñas y adolescentes",2021,2,1,3292,30.3766707168894,0,1676,0,1,1616,61.8811881188119
33546,23,23570,81,"Tasa de exámenes médico legales por presunto delito sexual contra niños, niñas y adolescentes",2021,3,1,4025,24.8447204968944,0,2043,0,1,1982,50.4540867810293
33547,23,23570,81,"Tasa de exámenes médico legales por presunto delito sexual contra niños, niñas y adolescentes",2021,4,4,4042,98.9609104403761,0,2063,0,4,1979,202.122283981809
33548,23,23570,121,Tasa de exámenes médico legales por presunto delito sexual cuando la víctima está entre 18 y 28 años,2021,5,1,6492,15.4035736290819,1,3346,29.8864315600717,0,3146,0
33549,23,23574,81,"Tasa de exámenes médico legales por presunto delito sexual contra niños, niñas y adolescentes",2021,3,2,2856,70.0280112044818,0,1482,0,2,1374,145.560407569141
33550,23,23574,81,"Tasa de exámenes médico legales por presunto delito sexual contra niños, niñas y adolescentes",2021,4,5,2870,174.216027874564,0,1517,0,5,1353,369.549150036955
33551,23,23580,81,"Tasa de exámenes médico legales por presunto delito sexual contra niños, niñas y adolescentes",2021,3,2,5745,34.8128807658834,0,2963,0,2,2782,71.8907260963336
33552,23,23580,81,"Tasa de exámenes médico legales por presunto delito sexual contra niños, niñas y adolescentes",2021,4,2,5255,38.0589914367269,0,2729,0,2,2526,79.1765637371338
33553,23,23580,121,Tasa de exámenes médico legales por presunto delito sexual cuando la víctima está entre 18 y 28 años,2021,5,1,7876,12.6968004062976,0,3956,0,1,3920,25.5102040816327
33554,23,23586,81,"Tasa de exámenes médico legales por presunto delito sexual contra niños, niñas y adolescentes",2021,2,1,1582,63.2111251580278,0,835,0,1,747,133.868808567604
33555,23,23586,81,"Tasa de exámenes médico legales por presunto delito sexual contra niños, niñas y adolescentes",2021,3,1,1837,54.4365813826892,0,964,0,1,873,114.54753722795
33556,23,23586,81,"Tasa de exámenes médico legales por presunto delito sexual contra niños, niñas y adolescentes",2021,4,1,1796,55.6792873051225,0,935,0,1,861,116.144018583043
33557,23,23660,81,"Tasa de exámenes médico legales por presunto delito sexual contra niños, niñas y adolescentes",2021,2,8,8782,91.0954224550216,1,4460,22.4215246636771,7,4322,161.96205460435
33558,23,23660,81,"Tasa de exámenes médico legales por presunto delito sexual contra niños, niñas y adolescentes",2021,3,20,10757,185.925443896997,4,5485,72.926162260711,16,5272,303.490136570561
33559,23,23660,81,"Tasa de exámenes médico legales por presunto delito sexual contra niños, niñas y adolescentes",2021,4,30,10938,274.273176083379,3,5576,53.8020086083214,27,5362,503.543453935099
33560,23,23660,121,Tasa de exámenes médico legales por presunto delito sexual cuando la víctima está entre 18 y 28 años,2021,5,2,19042,10.5030984140321,0,9493,0,2,9549,20.9446015289559
33561,23,23670,81,"Tasa de exámenes médico legales por presunto delito sexual contra niños, niñas y adolescentes",2021,2,1,5262,19.0041809198024,0,2717,0,1,2545,39.2927308447937
33562,23,23670,81,"Tasa de exámenes médico legales por presunto delito sexual contra niños, niñas y adolescentes",2021,3,4,5808,68.870523415978,0,2952,0,4,2856,140.056022408964
33563,23,23670,81,"Tasa de exámenes médico legales por presunto delito sexual contra niños, niñas y adolescentes",2021,4,8,5476,146.09203798393,1,2778,35.9971202303816,7,2698,259.451445515196
33564,23,23670,121,Tasa de exámenes médico legales por presunto delito sexual cuando la víctima está entre 18 y 28 años,2021,5,2,9686,20.6483584555028,0,5105,0,2,4581,43.6585898275486
33565,23,23672,81,"Tasa de exámenes médico legales por presunto delito sexual contra niños, niñas y adolescentes",2021,3,1,3933,25.4258835494533,0,2028,0,1,1905,52.49343832021
33566,23,23672,81,"Tasa de exámenes médico legales por presunto delito sexual contra niños, niñas y adolescentes",2021,4,2,3692,54.1711809317443,0,1852,0,2,1840,108.695652173913
33567,23,23675,81,"Tasa de exámenes médico legales por presunto delito sexual contra niños, niñas y adolescentes",2021,3,4,4161,96.1307378034126,2,2165,92.378752886836,2,1996,100.200400801603
33568,23,23675,81,"Tasa de exámenes médico legales por presunto delito sexual contra niños, niñas y adolescentes",2021,4,6,4110,145.985401459854,0,2171,0,6,1939,309.437854564208
33569,23,23675,121,Tasa de exámenes médico legales por presunto delito sexual cuando la víctima está entre 18 y 28 años,2021,5,1,6318,15.8277936055714,0,3161,0,1,3157,31.675641431739
33570,23,23678,81,"Tasa de exámenes médico legales por presunto delito sexual contra niños, niñas y adolescentes",2021,3,2,2930,68.259385665529,0,1500,0,2,1430,139.86013986014
33571,23,23678,81,"Tasa de exámenes médico legales por presunto delito sexual contra niños, niñas y adolescentes",2021,4,3,2902,103.376981392143,0,1472,0,3,1430,209.79020979021
33572,23,23678,121,Tasa de exámenes médico legales por presunto delito sexual cuando la víctima está entre 18 y 28 años,2021,5,1,4555,21.953896816685,0,2298,0,1,2257,44.3066016836509
33573,23,23682,81,"Tasa de exámenes médico legales por presunto delito sexual contra niños, niñas y adolescentes",2021,3,1,1920,52.0833333333333,0,1003,0,1,917,109.051254089422
33574,23,23682,81,"Tasa de exámenes médico legales por presunto delito sexual contra niños, niñas y adolescentes",2021,4,1,1778,56.2429696287964,1,924,108.225108225108,0,854,0
33575,23,23686,81,"Tasa de exámenes médico legales por presunto delito sexual contra niños, niñas y adolescentes",2021,2,1,3901,25.6344527044348,0,2018,0,1,1883,53.1067445565587
33576,23,23686,81,"Tasa de exámenes médico legales por presunto delito sexual contra niños, niñas y adolescentes",2021,3,5,4856,102.965403624382,4,2528,158.227848101266,1,2328,42.9553264604811
33577,23,23686,81,"Tasa de exámenes médico legales por presunto delito sexual contra niños, niñas y adolescentes",2021,4,3,5068,59.1949486977111,0,2638,0,3,2430,123.456790123457
33578,23,23686,121,Tasa de exámenes médico legales por presunto delito sexual cuando la víctima está entre 18 y 28 años,2021,5,3,8949,33.5232986925914,1,4590,21.7864923747277,2,4359,45.8820830465703
33579,23,23807,81,"Tasa de exámenes médico legales por presunto delito sexual contra niños, niñas y adolescentes",2021,4,3,11250,26.6666666666667,0,5677,0,3,5573,53.8309707518392
33580,23,23807,121,Tasa de exámenes médico legales por presunto delito sexual cuando la víctima está entre 18 y 28 años,2021,5,1,17346,5.7650178715554,0,8754,0,1,8592,11.6387337057728
33581,23,23815,81,"Tasa de exámenes médico legales por presunto delito sexual contra niños, niñas y adolescentes",2021,3,1,7550,13.2450331125828,1,3905,25.6081946222791,0,3645,0
33582,23,23815,81,"Tasa de exámenes médico legales por presunto delito sexual contra niños, niñas y adolescentes",2021,4,7,6698,104.508808599582,0,3418,0,7,3280,213.414634146341
33583,23,23815,121,Tasa de exámenes médico legales por presunto delito sexual cuando la víctima está entre 18 y 28 años,2021,5,1,11301,8.8487744447394,1,5765,17.3460537727667,0,5536,0
33584,23,23855,81,"Tasa de exámenes médico legales por presunto delito sexual contra niños, niñas y adolescentes",2021,4,2,4235,47.2255017709563,0,2204,0,2,2031,98.4736582964057
33585,23,23855,121,Tasa de exámenes médico legales por presunto delito sexual cuando la víctima está entre 18 y 28 años,2021,5,2,5942,33.6587007741501,2,2875,69.5652173913044,0,3067,0
33586,25,25001,81,"Tasa de exámenes médico legales por presunto delito sexual contra niños, niñas y adolescentes",2021,3,1,915,109.289617486339,1,482,207.46887966805,0,433,0
33587,25,25001,81,"Tasa de exámenes médico legales por presunto delito sexual contra niños, niñas y adolescentes",2021,4,4,1000,400,0,512,0,4,488,819.672131147541
33588,25,25001,121,Tasa de exámenes médico legales por presunto delito sexual cuando la víctima está entre 18 y 28 años,2021,5,2,1668,119.904076738609,0,826,0,2,842,237.529691211401
33589,25,25019,81,"Tasa de exámenes médico legales por presunto delito sexual contra niños, niñas y adolescentes",2021,3,5,608,822.368421052632,1,312,320.512820512821,4,296,1351.35135135135
33590,25,25019,81,"Tasa de exámenes médico legales por presunto delito sexual contra niños, niñas y adolescentes",2021,4,1,663,150.829562594268,0,345,0,1,318,314.465408805032
33591,25,25019,121,Tasa de exámenes médico legales por presunto delito sexual cuando la víctima está entre 18 y 28 años,2021,5,2,1273,157.109190887667,0,675,0,2,598,334.448160535117
33592,25,25035,81,"Tasa de exámenes médico legales por presunto delito sexual contra niños, niñas y adolescentes",2021,3,3,1385,216.606498194946,0,702,0,3,683,439.238653001464
33593,25,25035,81,"Tasa de exámenes médico legales por presunto delito sexual contra niños, niñas y adolescentes",2021,4,5,1387,360.490266762797,1,711,140.646976090014,4,676,591.715976331361
33594,25,25035,121,Tasa de exámenes médico legales por presunto delito sexual cuando la víctima está entre 18 y 28 años,2021,5,2,2560,78125,0,1285,0,2,1275,156.862745098039
33595,25,25599,81,"Tasa de exámenes médico legales por presunto delito sexual contra niños, niñas y adolescentes",2021,4,2,779,256.739409499358,1,411,243.30900243309,1,368,271.739130434783
33596,25,25053,81,"Tasa de exámenes médico legales por presunto delito sexual contra niños, niñas y adolescentes",2021,3,6,926,647.948164146868,4,461,867.67895878525,2,465,430.10752688172
33597,25,25053,121,Tasa de exámenes médico legales por presunto delito sexual cuando la víctima está entre 18 y 28 años,2021,5,1,1608,62.1890547263682,0,848,0,1,760,131.578947368421
33598,25,25086,81,"Tasa de exámenes médico legales por presunto delito sexual contra niños, niñas y adolescentes",2021,3,1,178,561.797752808989,0,95,0,1,83,1204.81927710843
33599,25,25095,81,"Tasa de exámenes médico legales por presunto delito sexual contra niños, niñas y adolescentes",2021,4,1,199,502.51256281407,0,106,0,1,93,1075.2688172043
33600,25,25095,121,Tasa de exámenes médico legales por presunto delito sexual cuando la víctima está entre 18 y 28 años,2021,5,1,278,359.712230215827,0,151,0,1,127,787.40157480315
33601,25,25099,81,"Tasa de exámenes médico legales por presunto delito sexual contra niños, niñas y adolescentes",2021,3,1,1103,90.6618313689937,0,554,0,1,549,182.149362477231
33602,25,25099,81,"Tasa de exámenes médico legales por presunto delito sexual contra niños, niñas y adolescentes",2021,4,1,1205,82.9875518672199,0,617,0,1,588,170.068027210884
33603,25,25099,121,Tasa de exámenes médico legales por presunto delito sexual cuando la víctima está entre 18 y 28 años,2021,5,1,2238,44.6827524575514,1,1138,87.8734622144113,0,1100,0
33604,25,25120,81,"Tasa de exámenes médico legales por presunto delito sexual contra niños, niñas y adolescentes",2021,2,1,495,202.020202020202,0,272,0,1,223,448.430493273543
33605,25,25123,81,"Tasa de exámenes médico legales por presunto delito sexual contra niños, niñas y adolescentes",2021,2,4,794,503.778337531486,2,369,542.005420054201,2,425,470.588235294118
33606,25,25123,81,"Tasa de exámenes médico legales por presunto delito sexual contra niños, niñas y adolescentes",2021,4,5,948,527.426160337553,0,503,0,5,445,1123.59550561798
33607,25,25123,121,Tasa de exámenes médico legales por presunto delito sexual cuando la víctima está entre 18 y 28 años,2021,5,3,1533,195.694716242661,0,805,0,3,728,412.087912087912
33608,25,25126,81,"Tasa de exámenes médico legales por presunto delito sexual contra niños, niñas y adolescentes",2021,2,10,7361,135.851107186524,2,3715,53.835800807537,8,3646,219.418540866703
33609,25,25126,81,"Tasa de exámenes médico legales por presunto delito sexual contra niños, niñas y adolescentes",2021,3,7,8515,82.2078684674105,2,4391,45.5477112275108,5,4124,121.241513094083
33610,25,25126,81,"Tasa de exámenes médico legales por presunto delito sexual contra niños, niñas y adolescentes",2021,4,20,8571,233.345000583363,6,4440,135.135135135135,14,4131,338.900992495764
33611,25,25126,121,Tasa de exámenes médico legales por presunto delito sexual cuando la víctima está entre 18 y 28 años,2021,5,3,17210,17.4317257408483,0,8436,0,3,8774,34.1919307043538
33612,25,25148,81,"Tasa de exámenes médico legales por presunto delito sexual contra niños, niñas y adolescentes",2021,2,8,829,965.018094089264,3,410,731.707317073171,5,419,1193.31742243437
33613,25,25148,81,"Tasa de exámenes médico legales por presunto delito sexual contra niños, niñas y adolescentes",2021,3,14,1153,1214.22376409367,4,596,671.140939597315,10,557,1795.33213644524
33614,25,25148,81,"Tasa de exámenes médico legales por presunto delito sexual contra niños, niñas y adolescentes",2021,4,26,1216,2138.15789473684,5,644,776.39751552795,21,572,3671.32867132867
33615,25,25148,121,Tasa de exámenes médico legales por presunto delito sexual cuando la víctima está entre 18 y 28 años,2021,5,2,1684,118.764845605701,0,899,0,2,785,254.777070063694
33616,25,25151,81,"Tasa de exámenes médico legales por presunto delito sexual contra niños, niñas y adolescentes",2021,2,2,1512,132.275132275132,1,809,123.609394313968,1,703,142.247510668563
33617,25,25151,81,"Tasa de exámenes médico legales por presunto delito sexual contra niños, niñas y adolescentes",2021,3,6,1753,342.270393610953,3,927,323.624595469256,3,826,363.19612590799
33618,25,25151,81,"Tasa de exámenes médico legales por presunto delito sexual contra niños, niñas y adolescentes",2021,4,6,1690,355.029585798817,0,876,0,6,814,737.100737100737
33619,25,25154,81,"Tasa de exámenes médico legales por presunto delito sexual contra niños, niñas y adolescentes",2021,2,1,656,152.439024390244,1,346,289.017341040462,0,310,0
33620,25,25154,81,"Tasa de exámenes médico legales por presunto delito sexual contra niños, niñas y adolescentes",2021,3,1,820,121.951219512195,0,431,0,1,389,257.06940874036
33621,25,25154,121,Tasa de exámenes médico legales por presunto delito sexual cuando la víctima está entre 18 y 28 años,2021,5,2,1303,153.491941673062,0,663,0,2,640,312.5
33622,25,25168,81,"Tasa de exámenes médico legales por presunto delito sexual contra niños, niñas y adolescentes",2021,3,4,369,1084.0108401084,0,194,0,4,175,2285.71428571429
33623,25,25168,81,"Tasa de exámenes médico legales por presunto delito sexual contra niños, niñas y adolescentes",2021,4,4,378,1058.20105820106,0,207,0,4,171,2339.18128654971
33624,25,25175,81,"Tasa de exámenes médico legales por presunto delito sexual contra niños, niñas y adolescentes",2021,2,8,9474,84.4416297234537,5,4829,103.54110581901,3,4645,64.5855758880517
33625,25,25175,81,"Tasa de exámenes médico legales por presunto delito sexual contra niños, niñas y adolescentes",2021,3,11,12197,90.1861113388538,0,6265,0,11,5932,185.434929197572
33626,25,25175,81,"Tasa de exámenes médico legales por presunto delito sexual contra niños, niñas y adolescentes",2021,4,34,13881,244.93912542324,5,7148,69.9496362618914,29,6733,430.714391801574
33627,25,25175,121,Tasa de exámenes médico legales por presunto delito sexual cuando la víctima está entre 18 y 28 años,2021,5,13,28953,44.9003557489725,0,14594,0,13,14359,90.5355526150846
33628,25,25178,81,"Tasa de exámenes médico legales por presunto delito sexual contra niños, niñas y adolescentes",2021,2,1,866,115.473441108545,0,450,0,1,416,240.384615384615
33629,25,25178,81,"Tasa de exámenes médico legales por presunto delito sexual contra niños, niñas y adolescentes",2021,3,2,1007,198.609731876862,0,517,0,2,490,408.163265306122
33630,25,25178,81,"Tasa de exámenes médico legales por presunto delito sexual contra niños, niñas y adolescentes",2021,4,3,985,304.568527918782,0,505,0,3,480,625
33631,25,25181,81,"Tasa de exámenes médico legales por presunto delito sexual contra niños, niñas y adolescentes",2021,2,1,791,126.422250316056,0,433,0,1,358,279.329608938548
33632,25,25181,81,"Tasa de exámenes médico legales por presunto delito sexual contra niños, niñas y adolescentes",2021,4,6,1117,537.15308863026,3,548,547.445255474453,3,569,527.240773286468
33633,25,25181,121,Tasa de exámenes médico legales por presunto delito sexual cuando la víctima está entre 18 y 28 años,2021,5,1,1787,55.9597090095132,0,881,0,1,906,110.37527593819
33634,25,25183,81,"Tasa de exámenes médico legales por presunto delito sexual contra niños, niñas y adolescentes",2021,2,1,2043,48.9476260401371,0,1038,0,1,1005,99.5024875621891
33635,25,25183,81,"Tasa de exámenes médico legales por presunto delito sexual contra niños, niñas y adolescentes",2021,3,2,2450,81.6326530612245,1,1256,79.6178343949045,1,1194,83.7520938023451
33636,25,25183,81,"Tasa de exámenes médico legales por presunto delito sexual contra niños, niñas y adolescentes",2021,4,7,2446,286.181520850368,0,1245,0,7,1201,582.847626977519
33637,25,25183,121,Tasa de exámenes médico legales por presunto delito sexual cuando la víctima está entre 18 y 28 años,2021,5,1,4185,23.89486260454,0,2102,0,1,2083,48.0076812289966
33638,25,25200,81,"Tasa de exámenes médico legales por presunto delito sexual contra niños, niñas y adolescentes",2021,2,1,2066,48.402710551790904,0,1040,0,1,1026,97.4658869395712
33639,25,25200,81,"Tasa de exámenes médico legales por presunto delito sexual contra niños, niñas y adolescentes",2021,4,3,2419,124.018189334436,0,1224,0,3,1195,251.046025104603
33640,25,25200,121,Tasa de exámenes médico legales por presunto delito sexual cuando la víctima está entre 18 y 28 años,2021,5,1,4552,21.9683655536028,0,2316,0,1,2236,44.7227191413238
33641,25,25214,81,"Tasa de exámenes médico legales por presunto delito sexual contra niños, niñas y adolescentes",2021,2,1,2704,36.9822485207101,0,1408,0,1,1296,77.1604938271605
33642,25,25214,81,"Tasa de exámenes médico legales por presunto delito sexual contra niños, niñas y adolescentes",2021,3,2,3493,57.2573718866304,0,1861,0,2,1632,122.549019607843
33643,25,25214,81,"Tasa de exámenes médico legales por presunto delito sexual contra niños, niñas y adolescentes",2021,4,6,3774,158.982511923688,3,2012,149.105367793241,3,1762,170.261066969353
33644,25,25214,121,Tasa de exámenes médico legales por presunto delito sexual cuando la víctima está entre 18 y 28 años,2021,5,3,7053,42.5350914504466,0,3518,0,3,3535,84.8656294200849
33645,25,25224,81,"Tasa de exámenes médico legales por presunto delito sexual contra niños, niñas y adolescentes",2021,2,1,961,104.058272632674,0,505,0,1,456,219.298245614035
33646,25,25224,81,"Tasa de exámenes médico legales por presunto delito sexual contra niños, niñas y adolescentes",2021,3,1,961,104.058272632674,0,507,0,1,454,220.264317180617
33647,25,25224,81,"Tasa de exámenes médico legales por presunto delito sexual contra niños, niñas y adolescentes",2021,4,3,814,368.550368550369,0,425,0,3,389,771.20822622108
33648,25,25224,121,Tasa de exámenes médico legales por presunto delito sexual cuando la víctima está entre 18 y 28 años,2021,5,2,1444,138.504155124654,0,686,0,2,758,263.852242744063
33649,25,25245,81,"Tasa de exámenes médico legales por presunto delito sexual contra niños, niñas y adolescentes",2021,2,2,1707,117.164616285882,0,843,0,2,864,231.481481481481
33650,25,25245,81,"Tasa de exámenes médico legales por presunto delito sexual contra niños, niñas y adolescentes",2021,3,5,2234,223.813786929275,2,1139,175.592625109745,3,1095,273.972602739726
33651,25,25245,81,"Tasa de exámenes médico legales por presunto delito sexual contra niños, niñas y adolescentes",2021,4,9,2299,391.47455415398,2,1203,166.251039068994,7,1096,638.686131386861
33652,25,25245,121,Tasa de exámenes médico legales por presunto delito sexual cuando la víctima está entre 18 y 28 años,2021,5,2,3602,55.5247084952804,0,1820,0,2,1782,112.233445566779
33653,25,25260,81,"Tasa de exámenes médico legales por presunto delito sexual contra niños, niñas y adolescentes",2021,3,1,2618,38.1970970206264,0,1354,0,1,1264,79.1139240506329
33654,25,25260,81,"Tasa de exámenes médico legales por presunto delito sexual contra niños, niñas y adolescentes",2021,4,5,2658,188.11136192626,0,1330,0,5,1328,376.506024096386
33655,25,25260,121,Tasa de exámenes médico legales por presunto delito sexual cuando la víctima está entre 18 y 28 años,2021,5,2,5766,34.6860908775581,0,2893,0,2,2873,69.6136442742778
33656,25,25269,81,"Tasa de exámenes médico legales por presunto delito sexual contra niños, niñas y adolescentes",2021,2,5,12002,41.6597233794368,0,6072,0,5,5930,84.3170320404722
33657,25,25269,81,"Tasa de exámenes médico legales por presunto delito sexual contra niños, niñas y adolescentes",2021,3,16,14480,110.497237569061,3,7311,41.0340582683627,13,7169,181.336309108662
33658,25,25269,81,"Tasa de exámenes médico legales por presunto delito sexual contra niños, niñas y adolescentes",2021,4,37,15383,240.525255151791,5,7811,64.0122903597491,32,7572,422.609614368727
33659,25,25269,121,Tasa de exámenes médico legales por presunto delito sexual cuando la víctima está entre 18 y 28 años,2021,5,6,33385,17.972143178074,1,16873,5.92662834113673,5,16512,30.281007751938
33660,25,25279,81,"Tasa de exámenes médico legales por presunto delito sexual contra niños, niñas y adolescentes",2021,3,2,1254,159.489633173844,0,665,0,2,589,339.55857385399
33661,25,25279,81,"Tasa de exámenes médico legales por presunto delito sexual contra niños, niñas y adolescentes",2021,4,4,1190,336.134453781513,0,636,0,4,554,722.02166064982
33662,25,25281,81,"Tasa de exámenes médico legales por presunto delito sexual contra niños, niñas y adolescentes",2021,2,1,550,181.818181818182,1,268,373.134328358209,0,282,0
33663,25,25281,81,"Tasa de exámenes médico legales por presunto delito sexual contra niños, niñas y adolescentes",2021,4,2,666,300.3003003003,0,346,0,2,320,625
33664,25,25281,121,Tasa de exámenes médico legales por presunto delito sexual cuando la víctima está entre 18 y 28 años,2021,5,1,994,100.603621730382,0,535,0,1,459,217.864923747277
33665,25,25286,81,"Tasa de exámenes médico legales por presunto delito sexual contra niños, niñas y adolescentes",2021,2,2,7932,25.2143217347453,0,3929,0,2,4003,49.9625281039221
33666,25,25286,81,"Tasa de exámenes médico legales por presunto delito sexual contra niños, niñas y adolescentes",2021,3,6,9456,63.4517766497462,0,4761,0,6,4695,127.79552715655
33667,25,25286,81,"Tasa de exámenes médico legales por presunto delito sexual contra niños, niñas y adolescentes",2021,4,11,9773,112.554998465159,1,5003,19.9880071956826,10,4770,209.643605870021
33668,25,25286,121,Tasa de exámenes médico legales por presunto delito sexual cuando la víctima está entre 18 y 28 años,2021,5,2,20780,9.62463907603465,0,10514,0,2,10266,19.4817845314631
33669,25,25288,81,"Tasa de exámenes médico legales por presunto delito sexual contra niños, niñas y adolescentes",2021,2,1,455,219.78021978022,0,245,0,1,210,476.190476190476
33670,25,25288,81,"Tasa de exámenes médico legales por presunto delito sexual contra niños, niñas y adolescentes",2021,4,1,495,202.020202020202,0,244,0,1,251,398.406374501992
33671,25,25290,81,"Tasa de exámenes médico legales por presunto delito sexual contra niños, niñas y adolescentes",2021,2,11,9785,112.416964741952,2,4969,40.2495471925941,9,4816,186.87707641196
33672,25,25290,81,"Tasa de exámenes médico legales por presunto delito sexual contra niños, niñas y adolescentes",2021,3,20,12516,159.795461808885,1,6435,15.5400155400155,19,6081,312.448610425917
33673,25,25290,81,"Tasa de exámenes médico legales por presunto delito sexual contra niños, niñas y adolescentes",2021,4,49,13725,357.012750455373,9,7130,126.227208976157,40,6595,606.520090978014
33674,25,25290,121,Tasa de exámenes médico legales por presunto delito sexual cuando la víctima está entre 18 y 28 años,2021,5,17,26134,65.0493609856891,0,13134,0,17,13000,130.769230769231
33675,25,25293,121,Tasa de exámenes médico legales por presunto delito sexual cuando la víctima está entre 18 y 28 años,2021,5,1,661,151.285930408472,0,357,0,1,304,328.947368421053
33676,25,25295,81,"Tasa de exámenes médico legales por presunto delito sexual contra niños, niñas y adolescentes",2021,2,1,1847,54.1418516513265,1,939,106.496272630458,0,908,0
33677,25,25295,81,"Tasa de exámenes médico legales por presunto delito sexual contra niños, niñas y adolescentes",2021,3,4,2010,199.004975124378,0,1027,0,4,983,406.917599186165
33678,25,25295,81,"Tasa de exámenes médico legales por presunto delito sexual contra niños, niñas y adolescentes",2021,4,3,1942,154.479917610711,0,985,0,3,957,313.479623824451
33679,25,25299,81,"Tasa de exámenes médico legales por presunto delito sexual contra niños, niñas y adolescentes",2021,3,1,313,319.488817891374,1,170,588.235294117647,0,143,0
33680,25,25307,81,"Tasa de exámenes médico legales por presunto delito sexual contra niños, niñas y adolescentes",2021,2,8,7549,105.974301231951,1,3938,25.3936008125952,7,3611,193.852118526724
33681,25,25307,81,"Tasa de exámenes médico legales por presunto delito sexual contra niños, niñas y adolescentes",2021,3,22,8907,246.996744133827,3,4580,65.5021834061135,19,4327,439.103304830136
33682,25,25307,81,"Tasa de exámenes médico legales por presunto delito sexual contra niños, niñas y adolescentes",2021,4,29,9106,318.471337579618,0,4598,0,29,4508,643.300798580302
33683,25,25307,121,Tasa de exámenes médico legales por presunto delito sexual cuando la víctima está entre 18 y 28 años,2021,5,8,18944,42.2297297297297,1,9620,10.3950103950104,7,9324,75.0750750750751
33684,25,25312,81,"Tasa de exámenes médico legales por presunto delito sexual contra niños, niñas y adolescentes",2021,2,1,719,139.082058414465,0,364,0,1,355,281.69014084507
33685,25,25317,81,"Tasa de exámenes médico legales por presunto delito sexual contra niños, niñas y adolescentes",2021,4,2,1460,136.986301369863,0,762,0,2,698,286.532951289398
33686,25,25320,81,"Tasa de exámenes médico legales por presunto delito sexual contra niños, niñas y adolescentes",2021,2,9,2117,425.129900803023,3,1085,276.497695852535,6,1032,581.395348837209
33687,25,25320,81,"Tasa de exámenes médico legales por presunto delito sexual contra niños, niñas y adolescentes",2021,3,20,2617,764.233855559801,5,1353,369.549150036955,15,1264,1186.70886075949
33688,25,25320,81,"Tasa de exámenes médico legales por presunto delito sexual contra niños, niñas y adolescentes",2021,4,25,2660,939.84962406015,4,1387,288.392213410238,21,1273,1649.6465043205
33689,25,25320,121,Tasa de exámenes médico legales por presunto delito sexual cuando la víctima está entre 18 y 28 años,2021,5,2,5814,34.3997248022016,1,3529,28.336639274582,1,2285,43.7636761487965
33690,25,25322,81,"Tasa de exámenes médico legales por presunto delito sexual contra niños, niñas y adolescentes",2021,2,1,1364,73.3137829912023,0,670,0,1,694,144.092219020173
33691,25,25322,81,"Tasa de exámenes médico legales por presunto delito sexual contra niños, niñas y adolescentes",2021,4,3,1698,176.678445229682,0,846,0,3,852,352.112676056338
33692,25,25322,121,Tasa de exámenes médico legales por presunto delito sexual cuando la víctima está entre 18 y 28 años,2021,5,1,3288,30.4136253041363,0,1694,0,1,1594,62.7352572145546
33693,25,25324,81,"Tasa de exámenes médico legales por presunto delito sexual contra niños, niñas y adolescentes",2021,4,1,245,408.163265306122,0,133,0,1,112,892.857142857143
33694,25,25326,81,"Tasa de exámenes médico legales por presunto delito sexual contra niños, niñas y adolescentes",2021,4,3,648,462.962962962963,0,350,0,3,298,1006.71140939597
33695,25,25326,121,Tasa de exámenes médico legales por presunto delito sexual cuando la víctima está entre 18 y 28 años,2021,5,1,1185,84.3881856540084,0,608,0,1,577,173.310225303293
33696,25,25328,81,"Tasa de exámenes médico legales por presunto delito sexual contra niños, niñas y adolescentes",2021,3,2,424,471.698113207547,0,208,0,2,216,925.925925925926
33697,25,25328,81,"Tasa de exámenes médico legales por presunto delito sexual contra niños, niñas y adolescentes",2021,4,2,423,472.813238770686,0,216,0,2,207,966.183574879227
33698,25,25335,81,"Tasa de exámenes médico legales por presunto delito sexual contra niños, niñas y adolescentes",2021,3,2,753,265.604249667995,1,376,265.957446808511,1,377,265.25198938992
33699,25,25335,81,"Tasa de exámenes médico legales por presunto delito sexual contra niños, niñas y adolescentes",2021,4,2,647,309.119010819165,0,323,0,2,324,617.283950617284
33700,25,25339,81,"Tasa de exámenes médico legales por presunto delito sexual contra niños, niñas y adolescentes",2021,3,2,373,536.193029490617,0,186,0,2,187,1069.51871657754
33701,25,25339,81,"Tasa de exámenes médico legales por presunto delito sexual contra niños, niñas y adolescentes",2021,4,3,373,804.289544235925,0,196,0,3,177,1694.91525423729
33702,25,25368,81,"Tasa de exámenes médico legales por presunto delito sexual contra niños, niñas y adolescentes",2021,4,1,183,546.448087431694,0,107,0,1,76,1315.78947368421
33703,25,25368,121,Tasa de exámenes médico legales por presunto delito sexual cuando la víctima está entre 18 y 28 años,2021,5,1,273,366.300366300366,0,140,0,1,133,751.87969924812
33704,25,25377,81,"Tasa de exámenes médico legales por presunto delito sexual contra niños, niñas y adolescentes",2021,3,1,2788,35.8680057388809,0,1415,0,1,1373,72.8332119446468
33705,25,25377,81,"Tasa de exámenes médico legales por presunto delito sexual contra niños, niñas y adolescentes",2021,4,8,2971,269.269606193201,0,1516,0,8,1455,549.828178694158
33706,25,25377,121,Tasa de exámenes médico legales por presunto delito sexual cuando la víctima está entre 18 y 28 años,2021,5,3,5887,50.9597418039749,0,2981,0,3,2906,103.234686854783
33707,25,25386,81,"Tasa de exámenes médico legales por presunto delito sexual contra niños, niñas y adolescentes",2021,3,15,2998,500.333555703803,0,1552,0,15,1446,1037.34439834025
33708,25,25386,81,"Tasa de exámenes médico legales por presunto delito sexual contra niños, niñas y adolescentes",2021,4,16,3007,532.091785833056,0,1569,0,16,1438,1112.65646731572
33709,25,25386,121,Tasa de exámenes médico legales por presunto delito sexual cuando la víctima está entre 18 y 28 años,2021,5,4,5400,74.0740740740741,0,2740,0,4,2660,150.375939849624
33710,25,25394,81,"Tasa de exámenes médico legales por presunto delito sexual contra niños, niñas y adolescentes",2021,4,2,819,244.200244200244,0,441,0,2,378,529.100529100529
33711,25,25398,81,"Tasa de exámenes médico legales por presunto delito sexual contra niños, niñas y adolescentes",2021,3,3,494,607.287449392713,0,264,0,3,230,1304.34782608696
33712,25,25398,81,"Tasa de exámenes médico legales por presunto delito sexual contra niños, niñas y adolescentes",2021,4,2,531,376.647834274953,0,276,0,2,255,784.313725490196
33713,25,25402,81,"Tasa de exámenes médico legales por presunto delito sexual contra niños, niñas y adolescentes",2021,2,3,1435,209.059233449477,1,716,139.664804469274,2,719,278.164116828929
33714,25,25402,81,"Tasa de exámenes médico legales por presunto delito sexual contra niños, niñas y adolescentes",2021,3,5,1725,289.855072463768,1,868,115.207373271889,4,857,466.744457409568
33715,25,25402,81,"Tasa de exámenes médico legales por presunto delito sexual contra niños, niñas y adolescentes",2021,4,10,1713,583.771161704612,1,879,113.765642775882,9,834,1079.13669064748
33716,25,25402,121,Tasa de exámenes médico legales por presunto delito sexual cuando la víctima está entre 18 y 28 años,2021,5,4,2910,137.45704467354,0,1418,0,4,1492,268.096514745308
33717,25,25407,81,"Tasa de exámenes médico legales por presunto delito sexual contra niños, niñas y adolescentes",2021,4,3,1088,275.735294117647,1,563,177.619893428064,2,525,380.952380952381
33718,25,25407,121,Tasa de exámenes médico legales por presunto delito sexual cuando la víctima está entre 18 y 28 años,2021,5,3,1907,157.315154693235,1,975,102.564102564103,2,932,214.592274678112
33719,25,25426,81,"Tasa de exámenes médico legales por presunto delito sexual contra niños, niñas y adolescentes",2021,3,2,519,385.356454720617,0,261,0,2,258,775.193798449612
33720,25,25426,81,"Tasa de exámenes médico legales por presunto delito sexual contra niños, niñas y adolescentes",2021,4,4,583,686.106346483705,0,306,0,4,277,1444.04332129964
33721,25,25426,121,Tasa de exámenes médico legales por presunto delito sexual cuando la víctima está entre 18 y 28 años,2021,5,1,890,112.359550561798,0,498,0,1,392,255.102040816327
33722,25,25430,81,"Tasa de exámenes médico legales por presunto delito sexual contra niños, niñas y adolescentes",2021,2,7,10967,63.8278471778973,4,5582,71.6589036187746,3,5385,55.7103064066852
33723,25,25430,81,"Tasa de exámenes médico legales por presunto delito sexual contra niños, niñas y adolescentes",2021,3,8,12339,64.8350757759948,2,6237,32.0666987333654,6,6102,98.3284169124877
33724,25,25430,81,"Tasa de exámenes médico legales por presunto delito sexual contra niños, niñas y adolescentes",2021,4,21,12043,174.375155692103,2,6055,33.0305532617671,19,5988,317.301269205077
33725,25,25430,121,Tasa de exámenes médico legales por presunto delito sexual cuando la víctima está entre 18 y 28 años,2021,5,5,26878,18.6025745963241,0,13441,0,5,13437,37.2106869092804
33726,25,25430,81,"Tasa de exámenes médico legales por presunto delito sexual contra niños, niñas y adolescentes",2021,1,1,2089,47.8697941598851,0,1067,0,1,1022,97.8473581213307
33727,25,25436,81,"Tasa de exámenes médico legales por presunto delito sexual contra niños, niñas y adolescentes",2021,3,1,274,364.963503649635,0,150,0,1,124,806.451612903226
33728,25,25438,81,"Tasa de exámenes médico legales por presunto delito sexual contra niños, niñas y adolescentes",2021,2,1,754,132.62599469496,1,408,245.098039215686,0,346,0
33729,25,25438,81,"Tasa de exámenes médico legales por presunto delito sexual contra niños, niñas y adolescentes",2021,3,2,927,215.749730312837,0,495,0,2,432,462.962962962963
33730,25,25438,81,"Tasa de exámenes médico legales por presunto delito sexual contra niños, niñas y adolescentes",2021,4,9,893,1007.83874580067,0,479,0,9,414,2173.91304347826
33731,25,25438,121,Tasa de exámenes médico legales por presunto delito sexual cuando la víctima está entre 18 y 28 años,2021,5,2,1332,150.15015015015,0,708,0,2,624,320.512820512821
33732,25,25473,81,"Tasa de exámenes médico legales por presunto delito sexual contra niños, niñas y adolescentes",2021,2,2,12120,16.5016501650165,0,6215,0,2,5905,33.8696020321761
33733,25,25473,81,"Tasa de exámenes médico legales por presunto delito sexual contra niños, niñas y adolescentes",2021,3,6,14206,42.2356750668732,2,7266,27.5254610514726,4,6940,57.6368876080692
33734,25,25473,81,"Tasa de exámenes médico legales por presunto delito sexual contra niños, niñas y adolescentes",2021,4,20,14457,138.341287957391,0,7318,0,20,7139,280.151281692114
33735,25,25473,121,Tasa de exámenes médico legales por presunto delito sexual cuando la víctima está entre 18 y 28 años,2021,5,2,31381,6.37328319683885,0,15565,0,2,15816,12.6454223571067
33736,25,25483,81,"Tasa de exámenes médico legales por presunto delito sexual contra niños, niñas y adolescentes",2021,4,1,211,473.9336492891,0,118,0,1,93,1075.2688172043
33737,25,25486,81,"Tasa de exámenes médico legales por presunto delito sexual contra niños, niñas y adolescentes",2021,2,2,1572,127.226463104326,1,824,121.359223300971,1,748,133.689839572193
33738,25,25486,81,"Tasa de exámenes médico legales por presunto delito sexual contra niños, niñas y adolescentes",2021,3,3,1643,182.592818015825,0,838,0,3,805,372.670807453416
33739,25,25486,81,"Tasa de exámenes médico legales por presunto delito sexual contra niños, niñas y adolescentes",2021,4,6,1519,394.996708360764,1,754,132.62599469496,5,765,653.59477124183
33740,25,25486,121,Tasa de exámenes médico legales por presunto delito sexual cuando la víctima está entre 18 y 28 años,2021,5,2,2955,67.6818950930626,0,1449,0,2,1506,132.802124833997
33741,25,25488,81,"Tasa de exámenes médico legales por presunto delito sexual contra niños, niñas y adolescentes",2021,3,2,863,231.749710312862,0,449,0,2,414,483.091787439614
33742,25,25488,81,"Tasa de exámenes médico legales por presunto delito sexual contra niños, niñas y adolescentes",2021,4,1,810,123.456790123457,0,450,0,1,360,277.777777777778
33743,25,25489,81,"Tasa de exámenes médico legales por presunto delito sexual contra niños, niñas y adolescentes",2021,3,2,292,684.931506849315,0,158,0,2,134,1492.53731343284
33744,25,25489,81,"Tasa de exámenes médico legales por presunto delito sexual contra niños, niñas y adolescentes",2021,4,1,308,324.675324675325,0,173,0,1,135,740.740740740741
33745,25,25489,121,Tasa de exámenes médico legales por presunto delito sexual cuando la víctima está entre 18 y 28 años,2021,5,1,501,199.600798403194,1,257,389.105058365759,0,244,0
33746,25,25491,81,"Tasa de exámenes médico legales por presunto delito sexual contra niños, niñas y adolescentes",2021,2,1,503,198.807157057654,0,237,0,1,266,375.93984962406
33747,25,25491,81,"Tasa de exámenes médico legales por presunto delito sexual contra niños, niñas y adolescentes",2021,3,1,540,185.185185185185,0,269,0,1,271,369.0036900369
33748,25,25491,81,"Tasa de exámenes médico legales por presunto delito sexual contra niños, niñas y adolescentes",2021,4,1,517,193.423597678917,0,276,0,1,241,414.9377593361
33749,25,25491,121,Tasa de exámenes médico legales por presunto delito sexual cuando la víctima está entre 18 y 28 años,2021,5,1,888,112.612612612613,0,462,0,1,426,234.741784037559
33750,25,25513,81,"Tasa de exámenes médico legales por presunto delito sexual contra niños, niñas y adolescentes",2021,3,1,2422,41.2881915772089,0,1236,0,1,1186,84.3170320404722
33751,25,25513,81,"Tasa de exámenes médico legales por presunto delito sexual contra niños, niñas y adolescentes",2021,4,6,2520,238.095238095238,2,1321,151.400454201363,4,1199,333.611342785655
33752,25,25513,121,Tasa de exámenes médico legales por presunto delito sexual cuando la víctima está entre 18 y 28 años,2021,5,1,3921,25.5036980362153,0,1957,0,1,1964,50.9164969450102
33753,25,25524,81,"Tasa de exámenes médico legales por presunto delito sexual contra niños, niñas y adolescentes",2021,3,5,501,998.003992015968,0,277,0,5,224,2232.14285714286
33754,25,25524,81,"Tasa de exámenes médico legales por presunto delito sexual contra niños, niñas y adolescentes",2021,4,4,493,811.359026369168,0,285,0,4,208,1923.07692307692
33755,25,25530,81,"Tasa de exámenes médico legales por presunto delito sexual contra niños, niñas y adolescentes",2021,2,2,978,204.498977505113,0,514,0,2,464,431.034482758621
33756,25,25530,81,"Tasa de exámenes médico legales por presunto delito sexual contra niños, niñas y adolescentes",2021,3,2,1115,179.372197309417,0,564,0,2,551,362.976406533575
33757,25,25530,81,"Tasa de exámenes médico legales por presunto delito sexual contra niños, niñas y adolescentes",2021,4,3,1033,290.416263310745,0,503,0,3,530,566.037735849057
33758,25,25530,121,Tasa de exámenes médico legales por presunto delito sexual cuando la víctima está entre 18 y 28 años,2021,5,1,1728,57.8703703703704,0,862,0,1,866,115.473441108545
33759,25,25535,81,"Tasa de exámenes médico legales por presunto delito sexual contra niños, niñas y adolescentes",2021,3,5,968,516.528925619835,3,506,592.885375494071,2,462,432.900432900433
33760,25,25535,81,"Tasa de exámenes médico legales por presunto delito sexual contra niños, niñas y adolescentes",2021,4,2,1046,191.204588910134,0,536,0,2,510,392.156862745098
33761,25,25572,81,"Tasa de exámenes médico legales por presunto delito sexual contra niños, niñas y adolescentes",2021,2,1,1315,76.0456273764259,0,647,0,1,668,149.700598802395
33762,25,25572,81,"Tasa de exámenes médico legales por presunto delito sexual contra niños, niñas y adolescentes",2021,4,2,1554,128.700128700129,2,810,246.913580246914,0,744,0
33763,25,25572,121,Tasa de exámenes médico legales por presunto delito sexual cuando la víctima está entre 18 y 28 años,2021,5,1,3145,31.7965023847377,0,1738,0,1,1407,71.0732054015636
33764,25,25580,81,"Tasa de exámenes médico legales por presunto delito sexual contra niños, niñas y adolescentes",2021,4,1,325,307.692307692308,0,161,0,1,164,609.756097560976
33765,25,25592,81,"Tasa de exámenes médico legales por presunto delito sexual contra niños, niñas y adolescentes",2021,4,2,419,477.326968973747,0,204,0,2,215,930.232558139535
33766,25,25594,81,"Tasa de exámenes médico legales por presunto delito sexual contra niños, niñas y adolescentes",2021,4,2,548,364.963503649635,0,291,0,2,257,778.210116731518
33767,25,25594,121,Tasa de exámenes médico legales por presunto delito sexual cuando la víctima está entre 18 y 28 años,2021,5,1,953,104.931794333683,0,479,0,1,474,210.970464135021
33768,25,25596,81,"Tasa de exámenes médico legales por presunto delito sexual contra niños, niñas y adolescentes",2021,4,4,555,720.720720720721,0,279,0,4,276,1449.27536231884
33769,25,25596,121,Tasa de exámenes médico legales por presunto delito sexual cuando la víctima está entre 18 y 28 años,2021,5,1,734,136.239782016349,0,393,0,1,341,293.255131964809
33770,25,25612,81,"Tasa de exámenes médico legales por presunto delito sexual contra niños, niñas y adolescentes",2021,3,1,1323,75.5857898715042,0,684,0,1,639,156.494522691706
33771,25,25612,81,"Tasa de exámenes médico legales por presunto delito sexual contra niños, niñas y adolescentes",2021,4,3,1254,239.234449760766,0,636,0,3,618,485.436893203883
33772,25,25612,121,Tasa de exámenes médico legales por presunto delito sexual cuando la víctima está entre 18 y 28 años,2021,5,2,2415,82.815734989648,0,1177,0,2,1238,161.550888529887
33773,25,25645,81,"Tasa de exámenes médico legales por presunto delito sexual contra niños, niñas y adolescentes",2021,3,1,1103,90.6618313689937,0,562,0,1,541,184.842883548983
33774,25,25645,81,"Tasa de exámenes médico legales por presunto delito sexual contra niños, niñas y adolescentes",2021,4,4,1122,356.50623885918,1,577,173.310225303293,3,545,550.45871559633
33775,25,25645,121,Tasa de exámenes médico legales por presunto delito sexual cuando la víctima está entre 18 y 28 años,2021,5,2,1784,112.107623318386,0,881,0,2,903,221.483942414175
33776,25,25649,81,"Tasa de exámenes médico legales por presunto delito sexual contra niños, niñas y adolescentes",2021,2,1,815,122.699386503067,0,422,0,1,393,254.452926208651
33777,25,25649,81,"Tasa de exámenes médico legales por presunto delito sexual contra niños, niñas y adolescentes",2021,4,2,862,232.018561484919,0,455,0,2,407,491.400491400491
33778,25,25653,81,"Tasa de exámenes médico legales por presunto delito sexual contra niños, niñas y adolescentes",2021,3,1,479,208.768267223382,0,249,0,1,230,434.782608695652
33779,25,25658,81,"Tasa de exámenes médico legales por presunto delito sexual contra niños, niñas y adolescentes",2021,3,3,1073,279.589934762349,0,553,0,3,520,576.923076923077
33780,25,25658,81,"Tasa de exámenes médico legales por presunto delito sexual contra niños, niñas y adolescentes",2021,4,5,1048,477.099236641221,0,533,0,5,515,970.873786407767
33781,25,25658,121,Tasa de exámenes médico legales por presunto delito sexual cuando la víctima está entre 18 y 28 años,2021,5,2,1816,110.132158590308,0,884,0,2,932,214.592274678112
33782,25,25662,81,"Tasa de exámenes médico legales por presunto delito sexual contra niños, niñas y adolescentes",2021,3,1,798,125.31328320802,1,421,237.529691211401,0,377,0
33783,25,25662,81,"Tasa de exámenes médico legales por presunto delito sexual contra niños, niñas y adolescentes",2021,4,1,775,129.032258064516,0,404,0,1,371,269.541778975741
33784,25,25718,81,"Tasa de exámenes médico legales por presunto delito sexual contra niños, niñas y adolescentes",2021,2,3,748,401.069518716578,1,371,269.541778975741,2,377,530.503978779841
33785,25,25718,81,"Tasa de exámenes médico legales por presunto delito sexual contra niños, niñas y adolescentes",2021,3,7,1104,634.057971014493,4,596,671.140939597315,3,508,590.551181102362
33786,25,25718,81,"Tasa de exámenes médico legales por presunto delito sexual contra niños, niñas y adolescentes",2021,4,4,1197,334.168755221387,1,682,146.627565982405,3,515,582.52427184466
33787,25,25736,81,"Tasa de exámenes médico legales por presunto delito sexual contra niños, niñas y adolescentes",2021,2,3,1080,277.777777777778,2,560,357.142857142857,1,520,192.307692307692
33788,25,25736,81,"Tasa de exámenes médico legales por presunto delito sexual contra niños, niñas y adolescentes",2021,3,1,1277,78.3085356303837,1,666,150.15015015015,0,611,0
33789,25,25736,81,"Tasa de exámenes médico legales por presunto delito sexual contra niños, niñas y adolescentes",2021,4,5,1321,378.501135503407,1,686,145.772594752187,4,635,629.92125984252
33790,25,25736,121,Tasa de exámenes médico legales por presunto delito sexual cuando la víctima está entre 18 y 28 años,2021,5,2,2411,82.9531314807134,0,1213,0,2,1198,166.944908180301
33791,25,25740,81,"Tasa de exámenes médico legales por presunto delito sexual contra niños, niñas y adolescentes",2021,2,6,2837,211.491011632006,2,1429,139.958012596221,4,1408,284.090909090909
33792,25,25740,81,"Tasa de exámenes médico legales por presunto delito sexual contra niños, niñas y adolescentes",2021,3,10,3446,290.191526407429,2,1738,115.074798619102,8,1708,468.384074941452
33793,25,25740,81,"Tasa de exámenes médico legales por presunto delito sexual contra niños, niñas y adolescentes",2021,4,15,3573,419.815281276238,3,1845,162.60162601626,12,1728,694.444444444445
33794,25,25740,121,Tasa de exámenes médico legales por presunto delito sexual cuando la víctima está entre 18 y 28 años,2021,5,2,7257,27.5595976298746,0,3652,0,2,3605,55.4785020804438
33795,25,25743,81,"Tasa de exámenes médico legales por presunto delito sexual contra niños, niñas y adolescentes",2021,3,2,2250,88.8888888888889,0,1179,0,2,1071,186.741363211951
33796,25,25743,81,"Tasa de exámenes médico legales por presunto delito sexual contra niños, niñas y adolescentes",2021,4,7,2216,315.884476534296,2,1152,173.611111111111,5,1064,469.924812030075
33797,25,25743,121,Tasa de exámenes médico legales por presunto delito sexual cuando la víctima está entre 18 y 28 años,2021,5,1,3666,27.2776868521549,0,1855,0,1,1811,55.2181115405853
33798,25,25745,81,"Tasa de exámenes médico legales por presunto delito sexual contra niños, niñas y adolescentes",2021,2,1,1176,85.0340136054422,1,615,162.60162601626,0,561,0
33799,25,25745,81,"Tasa de exámenes médico legales por presunto delito sexual contra niños, niñas y adolescentes",2021,4,4,1585,252.365930599369,0,808,0,4,777,514.800514800515
33800,25,25745,121,Tasa de exámenes médico legales por presunto delito sexual cuando la víctima está entre 18 y 28 años,2021,5,1,2282,43.8212094653812,0,1125,0,1,1157,86.4304235090752
33801,25,25754,81,"Tasa de exámenes médico legales por presunto delito sexual contra niños, niñas y adolescentes",2021,2,42,62459,67.2441121375622,9,31895,28.2175889637874,33,30564,107.970160973695
33802,25,25754,81,"Tasa de exámenes médico legales por presunto delito sexual contra niños, niñas y adolescentes",2021,3,69,73630,93.7118022545158,22,37559,58.5745094384835,47,36071,130.298577804885
33803,25,25754,81,"Tasa de exámenes médico legales por presunto delito sexual contra niños, niñas y adolescentes",2021,4,147,74644,196.934783773646,10,37668,26.5477328236169,137,36976,370.510601471225
33804,25,25754,121,Tasa de exámenes médico legales por presunto delito sexual cuando la víctima está entre 18 y 28 años,2021,5,29,157869,18.3696609213969,2,77518,2.58004592481746,27,80351,33.6025687296985
33805,25,25754,81,"Tasa de exámenes médico legales por presunto delito sexual contra niños, niñas y adolescentes",2021,1,2,11786,16.9692855930765,0,6032,0,2,5754,34.7584289190129
33806,25,25758,81,"Tasa de exámenes médico legales por presunto delito sexual contra niños, niñas y adolescentes",2021,2,2,1944,102.880658436214,0,1023,0,2,921,217.155266015201
33807,25,25758,81,"Tasa de exámenes médico legales por presunto delito sexual contra niños, niñas y adolescentes",2021,3,1,2507,39.8883127243718,1,1304,76.6871165644172,0,1203,0
33808,25,25758,81,"Tasa de exámenes médico legales por presunto delito sexual contra niños, niñas y adolescentes",2021,4,1,2827,35.3731871241599,0,1445,0,1,1382,72.3589001447178
33809,25,25758,121,Tasa de exámenes médico legales por presunto delito sexual cuando la víctima está entre 18 y 28 años,2021,5,2,5810,34.4234079173838,0,2912,0,2,2898,69.0131124913734
33810,25,25769,81,"Tasa de exámenes médico legales por presunto delito sexual contra niños, niñas y adolescentes",2021,2,1,1280,78125,0,673,0,1,607,164.744645799012
33811,25,25769,81,"Tasa de exámenes médico legales por presunto delito sexual contra niños, niñas y adolescentes",2021,3,1,1527,65.4878847413229,0,779,0,1,748,133.689839572193
33812,25,25769,81,"Tasa de exámenes médico legales por presunto delito sexual contra niños, niñas y adolescentes",2021,4,5,1600,312.5,0,792,0,5,808,618.811881188119
33813,25,25769,121,Tasa de exámenes médico legales por presunto delito sexual cuando la víctima está entre 18 y 28 años,2021,5,2,3185,62.7943485086342,0,1574,0,2,1611,124.146492861577
33814,25,25772,81,"Tasa de exámenes médico legales por presunto delito sexual contra niños, niñas y adolescentes",2021,2,1,1710,58.4795321637427,1,889,112.485939257593,0,821,0
33815,25,25772,81,"Tasa de exámenes médico legales por presunto delito sexual contra niños, niñas y adolescentes",2021,4,6,2005,299.25187032419,0,1019,0,6,986,608.519269776876
33816,25,25779,81,"Tasa de exámenes médico legales por presunto delito sexual contra niños, niñas y adolescentes",2021,3,1,780,128.205128205128,0,418,0,1,362,276.243093922652
33817,25,25781,81,"Tasa de exámenes médico legales por presunto delito sexual contra niños, niñas y adolescentes",2021,4,1,659,151.745068285281,0,328,0,1,331,302.114803625378
33818,25,25785,81,"Tasa de exámenes médico legales por presunto delito sexual contra niños, niñas y adolescentes",2021,3,1,2235,44.7427293064877,0,1127,0,1,1108,90.2527075812274
33819,25,25793,81,"Tasa de exámenes médico legales por presunto delito sexual contra niños, niñas y adolescentes",2021,4,3,895,335.195530726257,0,452,0,3,443,677.200902934537
33820,25,25797,81,"Tasa de exámenes médico legales por presunto delito sexual contra niños, niñas y adolescentes",2021,3,4,955,418.848167539267,0,492,0,4,463,863.930885529158
33821,25,25797,81,"Tasa de exámenes médico legales por presunto delito sexual contra niños, niñas y adolescentes",2021,4,2,962,207.900207900208,0,528,0,2,434,460.829493087558
33822,25,25797,121,Tasa de exámenes médico legales por presunto delito sexual cuando la víctima está entre 18 y 28 años,2021,5,2,1574,127.064803049555,0,840,0,2,734,272.479564032698
33823,25,25799,81,"Tasa de exámenes médico legales por presunto delito sexual contra niños, niñas y adolescentes",2021,3,1,2209,45.2693526482571,0,1122,0,1,1087,91.9963201471941
33824,25,25799,81,"Tasa de exámenes médico legales por presunto delito sexual contra niños, niñas y adolescentes",2021,4,1,2312,43.2525951557093,0,1172,0,1,1140,87.719298245614
33825,25,25799,121,Tasa de exámenes médico legales por presunto delito sexual cuando la víctima está entre 18 y 28 años,2021,5,1,4756,21.0260723296888,0,2371,0,1,2385,41.9287211740042
33826,25,25805,81,"Tasa de exámenes médico legales por presunto delito sexual contra niños, niñas y adolescentes",2021,3,1,438,228.310502283105,0,208,0,1,230,434.782608695652
33827,25,25805,81,"Tasa de exámenes médico legales por presunto delito sexual contra niños, niñas y adolescentes",2021,4,1,451,221.729490022173,0,216,0,1,235,425.531914893617
33828,25,25807,81,"Tasa de exámenes médico legales por presunto delito sexual contra niños, niñas y adolescentes",2021,4,1,254,393.700787401575,0,119,0,1,135,740.740740740741
33829,25,25815,81,"Tasa de exámenes médico legales por presunto delito sexual contra niños, niñas y adolescentes",2021,3,4,1361,293.901542983101,2,713,280.504908835905,2,648,308.641975308642
33830,25,25815,81,"Tasa de exámenes médico legales por presunto delito sexual contra niños, niñas y adolescentes",2021,4,4,1498,267.022696929239,1,804,124.378109452736,3,694,432.276657060519
33831,25,25817,81,"Tasa de exámenes médico legales por presunto delito sexual contra niños, niñas y adolescentes",2021,3,4,4797,83.3854492391078,0,2467,0,4,2330,171.673819742489
33832,25,25817,81,"Tasa de exámenes médico legales por presunto delito sexual contra niños, niñas y adolescentes",2021,4,6,4701,127.632418634333,0,2403,0,6,2298,261.096605744125
33833,25,25817,121,Tasa de exámenes médico legales por presunto delito sexual cuando la víctima está entre 18 y 28 años,2021,5,2,10393,19.2437217357837,0,5241,0,2,5152,38.8198757763975
33834,25,25823,121,Tasa de exámenes médico legales por presunto delito sexual cuando la víctima está entre 18 y 28 años,2021,5,1,549,182.149362477231,0,281,0,1,268,373.134328358209
33835,25,25841,81,"Tasa de exámenes médico legales por presunto delito sexual contra niños, niñas y adolescentes",2021,2,1,544,183.823529411765,1,317,315.457413249211,0,227,0
33836,25,25841,81,"Tasa de exámenes médico legales por presunto delito sexual contra niños, niñas y adolescentes",2021,3,4,663,603.318250377074,1,358,279.329608938548,3,305,983.606557377049
33837,25,25841,81,"Tasa de exámenes médico legales por presunto delito sexual contra niños, niñas y adolescentes",2021,4,5,667,749.625187406297,0,346,0,5,321,1557.63239875389
33838,25,25845,81,"Tasa de exámenes médico legales por presunto delito sexual contra niños, niñas y adolescentes",2021,3,2,691,289.435600578871,1,350,285.714285714286,1,341,293.255131964809
33839,25,25851,81,"Tasa de exámenes médico legales por presunto delito sexual contra niños, niñas y adolescentes",2021,4,1,365,273.972602739726,0,183,0,1,182,549.45054945055
33840,25,25506,81,"Tasa de exámenes médico legales por presunto delito sexual contra niños, niñas y adolescentes",2021,4,1,423,236.406619385343,0,236,0,1,187,534.75935828877
33841,25,25506,121,Tasa de exámenes médico legales por presunto delito sexual cuando la víctima está entre 18 y 28 años,2021,5,1,666,150.15015015015,0,340,0,1,326,306.748466257669
33842,25,25862,81,"Tasa de exámenes médico legales por presunto delito sexual contra niños, niñas y adolescentes",2021,3,1,615,162.60162601626,0,318,0,1,297,336.700336700337
33843,25,25862,81,"Tasa de exámenes médico legales por presunto delito sexual contra niños, niñas y adolescentes",2021,4,3,609,492.610837438424,0,320,0,3,289,1038.06228373702
33844,25,25867,81,"Tasa de exámenes médico legales por presunto delito sexual contra niños, niñas y adolescentes",2021,3,2,429,466.200466200466,0,214,0,2,215,930.232558139535
33845,25,25843,81,"Tasa de exámenes médico legales por presunto delito sexual contra niños, niñas y adolescentes",2021,2,2,4114,48.6144871171609,0,2138,0,2,1976,101.214574898785
33846,25,25843,81,"Tasa de exámenes médico legales por presunto delito sexual contra niños, niñas y adolescentes",2021,3,8,4878,164.0016400164,0,2465,0,8,2413,331.537505180274
33847,25,25843,81,"Tasa de exámenes médico legales por presunto delito sexual contra niños, niñas y adolescentes",2021,4,10,4849,206.228088265622,2,2401,83.2986255726781,8,2448,326.797385620915
33848,25,25843,121,Tasa de exámenes médico legales por presunto delito sexual cuando la víctima está entre 18 y 28 años,2021,5,5,9140,54.7045951859956,0,4486,0,5,4654,107.434464976364
33849,25,25871,81,"Tasa de exámenes médico legales por presunto delito sexual contra niños, niñas y adolescentes",2021,4,1,178,561.797752808989,0,97,0,1,81,1234.56790123457
33850,25,25873,81,"Tasa de exámenes médico legales por presunto delito sexual contra niños, niñas y adolescentes",2021,4,2,2101,95.1927653498334,0,1105,0,2,996,200.803212851406
33851,25,25873,121,Tasa de exámenes médico legales por presunto delito sexual cuando la víctima está entre 18 y 28 años,2021,5,1,3372,29.655990510083,0,1747,0,1,1625,61.5384615384615
33852,25,25875,81,"Tasa de exámenes médico legales por presunto delito sexual contra niños, niñas y adolescentes",2021,2,4,2072,193.050193050193,0,1054,0,4,1018,392.927308447937
33853,25,25875,81,"Tasa de exámenes médico legales por presunto delito sexual contra niños, niñas y adolescentes",2021,3,8,2555,313.111545988258,1,1311,76.27765064836,7,1244,562.700964630225
33854,25,25875,81,"Tasa de exámenes médico legales por presunto delito sexual contra niños, niñas y adolescentes",2021,4,13,2655,489.642184557439,0,1385,0,13,1270,1023.62204724409
33855,25,25875,121,Tasa de exámenes médico legales por presunto delito sexual cuando la víctima está entre 18 y 28 años,2021,5,6,4858,123.507616303005,1,2456,40.7166123778502,5,2402,208.159866777685
33856,25,25878,81,"Tasa de exámenes médico legales por presunto delito sexual contra niños, niñas y adolescentes",2021,3,8,1299,615.858352578907,1,652,153.374233128834,7,647,1081.91653786708
33857,25,25878,81,"Tasa de exámenes médico legales por presunto delito sexual contra niños, niñas y adolescentes",2021,4,3,1340,223.880597014925,0,704,0,3,636,471.698113207547
33858,25,25885,81,"Tasa de exámenes médico legales por presunto delito sexual contra niños, niñas y adolescentes",2021,3,1,1190,84.0336134453782,0,635,0,1,555,180.18018018018
33859,25,25885,81,"Tasa de exámenes médico legales por presunto delito sexual contra niños, niñas y adolescentes",2021,4,1,1192,83.8926174496644,0,654,0,1,538,185.873605947955
33860,25,25899,81,"Tasa de exámenes médico legales por presunto delito sexual contra niños, niñas y adolescentes",2021,2,8,11900,67.2268907563025,2,6121,32.6743996079072,6,5779,103.824191036512
33861,25,25899,81,"Tasa de exámenes médico legales por presunto delito sexual contra niños, niñas y adolescentes",2021,3,13,13406,96.9715052961361,2,6835,29.2611558156547,11,6571,167.402221884036
33862,25,25899,81,"Tasa de exámenes médico legales por presunto delito sexual contra niños, niñas y adolescentes",2021,4,24,13418,178.864212252199,1,6756,14.801657785672,23,6662,345.241669168418
33863,25,25899,121,Tasa de exámenes médico legales por presunto delito sexual cuando la víctima está entre 18 y 28 años,2021,5,4,29394,13.6082193644962,0,14624,0,4,14770,27.08192281652
33864,94,94001,81,"Tasa de exámenes médico legales por presunto delito sexual contra niños, niñas y adolescentes",2021,2,1,3840,26.0416666666667,0,1971,0,1,1869,53.5045478865704
33865,94,94001,81,"Tasa de exámenes médico legales por presunto delito sexual contra niños, niñas y adolescentes",2021,3,13,4734,274.609209970427,0,2399,0,13,2335,556.745182012848
33866,94,94001,81,"Tasa de exámenes médico legales por presunto delito sexual contra niños, niñas y adolescentes",2021,4,25,4578,546.08999563128,0,2333,0,25,2245,1113.58574610245
33867,94,94001,121,Tasa de exámenes médico legales por presunto delito sexual cuando la víctima está entre 18 y 28 años,2021,5,6,7324,81.9224467504096,0,3860,0,6,3464,173.210161662818
33868,94,94001,81,"Tasa de exámenes médico legales por presunto delito sexual contra niños, niñas y adolescentes",2021,1,1,795,125.786163522013,0,409,0,1,386,259.067357512953
33869,95,95015,81,"Tasa de exámenes médico legales por presunto delito sexual contra niños, niñas y adolescentes",2021,3,1,1190,84.0336134453782,0,618,0,1,572,174.825174825175
33870,95,95015,81,"Tasa de exámenes médico legales por presunto delito sexual contra niños, niñas y adolescentes",2021,4,2,1130,176.991150442478,0,601,0,2,529,378.071833648393
33871,95,95025,81,"Tasa de exámenes médico legales por presunto delito sexual contra niños, niñas y adolescentes",2021,2,2,1452,137.741046831956,1,742,134.770889487871,1,710,140.845070422535
33872,95,95025,81,"Tasa de exámenes médico legales por presunto delito sexual contra niños, niñas y adolescentes",2021,3,3,1924,155.925155925156,0,980,0,3,944,317.796610169492
33873,95,95025,81,"Tasa de exámenes médico legales por presunto delito sexual contra niños, niñas y adolescentes",2021,4,5,1994,250.752256770311,2,1060,188.679245283019,3,934,321.199143468951
33874,95,95025,121,Tasa de exámenes médico legales por presunto delito sexual cuando la víctima está entre 18 y 28 años,2021,5,1,2387,41.8935902806871,0,1268,0,1,1119,89.3655049151028
33875,95,95200,81,"Tasa de exámenes médico legales por presunto delito sexual contra niños, niñas y adolescentes",2021,2,1,767,130.378096479791,0,395,0,1,372,268.817204301075
33876,95,95200,81,"Tasa de exámenes médico legales por presunto delito sexual contra niños, niñas y adolescentes",2021,3,3,1042,287.907869481766,0,536,0,3,506,592.885375494071
33877,95,95200,81,"Tasa de exámenes médico legales por presunto delito sexual contra niños, niñas y adolescentes",2021,4,5,853,586.166471277843,1,435,229.885057471264,4,418,956.937799043062
33878,95,95001,81,"Tasa de exámenes médico legales por presunto delito sexual contra niños, niñas y adolescentes",2021,2,10,6034,165.727543917799,4,3089,129.491744901263,6,2945,203.735144312394
33879,95,95001,81,"Tasa de exámenes médico legales por presunto delito sexual contra niños, niñas y adolescentes",2021,3,16,6785,235.81429624171,0,3415,0,16,3370,474.777448071217
33880,95,95001,81,"Tasa de exámenes médico legales por presunto delito sexual contra niños, niñas y adolescentes",2021,4,25,6621,377.586467301012,1,3370,29.673590504451,24,3251,738.23438941864
33881,95,95001,121,Tasa de exámenes médico legales por presunto delito sexual cuando la víctima está entre 18 y 28 años,2021,5,6,11719,51.1989077566345,0,6185,0,6,5534,108.420672208168
33882,41,41006,81,"Tasa de exámenes médico legales por presunto delito sexual contra niños, niñas y adolescentes",2021,3,4,3357,119.15400655347,0,1694,0,4,1663,240.529164161155
33883,41,41006,81,"Tasa de exámenes médico legales por presunto delito sexual contra niños, niñas y adolescentes",2021,4,4,3224,124.069478908189,0,1647,0,4,1577,253.646163601776
33884,41,41006,121,Tasa de exámenes médico legales por presunto delito sexual cuando la víctima está entre 18 y 28 años,2021,5,1,4783,20.9073803052478,0,2439,0,1,2344,42.6621160409556
33885,41,41013,81,"Tasa de exámenes médico legales por presunto delito sexual contra niños, niñas y adolescentes",2021,3,1,1047,95.5109837631328,0,526,0,1,521,191.938579654511
33886,41,41016,81,"Tasa de exámenes médico legales por presunto delito sexual contra niños, niñas y adolescentes",2021,3,2,1902,105.15247108307,0,950,0,2,952,210.084033613445
33887,41,41016,81,"Tasa de exámenes médico legales por presunto delito sexual contra niños, niñas y adolescentes",2021,4,4,1801,222.098833981122,2,909,220.02200220022,2,892,224.215246636771
33888,41,41016,121,Tasa de exámenes médico legales por presunto delito sexual cuando la víctima está entre 18 y 28 años,2021,5,1,2874,34.794711203897,0,1407,0,1,1467,68.1663258350375
33889,41,41020,81,"Tasa de exámenes médico legales por presunto delito sexual contra niños, niñas y adolescentes",2021,2,2,1969,101.574403250381,0,977,0,2,992,201.612903225806
33890,41,41020,81,"Tasa de exámenes médico legales por presunto delito sexual contra niños, niñas y adolescentes",2021,3,11,2609,421.617477960905,3,1329,225.733634311512,8,1280,625
33891,41,41020,81,"Tasa de exámenes médico legales por presunto delito sexual contra niños, niñas y adolescentes",2021,4,10,2738,365.230094959825,1,1455,68.7285223367698,9,1283,701.480904130943
33892,41,41020,121,Tasa de exámenes médico legales por presunto delito sexual cuando la víctima está entre 18 y 28 años,2021,5,2,4137,48.344210780759,0,2218,0,2,1919,104.220948410631
33893,41,41078,81,"Tasa de exámenes médico legales por presunto delito sexual contra niños, niñas y adolescentes",2021,3,1,834,119.904076738609,1,430,232.558139534884,0,404,0
33894,41,41078,81,"Tasa de exámenes médico legales por presunto delito sexual contra niños, niñas y adolescentes",2021,4,2,977,204.708290685773,1,520,192.307692307692,1,457,218.818380743983
33895,41,41132,81,"Tasa de exámenes médico legales por presunto delito sexual contra niños, niñas y adolescentes",2021,2,1,2683,37.2717107715244,0,1379,0,1,1304,76.6871165644172
33896,41,41132,81,"Tasa de exámenes médico legales por presunto delito sexual contra niños, niñas y adolescentes",2021,3,3,3242,92.5354719309069,0,1684,0,3,1558,192.554557124519
33897,41,41132,81,"Tasa de exámenes médico legales por presunto delito sexual contra niños, niñas y adolescentes",2021,4,8,3201,249.921899406435,0,1650,0,8,1551,515.796260477112
33898,41,41132,121,Tasa de exámenes médico legales por presunto delito sexual cuando la víctima está entre 18 y 28 años,2021,5,1,5388,18.5597624350408,0,2707,0,1,2681,37.2995151063036
33899,41,41206,81,"Tasa de exámenes médico legales por presunto delito sexual contra niños, niñas y adolescentes",2021,2,2,688,290.697674418605,1,354,282.485875706215,1,334,299.40119760479
33900,41,41206,81,"Tasa de exámenes médico legales por presunto delito sexual contra niños, niñas y adolescentes",2021,3,3,788,380.710659898477,2,417,479.616306954436,1,371,269.541778975741
33901,41,41206,81,"Tasa de exámenes médico legales por presunto delito sexual contra niños, niñas y adolescentes",2021,4,2,725,275.862068965517,0,401,0,2,324,617.283950617284
33902,41,41206,121,Tasa de exámenes médico legales por presunto delito sexual cuando la víctima está entre 18 y 28 años,2021,5,1,1142,87.5656742556918,0,640,0,1,502,199.203187250996
33903,41,41298,81,"Tasa de exámenes médico legales por presunto delito sexual contra niños, niñas y adolescentes",2021,2,3,6907,43.4341971912553,0,3522,0,3,3385,88.6262924667652
33904,41,41298,81,"Tasa de exámenes médico legales por presunto delito sexual contra niños, niñas y adolescentes",2021,3,3,8368,35.8508604206501,0,4307,0,3,4061,73.8734301896085
33905,41,41298,81,"Tasa de exámenes médico legales por presunto delito sexual contra niños, niñas y adolescentes",2021,4,8,8300,96.3855421686747,1,4323,23.1320842007865,7,3977,176.012069399045
33906,41,41298,121,Tasa de exámenes médico legales por presunto delito sexual cuando la víctima está entre 18 y 28 años,2021,5,5,13389,37.3440884308014,0,6838,0,5,6551,76.3242253091131
33907,41,41306,81,"Tasa de exámenes médico legales por presunto delito sexual contra niños, niñas y adolescentes",2021,4,6,2778,215.982721382289,0,1351,0,6,1427,420.462508759636
33908,41,41319,81,"Tasa de exámenes médico legales por presunto delito sexual contra niños, niñas y adolescentes",2021,4,1,2148,46.5549348230912,0,1114,0,1,1034,96.7117988394584
33909,41,41349,81,"Tasa de exámenes médico legales por presunto delito sexual contra niños, niñas y adolescentes",2021,3,1,853,117.233294255569,0,447,0,1,406,246.305418719212
33910,41,41349,81,"Tasa de exámenes médico legales por presunto delito sexual contra niños, niñas y adolescentes",2021,4,2,798,250.62656641604,0,417,0,2,381,524.9343832021
33911,41,41349,121,Tasa de exámenes médico legales por presunto delito sexual cuando la víctima está entre 18 y 28 años,2021,5,1,1294,77.2797527047914,0,650,0,1,644,155.27950310559
33912,41,41357,81,"Tasa de exámenes médico legales por presunto delito sexual contra niños, niñas y adolescentes",2021,3,1,1143,87.4890638670166,0,583,0,1,560,178.571428571429
33913,41,41357,81,"Tasa de exámenes médico legales por presunto delito sexual contra niños, niñas y adolescentes",2021,4,1,1070,93.4579439252337,0,557,0,1,513,194.931773879142
33914,41,41359,81,"Tasa de exámenes médico legales por presunto delito sexual contra niños, niñas y adolescentes",2021,2,4,2309,173.235166738848,2,1131,176.83465959328,2,1178,169.779286926995
33915,41,41359,81,"Tasa de exámenes médico legales por presunto delito sexual contra niños, niñas y adolescentes",2021,3,7,2833,247.087892693258,2,1426,140.252454417952,5,1407,355.366027007818
33916,41,41359,81,"Tasa de exámenes médico legales por presunto delito sexual contra niños, niñas y adolescentes",2021,4,16,2875,556.521739130435,1,1481,67.5219446320054,15,1394,1076.04017216643
33917,41,41359,121,Tasa de exámenes médico legales por presunto delito sexual cuando la víctima está entre 18 y 28 años,2021,5,2,4894,40.8663669799755,0,2495,0,2,2399,83.3680700291788
33918,41,41378,81,"Tasa de exámenes médico legales por presunto delito sexual contra niños, niñas y adolescentes",2021,3,2,1628,122.850122850123,0,841,0,2,787,254.129606099111
33919,41,41378,81,"Tasa de exámenes médico legales por presunto delito sexual contra niños, niñas y adolescentes",2021,4,1,1567,63.8162093171666,0,804,0,1,763,131.061598951507
33920,41,41396,81,"Tasa de exámenes médico legales por presunto delito sexual contra niños, niñas y adolescentes",2021,2,2,6714,29.7885016383676,0,3444,0,2,3270,61.1620795107034
33921,41,41396,81,"Tasa de exámenes médico legales por presunto delito sexual contra niños, niñas y adolescentes",2021,3,6,7752,77.3993808049536,0,3990,0,6,3762,159.489633173844
33922,41,41396,81,"Tasa de exámenes médico legales por presunto delito sexual contra niños, niñas y adolescentes",2021,4,13,7252,179.260893546608,0,3734,0,13,3518,369.528140989198
33923,41,41396,121,Tasa de exámenes médico legales por presunto delito sexual cuando la víctima está entre 18 y 28 años,2021,5,3,11430,26.246719160105,0,5828,0,3,5602,53.5523027490182
33924,41,41483,81,"Tasa de exámenes médico legales por presunto delito sexual contra niños, niñas y adolescentes",2021,4,1,746,134.048257372654,0,381,0,1,365,273.972602739726
33925,41,41001,81,"Tasa de exámenes médico legales por presunto delito sexual contra niños, niñas y adolescentes",2021,2,37,30941,119.582431078504,8,15852,50.4668180671209,29,15089,192.1929882696
33926,41,41001,81,"Tasa de exámenes médico legales por presunto delito sexual contra niños, niñas y adolescentes",2021,3,92,35703,257.681427331037,12,18342,65.4236179260713,80,17361,460.802949138875
33927,41,41001,81,"Tasa de exámenes médico legales por presunto delito sexual contra niños, niñas y adolescentes",2021,4,130,34599,375.7334026995,16,17615,90.8316775475447,114,16984,671.219971738106
33928,41,41001,121,Tasa de exámenes médico legales por presunto delito sexual cuando la víctima está entre 18 y 28 años,2021,5,32,65180,49.0948143602332,4,32272,12.3946455131383,28,32908,85.0856934484016
33929,41,41001,81,"Tasa de exámenes médico legales por presunto delito sexual contra niños, niñas y adolescentes",2021,1,1,6098,16.3988192850115,1,3125,32,0,2973,0
33930,41,41503,121,Tasa de exámenes médico legales por presunto delito sexual cuando la víctima está entre 18 y 28 años,2021,5,1,2187,45.7247370827618,0,1100,0,1,1087,91.9963201471941
33931,41,41518,81,"Tasa de exámenes médico legales por presunto delito sexual contra niños, niñas y adolescentes",2021,2,1,627,159.489633173844,1,333,300.3003003003,0,294,0
33932,41,41518,81,"Tasa de exámenes médico legales por presunto delito sexual contra niños, niñas y adolescentes",2021,4,2,780,256.410256410256,0,410,0,2,370,540.540540540541
33933,41,41518,121,Tasa de exámenes médico legales por presunto delito sexual cuando la víctima está entre 18 y 28 años,2021,5,1,1161,86.1326442721792,0,582,0,1,579,172.711571675302
33934,41,41524,81,"Tasa de exámenes médico legales por presunto delito sexual contra niños, niñas y adolescentes",2021,3,1,2798,35.7398141529664,0,1448,0,1,1350,74.0740740740741
33935,41,41524,81,"Tasa de exámenes médico legales por presunto delito sexual contra niños, niñas y adolescentes",2021,4,5,2689,185.942729639271,1,1378,72.5689404934688,4,1311,305.11060259344
33936,41,41524,121,Tasa de exámenes médico legales por presunto delito sexual cuando la víctima está entre 18 y 28 años,2021,5,3,4736,63.3445945945946,0,2411,0,3,2325,129.032258064516
33937,41,41530,81,"Tasa de exámenes médico legales por presunto delito sexual contra niños, niñas y adolescentes",2021,3,2,1351,148.038490007402,0,710,0,2,641,312.01248049922
33938,41,41530,81,"Tasa de exámenes médico legales por presunto delito sexual contra niños, niñas y adolescentes",2021,4,1,1232,81.1688311688312,0,627,0,1,605,165.289256198347
33939,41,41530,121,Tasa de exámenes médico legales por presunto delito sexual cuando la víctima está entre 18 y 28 años,2021,5,1,2127,47.0145745181006,0,1065,0,1,1062,94.1619585687382
33940,41,41548,81,"Tasa de exámenes médico legales por presunto delito sexual contra niños, niñas y adolescentes",2021,3,2,1778,112.485939257593,0,915,0,2,863,231.749710312862
33941,41,41548,81,"Tasa de exámenes médico legales por presunto delito sexual contra niños, niñas y adolescentes",2021,4,2,1578,126.742712294043,0,814,0,2,764,261.780104712042
33942,41,41551,81,"Tasa de exámenes médico legales por presunto delito sexual contra niños, niñas y adolescentes",2021,2,11,11827,93.0075251543079,5,6091,82.0883270398949,6,5736,104.602510460251
33943,41,41551,81,"Tasa de exámenes médico legales por presunto delito sexual contra niños, niñas y adolescentes",2021,3,29,14231,203.780479235472,4,7289,54.8772122376183,25,6942,360.126764621147
33944,41,41551,81,"Tasa de exámenes médico legales por presunto delito sexual contra niños, niñas y adolescentes",2021,4,29,14296,202.853945159485,3,7245,41.407867494824,26,7051,368.742022408169
33945,41,41551,121,Tasa de exámenes médico legales por presunto delito sexual cuando la víctima está entre 18 y 28 años,2021,5,6,25092,23.9120038259206,0,12627,0,6,12465,48.1347773766546
33946,41,41615,81,"Tasa de exámenes médico legales por presunto delito sexual contra niños, niñas y adolescentes",2021,2,4,1997,200.300450676014,2,1034,193.423597678917,2,963,207.684319833853
33947,41,41615,81,"Tasa de exámenes médico legales por presunto delito sexual contra niños, niñas y adolescentes",2021,3,8,2399,333.472280116715,2,1254,159.489633173844,6,1145,524.017467248908
33948,41,41615,81,"Tasa de exámenes médico legales por presunto delito sexual contra niños, niñas y adolescentes",2021,4,8,2471,323.755564548766,1,1327,75.3579502637528,7,1144,611.888111888112
33949,41,41615,121,Tasa de exámenes médico legales por presunto delito sexual cuando la víctima está entre 18 y 28 años,2021,5,5,4883,102.396067990989,2,2788,71.7360114777618,3,2095,143.198090692124
33950,41,41660,81,"Tasa de exámenes médico legales por presunto delito sexual contra niños, niñas y adolescentes",2021,2,1,1219,82.0344544708778,0,637,0,1,582,171.821305841924
33951,41,41660,81,"Tasa de exámenes médico legales por presunto delito sexual contra niños, niñas y adolescentes",2021,3,1,1409,70.97232079489,0,752,0,1,657,152.20700152207
33952,41,41668,81,"Tasa de exámenes médico legales por presunto delito sexual contra niños, niñas y adolescentes",2021,2,1,3061,32.6690623979092,0,1603,0,1,1458,68.5871056241427
33953,41,41668,81,"Tasa de exámenes médico legales por presunto delito sexual contra niños, niñas y adolescentes",2021,3,8,3548,225.479143179256,3,1859,161.377084454008,5,1689,296.03315571344
33954,41,41668,81,"Tasa de exámenes médico legales por presunto delito sexual contra niños, niñas y adolescentes",2021,4,9,3463,259.890268553278,0,1791,0,9,1672,538.277511961723
33955,41,41668,121,Tasa de exámenes médico legales por presunto delito sexual cuando la víctima está entre 18 y 28 años,2021,5,5,6357,78.6534528865817,0,3266,0,5,3091,161.759948236817
33956,41,41676,81,"Tasa de exámenes médico legales por presunto delito sexual contra niños, niñas y adolescentes",2021,3,2,1265,158.102766798419,0,641,0,2,624,320.512820512821
33957,41,41676,81,"Tasa de exámenes médico legales por presunto delito sexual contra niños, niñas y adolescentes",2021,4,1,1134,88.1834215167549,0,595,0,1,539,185.528756957328
33958,41,41770,81,"Tasa de exámenes médico legales por presunto delito sexual contra niños, niñas y adolescentes",2021,3,1,2776,36.0230547550432,1,1431,69.8812019566737,0,1345,0
33959,41,41770,81,"Tasa de exámenes médico legales por presunto delito sexual contra niños, niñas y adolescentes",2021,4,2,2552,78.3699059561129,1,1301,76.8639508070715,1,1251,79.9360511590728
33960,41,41791,81,"Tasa de exámenes médico legales por presunto delito sexual contra niños, niñas y adolescentes",2021,3,2,2141,93.4142923867352,0,1095,0,2,1046,191.204588910134
33961,41,41791,81,"Tasa de exámenes médico legales por presunto delito sexual contra niños, niñas y adolescentes",2021,4,3,2161,138.8246182323,0,1114,0,3,1047,286.532951289398
33962,41,41791,121,Tasa de exámenes médico legales por presunto delito sexual cuando la víctima está entre 18 y 28 años,2021,5,1,3263,30.6466441924609,0,1696,0,1,1567,63.8162093171666
33963,41,41799,81,"Tasa de exámenes médico legales por presunto delito sexual contra niños, niñas y adolescentes",2021,2,3,1084,276.752767527675,0,589,0,3,495,606.060606060606
33964,41,41799,81,"Tasa de exámenes médico legales por presunto delito sexual contra niños, niñas y adolescentes",2021,3,2,1342,149.03129657228,0,720,0,2,622,321.543408360129
33965,41,41799,81,"Tasa de exámenes médico legales por presunto delito sexual contra niños, niñas y adolescentes",2021,4,3,1323,226.757369614512,0,703,0,3,620,483.870967741936
33966,41,41801,81,"Tasa de exámenes médico legales por presunto delito sexual contra niños, niñas y adolescentes",2021,3,3,895,335.195530726257,0,473,0,3,422,710.900473933649
33967,41,41801,81,"Tasa de exámenes médico legales por presunto delito sexual contra niños, niñas y adolescentes",2021,4,3,839,357.568533969011,0,437,0,3,402,746.268656716418
33968,41,41797,121,Tasa de exámenes médico legales por presunto delito sexual cuando la víctima está entre 18 y 28 años,2021,5,1,1858,53.8213132400431,0,953,0,1,905,110.497237569061
33969,41,41807,121,Tasa de exámenes médico legales por presunto delito sexual cuando la víctima está entre 18 y 28 años,2021,5,1,3873,25.8197779499096,0,1972,0,1,1901,52.6038926880589
33970,41,41872,81,"Tasa de exámenes médico legales por presunto delito sexual contra niños, niñas y adolescentes",2021,3,1,683,146.412884333821,0,364,0,1,319,313.479623824451
33971,41,41885,81,"Tasa de exámenes médico legales por presunto delito sexual contra niños, niñas y adolescentes",2021,4,1,723,138.312586445367,0,381,0,1,342,292.397660818713
33972,44,44035,81,"Tasa de exámenes médico legales por presunto delito sexual contra niños, niñas y adolescentes",2021,3,4,4459,89.7062121551918,0,2200,0,4,2259,177.069499778663
33973,44,44035,81,"Tasa de exámenes médico legales por presunto delito sexual contra niños, niñas y adolescentes",2021,4,1,4178,23.9348970799426,0,2097,0,1,2081,48.0538202787122
33974,44,44035,121,Tasa de exámenes médico legales por presunto delito sexual cuando la víctima está entre 18 y 28 años,2021,5,1,7323,13.6556056261095,0,3839,0,1,3484,28.7026406429392
33975,44,44078,81,"Tasa de exámenes médico legales por presunto delito sexual contra niños, niñas y adolescentes",2021,3,3,4919,60.9880056922139,0,2537,0,3,2382,125.944584382872
33976,44,44078,81,"Tasa de exámenes médico legales por presunto delito sexual contra niños, niñas y adolescentes",2021,4,6,4662,128.700128700129,1,2415,41.407867494824,5,2247,222.518914107699
33977,44,44078,121,Tasa de exámenes médico legales por presunto delito sexual cuando la víctima está entre 18 y 28 años,2021,5,2,8342,23.9750659314313,0,4141,0,2,4201,47.6077124494168
33978,44,44090,81,"Tasa de exámenes médico legales por presunto delito sexual contra niños, niñas y adolescentes",2021,2,1,4902,20.3998368013056,0,2462,0,1,2440,40.9836065573771
33979,44,44090,81,"Tasa de exámenes médico legales por presunto delito sexual contra niños, niñas y adolescentes",2021,3,2,6079,32.9001480506662,0,3177,0,2,2902,68.9179875947622
33980,44,44090,81,"Tasa de exámenes médico legales por presunto delito sexual contra niños, niñas y adolescentes",2021,4,7,5604,124.910778015703,0,3030,0,7,2574,271.950271950272
33981,44,44090,121,Tasa de exámenes médico legales por presunto delito sexual cuando la víctima está entre 18 y 28 años,2021,5,3,8775,34.1880341880342,0,4518,0,3,4257,70.4721634954193
33982,44,44098,81,"Tasa de exámenes médico legales por presunto delito sexual contra niños, niñas y adolescentes",2021,4,3,1590,188.679245283019,0,826,0,3,764,392.670157068063
33983,44,44098,121,Tasa de exámenes médico legales por presunto delito sexual cuando la víctima está entre 18 y 28 años,2021,5,1,3091,32.3519896473633,0,1694,0,1,1397,71.5819613457409
33984,44,44110,81,"Tasa de exámenes médico legales por presunto delito sexual contra niños, niñas y adolescentes",2021,2,1,669,149.476831091181,1,332,301.204819277108,0,337,0
33985,44,44110,81,"Tasa de exámenes médico legales por presunto delito sexual contra niños, niñas y adolescentes",2021,4,1,798,125.31328320802,0,420,0,1,378,264.550264550265
33986,44,44279,81,"Tasa de exámenes médico legales por presunto delito sexual contra niños, niñas y adolescentes",2021,2,3,5131,58.4681348664978,0,2611,0,3,2520,119.047619047619
33987,44,44279,81,"Tasa de exámenes médico legales por presunto delito sexual contra niños, niñas y adolescentes",2021,3,4,5765,69.3842150910668,1,2962,33.7609723160027,3,2803,107.028184088477
33988,44,44279,81,"Tasa de exámenes médico legales por presunto delito sexual contra niños, niñas y adolescentes",2021,4,20,4866,411.01520756268,2,2510,79.6812749003984,18,2356,764.006791171477
33989,44,44279,121,Tasa de exámenes médico legales por presunto delito sexual cuando la víctima está entre 18 y 28 años,2021,5,6,8798,68.1973175721755,0,4310,0,6,4488,133.689839572193
33990,44,44378,81,"Tasa de exámenes médico legales por presunto delito sexual contra niños, niñas y adolescentes",2021,2,2,2473,80.8734330772341,1,1284,77.8816199376947,1,1189,84.1042893187553
33991,44,44378,81,"Tasa de exámenes médico legales por presunto delito sexual contra niños, niñas y adolescentes",2021,3,2,2969,67.3627484001347,1,1518,65.8761528326746,1,1451,68.9179875947622
33992,44,44378,81,"Tasa de exámenes médico legales por presunto delito sexual contra niños, niñas y adolescentes",2021,4,5,2771,180.440274269217,2,1395,143.36917562724,3,1376,218.023255813953
33993,44,44420,81,"Tasa de exámenes médico legales por presunto delito sexual contra niños, niñas y adolescentes",2021,3,1,501,199.600798403194,0,249,0,1,252,396.825396825397
33994,44,44430,81,"Tasa de exámenes médico legales por presunto delito sexual contra niños, niñas y adolescentes",2021,2,16,22272,71.8390804597701,4,11389,35.1216085696725,12,10883,110.263714049435
33995,44,44430,81,"Tasa de exámenes médico legales por presunto delito sexual contra niños, niñas y adolescentes",2021,3,25,25764,97.0346219531129,3,13169,22.7807730275647,22,12595,174.672489082969
33996,44,44430,81,"Tasa de exámenes médico legales por presunto delito sexual contra niños, niñas y adolescentes",2021,4,45,22641,198.754471975619,1,11467,8.72067672451382,44,11174,393.771254698407
33997,44,44430,121,Tasa de exámenes médico legales por presunto delito sexual cuando la víctima está entre 18 y 28 años,2021,5,7,38845,18.0203372377397,0,18865,0,7,19980,35.035035035035
33998,44,44560,81,"Tasa de exámenes médico legales por presunto delito sexual contra niños, niñas y adolescentes",2021,2,1,13354,7.48839299086416,1,6817,14.6692093296171,0,6537,0
33999,44,44560,81,"Tasa de exámenes médico legales por presunto delito sexual contra niños, niñas y adolescentes",2021,3,3,15419,19.4565146896686,0,7816,0,3,7603,39.4581086413258
34000,44,44560,81,"Tasa de exámenes médico legales por presunto delito sexual contra niños, niñas y adolescentes",2021,4,5,13176,37.9477838494232,1,6561,15.2415790275873,4,6615,60.4686318972033
34001,44,44001,81,"Tasa de exámenes médico legales por presunto delito sexual contra niños, niñas y adolescentes",2021,2,11,23750,46.3157894736842,2,11943,16.7462111697229,9,11807,76.2259676463115
34002,44,44001,81,"Tasa de exámenes médico legales por presunto delito sexual contra niños, niñas y adolescentes",2021,3,46,27137,169.510262740907,3,13664,21.9555035128806,43,13473,319.156832182884
34003,44,44001,81,"Tasa de exámenes médico legales por presunto delito sexual contra niños, niñas y adolescentes",2021,4,66,23544,280.32619775739,3,11826,25.3678335870117,63,11718,537.634408602151
34004,44,44001,121,Tasa de exámenes médico legales por presunto delito sexual cuando la víctima está entre 18 y 28 años,2021,5,18,41822,43.0395485629573,1,20360,4.91159135559921,17,21462,79.2097660982201
34005,44,44650,81,"Tasa de exámenes médico legales por presunto delito sexual contra niños, niñas y adolescentes",2021,2,1,4553,21.9635405227323,1,2293,43.6109899694723,0,2260,0
34006,44,44650,81,"Tasa de exámenes médico legales por presunto delito sexual contra niños, niñas y adolescentes",2021,3,9,5614,160.313501959387,2,2841,70.3977472720873,7,2773,252.434186801298
34007,44,44650,81,"Tasa de exámenes médico legales por presunto delito sexual contra niños, niñas y adolescentes",2021,4,4,5377,74.3909243072345,1,2741,36.4830353885443,3,2636,113.808801213961
34008,44,44650,121,Tasa de exámenes médico legales por presunto delito sexual cuando la víctima está entre 18 y 28 años,2021,5,4,9740,41.0677618069815,0,4862,0,4,4878,82.0008200082001
34009,44,44847,81,"Tasa de exámenes médico legales por presunto delito sexual contra niños, niñas y adolescentes",2021,2,1,21394,4.67420772179116,1,11083,9.02282775421817,0,10311,0
34010,44,44847,81,"Tasa de exámenes médico legales por presunto delito sexual contra niños, niñas y adolescentes",2021,3,2,26479,7.55315533063938,1,13476,7.42059958444642,1,13003,7.69053295393371
34011,44,44847,81,"Tasa de exámenes médico legales por presunto delito sexual contra niños, niñas y adolescentes",2021,4,7,25754,27.1802438456162,1,12652,7.90388871324692,6,13102,45.7945351854679
34012,44,44847,121,Tasa de exámenes médico legales por presunto delito sexual cuando la víctima está entre 18 y 28 años,2021,5,1,42014,2.38015899462084,0,20604,0,1,21410,4.67071461933676
34013,44,44855,81,"Tasa de exámenes médico legales por presunto delito sexual contra niños, niñas y adolescentes",2021,3,2,1294,154.559505409583,0,643,0,2,651,307.219662058372
34014,44,44874,81,"Tasa de exámenes médico legales por presunto delito sexual contra niños, niñas y adolescentes",2021,3,1,3569,28.0190529560101,0,1769,0,1,1800,55.5555555555556
34015,44,44874,81,"Tasa de exámenes médico legales por presunto delito sexual contra niños, niñas y adolescentes",2021,4,5,3201,156.201187129022,1,1609,62.1504039776259,4,1592,251.256281407035
34016,47,47030,81,"Tasa de exámenes médico legales por presunto delito sexual contra niños, niñas y adolescentes",2021,4,3,2166,138.504155124654,0,1130,0,3,1036,289.57528957529
34017,47,47030,121,Tasa de exámenes médico legales por presunto delito sexual cuando la víctima está entre 18 y 28 años,2021,5,2,3138,63.7348629700446,0,1653,0,2,1485,134.680134680135
34018,47,47053,81,"Tasa de exámenes médico legales por presunto delito sexual contra niños, niñas y adolescentes",2021,4,2,5276,37.9075056861259,0,2738,0,2,2538,78.8022064617809
34019,47,47053,121,Tasa de exámenes médico legales por presunto delito sexual cuando la víctima está entre 18 y 28 años,2021,5,1,8425,11.8694362017804,0,4373,0,1,4052,24.6791707798618
34020,47,47058,81,"Tasa de exámenes médico legales por presunto delito sexual contra niños, niñas y adolescentes",2021,2,2,3233,61.8620476337767,1,1644,60.8272506082725,1,1589,62.9326620516048
34021,47,47058,81,"Tasa de exámenes médico legales por presunto delito sexual contra niños, niñas y adolescentes",2021,3,6,3958,151.591712986357,0,2039,0,6,1919,312.662845231892
34022,47,47058,81,"Tasa de exámenes médico legales por presunto delito sexual contra niños, niñas y adolescentes",2021,4,14,3804,368.033648790747,1,1975,50.6329113924051,13,1829,710.77091306725
34023,47,47058,121,Tasa de exámenes médico legales por presunto delito sexual cuando la víctima está entre 18 y 28 años,2021,5,1,5763,17.3520735727919,0,2916,0,1,2847,35.1246926589392
34024,47,47170,81,"Tasa de exámenes médico legales por presunto delito sexual contra niños, niñas y adolescentes",2021,4,5,2805,178.25311942959,0,1492,0,5,1313,380.807311500381
34025,47,47189,81,"Tasa de exámenes médico legales por presunto delito sexual contra niños, niñas y adolescentes",2021,3,5,14265,35.0508236943568,1,7285,13.7268359643102,4,6980,57.3065902578797
34026,47,47189,81,"Tasa de exámenes médico legales por presunto delito sexual contra niños, niñas y adolescentes",2021,4,10,14479,69.0655432004973,0,7487,0,10,6992,143.020594965675
34027,47,47189,121,Tasa de exámenes médico legales por presunto delito sexual cuando la víctima está entre 18 y 28 años,2021,5,3,24749,12.1217018869449,0,12641,0,3,12108,24.7770069375619
34028,47,47245,81,"Tasa de exámenes médico legales por presunto delito sexual contra niños, niñas y adolescentes",2021,2,3,7206,41.6319733555371,0,3711,0,3,3495,85.8369098712446
34029,47,47245,81,"Tasa de exámenes médico legales por presunto delito sexual contra niños, niñas y adolescentes",2021,3,10,8752,114.259597806216,2,4481,44.6328944432046,8,4271,187.309763521424
34030,47,47245,81,"Tasa de exámenes médico legales por presunto delito sexual contra niños, niñas y adolescentes",2021,4,26,8397,309.634393235679,2,4304,46.4684014869888,24,4093,586.366967994136
34031,47,47245,121,Tasa de exámenes médico legales por presunto delito sexual cuando la víctima está entre 18 y 28 años,2021,5,4,12886,31.041440322831,0,6653,0,4,6233,64.1745547890262
34032,47,47258,81,"Tasa de exámenes médico legales por presunto delito sexual contra niños, niñas y adolescentes",2021,3,1,2686,37.2300819061802,0,1362,0,1,1324,75.5287009063444
34033,47,47268,81,"Tasa de exámenes médico legales por presunto delito sexual contra niños, niñas y adolescentes",2021,4,2,2784,71.8390804597701,0,1459,0,2,1325,150.943396226415
34034,47,47268,121,Tasa de exámenes médico legales por presunto delito sexual cuando la víctima está entre 18 y 28 años,2021,5,1,4267,23.4356690883525,1,2189,45.6829602558246,0,2078,0
34035,47,47288,81,"Tasa de exámenes médico legales por presunto delito sexual contra niños, niñas y adolescentes",2021,3,2,8868,22.55299954894,0,4534,0,2,4334,46.1467466543609
34036,47,47288,81,"Tasa de exámenes médico legales por presunto delito sexual contra niños, niñas y adolescentes",2021,4,8,8819,90.7132327928337,0,4513,0,8,4306,185.78727357176
34037,47,47288,121,Tasa de exámenes médico legales por presunto delito sexual cuando la víctima está entre 18 y 28 años,2021,5,5,13491,37.0617448669483,1,6813,14.6778218112432,4,6678,59.8981731057203
34038,47,47318,81,"Tasa de exámenes médico legales por presunto delito sexual contra niños, niñas y adolescentes",2021,4,3,3281,91.4355379457483,0,1764,0,3,1517,197.7587343441
34039,47,47460,81,"Tasa de exámenes médico legales por presunto delito sexual contra niños, niñas y adolescentes",2021,3,1,2847,35.1246926589392,1,1476,67.7506775067751,0,1371,0
34040,47,47460,81,"Tasa de exámenes médico legales por presunto delito sexual contra niños, niñas y adolescentes",2021,4,4,2702,148.038490007402,0,1407,0,4,1295,308.880308880309
34041,47,47541,81,"Tasa de exámenes médico legales por presunto delito sexual contra niños, niñas y adolescentes",2021,2,1,928,107.758620689655,0,491,0,1,437,228.83295194508
34042,47,47541,81,"Tasa de exámenes médico legales por presunto delito sexual contra niños, niñas y adolescentes",2021,4,1,1046,95.6022944550669,0,544,0,1,502,199.203187250996
34043,47,47555,81,"Tasa de exámenes médico legales por presunto delito sexual contra niños, niñas y adolescentes",2021,2,2,6390,31.2989045383412,0,3194,0,2,3196,62.5782227784731
34044,47,47555,81,"Tasa de exámenes médico legales por presunto delito sexual contra niños, niñas y adolescentes",2021,3,14,7838,178.616994131156,2,3966,50.4286434694907,12,3872,309.917355371901
34045,47,47555,81,"Tasa de exámenes médico legales por presunto delito sexual contra niños, niñas y adolescentes",2021,4,23,7642,300.968332897147,1,3939,25.3871541000254,22,3703,594.112881447475
34046,47,47555,121,Tasa de exámenes médico legales por presunto delito sexual cuando la víctima está entre 18 y 28 años,2021,5,3,11894,25.2228014124769,0,6107,0,3,5787,51.8403317781234
34047,47,47570,81,"Tasa de exámenes médico legales por presunto delito sexual contra niños, niñas y adolescentes",2021,3,1,4050,24.6913580246914,0,2001,0,1,2049,48.8042947779405
34048,47,47605,81,"Tasa de exámenes médico legales por presunto delito sexual contra niños, niñas y adolescentes",2021,4,1,1249,80.0640512409928,0,661,0,1,588,170.068027210884
34049,47,47660,81,"Tasa de exámenes médico legales por presunto delito sexual contra niños, niñas y adolescentes",2021,4,1,2087,47.9156684235745,0,1127,0,1,960,104.166666666667
34050,47,47692,81,"Tasa de exámenes médico legales por presunto delito sexual contra niños, niñas y adolescentes",2021,4,2,2463,81.2017864393017,0,1309,0,2,1154,173.310225303293
34051,47,47692,121,Tasa de exámenes médico legales por presunto delito sexual cuando la víctima está entre 18 y 28 años,2021,5,1,3365,29.7176820208024,1,1706,58.6166471277843,0,1659,0
34052,47,47707,121,Tasa de exámenes médico legales por presunto delito sexual cuando la víctima está entre 18 y 28 años,2021,5,1,4643,21.5377988369589,0,2357,0,1,2286,43.7445319335083
34053,47,47720,81,"Tasa de exámenes médico legales por presunto delito sexual contra niños, niñas y adolescentes",2021,4,1,1361,73.4753857457752,0,706,0,1,655,152.671755725191
34054,47,47001,81,"Tasa de exámenes médico legales por presunto delito sexual contra niños, niñas y adolescentes",2021,2,27,44420,60.7834308869879,6,22846,26.2628031165193,21,21574,97.3393900064893
34055,47,47001,81,"Tasa de exámenes médico legales por presunto delito sexual contra niños, niñas y adolescentes",2021,3,57,54947,103.736327733998,15,28197,53.1971486328333,42,26750,157.009345794393
34056,47,47001,81,"Tasa de exámenes médico legales por presunto delito sexual contra niños, niñas y adolescentes",2021,4,126,56696,222.237900380979,7,28832,24.2785793562708,119,27864,427.074361182888
34057,47,47001,121,Tasa de exámenes médico legales por presunto delito sexual cuando la víctima está entre 18 y 28 años,2021,5,33,107036,30.8307485332038,1,53194,1.87991126818814,32,53842,59.4331562720553
34058,47,47745,81,"Tasa de exámenes médico legales por presunto delito sexual contra niños, niñas y adolescentes",2021,2,1,2913,34.3288705801579,1,1485,67.3400673400674,0,1428,0
34059,47,47745,81,"Tasa de exámenes médico legales por presunto delito sexual contra niños, niñas y adolescentes",2021,3,4,3570,112.044817927171,0,1816,0,4,1754,228.050171037628
34060,47,47745,81,"Tasa de exámenes médico legales por presunto delito sexual contra niños, niñas y adolescentes",2021,4,2,3506,57.0450656018254,0,1787,0,2,1719,116.346713205352
34061,47,47798,81,"Tasa de exámenes médico legales por presunto delito sexual contra niños, niñas y adolescentes",2021,2,1,1297,77.1010023130301,1,690,144.927536231884,0,607,0
34062,47,47798,81,"Tasa de exámenes médico legales por presunto delito sexual contra niños, niñas y adolescentes",2021,4,6,1649,363.856882959369,2,853,234.466588511137,4,796,502.51256281407
34063,47,47798,121,Tasa de exámenes médico legales por presunto delito sexual cuando la víctima está entre 18 y 28 años,2021,5,1,2327,42.9737859905458,0,1240,0,1,1087,91.9963201471941
34064,47,47980,81,"Tasa de exámenes médico legales por presunto delito sexual contra niños, niñas y adolescentes",2021,3,2,9680,20.6611570247934,0,4906,0,2,4774,41.8935902806871
34065,47,47980,81,"Tasa de exámenes médico legales por presunto delito sexual contra niños, niñas y adolescentes",2021,4,3,9308,32.2303394929093,1,4732,21.1327134404057,2,4576,43.7062937062937
34066,50,50006,81,"Tasa de exámenes médico legales por presunto delito sexual contra niños, niñas y adolescentes",2021,2,6,7187,83.4840684569361,2,3718,53.7923614846692,4,3469,115.307004900548
34067,50,50006,81,"Tasa de exámenes médico legales por presunto delito sexual contra niños, niñas y adolescentes",2021,3,14,8725,160.458452722063,3,4471,67.0990829791993,11,4254,258.580159849553
34068,50,50006,81,"Tasa de exámenes médico legales por presunto delito sexual contra niños, niñas y adolescentes",2021,4,23,8761,262.527108777537,2,4411,45.3411924733621,21,4350,482.758620689655
34069,50,50006,121,Tasa de exámenes médico legales por presunto delito sexual cuando la víctima está entre 18 y 28 años,2021,5,10,17196,58.1530588508956,0,9039,0,10,8157,122.594090964815
34070,50,50110,81,"Tasa de exámenes médico legales por presunto delito sexual contra niños, niñas y adolescentes",2021,2,2,669,298.953662182362,1,322,310.55900621118,1,347,288.184438040346
34071,50,50110,81,"Tasa de exámenes médico legales por presunto delito sexual contra niños, niñas y adolescentes",2021,4,4,827,483.675937122128,1,409,244.498777506112,3,418,717.703349282297
34072,50,50124,81,"Tasa de exámenes médico legales por presunto delito sexual contra niños, niñas y adolescentes",2021,2,1,598,167.224080267559,0,308,0,1,290,344.827586206897
34073,50,50124,81,"Tasa de exámenes médico legales por presunto delito sexual contra niños, niñas y adolescentes",2021,3,6,711,843.881856540084,1,383,261.096605744125,5,328,1524.39024390244
34074,50,50124,81,"Tasa de exámenes médico legales por presunto delito sexual contra niños, niñas y adolescentes",2021,4,4,652,613.496932515337,0,356,0,4,296,1351.35135135135
34075,50,50124,121,Tasa de exámenes médico legales por presunto delito sexual cuando la víctima está entre 18 y 28 años,2021,5,2,1119,178.731009830206,0,593,0,2,526,380.228136882129
34076,50,50150,81,"Tasa de exámenes médico legales por presunto delito sexual contra niños, niñas y adolescentes",2021,3,1,1759,56.8504832291075,0,883,0,1,876,114.155251141553
34077,50,50150,81,"Tasa de exámenes médico legales por presunto delito sexual contra niños, niñas y adolescentes",2021,4,5,1739,287.521564117309,0,866,0,5,873,572.737686139748
34078,50,50226,81,"Tasa de exámenes médico legales por presunto delito sexual contra niños, niñas y adolescentes",2021,3,6,2428,247.116968698517,1,1230,81.3008130081301,5,1198,417.362270450751
34079,50,50226,81,"Tasa de exámenes médico legales por presunto delito sexual contra niños, niñas y adolescentes",2021,4,5,2505,199.600798403194,1,1259,79.428117553614,4,1246,321.027287319422
34080,50,50226,121,Tasa de exámenes médico legales por presunto delito sexual cuando la víctima está entre 18 y 28 años,2021,5,3,4293,69.8812019566737,0,2094,0,3,2199,136.425648021828
34081,50,50251,81,"Tasa de exámenes médico legales por presunto delito sexual contra niños, niñas y adolescentes",2021,3,1,849,117.785630153121,1,437,228.83295194508,0,412,0
34082,50,50251,81,"Tasa de exámenes médico legales por presunto delito sexual contra niños, niñas y adolescentes",2021,4,2,860,232.558139534884,0,453,0,2,407,491.400491400491
34083,50,50251,121,Tasa de exámenes médico legales por presunto delito sexual cuando la víctima está entre 18 y 28 años,2021,5,2,1197,167.084377610693,0,609,0,2,588,340.136054421769
34084,50,50270,81,"Tasa de exámenes médico legales por presunto delito sexual contra niños, niñas y adolescentes",2021,2,1,284,352.112676056338,0,140,0,1,144,694.444444444445
34085,50,50270,81,"Tasa de exámenes médico legales por presunto delito sexual contra niños, niñas y adolescentes",2021,3,5,451,1108.64745011086,0,232,0,5,219,2283.10502283105
34086,50,50270,81,"Tasa de exámenes médico legales por presunto delito sexual contra niños, niñas y adolescentes",2021,4,4,503,795.228628230616,0,263,0,4,240,1666.66666666667
34087,50,50287,81,"Tasa de exámenes médico legales por presunto delito sexual contra niños, niñas y adolescentes",2021,2,1,1032,96.8992248062015,1,525,190.47619047619,0,507,0
34088,50,50287,81,"Tasa de exámenes médico legales por presunto delito sexual contra niños, niñas y adolescentes",2021,3,6,1353,443.458980044346,2,683,292.825768667643,4,670,597.014925373134
34089,50,50287,81,"Tasa de exámenes médico legales por presunto delito sexual contra niños, niñas y adolescentes",2021,4,4,1380,289.855072463768,0,703,0,4,677,590.841949778434
34090,50,50313,81,"Tasa de exámenes médico legales por presunto delito sexual contra niños, niñas y adolescentes",2021,2,2,6062,32.9924117452986,1,3033,32.9706561160567,1,3029,33.0141961043249
34091,50,50313,81,"Tasa de exámenes médico legales por presunto delito sexual contra niños, niñas y adolescentes",2021,3,6,7547,79.5017887902478,2,3785,52.8401585204756,4,3762,106.326422115896
34092,50,50313,81,"Tasa de exámenes médico legales por presunto delito sexual contra niños, niñas y adolescentes",2021,4,3,7674,39.0930414386239,0,3848,0,3,3826,78.4108729743858
34093,50,50313,121,Tasa de exámenes médico legales por presunto delito sexual cuando la víctima está entre 18 y 28 años,2021,5,2,12872,15.5376009944065,0,6218,0,2,6654,30.0571085061617
34094,50,50318,81,"Tasa de exámenes médico legales por presunto delito sexual contra niños, niñas y adolescentes",2021,3,1,1446,69.1562932226833,0,739,0,1,707,141.442715700141
34095,50,50318,81,"Tasa de exámenes médico legales por presunto delito sexual contra niños, niñas y adolescentes",2021,4,1,1423,70.2740688685875,0,723,0,1,700,142.857142857143
34096,50,50350,81,"Tasa de exámenes médico legales por presunto delito sexual contra niños, niñas y adolescentes",2021,3,3,3890,77.120822622108,0,1981,0,3,1909,157.150340492404
34097,50,50350,81,"Tasa de exámenes médico legales por presunto delito sexual contra niños, niñas y adolescentes",2021,4,2,3598,55.5864369093941,0,1891,0,2,1707,117.164616285882
34098,50,50400,81,"Tasa de exámenes médico legales por presunto delito sexual contra niños, niñas y adolescentes",2021,3,3,1240,241.935483870968,1,651,153.609831029186,2,589,339.55857385399
34099,50,50400,81,"Tasa de exámenes médico legales por presunto delito sexual contra niños, niñas y adolescentes",2021,4,2,1249,160.128102481986,1,668,149.700598802395,1,581,172.117039586919
34100,50,50325,81,"Tasa de exámenes médico legales por presunto delito sexual contra niños, niñas y adolescentes",2021,3,3,1098,273.224043715847,2,551,362.976406533575,1,547,182.815356489945
34101,50,50325,81,"Tasa de exámenes médico legales por presunto delito sexual contra niños, niñas y adolescentes",2021,4,1,827,120.918984280532,0,430,0,1,397,251.889168765743
34102,50,50325,121,Tasa de exámenes médico legales por presunto delito sexual cuando la víctima está entre 18 y 28 años,2021,5,1,1132,88.339222614841,0,575,0,1,557,179.533213644524
34103,50,50330,81,"Tasa de exámenes médico legales por presunto delito sexual contra niños, niñas y adolescentes",2021,2,1,957,104.493207941484,0,472,0,1,485,206.185567010309
34104,50,50330,81,"Tasa de exámenes médico legales por presunto delito sexual contra niños, niñas y adolescentes",2021,3,2,1191,167.926112510495,0,612,0,2,579,345.423143350604
34105,50,50330,81,"Tasa de exámenes médico legales por presunto delito sexual contra niños, niñas y adolescentes",2021,4,4,1168,342.465753424658,0,618,0,4,550,727.272727272727
34106,50,50330,121,Tasa de exámenes médico legales por presunto delito sexual cuando la víctima está entre 18 y 28 años,2021,5,1,1747,57.2409845449342,0,879,0,1,868,115.207373271889
34107,50,50450,81,"Tasa de exámenes médico legales por presunto delito sexual contra niños, niñas y adolescentes",2021,2,1,900,111.111111111111,1,486,205.761316872428,0,414,0
34108,50,50450,81,"Tasa de exámenes médico legales por presunto delito sexual contra niños, niñas y adolescentes",2021,3,3,1137,263.852242744063,0,596,0,3,541,554.52865064695
34109,50,50450,81,"Tasa de exámenes médico legales por presunto delito sexual contra niños, niñas y adolescentes",2021,4,4,1077,371.402042711235,0,550,0,4,527,759.013282732448
34110,50,50450,121,Tasa de exámenes médico legales por presunto delito sexual cuando la víctima está entre 18 y 28 años,2021,5,1,1355,73.8007380073801,0,677,0,1,678,147.492625368732
34111,50,50568,81,"Tasa de exámenes médico legales por presunto delito sexual contra niños, niñas y adolescentes",2021,3,1,6020,16.6112956810631,0,3028,0,1,2992,33.4224598930481
34112,50,50568,81,"Tasa de exámenes médico legales por presunto delito sexual contra niños, niñas y adolescentes",2021,4,4,5165,77.4443368828654,0,2647,0,4,2518,158.856235107228
34113,50,50577,81,"Tasa de exámenes médico legales por presunto delito sexual contra niños, niñas y adolescentes",2021,2,3,914,328.227571115974,1,476,210.084033613445,2,438,456.62100456621
34114,50,50577,81,"Tasa de exámenes médico legales por presunto delito sexual contra niños, niñas y adolescentes",2021,3,2,1233,162.20600162206,0,645,0,2,588,340.136054421769
34115,50,50577,81,"Tasa de exámenes médico legales por presunto delito sexual contra niños, niñas y adolescentes",2021,4,3,1270,236.220472440945,0,671,0,3,599,500.834724540902
34116,50,50577,121,Tasa de exámenes médico legales por presunto delito sexual cuando la víctima está entre 18 y 28 años,2021,5,1,1708,58.5480093676815,0,880,0,1,828,120.772946859903
34117,50,50573,81,"Tasa de exámenes médico legales por presunto delito sexual contra niños, niñas y adolescentes",2021,2,3,2897,103.555402140145,0,1502,0,3,1395,215.05376344086
34118,50,50573,81,"Tasa de exámenes médico legales por presunto delito sexual contra niños, niñas y adolescentes",2021,3,10,3506,285.225328009127,2,1825,109.58904109589,8,1681,475.907198096371
34119,50,50573,81,"Tasa de exámenes médico legales por presunto delito sexual contra niños, niñas y adolescentes",2021,4,28,3349,836.070468796656,4,1747,228.963938179737,24,1602,1498.12734082397
34120,50,50573,121,Tasa de exámenes médico legales por presunto delito sexual cuando la víctima está entre 18 y 28 años,2021,5,3,5348,56.095736724009,0,2656,0,3,2692,111.441307578009
34121,50,50590,81,"Tasa de exámenes médico legales por presunto delito sexual contra niños, niñas y adolescentes",2021,2,2,1222,163.66612111293,1,608,164.473684210526,1,614,162.866449511401
34122,50,50590,81,"Tasa de exámenes médico legales por presunto delito sexual contra niños, niñas y adolescentes",2021,4,3,1400,214.285714285714,0,708,0,3,692,433.526011560694
34123,50,50606,81,"Tasa de exámenes médico legales por presunto delito sexual contra niños, niñas y adolescentes",2021,2,4,1461,273.78507871321,0,738,0,4,723,553.250345781466
34124,50,50606,81,"Tasa de exámenes médico legales por presunto delito sexual contra niños, niñas y adolescentes",2021,3,4,1811,220.872446162341,0,932,0,4,879,455.062571103527
34125,50,50606,81,"Tasa de exámenes médico legales por presunto delito sexual contra niños, niñas y adolescentes",2021,4,7,1849,378.583017847485,1,970,103.092783505155,6,879,682.59385665529
34126,50,50606,121,Tasa de exámenes médico legales por presunto delito sexual cuando la víctima está entre 18 y 28 años,2021,5,1,3242,30.8451573103023,0,1647,0,1,1595,62.6959247648903
34127,50,50680,81,"Tasa de exámenes médico legales por presunto delito sexual contra niños, niñas y adolescentes",2021,2,1,1352,73.9644970414201,0,690,0,1,662,151.057401812689
34128,50,50680,81,"Tasa de exámenes médico legales por presunto delito sexual contra niños, niñas y adolescentes",2021,3,2,1557,128.452151573539,0,792,0,2,765,261.437908496732
34129,50,50680,81,"Tasa de exámenes médico legales por presunto delito sexual contra niños, niñas y adolescentes",2021,4,3,1451,206.753962784287,1,737,135.685210312076,2,714,280.112044817927
34130,50,50680,121,Tasa de exámenes médico legales por presunto delito sexual cuando la víctima está entre 18 y 28 años,2021,5,1,2414,41.4250207125104,0,1226,0,1,1188,84.1750841750842
34131,50,50683,81,"Tasa de exámenes médico legales por presunto delito sexual contra niños, niñas y adolescentes",2021,3,2,894,223.713646532438,0,449,0,2,445,449.438202247191
34132,50,50683,81,"Tasa de exámenes médico legales por presunto delito sexual contra niños, niñas y adolescentes",2021,4,1,1064,93.984962406015,0,584,0,1,480,208.333333333333
34133,50,50223,81,"Tasa de exámenes médico legales por presunto delito sexual contra niños, niñas y adolescentes",2021,3,1,701,142.65335235378,0,370,0,1,331,302.114803625378
34134,50,50689,81,"Tasa de exámenes médico legales por presunto delito sexual contra niños, niñas y adolescentes",2021,3,1,2862,34.9406009783368,1,1449,69.0131124913734,0,1413,0
34135,50,50689,81,"Tasa de exámenes médico legales por presunto delito sexual contra niños, niñas y adolescentes",2021,4,2,2951,67.7736360555744,0,1516,0,2,1435,139.372822299652
34136,50,50370,81,"Tasa de exámenes médico legales por presunto delito sexual contra niños, niñas y adolescentes",2021,3,2,1131,176.83465959328,0,583,0,2,548,364.963503649635
34137,50,50370,81,"Tasa de exámenes médico legales por presunto delito sexual contra niños, niñas y adolescentes",2021,4,6,1350,444.444444444444,0,726,0,6,624,961.538461538462
34138,50,50001,81,"Tasa de exámenes médico legales por presunto delito sexual contra niños, niñas y adolescentes",2021,2,50,40176,124.452409398646,7,20841,33.5876397485725,43,19335,222.394621153349
34139,50,50001,81,"Tasa de exámenes médico legales por presunto delito sexual contra niños, niñas y adolescentes",2021,3,137,49666,275.842628760118,28,25708,108.915512680878,109,23958,454.962851657067
34140,50,50001,81,"Tasa de exámenes médico legales por presunto delito sexual contra niños, niñas y adolescentes",2021,4,188,52395,358.812863822884,18,27047,66.5508189447998,170,25348,670.664352217137
34141,50,50001,121,Tasa de exámenes médico legales por presunto delito sexual cuando la víctima está entre 18 y 28 años,2021,5,42,103870,40.4351593337826,2,53315,3.75128950576761,40,50555,79.1217485906439
34142,50,50001,81,"Tasa de exámenes médico legales por presunto delito sexual contra niños, niñas y adolescentes",2021,1,2,7772,25.7334019557386,0,4028,0,2,3744,53.4188034188034
34143,50,50711,81,"Tasa de exámenes médico legales por presunto delito sexual contra niños, niñas y adolescentes",2021,2,2,1455,137.45704467354,0,749,0,2,706,283.28611898017
34144,50,50711,81,"Tasa de exámenes médico legales por presunto delito sexual contra niños, niñas y adolescentes",2021,3,1,1944,51.440329218107,0,985,0,1,959,104.275286757039
34145,50,50711,81,"Tasa de exámenes médico legales por presunto delito sexual contra niños, niñas y adolescentes",2021,4,2,1993,100.351229302559,0,1007,0,2,986,202.839756592292
34146,52,52019,121,Tasa de exámenes médico legales por presunto delito sexual cuando la víctima está entre 18 y 28 años,2021,5,1,1657,60.3500301750151,0,843,0,1,814,122.850122850123
34147,52,52022,81,"Tasa de exámenes médico legales por presunto delito sexual contra niños, niñas y adolescentes",2021,2,1,494,202.429149797571,0,269,0,1,225,444.444444444444
34148,52,52079,121,Tasa de exámenes médico legales por presunto delito sexual cuando la víctima está entre 18 y 28 años,2021,5,2,11116,17.9920834832674,2,5803,34.4649319317594,0,5313,0
34149,52,52083,81,"Tasa de exámenes médico legales por presunto delito sexual contra niños, niñas y adolescentes",2021,4,1,478,209.205020920502,0,242,0,1,236,423.728813559322
34150,52,52240,121,Tasa de exámenes médico legales por presunto delito sexual cuando la víctima está entre 18 y 28 años,2021,5,1,2720,36.7647058823529,0,1378,0,1,1342,74.5156482861401
34151,52,52215,81,"Tasa de exámenes médico legales por presunto delito sexual contra niños, niñas y adolescentes",2021,3,1,1390,71.9424460431655,0,702,0,1,688,145.348837209302
34152,52,52250,81,"Tasa de exámenes médico legales por presunto delito sexual contra niños, niñas y adolescentes",2021,4,1,2873,34.8068221371389,0,1476,0,1,1397,71.5819613457409
34153,52,52256,81,"Tasa de exámenes médico legales por presunto delito sexual contra niños, niñas y adolescentes",2021,4,1,1145,87.3362445414847,0,596,0,1,549,182.149362477231
34154,52,52520,81,"Tasa de exámenes médico legales por presunto delito sexual contra niños, niñas y adolescentes",2021,3,1,1794,55.7413600891862,0,926,0,1,868,115.207373271889
34155,52,52520,121,Tasa de exámenes médico legales por presunto delito sexual cuando la víctima está entre 18 y 28 años,2021,5,1,2381,41.9991600167997,0,1213,0,1,1168,85.6164383561644
34156,52,52320,81,"Tasa de exámenes médico legales por presunto delito sexual contra niños, niñas y adolescentes",2021,3,3,831,361.01083032491,0,417,0,3,414,724.63768115942
34157,52,52352,81,"Tasa de exámenes médico legales por presunto delito sexual contra niños, niñas y adolescentes",2021,2,1,546,183.150183150183,0,280,0,1,266,375.93984962406
34158,52,52356,81,"Tasa de exámenes médico legales por presunto delito sexual contra niños, niñas y adolescentes",2021,3,1,10282,9.72573429293912,0,5222,0,1,5060,19.7628458498024
34159,52,52356,81,"Tasa de exámenes médico legales por presunto delito sexual contra niños, niñas y adolescentes",2021,4,5,10448,47.8560490045942,0,5329,0,5,5119,97.6753272123462
34160,52,52356,121,Tasa de exámenes médico legales por presunto delito sexual cuando la víctima está entre 18 y 28 años,2021,5,4,20872,19.1644308164048,0,10573,0,4,10299,38.8387222060394
34161,52,52385,121,Tasa de exámenes médico legales por presunto delito sexual cuando la víctima está entre 18 y 28 años,2021,5,1,1232,81.1688311688312,0,621,0,1,611,163.66612111293
34162,52,52473,81,"Tasa de exámenes médico legales por presunto delito sexual contra niños, niñas y adolescentes",2021,4,1,1562,64.0204865556978,0,778,0,1,784,127.551020408163
34163,52,52506,121,Tasa de exámenes médico legales por presunto delito sexual cuando la víctima está entre 18 y 28 años,2021,5,1,1240,80.6451612903226,0,640,0,1,600,166.666666666667
34164,52,52001,81,"Tasa de exámenes médico legales por presunto delito sexual contra niños, niñas y adolescentes",2021,2,5,23472,21.3019768234492,2,11987,16.6847418036206,3,11485,26.1210274270788
34165,52,52001,81,"Tasa de exámenes médico legales por presunto delito sexual contra niños, niñas y adolescentes",2021,3,7,28512,24.5510662177329,1,14494,6.89940665102801,6,14018,42.8021115708375
34166,52,52001,81,"Tasa de exámenes médico legales por presunto delito sexual contra niños, niñas y adolescentes",2021,4,16,31222,51.2459163410416,0,15802,0,16,15420,103.761348897536
34167,52,52001,121,Tasa de exámenes médico legales por presunto delito sexual cuando la víctima está entre 18 y 28 años,2021,5,18,70924,25.3792792284699,2,35486,5.63602547483515,16,35438,45.1492747897737
34168,52,52573,81,"Tasa de exámenes médico legales por presunto delito sexual contra niños, niñas y adolescentes",2021,4,1,693,144.300144300144,0,377,0,1,316,316.455696202532
34169,52,52678,81,"Tasa de exámenes médico legales por presunto delito sexual contra niños, niñas y adolescentes",2021,3,1,2103,47.5511174512601,0,1081,0,1,1022,97.8473581213307
34170,52,52835,81,"Tasa de exámenes médico legales por presunto delito sexual contra niños, niñas y adolescentes",2021,2,2,25573,7.82074844562625,0,13027,0,2,12546,15.9413358839471
34171,52,52835,81,"Tasa de exámenes médico legales por presunto delito sexual contra niños, niñas y adolescentes",2021,3,8,30236,26.4585262600873,0,15333,0,8,14903,53.6804670200631
34172,52,52835,81,"Tasa de exámenes médico legales por presunto delito sexual contra niños, niñas y adolescentes",2021,4,3,29639,10.1217989810722,0,15056,0,3,14583,20.571898786258
34173,52,52835,121,Tasa de exámenes médico legales por presunto delito sexual cuando la víctima está entre 18 y 28 años,2021,5,1,50130,1.99481348493916,0,25251,0,1,24879,4.01945415812533
34174,52,52786,81,"Tasa de exámenes médico legales por presunto delito sexual contra niños, niñas y adolescentes",2021,4,1,1509,66.2690523525514,0,787,0,1,722,138.504155124654
34175,52,52838,81,"Tasa de exámenes médico legales por presunto delito sexual contra niños, niñas y adolescentes",2021,4,1,3969,25.1952632905014,0,2059,0,1,1910,52.3560209424084
34176,52,52885,81,"Tasa de exámenes médico legales por presunto delito sexual contra niños, niñas y adolescentes",2021,3,1,847,118.063754427391,0,437,0,1,410,243.90243902439
34177,54,54003,81,"Tasa de exámenes médico legales por presunto delito sexual contra niños, niñas y adolescentes",2021,3,3,4002,74.9625187406297,1,2035,49.1400491400491,2,1967,101.677681748856
34178,54,54003,81,"Tasa de exámenes médico legales por presunto delito sexual contra niños, niñas y adolescentes",2021,4,9,3784,237.84355179704,3,1915,156.657963446475,6,1869,321.027287319422
34179,54,54051,81,"Tasa de exámenes médico legales por presunto delito sexual contra niños, niñas y adolescentes",2021,3,1,1077,92.8505106778087,1,566,176.678445229682,0,511,0
34180,54,54051,81,"Tasa de exámenes médico legales por presunto delito sexual contra niños, niñas y adolescentes",2021,4,2,1108,180.505415162455,0,615,0,2,493,405.679513184584
34181,54,54051,121,Tasa de exámenes médico legales por presunto delito sexual cuando la víctima está entre 18 y 28 años,2021,5,1,1774,56.369785794814,0,974,0,1,800,125
34182,54,54099,81,"Tasa de exámenes médico legales por presunto delito sexual contra niños, niñas y adolescentes",2021,3,2,865,231.21387283237,0,474,0,2,391,511.50895140665
34183,54,54099,81,"Tasa de exámenes médico legales por presunto delito sexual contra niños, niñas y adolescentes",2021,4,1,883,113.250283125708,0,505,0,1,378,264.550264550265
34184,54,54099,121,Tasa de exámenes médico legales por presunto delito sexual cuando la víctima está entre 18 y 28 años,2021,5,1,1537,65.0618087182824,0,833,0,1,704,142.045454545455
34185,54,54128,81,"Tasa de exámenes médico legales por presunto delito sexual contra niños, niñas y adolescentes",2021,4,1,1315,76.0456273764259,0,702,0,1,613,163.132137030995
34186,54,54172,81,"Tasa de exámenes médico legales por presunto delito sexual contra niños, niñas y adolescentes",2021,2,3,1465,204.778156996587,1,731,136.798905608755,2,734,272.479564032698
34187,54,54172,81,"Tasa de exámenes médico legales por presunto delito sexual contra niños, niñas y adolescentes",2021,3,3,1816,165.198237885463,0,905,0,3,911,329.308452250274
34188,54,54172,121,Tasa de exámenes médico legales por presunto delito sexual cuando la víctima está entre 18 y 28 años,2021,5,1,3254,30.7314074984634,0,1634,0,1,1620,61.7283950617284
34189,54,54174,81,"Tasa de exámenes médico legales por presunto delito sexual contra niños, niñas y adolescentes",2021,4,1,1356,73.7463126843658,0,724,0,1,632,158.227848101266
34190,54,54206,81,"Tasa de exámenes médico legales por presunto delito sexual contra niños, niñas y adolescentes",2021,4,5,2369,211.059518784297,1,1222,81.8330605564648,4,1147,348.7358326068
34191,54,54001,81,"Tasa de exámenes médico legales por presunto delito sexual contra niños, niñas y adolescentes",2021,2,36,62225,57.8545600642828,13,31997,40.6288089508391,23,30228,76.0883948656874
34192,54,54001,81,"Tasa de exámenes médico legales por presunto delito sexual contra niños, niñas y adolescentes",2021,3,98,73620,133.116001086661,21,37769,55.601154385872,77,35851,214.77783046498
34193,54,54001,81,"Tasa de exámenes médico legales por presunto delito sexual contra niños, niñas y adolescentes",2021,4,137,73650,186.014935505771,12,37476,32.020493115594,125,36174,345.552053961409
34194,54,54001,121,Tasa de exámenes médico legales por presunto delito sexual cuando la víctima está entre 18 y 28 años,2021,5,26,152099,17.0941294814562,4,76733,5.21288102902272,22,75366,29.1908818300029
34195,54,54223,81,"Tasa de exámenes médico legales por presunto delito sexual contra niños, niñas y adolescentes",2021,3,3,853,351.699882766706,2,428,467.289719626168,1,425,235.294117647059
34196,54,54223,81,"Tasa de exámenes médico legales por presunto delito sexual contra niños, niñas y adolescentes",2021,4,3,930,322.58064516129,0,481,0,3,449,668.15144766147
34197,54,54223,121,Tasa de exámenes médico legales por presunto delito sexual cuando la víctima está entre 18 y 28 años,2021,5,1,1509,66.2690523525514,0,794,0,1,715,139.86013986014
34198,54,54239,81,"Tasa de exámenes médico legales por presunto delito sexual contra niños, niñas y adolescentes",2021,4,1,450,222.222222222222,0,244,0,1,206,485.436893203883
34199,54,54245,81,"Tasa de exámenes médico legales por presunto delito sexual contra niños, niñas y adolescentes",2021,3,1,1789,55.8971492453885,0,915,0,1,874,114.41647597254
34200,54,54250,81,"Tasa de exámenes médico legales por presunto delito sexual contra niños, niñas y adolescentes",2021,2,1,2995,33.3889816360601,1,1543,64.8088139987038,0,1452,0
34201,54,54250,81,"Tasa de exámenes médico legales por presunto delito sexual contra niños, niñas y adolescentes",2021,3,1,3174,31.5059861373661,0,1644,0,1,1530,65.359477124183
34202,54,54250,121,Tasa de exámenes médico legales por presunto delito sexual cuando la víctima está entre 18 y 28 años,2021,5,1,4604,21.7202432667246,0,2368,0,1,2236,44.7227191413238
34203,54,54261,81,"Tasa de exámenes médico legales por presunto delito sexual contra niños, niñas y adolescentes",2021,3,3,3308,90.689238210399,2,1728,115.740740740741,1,1580,63.2911392405063
34204,54,54261,81,"Tasa de exámenes médico legales por presunto delito sexual contra niños, niñas y adolescentes",2021,4,4,3158,126.662444585181,0,1637,0,4,1521,262.984878369494
34205,54,54313,81,"Tasa de exámenes médico legales por presunto delito sexual contra niños, niñas y adolescentes",2021,3,1,652,153.374233128834,0,351,0,1,301,332.225913621262
34206,54,54344,81,"Tasa de exámenes médico legales por presunto delito sexual contra niños, niñas y adolescentes",2021,3,1,1551,64.4745325596389,0,797,0,1,754,132.62599469496
34207,54,54344,81,"Tasa de exámenes médico legales por presunto delito sexual contra niños, niñas y adolescentes",2021,4,1,1374,72.7802037845706,0,710,0,1,664,150.602409638554
34208,54,54385,81,"Tasa de exámenes médico legales por presunto delito sexual contra niños, niñas y adolescentes",2021,2,1,1467,68.1663258350375,0,775,0,1,692,144.508670520231
34209,54,54385,81,"Tasa de exámenes médico legales por presunto delito sexual contra niños, niñas y adolescentes",2021,3,2,1666,120.048019207683,0,850,0,2,816,245.098039215686
34210,54,54385,81,"Tasa de exámenes médico legales por presunto delito sexual contra niños, niñas y adolescentes",2021,4,6,1488,403.225806451613,1,753,132.802124833997,5,735,680.272108843537
34211,54,54398,81,"Tasa de exámenes médico legales por presunto delito sexual contra niños, niñas y adolescentes",2021,2,1,801,124.843945068664,0,413,0,1,388,257.731958762887
34212,54,54398,81,"Tasa de exámenes médico legales por presunto delito sexual contra niños, niñas y adolescentes",2021,4,1,924,108.225108225108,0,468,0,1,456,219.298245614035
34213,54,54377,81,"Tasa de exámenes médico legales por presunto delito sexual contra niños, niñas y adolescentes",2021,2,1,546,183.150183150183,0,272,0,1,274,364.963503649635
34214,54,54377,81,"Tasa de exámenes médico legales por presunto delito sexual contra niños, niñas y adolescentes",2021,3,2,683,292.825768667643,0,344,0,2,339,589.970501474926
34215,54,54405,81,"Tasa de exámenes médico legales por presunto delito sexual contra niños, niñas y adolescentes",2021,2,2,7577,26.395671109938,1,3798,26.3296471827278,1,3779,26.4620269912675
34216,54,54405,81,"Tasa de exámenes médico legales por presunto delito sexual contra niños, niñas y adolescentes",2021,3,4,9177,43.58722894192,0,4679,0,4,4498,88.9284126278346
34217,54,54405,81,"Tasa de exámenes médico legales por presunto delito sexual contra niños, niñas y adolescentes",2021,4,11,9196,119.617224880383,5,4731,105.68590150074,6,4465,134.37849944009
34218,54,54405,121,Tasa de exámenes médico legales por presunto delito sexual cuando la víctima está entre 18 y 28 años,2021,5,3,18134,16.5435094298004,0,9006,0,3,9128,32.8659070990359
34219,54,54418,81,"Tasa de exámenes médico legales por presunto delito sexual contra niños, niñas y adolescentes",2021,3,2,476,420.168067226891,2,257,778.210116731518,0,219,0
34220,54,54418,81,"Tasa de exámenes médico legales por presunto delito sexual contra niños, niñas y adolescentes",2021,4,2,449,445.43429844098,0,240,0,2,209,956.937799043062
34221,54,54498,81,"Tasa de exámenes médico legales por presunto delito sexual contra niños, niñas y adolescentes",2021,2,4,10397,38.472636337405,1,5198,19.2381685263563,3,5199,57.7034045008655
34222,54,54498,81,"Tasa de exámenes médico legales por presunto delito sexual contra niños, niñas y adolescentes",2021,3,9,12599,71.4342408127629,1,6323,15.8152775581211,8,6276,127.469725940089
34223,54,54498,81,"Tasa de exámenes médico legales por presunto delito sexual contra niños, niñas y adolescentes",2021,4,19,12880,147.515527950311,1,6459,15.4822727976467,18,6421,280.33016664071
34224,54,54498,121,Tasa de exámenes médico legales por presunto delito sexual cuando la víctima está entre 18 y 28 años,2021,5,6,25026,23.9750659314313,1,12370,8.08407437348424,5,12656,39.5069532237674
34225,54,54518,81,"Tasa de exámenes médico legales por presunto delito sexual contra niños, niñas y adolescentes",2021,2,2,3469,57.6535024502739,0,1749,0,2,1720,116.279069767442
34226,54,54518,81,"Tasa de exámenes médico legales por presunto delito sexual contra niños, niñas y adolescentes",2021,3,5,4525,110.497237569061,1,2271,44.0334654337296,4,2254,177.462289263532
34227,54,54518,81,"Tasa de exámenes médico legales por presunto delito sexual contra niños, niñas y adolescentes",2021,4,10,5346,187.055742611298,0,2710,0,10,2636,379.362670713202
34228,54,54518,121,Tasa de exámenes médico legales por presunto delito sexual cuando la víctima está entre 18 y 28 años,2021,5,3,11537,26.0032937505417,0,5974,0,3,5563,53.9277368326443
34229,54,54520,81,"Tasa de exámenes médico legales por presunto delito sexual contra niños, niñas y adolescentes",2021,4,1,580,172.413793103448,0,306,0,1,274,364.963503649635
34230,54,54520,121,Tasa de exámenes médico legales por presunto delito sexual cuando la víctima está entre 18 y 28 años,2021,5,1,949,105.374077976818,0,469,0,1,480,208.333333333333
34231,54,54553,81,"Tasa de exámenes médico legales por presunto delito sexual contra niños, niñas y adolescentes",2021,2,1,991,100.908173562059,0,522,0,1,469,213.219616204691
34232,54,54553,81,"Tasa de exámenes médico legales por presunto delito sexual contra niños, niñas y adolescentes",2021,3,4,1123,356.188780053428,0,587,0,4,536,746.268656716418
34233,54,54599,81,"Tasa de exámenes médico legales por presunto delito sexual contra niños, niñas y adolescentes",2021,2,1,488,204.918032786885,0,269,0,1,219,456.62100456621
34234,54,54599,81,"Tasa de exámenes médico legales por presunto delito sexual contra niños, niñas y adolescentes",2021,3,2,591,338.409475465313,0,326,0,2,265,754.716981132076
34235,54,54599,81,"Tasa de exámenes médico legales por presunto delito sexual contra niños, niñas y adolescentes",2021,4,5,604,827.814569536424,0,329,0,5,275,1818.18181818182
34236,54,54660,81,"Tasa de exámenes médico legales por presunto delito sexual contra niños, niñas y adolescentes",2021,2,2,851,235.017626321974,0,432,0,2,419,477.326968973747
34237,54,54660,81,"Tasa de exámenes médico legales por presunto delito sexual contra niños, niñas y adolescentes",2021,4,2,1234,162.074554294976,0,647,0,2,587,340.715502555366
34238,54,54720,81,"Tasa de exámenes médico legales por presunto delito sexual contra niños, niñas y adolescentes",2021,2,3,2912,103.021978021978,0,1498,0,3,1414,212.164073550212
34239,54,54720,81,"Tasa de exámenes médico legales por presunto delito sexual contra niños, niñas y adolescentes",2021,3,2,3346,59.7728631201435,1,1704,58.6854460093897,1,1642,60.9013398294762
34240,54,54720,81,"Tasa de exámenes médico legales por presunto delito sexual contra niños, niñas y adolescentes",2021,4,3,3159,94.9667616334283,0,1618,0,3,1541,194.678780012979
34241,54,54800,81,"Tasa de exámenes médico legales por presunto delito sexual contra niños, niñas y adolescentes",2021,3,2,2462,81.2347684809098,0,1249,0,2,1213,164.880461665293
34242,54,54800,81,"Tasa de exámenes médico legales por presunto delito sexual contra niños, niñas y adolescentes",2021,4,1,2141,46.7071461933676,0,1097,0,1,1044,95.7854406130268
34243,54,54810,81,"Tasa de exámenes médico legales por presunto delito sexual contra niños, niñas y adolescentes",2021,2,3,7392,40.5844155844156,2,3863,51.7732332384157,1,3529,28.336639274582
34244,54,54810,81,"Tasa de exámenes médico legales por presunto delito sexual contra niños, niñas y adolescentes",2021,3,3,7888,38.0324543610548,0,4162,0,3,3726,80.5152979066023
34245,54,54810,81,"Tasa de exámenes médico legales por presunto delito sexual contra niños, niñas y adolescentes",2021,4,10,6922,144.46691707599,1,3659,27.3298715496037,9,3263,275.819797732148
34246,54,54810,121,Tasa de exámenes médico legales por presunto delito sexual cuando la víctima está entre 18 y 28 años,2021,5,1,12249,8.16393174953057,0,6256,0,1,5993,16.6861338227933
34247,54,54820,81,"Tasa de exámenes médico legales por presunto delito sexual contra niños, niñas y adolescentes",2021,3,3,1762,170.261066969353,0,903,0,3,859,349.243306169965
34248,54,54820,81,"Tasa de exámenes médico legales por presunto delito sexual contra niños, niñas y adolescentes",2021,4,4,1768,226.244343891403,1,948,105.485232067511,3,820,365.853658536585
34249,54,54820,121,Tasa de exámenes médico legales por presunto delito sexual cuando la víctima está entre 18 y 28 años,2021,5,1,2768,36.1271676300578,0,1502,0,1,1266,78.9889415481833
34250,54,54874,81,"Tasa de exámenes médico legales por presunto delito sexual contra niños, niñas y adolescentes",2021,2,2,9304,21.4961306964746,0,4796,0,2,4508,44.3655723158829
34251,54,54874,81,"Tasa de exámenes médico legales por presunto delito sexual contra niños, niñas y adolescentes",2021,3,10,10880,91.9117647058824,0,5625,0,10,5255,190.294957183635
34252,54,54874,81,"Tasa de exámenes médico legales por presunto delito sexual contra niños, niñas y adolescentes",2021,4,24,10522,228.09351834252,2,5367,37.2647661635923,22,5155,426.770126091174
34253,54,54874,121,Tasa de exámenes médico legales por presunto delito sexual cuando la víctima está entre 18 y 28 años,2021,5,5,21118,23.6764845155791,0,10284,0,5,10834,46.1510060919328
34254,86,86001,81,"Tasa de exámenes médico legales por presunto delito sexual contra niños, niñas y adolescentes",2021,2,5,4707,106.224771616741,0,2364,0,5,2343,213.401621852326
34255,86,86001,81,"Tasa de exámenes médico legales por presunto delito sexual contra niños, niñas y adolescentes",2021,3,3,5572,53.840631730079,0,2789,0,3,2783,107.797340998922
34256,86,86001,81,"Tasa de exámenes médico legales por presunto delito sexual contra niños, niñas y adolescentes",2021,4,7,5888,118.885869565217,2,2966,67.4308833445718,5,2922,171.115674195756
34257,86,86001,121,Tasa de exámenes médico legales por presunto delito sexual cuando la víctima está entre 18 y 28 años,2021,5,3,12326,24.3387960408892,0,6258,0,3,6068,49.4396835860251
34258,86,86320,81,"Tasa de exámenes médico legales por presunto delito sexual contra niños, niñas y adolescentes",2021,2,1,3639,27.4800769442154,0,1837,0,1,1802,55.4938956714761
34259,86,86320,81,"Tasa de exámenes médico legales por presunto delito sexual contra niños, niñas y adolescentes",2021,3,11,4489,245.043439518824,0,2275,0,11,2214,496.838301716351
34260,86,86320,81,"Tasa de exámenes médico legales por presunto delito sexual contra niños, niñas y adolescentes",2021,4,11,4579,240.227123826163,0,2340,0,11,2239,491.290754801251
34261,86,86320,121,Tasa de exámenes médico legales por presunto delito sexual cuando la víctima está entre 18 y 28 años,2021,5,4,7752,51.5995872033024,0,3893,0,4,3859,103.65379632029
34262,86,86568,81,"Tasa de exámenes médico legales por presunto delito sexual contra niños, niñas y adolescentes",2021,2,3,5716,52.4842547235829,0,2906,0,3,2810,106.761565836299
34263,86,86568,81,"Tasa de exámenes médico legales por presunto delito sexual contra niños, niñas y adolescentes",2021,3,14,7194,194.606616624965,4,3627,110.283981251723,10,3567,280.347631062518
34264,86,86568,81,"Tasa de exámenes médico legales por presunto delito sexual contra niños, niñas y adolescentes",2021,4,12,7737,155.098875533152,1,3933,25.4258835494533,11,3804,289.169295478444
34265,86,86568,121,Tasa de exámenes médico legales por presunto delito sexual cuando la víctima está entre 18 y 28 años,2021,5,6,14298,41.9639110365086,0,7398,0,6,6900,86.9565217391304
34266,86,86569,81,"Tasa de exámenes médico legales por presunto delito sexual contra niños, niñas y adolescentes",2021,3,3,1689,177.619893428064,0,858,0,3,831,361.01083032491
34267,86,86569,81,"Tasa de exámenes médico legales por presunto delito sexual contra niños, niñas y adolescentes",2021,4,4,1665,240.24024024024,0,876,0,4,789,506.970849176172
34268,86,86571,81,"Tasa de exámenes médico legales por presunto delito sexual contra niños, niñas y adolescentes",2021,2,1,4099,24.3961941937058,1,2168,46.1254612546125,0,1931,0
34269,86,86571,81,"Tasa de exámenes médico legales por presunto delito sexual contra niños, niñas y adolescentes",2021,3,1,5031,19.8767640628106,1,2556,39.1236306729264,0,2475,0
34270,86,86571,81,"Tasa de exámenes médico legales por presunto delito sexual contra niños, niñas y adolescentes",2021,4,7,4798,145.894122551063,0,2369,0,7,2429,288.184438040346
34271,86,86573,81,"Tasa de exámenes médico legales por presunto delito sexual contra niños, niñas y adolescentes",2021,2,2,3422,58.4453535943892,0,1695,0,2,1727,115.807759119861
34272,86,86573,81,"Tasa de exámenes médico legales por presunto delito sexual contra niños, niñas y adolescentes",2021,3,2,4037,49.5417389150359,1,2032,49.2125984251969,1,2005,49.8753117206983
34273,86,86573,81,"Tasa de exámenes médico legales por presunto delito sexual contra niños, niñas y adolescentes",2021,4,7,3770,185.676392572944,1,1952,51.2295081967213,6,1818,330.03300330033
34274,86,86573,121,Tasa de exámenes médico legales por presunto delito sexual cuando la víctima está entre 18 y 28 años,2021,5,1,6164,16.2232316677482,0,3544,0,1,2620,38.1679389312977
34275,86,86757,81,"Tasa de exámenes médico legales por presunto delito sexual contra niños, niñas y adolescentes",2021,2,2,1902,105.15247108307,0,967,0,2,935,213.903743315508
34276,86,86757,81,"Tasa de exámenes médico legales por presunto delito sexual contra niños, niñas y adolescentes",2021,3,2,2285,87.527352297593,0,1150,0,2,1135,176.211453744493
34277,86,86757,81,"Tasa de exámenes médico legales por presunto delito sexual contra niños, niñas y adolescentes",2021,4,4,2314,172.86084701815,0,1149,0,4,1165,343.347639484979
34278,86,86760,121,Tasa de exámenes médico legales por presunto delito sexual cuando la víctima está entre 18 y 28 años,2021,5,1,1353,73.909830007391,0,677,0,1,676,147.92899408284
34279,86,86749,81,"Tasa de exámenes médico legales por presunto delito sexual contra niños, niñas y adolescentes",2021,4,2,1506,132.802124833997,0,773,0,2,733,272.851296043656
34280,86,86749,121,Tasa de exámenes médico legales por presunto delito sexual cuando la víctima está entre 18 y 28 años,2021,5,1,2988,33.4672021419009,0,1476,0,1,1512,66.1375661375661
34281,86,86865,81,"Tasa de exámenes médico legales por presunto delito sexual contra niños, niñas y adolescentes",2021,2,2,2749,72.7537286285922,0,1431,0,2,1318,151.745068285281
34282,86,86865,81,"Tasa de exámenes médico legales por presunto delito sexual contra niños, niñas y adolescentes",2021,3,19,3697,513.930213686773,5,1921,260.281103591879,14,1776,788.288288288288
34283,86,86865,81,"Tasa de exámenes médico legales por presunto delito sexual contra niños, niñas y adolescentes",2021,4,26,4140,628.019323671498,1,2148,46.5549348230912,25,1992,1255.02008032129
34284,86,86865,121,Tasa de exámenes médico legales por presunto delito sexual cuando la víctima está entre 18 y 28 años,2021,5,2,7235,27.643400138217,0,3673,0,2,3562,56.1482313307131
34285,86,86885,81,"Tasa de exámenes médico legales por presunto delito sexual contra niños, niñas y adolescentes",2021,2,2,2322,86.1326442721792,2,1170,170.940170940171,0,1152,0
34286,86,86885,81,"Tasa de exámenes médico legales por presunto delito sexual contra niños, niñas y adolescentes",2021,3,5,2754,181.554103122731,0,1386,0,5,1368,365.497076023392
34287,86,86885,81,"Tasa de exámenes médico legales por presunto delito sexual contra niños, niñas y adolescentes",2021,4,9,2802,321.199143468951,0,1433,0,9,1369,657.414170927684
34288,63,63001,81,"Tasa de exámenes médico legales por presunto delito sexual contra niños, niñas y adolescentes",2021,2,31,17751,174.638048560644,8,9020,88.6917960088692,23,8731,263.429160462719
34289,63,63001,81,"Tasa de exámenes médico legales por presunto delito sexual contra niños, niñas y adolescentes",2021,3,57,20860,273.250239693193,9,10625,84.7058823529412,48,10235,468.978993649243
34290,63,63001,81,"Tasa de exámenes médico legales por presunto delito sexual contra niños, niñas y adolescentes",2021,4,97,22828,424.916768880322,10,11610,86.1326442721792,87,11218,775.539311820289
34291,63,63001,121,Tasa de exámenes médico legales por presunto delito sexual cuando la víctima está entre 18 y 28 años,2021,5,19,52388,36.2678475986867,2,25895,7.72349874493145,17,26493,64.1678934058053
34292,63,63111,81,"Tasa de exámenes médico legales por presunto delito sexual contra niños, niñas y adolescentes",2021,2,1,239,418.410041841004,0,113,0,1,126,793.650793650794
34293,63,63111,81,"Tasa de exámenes médico legales por presunto delito sexual contra niños, niñas y adolescentes",2021,4,3,305,983.606557377049,0,169,0,3,136,2205.88235294118
34294,63,63111,121,Tasa de exámenes médico legales por presunto delito sexual cuando la víctima está entre 18 y 28 años,2021,5,1,493,202.839756592292,0,269,0,1,224,446.428571428571
34295,63,63130,81,"Tasa de exámenes médico legales por presunto delito sexual contra niños, niñas y adolescentes",2021,2,7,4672,149.828767123288,3,2413,124.326564442603,4,2259,177.069499778663
34296,63,63130,81,"Tasa de exámenes médico legales por presunto delito sexual contra niños, niñas y adolescentes",2021,3,25,5646,442.791356712717,4,2874,139.178844815588,21,2772,757.575757575758
34297,63,63130,81,"Tasa de exámenes médico legales por presunto delito sexual contra niños, niñas y adolescentes",2021,4,33,6148,536.75992192583,1,3112,32.133676092545,32,3036,1054.01844532279
34298,63,63130,121,Tasa de exámenes médico legales por presunto delito sexual cuando la víctima está entre 18 y 28 años,2021,5,5,12914,38.717670744928,0,6663,0,5,6251,79.9872020476724
34299,63,63190,81,"Tasa de exámenes médico legales por presunto delito sexual contra niños, niñas y adolescentes",2021,3,7,2181,320.953690967446,3,1113,269.541778975741,4,1068,374.531835205993
34300,63,63190,81,"Tasa de exámenes médico legales por presunto delito sexual contra niños, niñas y adolescentes",2021,4,6,2317,258.955545964609,0,1188,0,6,1129,531.443755535873
34301,63,63190,121,Tasa de exámenes médico legales por presunto delito sexual cuando la víctima está entre 18 y 28 años,2021,5,3,4826,62.1632822213013,1,2351,42.5350914504466,2,2475,80.8080808080808
34302,63,63212,81,"Tasa de exámenes médico legales por presunto delito sexual contra niños, niñas y adolescentes",2021,3,1,502,199.203187250996,0,262,0,1,240,416.666666666667
34303,63,63212,81,"Tasa de exámenes médico legales por presunto delito sexual contra niños, niñas y adolescentes",2021,4,6,502,1195.21912350598,2,268,746.268656716418,4,234,1709.40170940171
34304,63,63212,121,Tasa de exámenes médico legales por presunto delito sexual cuando la víctima está entre 18 y 28 años,2021,5,1,893,111.982082866741,0,466,0,1,427,234.192037470726
34305,63,63272,81,"Tasa de exámenes médico legales por presunto delito sexual contra niños, niñas y adolescentes",2021,2,3,703,426.74253200569,1,371,269.541778975741,2,332,602.409638554217
34306,63,63272,81,"Tasa de exámenes médico legales por presunto delito sexual contra niños, niñas y adolescentes",2021,3,6,940,638.297872340425,1,493,202.839756592292,5,447,1118.56823266219
34307,63,63272,81,"Tasa de exámenes médico legales por presunto delito sexual contra niños, niñas y adolescentes",2021,4,5,1037,482.160077145612,2,533,375.234521575985,3,504,595.238095238095
34308,63,63302,81,"Tasa de exámenes médico legales por presunto delito sexual contra niños, niñas y adolescentes",2021,2,2,492,406.50406504065,1,259,386.100386100386,1,233,429.184549356223
34309,63,63302,81,"Tasa de exámenes médico legales por presunto delito sexual contra niños, niñas y adolescentes",2021,3,8,606,1320.13201320132,3,333,900.900900900901,5,273,1831.50183150183
34310,63,63302,81,"Tasa de exámenes médico legales por presunto delito sexual contra niños, niñas y adolescentes",2021,4,4,642,623.052959501558,2,363,550.964187327824,2,279,716.845878136201
34311,63,63401,81,"Tasa de exámenes médico legales por presunto delito sexual contra niños, niñas y adolescentes",2021,2,4,2373,168.563000421408,1,1206,82.9187396351576,3,1167,257.06940874036
34312,63,63401,81,"Tasa de exámenes médico legales por presunto delito sexual contra niños, niñas y adolescentes",2021,3,9,2872,313.370473537604,3,1486,201.884253028264,6,1386,432.900432900433
34313,63,63401,81,"Tasa de exámenes médico legales por presunto delito sexual contra niños, niñas y adolescentes",2021,4,7,3171,220.75055187638,0,1633,0,7,1538,455.136540962289
34314,63,63401,121,Tasa de exámenes médico legales por presunto delito sexual cuando la víctima está entre 18 y 28 años,2021,5,5,6433,77.724234416291,1,3211,31.1429461227032,4,3222,124.146492861577
34315,63,63470,81,"Tasa de exámenes médico legales por presunto delito sexual contra niños, niñas y adolescentes",2021,2,7,2574,271.950271950272,2,1320,151.515151515152,5,1254,398.724082934609
34316,63,63470,81,"Tasa de exámenes médico legales por presunto delito sexual contra niños, niñas y adolescentes",2021,3,17,3025,561.98347107438,1,1548,64.5994832041344,16,1477,1083.2769126608
34317,63,63470,81,"Tasa de exámenes médico legales por presunto delito sexual contra niños, niñas y adolescentes",2021,4,15,3199,468.896530165677,3,1632,183.823529411765,12,1567,765.794511805999
34318,63,63470,121,Tasa de exámenes médico legales por presunto delito sexual cuando la víctima está entre 18 y 28 años,2021,5,4,6613,60.4869197036141,0,3303,0,4,3310,120.845921450151
34319,63,63548,81,"Tasa de exámenes médico legales por presunto delito sexual contra niños, niñas y adolescentes",2021,4,4,451,886.917960088692,0,240,0,4,211,1895.7345971564
34320,63,63594,81,"Tasa de exámenes médico legales por presunto delito sexual contra niños, niñas y adolescentes",2021,2,5,2015,248.138957816377,1,1034,96.7117988394584,4,981,407.747196738022
34321,63,63594,81,"Tasa de exámenes médico legales por presunto delito sexual contra niños, niñas y adolescentes",2021,3,6,2358,254.452926208651,3,1221,245.700245700246,3,1137,263.852242744063
34322,63,63594,81,"Tasa de exámenes médico legales por presunto delito sexual contra niños, niñas y adolescentes",2021,4,7,2489,281.237444756931,0,1281,0,7,1208,579.470198675497
34323,63,63594,121,Tasa de exámenes médico legales por presunto delito sexual cuando la víctima está entre 18 y 28 años,2021,5,3,5213,57.5484366008057,0,2525,0,3,2688,111.607142857143
34324,63,63690,81,"Tasa de exámenes médico legales por presunto delito sexual contra niños, niñas y adolescentes",2021,2,1,608,164.473684210526,1,319,313.479623824451,0,289,0
34325,63,63690,81,"Tasa de exámenes médico legales por presunto delito sexual contra niños, niñas y adolescentes",2021,4,3,782,383.631713554987,2,424,471.698113207547,1,358,279.329608938548
34326,63,63690,121,Tasa de exámenes médico legales por presunto delito sexual cuando la víctima está entre 18 y 28 años,2021,5,1,1480,67.5675675675676,0,761,0,1,719,139.082058414465
34327,66,66045,81,"Tasa de exámenes médico legales por presunto delito sexual contra niños, niñas y adolescentes",2021,2,1,778,128.53470437018,0,399,0,1,379,263.852242744063
34328,66,66045,81,"Tasa de exámenes médico legales por presunto delito sexual contra niños, niñas y adolescentes",2021,3,3,1053,284.900284900285,0,566,0,3,487,616.016427104723
34329,66,66045,81,"Tasa de exámenes médico legales por presunto delito sexual contra niños, niñas y adolescentes",2021,4,16,1139,1404.74100087796,2,623,321.027287319422,14,516,2713.17829457364
34330,66,66075,81,"Tasa de exámenes médico legales por presunto delito sexual contra niños, niñas y adolescentes",2021,4,1,581,172.117039586919,0,308,0,1,273,366.300366300366
34331,66,66088,81,"Tasa de exámenes médico legales por presunto delito sexual contra niños, niñas y adolescentes",2021,2,2,1716,116.550116550117,0,916,0,2,800,250
34332,66,66088,81,"Tasa de exámenes médico legales por presunto delito sexual contra niños, niñas y adolescentes",2021,3,6,2248,266.903914590747,0,1177,0,6,1071,560.224089635854
34333,66,66088,81,"Tasa de exámenes médico legales por presunto delito sexual contra niños, niñas y adolescentes",2021,4,7,2332,300.171526586621,1,1200,83.3333333333333,6,1132,530.035335689046
34334,66,66088,121,Tasa de exámenes médico legales por presunto delito sexual cuando la víctima está entre 18 y 28 años,2021,5,2,3723,53.72011818426,0,1861,0,2,1862,107.411385606874
34335,66,66170,81,"Tasa de exámenes médico legales por presunto delito sexual contra niños, niñas y adolescentes",2021,2,13,14006,92.8173639868628,1,7035,14.2146410803127,12,6971,172.141730024387
34336,66,66170,81,"Tasa de exámenes médico legales por presunto delito sexual contra niños, niñas y adolescentes",2021,3,44,16654,264.200792602378,12,8463,141.793690180787,32,8191,390.672689537297
34337,66,66170,81,"Tasa de exámenes médico legales por presunto delito sexual contra niños, niñas y adolescentes",2021,4,74,17717,417.677936445222,7,8954,78.1773509046236,67,8763,764.578340750884
34338,66,66170,121,Tasa de exámenes médico legales por presunto delito sexual cuando la víctima está entre 18 y 28 años,2021,5,22,38650,56.9210866752911,1,18709,5.3450211128334,21,19941,105.310666466075
34339,66,66318,81,"Tasa de exámenes médico legales por presunto delito sexual contra niños, niñas y adolescentes",2021,4,3,1163,257.953568357696,0,600,0,3,563,532.859680284192
34340,66,66318,121,Tasa de exámenes médico legales por presunto delito sexual cuando la víctima está entre 18 y 28 años,2021,5,2,1778,112.485939257593,0,901,0,2,877,228.050171037628
34341,66,66383,81,"Tasa de exámenes médico legales por presunto delito sexual contra niños, niñas y adolescentes",2021,3,1,618,161.812297734628,0,331,0,1,287,348.432055749129
34342,66,66383,81,"Tasa de exámenes médico legales por presunto delito sexual contra niños, niñas y adolescentes",2021,4,1,635,157.48031496063,0,337,0,1,298,335.570469798658
34343,66,66400,81,"Tasa de exámenes médico legales por presunto delito sexual contra niños, niñas y adolescentes",2021,2,2,1808,110.619469026549,0,892,0,2,916,218.340611353712
34344,66,66400,81,"Tasa de exámenes médico legales por presunto delito sexual contra niños, niñas y adolescentes",2021,3,4,2279,175.515577007459,2,1148,174.216027874564,2,1131,176.83465959328
34345,66,66400,81,"Tasa de exámenes médico legales por presunto delito sexual contra niños, niñas y adolescentes",2021,4,1,2500,40,0,1259,0,1,1241,80.58017727639
34346,66,66440,81,"Tasa de exámenes médico legales por presunto delito sexual contra niños, niñas y adolescentes",2021,3,7,1497,467.601870407482,1,758,131.926121372032,6,739,811.90798376184
34347,66,66440,81,"Tasa de exámenes médico legales por presunto delito sexual contra niños, niñas y adolescentes",2021,4,4,1544,259.067357512953,0,788,0,4,756,529.100529100529
34348,66,66440,121,Tasa de exámenes médico legales por presunto delito sexual cuando la víctima está entre 18 y 28 años,2021,5,1,2507,39.8883127243718,1,1272,78.6163522012579,0,1235,0
34349,66,66456,81,"Tasa de exámenes médico legales por presunto delito sexual contra niños, niñas y adolescentes",2021,2,2,2397,83.4376303712975,0,1248,0,2,1149,174.064403829417
34350,66,66456,81,"Tasa de exámenes médico legales por presunto delito sexual contra niños, niñas y adolescentes",2021,3,3,2522,118.953211736717,1,1290,77.5193798449612,2,1232,162.337662337662
34351,66,66456,81,"Tasa de exámenes médico legales por presunto delito sexual contra niños, niñas y adolescentes",2021,4,3,2105,142.517814726841,0,1060,0,3,1045,287.081339712919
34352,66,66001,81,"Tasa de exámenes médico legales por presunto delito sexual contra niños, niñas y adolescentes",2021,2,65,28848,225.318912922906,19,14829,128.127318092926,46,14019,328.126114558813
34353,66,66001,81,"Tasa de exámenes médico legales por presunto delito sexual contra niños, niñas y adolescentes",2021,3,114,34635,329.146816803811,24,17786,134.937591363994,90,16849,534.156329752508
34354,66,66001,81,"Tasa de exámenes médico legales por presunto delito sexual contra niños, niñas y adolescentes",2021,4,195,37602,518.589436732089,15,19127,78.4231714330527,180,18475,974.289580514208
34355,66,66001,121,Tasa de exámenes médico legales por presunto delito sexual cuando la víctima está entre 18 y 28 años,2021,5,56,83197,67.3101193552652,7,41200,16.9902912621359,49,41997,116.675000595281
34356,66,66572,81,"Tasa de exámenes médico legales por presunto delito sexual contra niños, niñas y adolescentes",2021,3,3,2725,110.091743119266,3,1427,210.231254379818,0,1298,0
34357,66,66572,81,"Tasa de exámenes médico legales por presunto delito sexual contra niños, niñas y adolescentes",2021,4,8,1987,402.617010568697,2,1053,189.933523266857,6,934,642.398286937902
34358,66,66572,121,Tasa de exámenes médico legales por presunto delito sexual cuando la víctima está entre 18 y 28 años,2021,5,1,2606,38.3729854182655,0,1292,0,1,1314,76.103500761035
34359,66,66594,81,"Tasa de exámenes médico legales por presunto delito sexual contra niños, niñas y adolescentes",2021,2,1,2182,45.8295142071494,0,1157,0,1,1025,97.5609756097561
34360,66,66594,81,"Tasa de exámenes médico legales por presunto delito sexual contra niños, niñas y adolescentes",2021,3,2,2687,74.4324525493115,1,1400,71.4285714285714,1,1287,77.7000777000777
34361,66,66594,81,"Tasa de exámenes médico legales por presunto delito sexual contra niños, niñas y adolescentes",2021,4,1,2725,36.697247706422,0,1414,0,1,1311,76.27765064836
34362,66,66682,81,"Tasa de exámenes médico legales por presunto delito sexual contra niños, niñas y adolescentes",2021,2,5,4770,104.82180293501,0,2463,0,5,2307,216.731686172518
34363,66,66682,81,"Tasa de exámenes médico legales por presunto delito sexual contra niños, niñas y adolescentes",2021,3,11,6072,181.159420289855,3,3129,95.8772770853308,8,2943,271.831464492015
34364,66,66682,81,"Tasa de exámenes médico legales por presunto delito sexual contra niños, niñas y adolescentes",2021,4,12,6671,179.8830760006,0,3415,0,12,3256,368.550368550369
34365,66,66687,81,"Tasa de exámenes médico legales por presunto delito sexual contra niños, niñas y adolescentes",2021,3,3,1096,273.722627737226,1,568,176.056338028169,2,528,378.787878787879
34366,66,66687,81,"Tasa de exámenes médico legales por presunto delito sexual contra niños, niñas y adolescentes",2021,4,7,1204,581.395348837209,0,630,0,7,574,1219.51219512195
34367,68,68013,81,"Tasa de exámenes médico legales por presunto delito sexual contra niños, niñas y adolescentes",2021,4,1,155,645.161290322581,0,86,0,1,69,1449.27536231884
34368,68,68020,81,"Tasa de exámenes médico legales por presunto delito sexual contra niños, niñas y adolescentes",2021,3,1,383,261.096605744125,0,200,0,1,183,546.448087431694
34369,68,68051,81,"Tasa de exámenes médico legales por presunto delito sexual contra niños, niñas y adolescentes",2021,3,1,801,124.843945068664,1,399,250.62656641604,0,402,0
34370,68,68051,81,"Tasa de exámenes médico legales por presunto delito sexual contra niños, niñas y adolescentes",2021,4,1,867,115.340253748558,0,450,0,1,417,239.808153477218
34371,68,68077,81,"Tasa de exámenes médico legales por presunto delito sexual contra niños, niñas y adolescentes",2021,2,1,2400,41.6666666666667,0,1272,0,1,1128,88.6524822695036
34372,68,68077,81,"Tasa de exámenes médico legales por presunto delito sexual contra niños, niñas y adolescentes",2021,3,2,3051,65.5522779416585,0,1593,0,2,1458,137.174211248285
34373,68,68077,81,"Tasa de exámenes médico legales por presunto delito sexual contra niños, niñas y adolescentes",2021,4,11,3189,344.935716525557,1,1635,61.1620795107034,10,1554,643.500643500644
34374,68,68077,121,Tasa de exámenes médico legales por presunto delito sexual cuando la víctima está entre 18 y 28 años,2021,5,2,5693,35.1308624626735,0,2808,0,2,2885,69.3240901213172
34375,68,68081,81,"Tasa de exámenes médico legales por presunto delito sexual contra niños, niñas y adolescentes",2021,2,11,18386,59.8281300989884,2,9339,21.4155691187493,9,9047,99.4804907704211
34376,68,68081,81,"Tasa de exámenes médico legales por presunto delito sexual contra niños, niñas y adolescentes",2021,3,26,21175,122.786304604486,3,10821,27.7238702522872,23,10354,222.136372416457
34377,68,68081,81,"Tasa de exámenes médico legales por presunto delito sexual contra niños, niñas y adolescentes",2021,4,57,20050,284.28927680798,5,10318,48.4590036828843,52,9732,534.319769831484
34378,68,68081,121,Tasa de exámenes médico legales por presunto delito sexual cuando la víctima está entre 18 y 28 años,2021,5,15,38197,39.2700997460534,0,19194,0,15,19003,78.9349050149976
34379,68,68081,81,"Tasa de exámenes médico legales por presunto delito sexual contra niños, niñas y adolescentes",2021,1,1,3543,28.2246683601468,0,1800,0,1,1743,57.372346528973
34380,68,68092,81,"Tasa de exámenes médico legales por presunto delito sexual contra niños, niñas y adolescentes",2021,2,2,546,366.300366300366,1,292,342.465753424658,1,254,393.700787401575
34381,68,68092,81,"Tasa de exámenes médico legales por presunto delito sexual contra niños, niñas y adolescentes",2021,4,2,635,314.96062992126,0,334,0,2,301,664.451827242525
34382,68,68101,81,"Tasa de exámenes médico legales por presunto delito sexual contra niños, niñas y adolescentes",2021,3,1,1105,90.4977375565611,0,576,0,1,529,189.035916824197
34383,68,68101,81,"Tasa de exámenes médico legales por presunto delito sexual contra niños, niñas y adolescentes",2021,4,1,1198,83.4724540901503,0,618,0,1,580,172.413793103448
34384,68,68001,81,"Tasa de exámenes médico legales por presunto delito sexual contra niños, niñas y adolescentes",2021,2,45,39062,115.201474578875,9,19909,45.2056858707117,36,19153,187.960110687621
34385,68,68001,81,"Tasa de exámenes médico legales por presunto delito sexual contra niños, niñas y adolescentes",2021,3,65,46703,139.177354773783,17,23790,71.45859604876,48,22913,209.488063544713
34386,68,68001,81,"Tasa de exámenes médico legales por presunto delito sexual contra niños, niñas y adolescentes",2021,4,121,49865,242.655168956182,12,25358,47.3223440334411,109,24507,444.770881788877
34387,68,68001,121,Tasa de exámenes médico legales por presunto delito sexual cuando la víctima está entre 18 y 28 años,2021,5,33,116146,28.4125152824893,3,58550,5.12382578992314,30,57596,52.0869504826724
34388,68,68001,81,"Tasa de exámenes médico legales por presunto delito sexual contra niños, niñas y adolescentes",2021,1,1,7497,13.3386688008537,0,3828,0,1,3669,27.2553829381303
34389,68,68147,81,"Tasa de exámenes médico legales por presunto delito sexual contra niños, niñas y adolescentes",2021,4,3,517,580.270793036751,2,280,714.285714285714,1,237,421.940928270042
34390,68,68147,121,Tasa de exámenes médico legales por presunto delito sexual cuando la víctima está entre 18 y 28 años,2021,5,1,782,127.877237851662,1,400,250,0,382,0
34391,68,68152,81,"Tasa de exámenes médico legales por presunto delito sexual contra niños, niñas y adolescentes",2021,4,2,470,425.531914893617,0,261,0,2,209,956.937799043062
34392,68,68162,81,"Tasa de exámenes médico legales por presunto delito sexual contra niños, niñas y adolescentes",2021,3,1,695,143.884892086331,0,356,0,1,339,294.985250737463
34393,68,68162,81,"Tasa de exámenes médico legales por presunto delito sexual contra niños, niñas y adolescentes",2021,4,2,679,294.550810014728,0,362,0,2,317,630.914826498423
34394,68,68167,81,"Tasa de exámenes médico legales por presunto delito sexual contra niños, niñas y adolescentes",2021,3,2,1158,172.711571675302,1,601,166.389351081531,1,557,179.533213644524
34395,68,68167,81,"Tasa de exámenes médico legales por presunto delito sexual contra niños, niñas y adolescentes",2021,4,6,1145,524.017467248908,0,606,0,6,539,1113.17254174397
34396,68,68169,81,"Tasa de exámenes médico legales por presunto delito sexual contra niños, niñas y adolescentes",2021,2,1,221,452.488687782805,0,113,0,1,108,925.925925925926
34397,68,68169,81,"Tasa de exámenes médico legales por presunto delito sexual contra niños, niñas y adolescentes",2021,4,1,229,436.681222707424,0,118,0,1,111,900.900900900901
34398,68,68169,121,Tasa de exámenes médico legales por presunto delito sexual cuando la víctima está entre 18 y 28 años,2021,5,1,438,228.310502283105,0,230,0,1,208,480.769230769231
34399,68,68176,81,"Tasa de exámenes médico legales por presunto delito sexual contra niños, niñas y adolescentes",2021,3,1,280,357.142857142857,0,142,0,1,138,724.63768115942
34400,68,68176,81,"Tasa de exámenes médico legales por presunto delito sexual contra niños, niñas y adolescentes",2021,4,1,283,353.356890459364,0,139,0,1,144,694.444444444445
34401,68,68190,81,"Tasa de exámenes médico legales por presunto delito sexual contra niños, niñas y adolescentes",2021,2,6,2846,210.822206605762,1,1451,68.9179875947622,5,1395,358.4229390681
34402,68,68190,81,"Tasa de exámenes médico legales por presunto delito sexual contra niños, niñas y adolescentes",2021,3,7,3658,191.361399671952,0,1840,0,7,1818,385.038503850385
34403,68,68190,81,"Tasa de exámenes médico legales por presunto delito sexual contra niños, niñas y adolescentes",2021,4,15,3722,403.009134873724,1,1847,54.1418516513265,14,1875,746.666666666667
34404,68,68190,121,Tasa de exámenes médico legales por presunto delito sexual cuando la víctima está entre 18 y 28 años,2021,5,2,7186,27.8318953520735,0,4073,0,2,3113,64.246707356248
34405,68,68207,81,"Tasa de exámenes médico legales por presunto delito sexual contra niños, niñas y adolescentes",2021,4,3,560,535.714285714286,0,277,0,3,283,1060.07067137809
34406,68,68209,81,"Tasa de exámenes médico legales por presunto delito sexual contra niños, niñas y adolescentes",2021,4,2,297,673.400673400673,0,156,0,2,141,1418.43971631206
34407,68,68211,81,"Tasa de exámenes médico legales por presunto delito sexual contra niños, niñas y adolescentes",2021,4,1,316,316.455696202532,0,162,0,1,154,649.350649350649
34408,68,68217,81,"Tasa de exámenes médico legales por presunto delito sexual contra niños, niñas y adolescentes",2021,4,3,498,602.409638554217,0,271,0,3,227,1321.5859030837
34409,68,68229,81,"Tasa de exámenes médico legales por presunto delito sexual contra niños, niñas y adolescentes",2021,3,1,1275,78.4313725490196,0,636,0,1,639,156.494522691706
34410,68,68229,81,"Tasa de exámenes médico legales por presunto delito sexual contra niños, niñas y adolescentes",2021,4,3,1276,235.109717868339,0,635,0,3,641,468.01872074883
34411,68,68235,81,"Tasa de exámenes médico legales por presunto delito sexual contra niños, niñas y adolescentes",2021,2,4,1872,213.675213675214,0,936,0,4,936,427.350427350427
34412,68,68235,81,"Tasa de exámenes médico legales por presunto delito sexual contra niños, niñas y adolescentes",2021,3,4,2419,165.357585779248,0,1214,0,4,1205,331.95020746888
34413,68,68235,81,"Tasa de exámenes médico legales por presunto delito sexual contra niños, niñas y adolescentes",2021,4,13,2479,524.405002016942,1,1269,78.8022064617809,12,1210,991.735537190083
34414,68,68235,121,Tasa de exámenes médico legales por presunto delito sexual cuando la víctima está entre 18 y 28 años,2021,5,2,3845,52.0156046814044,1,1998,50.0500500500501,1,1847,54.1418516513265
34415,68,68245,81,"Tasa de exámenes médico legales por presunto delito sexual contra niños, niñas y adolescentes",2021,4,2,211,947.867298578199,0,113,0,2,98,2040.81632653061
34416,68,68250,81,"Tasa de exámenes médico legales por presunto delito sexual contra niños, niñas y adolescentes",2021,3,1,671,149.03129657228,0,342,0,1,329,303.951367781155
34417,68,68250,81,"Tasa de exámenes médico legales por presunto delito sexual contra niños, niñas y adolescentes",2021,4,4,715,559.44055944056,0,368,0,4,347,1152.73775216138
34418,68,68255,81,"Tasa de exámenes médico legales por presunto delito sexual contra niños, niñas y adolescentes",2021,2,5,1214,411.861614497529,3,619,484.652665589661,2,595,336.134453781513
34419,68,68255,81,"Tasa de exámenes médico legales por presunto delito sexual contra niños, niñas y adolescentes",2021,3,7,1529,457.815565729235,1,799,125.156445556946,6,730,821.917808219178
34420,68,68255,81,"Tasa de exámenes médico legales por presunto delito sexual contra niños, niñas y adolescentes",2021,4,9,1562,576.18437900128,1,822,121.654501216545,8,740,1081.08108108108
34421,68,68255,121,Tasa de exámenes médico legales por presunto delito sexual cuando la víctima está entre 18 y 28 años,2021,5,2,2473,80.8734330772341,0,1277,0,2,1196,167.224080267559
34422,68,68264,81,"Tasa de exámenes médico legales por presunto delito sexual contra niños, niñas y adolescentes",2021,2,1,235,425.531914893617,0,127,0,1,108,925.925925925926
34423,68,68264,121,Tasa de exámenes médico legales por presunto delito sexual cuando la víctima está entre 18 y 28 años,2021,5,1,434,230.414746543779,0,223,0,1,211,473.9336492891
34424,68,68266,81,"Tasa de exámenes médico legales por presunto delito sexual contra niños, niñas y adolescentes",2021,3,1,301,332.225913621262,0,157,0,1,144,694.444444444445
34425,68,68271,81,"Tasa de exámenes médico legales por presunto delito sexual contra niños, niñas y adolescentes",2021,2,1,385,259.74025974026,0,209,0,1,176,568.181818181818
34426,68,68271,81,"Tasa de exámenes médico legales por presunto delito sexual contra niños, niñas y adolescentes",2021,3,1,594,168.350168350168,0,307,0,1,287,348.432055749129
34427,68,68271,81,"Tasa de exámenes médico legales por presunto delito sexual contra niños, niñas y adolescentes",2021,4,1,646,154.798761609907,0,329,0,1,317,315.457413249211
34428,68,68276,81,"Tasa de exámenes médico legales por presunto delito sexual contra niños, niñas y adolescentes",2021,2,10,20504,48.7709715177526,1,10535,9.4921689606075,9,9969,90.2798675895275
34429,68,68276,81,"Tasa de exámenes médico legales por presunto delito sexual contra niños, niñas y adolescentes",2021,3,21,24595,85.3832079690994,1,12599,7.93713786808477,20,11996,166.722240746916
34430,68,68276,81,"Tasa de exámenes médico legales por presunto delito sexual contra niños, niñas y adolescentes",2021,4,42,25853,162.456968243531,5,13045,38.3288616328095,37,12808,288.881948782011
34431,68,68276,121,Tasa de exámenes médico legales por presunto delito sexual cuando la víctima está entre 18 y 28 años,2021,5,9,57405,15.6780768225764,1,28358,3.52634177304464,8,29047,27.5415705580611
34432,68,68296,81,"Tasa de exámenes médico legales por presunto delito sexual contra niños, niñas y adolescentes",2021,3,2,275,727.272727272727,0,147,0,2,128,1562.5
34433,68,68296,81,"Tasa de exámenes médico legales por presunto delito sexual contra niños, niñas y adolescentes",2021,4,1,258,387.596899224806,0,142,0,1,116,862.068965517241
34434,68,68298,81,"Tasa de exámenes médico legales por presunto delito sexual contra niños, niñas y adolescentes",2021,2,3,358,837.988826815643,0,170,0,3,188,1595.74468085106
34435,68,68298,81,"Tasa de exámenes médico legales por presunto delito sexual contra niños, niñas y adolescentes",2021,3,2,439,455.580865603645,0,229,0,2,210,952.380952380953
34436,68,68298,81,"Tasa de exámenes médico legales por presunto delito sexual contra niños, niñas y adolescentes",2021,4,3,419,715.990453460621,0,227,0,3,192,1562.5
34437,68,68307,81,"Tasa de exámenes médico legales por presunto delito sexual contra niños, niñas y adolescentes",2021,2,5,13122,38.1039475689681,1,6723,14.8743120630671,4,6399,62.5097671511174
34438,68,68307,81,"Tasa de exámenes médico legales por presunto delito sexual contra niños, niñas y adolescentes",2021,3,17,15488,109.762396694215,5,7907,63.2351081320349,12,7581,158.290462999604
34439,68,68307,81,"Tasa de exámenes médico legales por presunto delito sexual contra niños, niñas y adolescentes",2021,4,39,15654,249.137600613262,2,7909,25.2876469844481,37,7745,477.727566171724
34440,68,68307,121,Tasa de exámenes médico legales por presunto delito sexual cuando la víctima está entre 18 y 28 años,2021,5,2,33523,5.96605315753363,0,16810,0,2,16713,11.9667324836953
34441,68,68318,81,"Tasa de exámenes médico legales por presunto delito sexual contra niños, niñas y adolescentes",2021,4,2,610,327.868852459016,0,318,0,2,292,684.931506849315
34442,68,68318,121,Tasa de exámenes médico legales por presunto delito sexual cuando la víctima está entre 18 y 28 años,2021,5,1,956,104.602510460251,0,531,0,1,425,235.294117647059
34443,68,68320,81,"Tasa de exámenes médico legales por presunto delito sexual contra niños, niñas y adolescentes",2021,3,3,418,717.703349282297,2,215,930.232558139535,1,203,492.610837438424
34444,68,68322,81,"Tasa de exámenes médico legales por presunto delito sexual contra niños, niñas y adolescentes",2021,3,2,234,854.700854700855,0,94,0,2,140,1428.57142857143
34445,68,68327,81,"Tasa de exámenes médico legales por presunto delito sexual contra niños, niñas y adolescentes",2021,2,1,368,271.739130434783,0,192,0,1,176,568.181818181818
34446,68,68327,81,"Tasa de exámenes médico legales por presunto delito sexual contra niños, niñas y adolescentes",2021,3,1,462,216.450216450216,0,242,0,1,220,454.545454545455
34447,68,68327,81,"Tasa de exámenes médico legales por presunto delito sexual contra niños, niñas y adolescentes",2021,4,4,506,790.513833992095,2,255,784.313725490196,2,251,796.812749003984
34448,68,68344,81,"Tasa de exámenes médico legales por presunto delito sexual contra niños, niñas y adolescentes",2021,3,1,233,429.184549356223,0,126,0,1,107,934.579439252336
34449,68,68344,81,"Tasa de exámenes médico legales por presunto delito sexual contra niños, niñas y adolescentes",2021,4,1,236,423.728813559322,0,121,0,1,115,869.565217391304
34450,68,68368,81,"Tasa de exámenes médico legales por presunto delito sexual contra niños, niñas y adolescentes",2021,4,2,338,591.715976331361,1,173,578.034682080925,1,165,606.060606060606
34451,68,68377,81,"Tasa de exámenes médico legales por presunto delito sexual contra niños, niñas y adolescentes",2021,2,1,440,227.272727272727,0,219,0,1,221,452.488687782805
34452,68,68377,81,"Tasa de exámenes médico legales por presunto delito sexual contra niños, niñas y adolescentes",2021,3,1,613,163.132137030995,0,310,0,1,303,330.03300330033
34453,68,68377,81,"Tasa de exámenes médico legales por presunto delito sexual contra niños, niñas y adolescentes",2021,4,1,664,150.602409638554,0,344,0,1,320,312.5
34454,68,68397,81,"Tasa de exámenes médico legales por presunto delito sexual contra niños, niñas y adolescentes",2021,3,1,433,230.94688221709,0,229,0,1,204,490.196078431373
34455,68,68397,81,"Tasa de exámenes médico legales por presunto delito sexual contra niños, niñas y adolescentes",2021,4,2,479,417.536534446764,0,257,0,2,222,900.900900900901
34456,68,68385,81,"Tasa de exámenes médico legales por presunto delito sexual contra niños, niñas y adolescentes",2021,2,1,809,123.609394313968,0,434,0,1,375,266.666666666667
34457,68,68385,81,"Tasa de exámenes médico legales por presunto delito sexual contra niños, niñas y adolescentes",2021,3,2,1095,182.648401826484,0,570,0,2,525,380.952380952381
34458,68,68385,81,"Tasa de exámenes médico legales por presunto delito sexual contra niños, niñas y adolescentes",2021,4,4,1139,351.185250219491,1,588,170.068027210884,3,551,544.464609800363
34459,68,68406,81,"Tasa de exámenes médico legales por presunto delito sexual contra niños, niñas y adolescentes",2021,2,4,3582,111.669458403127,0,1817,0,4,1765,226.628895184136
34460,68,68406,81,"Tasa de exámenes médico legales por presunto delito sexual contra niños, niñas y adolescentes",2021,3,2,4336,46.1254612546125,1,2192,45.6204379562044,1,2144,46.6417910447761
34461,68,68406,81,"Tasa de exámenes médico legales por presunto delito sexual contra niños, niñas y adolescentes",2021,4,5,4387,113.973102347846,1,2229,44.8631673396142,4,2158,185.356811862836
34462,68,68418,81,"Tasa de exámenes médico legales por presunto delito sexual contra niños, niñas y adolescentes",2021,3,1,1555,64.3086816720257,0,797,0,1,758,131.926121372032
34463,68,68418,81,"Tasa de exámenes médico legales por presunto delito sexual contra niños, niñas y adolescentes",2021,4,1,1551,64.4745325596389,1,785,127.388535031847,0,766,0
34464,68,68432,81,"Tasa de exámenes médico legales por presunto delito sexual contra niños, niñas y adolescentes",2021,2,2,1499,133.422281521014,0,782,0,2,717,278.940027894003
34465,68,68432,81,"Tasa de exámenes médico legales por presunto delito sexual contra niños, niñas y adolescentes",2021,3,2,2025,98.7654320987654,0,1044,0,2,981,203.873598369011
34466,68,68432,81,"Tasa de exámenes médico legales por presunto delito sexual contra niños, niñas y adolescentes",2021,4,6,2207,271.86225645672903,0,1132,0,6,1075,558.139534883721
34467,68,68444,81,"Tasa de exámenes médico legales por presunto delito sexual contra niños, niñas y adolescentes",2021,4,1,452,221.238938053097,0,240,0,1,212,471.698113207547
34468,68,68444,121,Tasa de exámenes médico legales por presunto delito sexual cuando la víctima está entre 18 y 28 años,2021,5,1,742,134.770889487871,0,380,0,1,362,276.243093922652
34469,68,68464,81,"Tasa de exámenes médico legales por presunto delito sexual contra niños, niñas y adolescentes",2021,3,1,1167,85.6898029134533,0,587,0,1,580,172.413793103448
34470,68,68464,81,"Tasa de exámenes médico legales por presunto delito sexual contra niños, niñas y adolescentes",2021,4,5,1128,443.262411347518,1,577,173.310225303293,4,551,725.952813067151
34471,68,68464,121,Tasa de exámenes médico legales por presunto delito sexual cuando la víctima está entre 18 y 28 años,2021,5,1,1707,58.5823081429408,0,904,0,1,803,124.53300124533
34472,68,68468,81,"Tasa de exámenes médico legales por presunto delito sexual contra niños, niñas y adolescentes",2021,2,2,228,877.19298245614,0,126,0,2,102,1960.78431372549
34473,68,68498,81,"Tasa de exámenes médico legales por presunto delito sexual contra niños, niñas y adolescentes",2021,4,1,594,168.350168350168,0,311,0,1,283,353.356890459364
34474,68,68500,81,"Tasa de exámenes médico legales por presunto delito sexual contra niños, niñas y adolescentes",2021,3,1,1057,94.6073793755913,0,547,0,1,510,196.078431372549
34475,68,68500,81,"Tasa de exámenes médico legales por presunto delito sexual contra niños, niñas y adolescentes",2021,4,5,1101,454.132606721163,1,568,176.056338028169,4,533,750.46904315197
34476,68,68500,81,"Tasa de exámenes médico legales por presunto delito sexual contra niños, niñas y adolescentes",2021,1,1,152,657.894736842105,0,78,0,1,74,1351.35135135135
34477,68,68522,81,"Tasa de exámenes médico legales por presunto delito sexual contra niños, niñas y adolescentes",2021,3,1,132,757.575757575758,0,73,0,1,59,1694.91525423729
34478,68,68533,81,"Tasa de exámenes médico legales por presunto delito sexual contra niños, niñas y adolescentes",2021,3,1,496,201.612903225806,1,261,383.141762452107,0,235,0
34479,68,68547,81,"Tasa de exámenes médico legales por presunto delito sexual contra niños, niñas y adolescentes",2021,2,2,13737,14.5592196258281,0,7071,0,2,6666,30.00300030003
34480,68,68547,81,"Tasa de exámenes médico legales por presunto delito sexual contra niños, niñas y adolescentes",2021,3,10,16437,60.8383524974144,0,8459,0,10,7978,125.344697919278
34481,68,68547,81,"Tasa de exámenes médico legales por presunto delito sexual contra niños, niñas y adolescentes",2021,4,18,16734,107.565435640014,2,8565,23.3508464681845,16,8169,195.862406659322
34482,68,68547,121,Tasa de exámenes médico legales por presunto delito sexual cuando la víctima está entre 18 y 28 años,2021,5,2,34502,5.79676540490406,0,17254,0,2,17248,11.595547309833
34483,68,68572,81,"Tasa de exámenes médico legales por presunto delito sexual contra niños, niñas y adolescentes",2021,3,1,1269,78.8022064617809,0,643,0,1,626,159.744408945687
34484,68,68572,81,"Tasa de exámenes médico legales por presunto delito sexual contra niños, niñas y adolescentes",2021,4,3,1431,209.643605870021,0,747,0,3,684,438.59649122807
34485,68,68573,81,"Tasa de exámenes médico legales por presunto delito sexual contra niños, niñas y adolescentes",2021,3,3,986,304.259634888438,2,490,408.163265306122,1,496,201.612903225806
34486,68,68573,81,"Tasa de exámenes médico legales por presunto delito sexual contra niños, niñas y adolescentes",2021,4,3,855,350.877192982456,0,421,0,3,434,691.244239631336
34487,68,68575,81,"Tasa de exámenes médico legales por presunto delito sexual contra niños, niñas y adolescentes",2021,3,12,4117,291.474374544571,2,2136,93.6329588014981,10,1981,504.795557799091
34488,68,68575,81,"Tasa de exámenes médico legales por presunto delito sexual contra niños, niñas y adolescentes",2021,4,13,3784,343.551797040169,2,1970,101.522842639594,11,1814,606.394707828004
34489,68,68615,81,"Tasa de exámenes médico legales por presunto delito sexual contra niños, niñas y adolescentes",2021,2,4,2287,174.901617839965,2,1195,167.364016736402,2,1092,183.150183150183
34490,68,68615,81,"Tasa de exámenes médico legales por presunto delito sexual contra niños, niñas y adolescentes",2021,3,7,2767,252.981568485725,0,1437,0,7,1330,526.315789473684
34491,68,68615,81,"Tasa de exámenes médico legales por presunto delito sexual contra niños, niñas y adolescentes",2021,4,8,2693,297.066468622354,0,1416,0,8,1277,626.46828504307
34492,68,68615,121,Tasa de exámenes médico legales por presunto delito sexual cuando la víctima está entre 18 y 28 años,2021,5,1,4509,22.1778664892437,0,2375,0,1,2134,46.8603561387067
34493,68,68655,81,"Tasa de exámenes médico legales por presunto delito sexual contra niños, niñas y adolescentes",2021,2,3,3607,83.1716107568617,0,1855,0,3,1752,171.232876712329
34494,68,68655,81,"Tasa de exámenes médico legales por presunto delito sexual contra niños, niñas y adolescentes",2021,3,8,4080,196.078431372549,1,2087,47.9156684235745,7,1993,351.229302558956
34495,68,68655,81,"Tasa de exámenes médico legales por presunto delito sexual contra niños, niñas y adolescentes",2021,4,10,3654,273.672687465791,0,1850,0,10,1804,554.323725055432
34496,68,68655,121,Tasa de exámenes médico legales por presunto delito sexual cuando la víctima está entre 18 y 28 años,2021,5,1,6322,15.8177791838026,0,3171,0,1,3151,31.7359568390987
34497,68,68669,81,"Tasa de exámenes médico legales por presunto delito sexual contra niños, niñas y adolescentes",2021,2,1,582,171.821305841924,1,294,340.136054421769,0,288,0
34498,68,68669,81,"Tasa de exámenes médico legales por presunto delito sexual contra niños, niñas y adolescentes",2021,3,1,765,130.718954248366,0,409,0,1,356,280.898876404494
34499,68,68669,81,"Tasa de exámenes médico legales por presunto delito sexual contra niños, niñas y adolescentes",2021,4,4,784,510.204081632653,0,435,0,4,349,1146.13180515759
34500,68,68673,81,"Tasa de exámenes médico legales por presunto delito sexual contra niños, niñas y adolescentes",2021,3,1,247,404.858299595142,0,122,0,1,125,800
34501,68,68673,81,"Tasa de exámenes médico legales por presunto delito sexual contra niños, niñas y adolescentes",2021,4,1,261,383.141762452107,0,136,0,1,125,800
34502,68,68679,81,"Tasa de exámenes médico legales por presunto delito sexual contra niños, niñas y adolescentes",2021,2,1,4309,23.2072406590856,0,2189,0,1,2120,47.1698113207547
34503,68,68679,81,"Tasa de exámenes médico legales por presunto delito sexual contra niños, niñas y adolescentes",2021,3,11,5184,212.191358024691,1,2633,37.9794910748196,10,2551,392.003136025088
34504,68,68679,81,"Tasa de exámenes médico legales por presunto delito sexual contra niños, niñas y adolescentes",2021,4,12,5218,229.973169796857,1,2623,38.1242851696531,11,2595,423.892100192678
34505,68,68679,121,Tasa de exámenes médico legales por presunto delito sexual cuando la víctima está entre 18 y 28 años,2021,5,2,10578,18.9071658158442,0,5199,0,2,5379,37.1816322736568
34506,68,68682,81,"Tasa de exámenes médico legales por presunto delito sexual contra niños, niñas y adolescentes",2021,4,2,227,881.057268722467,0,120,0,2,107,1869.15887850467
34507,68,68684,81,"Tasa de exámenes médico legales por presunto delito sexual contra niños, niñas y adolescentes",2021,2,1,265,377.358490566038,1,139,719.424460431655,0,126,0
34508,68,68684,81,"Tasa de exámenes médico legales por presunto delito sexual contra niños, niñas y adolescentes",2021,4,3,441,680.272108843537,0,228,0,3,213,1408.45070422535
34509,68,68686,81,"Tasa de exámenes médico legales por presunto delito sexual contra niños, niñas y adolescentes",2021,3,1,236,423.728813559322,0,124,0,1,112,892.857142857143
34510,68,68689,81,"Tasa de exámenes médico legales por presunto delito sexual contra niños, niñas y adolescentes",2021,2,5,2618,190.985485103132,1,1353,73.909830007391,4,1265,316.205533596838
34511,68,68689,81,"Tasa de exámenes médico legales por presunto delito sexual contra niños, niñas y adolescentes",2021,3,11,3403,323.244196297385,4,1768,226.244343891403,7,1635,428.134556574924
34512,68,68689,81,"Tasa de exámenes médico legales por presunto delito sexual contra niños, niñas y adolescentes",2021,4,9,3579,251.466890192791,0,1904,0,9,1675,537.313432835821
34513,68,68705,81,"Tasa de exámenes médico legales por presunto delito sexual contra niños, niñas y adolescentes",2021,3,1,224,446.428571428571,0,123,0,1,101,990.09900990099
34514,68,68720,81,"Tasa de exámenes médico legales por presunto delito sexual contra niños, niñas y adolescentes",2021,3,3,388,773.19587628866,0,196,0,3,192,1562.5
34515,68,68745,81,"Tasa de exámenes médico legales por presunto delito sexual contra niños, niñas y adolescentes",2021,3,1,1080,92.5925925925926,0,532,0,1,548,182.481751824818
34516,68,68745,81,"Tasa de exámenes médico legales por presunto delito sexual contra niños, niñas y adolescentes",2021,4,3,1071,280.11204481792703,0,562,0,3,509,589.390962671906
34517,68,68755,81,"Tasa de exámenes médico legales por presunto delito sexual contra niños, niñas y adolescentes",2021,3,4,2779,143.936667866139,1,1374,72.7802037845706,3,1405,213.523131672598
34518,68,68755,81,"Tasa de exámenes médico legales por presunto delito sexual contra niños, niñas y adolescentes",2021,4,2,3164,63.2111251580278,0,1655,0,2,1509,132.538104705103
34519,68,68755,121,Tasa de exámenes médico legales por presunto delito sexual cuando la víctima está entre 18 y 28 años,2021,5,2,6305,31.7208564631245,1,3296,30.3398058252427,1,3009,33.2336324360253
34520,68,68770,81,"Tasa de exámenes médico legales por presunto delito sexual contra niños, niñas y adolescentes",2021,2,6,683,878.477306002928,2,348,574.712643678161,4,335,1194.02985074627
34521,68,68770,81,"Tasa de exámenes médico legales por presunto delito sexual contra niños, niñas y adolescentes",2021,3,5,903,553.709856035438,1,474,210.970464135021,4,429,932.400932400932
34522,68,68770,81,"Tasa de exámenes médico legales por presunto delito sexual contra niños, niñas y adolescentes",2021,4,1,944,105.932203389831,0,502,0,1,442,226.244343891403
34523,68,68770,121,Tasa de exámenes médico legales por presunto delito sexual cuando la víctima está entre 18 y 28 años,2021,5,2,1398,143.061516452074,0,715,0,2,683,292.825768667643
34524,68,68770,81,"Tasa de exámenes médico legales por presunto delito sexual contra niños, niñas y adolescentes",2021,1,1,129,775.193798449612,0,66,0,1,63,1587.30158730159
34525,68,68773,81,"Tasa de exámenes médico legales por presunto delito sexual contra niños, niñas y adolescentes",2021,4,4,736,543.478260869565,0,428,0,4,308,1298.7012987013
34526,68,68780,81,"Tasa de exámenes médico legales por presunto delito sexual contra niños, niñas y adolescentes",2021,4,3,354,847.457627118644,0,196,0,3,158,1898.73417721519
34527,68,68780,121,Tasa de exámenes médico legales por presunto delito sexual cuando la víctima está entre 18 y 28 años,2021,5,1,616,162.337662337662,0,333,0,1,283,353.356890459364
34528,68,68820,81,"Tasa de exámenes médico legales por presunto delito sexual contra niños, niñas y adolescentes",2021,2,1,658,151.975683890578,0,363,0,1,295,338.983050847458
34529,68,68820,121,Tasa de exámenes médico legales por presunto delito sexual cuando la víctima está entre 18 y 28 años,2021,5,1,1377,72.6216412490922,0,730,0,1,647,154.559505409583
34530,68,68855,81,"Tasa de exámenes médico legales por presunto delito sexual contra niños, niñas y adolescentes",2021,3,1,616,162.337662337662,0,309,0,1,307,325.732899022801
34531,68,68855,81,"Tasa de exámenes médico legales por presunto delito sexual contra niños, niñas y adolescentes",2021,4,2,640,312.5,0,337,0,2,303,660.06600660066
34532,68,68855,121,Tasa de exámenes médico legales por presunto delito sexual cuando la víctima está entre 18 y 28 años,2021,5,1,1077,92.8505106778087,0,567,0,1,510,196.078431372549
34533,68,68855,81,"Tasa de exámenes médico legales por presunto delito sexual contra niños, niñas y adolescentes",2021,1,1,92,1086.95652173913,0,43,0,1,49,2040.81632653061
34534,68,68861,81,"Tasa de exámenes médico legales por presunto delito sexual contra niños, niñas y adolescentes",2021,2,1,1315,76.0456273764259,0,652,0,1,663,150.829562594268
34535,68,68861,81,"Tasa de exámenes médico legales por presunto delito sexual contra niños, niñas y adolescentes",2021,3,5,1917,260.824204486176,0,956,0,5,961,520.291363163371
34536,68,68861,81,"Tasa de exámenes médico legales por presunto delito sexual contra niños, niñas y adolescentes",2021,4,4,2245,178.173719376392,0,1143,0,4,1102,362.976406533575
34537,68,68872,81,"Tasa de exámenes médico legales por presunto delito sexual contra niños, niñas y adolescentes",2021,4,1,748,133.689839572193,0,381,0,1,367,272.479564032698
34538,68,68895,81,"Tasa de exámenes médico legales por presunto delito sexual contra niños, niñas y adolescentes",2021,3,4,928,431.034482758621,0,480,0,4,448,892.857142857143
34543,70,70110,81,"Tasa de exámenes médico legales por presunto delito sexual contra niños, niñas y adolescentes",2021,2,1,996,100.401606425703,0,511,0,1,485,206.185567010309
34544,70,70110,81,"Tasa de exámenes médico legales por presunto delito sexual contra niños, niñas y adolescentes",2021,4,2,1203,166.251039068994,0,581,0,2,622,321.543408360129
34545,70,70124,81,"Tasa de exámenes médico legales por presunto delito sexual contra niños, niñas y adolescentes",2021,4,1,1933,51.7330574236937,0,981,0,1,952,105.042016806723
34546,70,70230,81,"Tasa de exámenes médico legales por presunto delito sexual contra niños, niñas y adolescentes",2021,2,1,358,279.329608938548,0,192,0,1,166,602.409638554217
34547,70,70204,81,"Tasa de exámenes médico legales por presunto delito sexual contra niños, niñas y adolescentes",2021,2,1,760,131.578947368421,0,402,0,1,358,279.329608938548
34548,70,70215,81,"Tasa de exámenes médico legales por presunto delito sexual contra niños, niñas y adolescentes",2021,2,2,5501,36.3570259952736,1,2760,36.231884057971,1,2741,36.4830353885443
34549,70,70215,81,"Tasa de exámenes médico legales por presunto delito sexual contra niños, niñas y adolescentes",2021,3,13,6911,188.105918101577,1,3454,28.9519397799653,12,3457,347.121781891814
34550,70,70215,81,"Tasa de exámenes médico legales por presunto delito sexual contra niños, niñas y adolescentes",2021,4,16,7305,219.028062970568,2,3745,53.4045393858478,14,3560,393.258426966292
34551,70,70215,121,Tasa de exámenes médico legales por presunto delito sexual cuando la víctima está entre 18 y 28 años,2021,5,3,12865,23.3190827827439,1,6641,15.0579731968077,2,6224,32.133676092545
34552,70,70221,81,"Tasa de exámenes médico legales por presunto delito sexual contra niños, niñas y adolescentes",2021,2,2,1546,129.366106080207,0,814,0,2,732,273.224043715847
34553,70,70221,81,"Tasa de exámenes médico legales por presunto delito sexual contra niños, niñas y adolescentes",2021,3,4,1856,215.51724137931,1,972,102.880658436214,3,884,339.366515837104
34554,70,70221,81,"Tasa de exámenes médico legales por presunto delito sexual contra niños, niñas y adolescentes",2021,4,5,1902,262.881177707676,1,985,101.522842639594,4,917,436.205016357688
34555,70,70221,121,Tasa de exámenes médico legales por presunto delito sexual cuando la víctima está entre 18 y 28 años,2021,5,4,5610,71.301247771836,1,3846,26.0010400416017,3,1764,170.068027210884
34556,70,70233,81,"Tasa de exámenes médico legales por presunto delito sexual contra niños, niñas y adolescentes",2021,2,1,919,108.813928182807,0,437,0,1,482,207.46887966805
34557,70,70233,81,"Tasa de exámenes médico legales por presunto delito sexual contra niños, niñas y adolescentes",2021,4,2,1149,174.064403829417,0,580,0,2,569,351.493848857645
34558,70,70235,81,"Tasa de exámenes médico legales por presunto delito sexual contra niños, niñas y adolescentes",2021,3,2,2680,74.6268656716418,2,1366,146.412884333821,0,1314,0
34559,70,70235,81,"Tasa de exámenes médico legales por presunto delito sexual contra niños, niñas y adolescentes",2021,4,1,2700,37.037037037037,0,1363,0,1,1337,74.794315632012
34560,70,70265,81,"Tasa de exámenes médico legales por presunto delito sexual contra niños, niñas y adolescentes",2021,4,1,2222,45.004500450045,0,1132,0,1,1090,91.7431192660551
34561,70,70418,81,"Tasa de exámenes médico legales por presunto delito sexual contra niños, niñas y adolescentes",2021,3,1,2497,40.0480576692031,0,1296,0,1,1201,83.2639467110741
34562,70,70418,81,"Tasa de exámenes médico legales por presunto delito sexual contra niños, niñas y adolescentes",2021,4,3,2414,124.275062137531,0,1238,0,3,1176,255.102040816327
34563,70,70429,81,"Tasa de exámenes médico legales por presunto delito sexual contra niños, niñas y adolescentes",2021,4,1,4274,23.3972859148339,0,2244,0,1,2030,49.2610837438424
34564,70,70473,81,"Tasa de exámenes médico legales por presunto delito sexual contra niños, niñas y adolescentes",2021,2,2,1456,137.362637362637,2,759,263.504611330698,0,697,0
34565,70,70473,81,"Tasa de exámenes médico legales por presunto delito sexual contra niños, niñas y adolescentes",2021,3,3,1686,177.935943060498,2,878,227.790432801822,1,808,123.762376237624
34566,70,70473,81,"Tasa de exámenes médico legales por presunto delito sexual contra niños, niñas y adolescentes",2021,4,4,1618,247.218788627936,0,826,0,4,792,505.050505050505
34567,70,70473,121,Tasa de exámenes médico legales por presunto delito sexual cuando la víctima está entre 18 y 28 años,2021,5,1,2910,34.3642611683849,0,1399,0,1,1511,66.1813368630046
34568,70,70508,81,"Tasa de exámenes médico legales por presunto delito sexual contra niños, niñas y adolescentes",2021,2,1,1943,51.4668039114771,0,990,0,1,953,104.931794333683
34569,70,70508,81,"Tasa de exámenes médico legales por presunto delito sexual contra niños, niñas y adolescentes",2021,3,4,2384,167.785234899329,0,1232,0,4,1152,347.222222222222
34570,70,70508,81,"Tasa de exámenes médico legales por presunto delito sexual contra niños, niñas y adolescentes",2021,4,6,2419,248.036378668871,0,1272,0,6,1147,523.103748910201
34571,70,70508,121,Tasa de exámenes médico legales por presunto delito sexual cuando la víctima está entre 18 y 28 años,2021,5,2,4132,48.402710551790904,0,2132,0,2,2000,100
34572,70,70523,81,"Tasa de exámenes médico legales por presunto delito sexual contra niños, niñas y adolescentes",2021,2,1,1489,67.1591672263264,1,768,130.208333333333,0,721,0
34573,70,70523,81,"Tasa de exámenes médico legales por presunto delito sexual contra niños, niñas y adolescentes",2021,3,1,1797,55.6483027267668,0,917,0,1,880,113.636363636364
34574,70,70523,81,"Tasa de exámenes médico legales por presunto delito sexual contra niños, niñas y adolescentes",2021,4,10,1834,545.25627044711,0,944,0,10,890,1123.59550561798
34575,70,70670,81,"Tasa de exámenes médico legales por presunto delito sexual contra niños, niñas y adolescentes",2021,2,3,4624,64.878892733564,0,2268,0,3,2356,127.334465195246
34576,70,70670,81,"Tasa de exámenes médico legales por presunto delito sexual contra niños, niñas y adolescentes",2021,3,3,5468,54.8646671543526,1,2748,36.3901018922853,2,2720,73.5294117647059
34577,70,70670,81,"Tasa de exámenes médico legales por presunto delito sexual contra niños, niñas y adolescentes",2021,4,4,5429,73.6783938110149,0,2820,0,4,2609,153.315446531238
34578,70,70670,121,Tasa de exámenes médico legales por presunto delito sexual cuando la víctima está entre 18 y 28 años,2021,5,1,9717,10.2912421529279,0,4973,0,1,4744,21.079258010118
34579,70,70678,81,"Tasa de exámenes médico legales por presunto delito sexual contra niños, niñas y adolescentes",2021,3,2,3413,58.5994726047466,0,1730,0,2,1683,118.83541295306
34580,70,70678,81,"Tasa de exámenes médico legales por presunto delito sexual contra niños, niñas y adolescentes",2021,4,7,3534,198.075834748161,1,1825,54.7945205479452,6,1709,351.082504388531
34581,70,70678,121,Tasa de exámenes médico legales por presunto delito sexual cuando la víctima está entre 18 y 28 años,2021,5,1,5623,17.7841010136938,0,2949,0,1,2674,37.397157816006
34582,70,70702,81,"Tasa de exámenes médico legales por presunto delito sexual contra niños, niñas y adolescentes",2021,4,4,1467,272.66530334015,0,740,0,4,727,550.206327372765
34583,70,70742,81,"Tasa de exámenes médico legales por presunto delito sexual contra niños, niñas y adolescentes",2021,2,1,2599,38.4763370527126,0,1338,0,1,1261,79.3021411578113
34584,70,70742,81,"Tasa de exámenes médico legales por presunto delito sexual contra niños, niñas y adolescentes",2021,3,2,3224,62.0347394540943,0,1631,0,2,1593,125.549278091651
34585,70,70742,81,"Tasa de exámenes médico legales por presunto delito sexual contra niños, niñas y adolescentes",2021,4,1,3296,30.3398058252427,0,1677,0,1,1619,61.7665225447807
34586,70,70708,81,"Tasa de exámenes médico legales por presunto delito sexual contra niños, niñas y adolescentes",2021,4,2,7153,27.9602963791416,0,3603,0,2,3550,56.3380281690141
34587,70,70713,81,"Tasa de exámenes médico legales por presunto delito sexual contra niños, niñas y adolescentes",2021,2,2,5182,38.5951370127364,1,2689,37.1885459278542,1,2493,40.1123144805455
34588,70,70713,81,"Tasa de exámenes médico legales por presunto delito sexual contra niños, niñas y adolescentes",2021,3,5,6507,76.8403258029814,1,3395,29.4550810014728,4,3112,128.53470437018
34589,70,70713,81,"Tasa de exámenes médico legales por presunto delito sexual contra niños, niñas y adolescentes",2021,4,10,6474,154.464009885697,1,3400,29.4117647058824,9,3074,292.778139232271
34590,70,70713,121,Tasa de exámenes médico legales por presunto delito sexual cuando la víctima está entre 18 y 28 años,2021,5,1,9006,11.1037086386853,0,4612,0,1,4394,22.7583067819754
34591,70,70717,81,"Tasa de exámenes médico legales por presunto delito sexual contra niños, niñas y adolescentes",2021,2,1,1641,60.9384521633151,0,816,0,1,825,121.212121212121
34592,70,70717,81,"Tasa de exámenes médico legales por presunto delito sexual contra niños, niñas y adolescentes",2021,3,1,2017,49.5785820525533,0,1024,0,1,993,100.704934541793
34593,70,70717,81,"Tasa de exámenes médico legales por presunto delito sexual contra niños, niñas y adolescentes",2021,4,4,2025,197.530864197531,0,1045,0,4,980,408.163265306122
34594,70,70717,121,Tasa de exámenes médico legales por presunto delito sexual cuando la víctima está entre 18 y 28 años,2021,5,1,3245,30.8166409861325,0,1621,0,1,1624,61.576354679803
34595,70,70820,81,"Tasa de exámenes médico legales por presunto delito sexual contra niños, niñas y adolescentes",2021,3,6,4004,149.85014985015,1,2012,49.7017892644135,5,1992,251.004016064257
34596,70,70820,81,"Tasa de exámenes médico legales por presunto delito sexual contra niños, niñas y adolescentes",2021,4,9,3960,227.272727272727,0,2007,0,9,1953,460.829493087558
34597,70,70820,121,Tasa de exámenes médico legales por presunto delito sexual cuando la víctima está entre 18 y 28 años,2021,5,3,6344,47.2887767969735,0,3131,0,3,3213,93.3706816059757
34598,70,70001,81,"Tasa de exámenes médico legales por presunto delito sexual contra niños, niñas y adolescentes",2021,2,9,24342,36.9731328567907,2,12432,16.0875160875161,7,11910,58.7741393786734
34599,70,70001,81,"Tasa de exámenes médico legales por presunto delito sexual contra niños, niñas y adolescentes",2021,3,31,29579,104.804083978498,3,15101,19.8662340242368,28,14478,193.396878021826
34600,70,70001,81,"Tasa de exámenes médico legales por presunto delito sexual contra niños, niñas y adolescentes",2021,4,84,30403,276.2885241588,7,15495,45.1758631816715,77,14908,516.50120740542
34601,70,70001,121,Tasa de exámenes médico legales por presunto delito sexual cuando la víctima está entre 18 y 28 años,2021,5,12,56395,21.278482134941,0,27618,0,12,28777,41.6999687250235
34602,70,70771,81,"Tasa de exámenes médico legales por presunto delito sexual contra niños, niñas y adolescentes",2021,3,1,3409,29.3341155764154,1,1821,54.9148819330039,0,1588,0
34603,70,70771,81,"Tasa de exámenes médico legales por presunto delito sexual contra niños, niñas y adolescentes",2021,4,1,3234,30.9214594928881,0,1738,0,1,1496,66.8449197860963
34604,70,70823,81,"Tasa de exámenes médico legales por presunto delito sexual contra niños, niñas y adolescentes",2021,2,1,1914,52.2466039707419,0,992,0,1,922,108.459869848156
34605,70,70823,81,"Tasa de exámenes médico legales por presunto delito sexual contra niños, niñas y adolescentes",2021,3,4,2386,167.644593461861,0,1230,0,4,1156,346.020761245675
34606,70,70823,81,"Tasa de exámenes médico legales por presunto delito sexual contra niños, niñas y adolescentes",2021,4,4,2445,163.59918200409,0,1259,0,4,1186,337.268128161889
34607,70,70823,121,Tasa de exámenes médico legales por presunto delito sexual cuando la víctima está entre 18 y 28 años,2021,5,1,4090,24.4498777506112,0,2069,0,1,2021,49.480455220188
34608,73,73024,81,"Tasa de exámenes médico legales por presunto delito sexual contra niños, niñas y adolescentes",2021,3,1,399,250.62656641604,0,212,0,1,187,534.75935828877
34609,73,73026,81,"Tasa de exámenes médico legales por presunto delito sexual contra niños, niñas y adolescentes",2021,3,4,794,503.778337531486,0,403,0,4,391,1023.0179028133
34610,73,73026,81,"Tasa de exámenes médico legales por presunto delito sexual contra niños, niñas y adolescentes",2021,4,2,839,238.379022646007,0,437,0,2,402,497.512437810945
34611,73,73030,81,"Tasa de exámenes médico legales por presunto delito sexual contra niños, niñas y adolescentes",2021,3,3,584,513.698630136986,1,300,333.333333333333,2,284,704.225352112676
34612,73,73030,81,"Tasa de exámenes médico legales por presunto delito sexual contra niños, niñas y adolescentes",2021,4,2,621,322.061191626409,0,333,0,2,288,694.444444444445
34613,73,73043,81,"Tasa de exámenes médico legales por presunto delito sexual contra niños, niñas y adolescentes",2021,2,2,832,240.384615384615,2,421,475.059382422803,0,411,0
34614,73,73043,81,"Tasa de exámenes médico legales por presunto delito sexual contra niños, niñas y adolescentes",2021,3,6,1120,535.714285714286,2,560,357.142857142857,4,560,714.285714285714
34615,73,73043,81,"Tasa de exámenes médico legales por presunto delito sexual contra niños, niñas y adolescentes",2021,4,16,1184,1351.35135135135,0,596,0,16,588,2721.08843537415
34616,73,73043,121,Tasa de exámenes médico legales por presunto delito sexual cuando la víctima está entre 18 y 28 años,2021,5,4,1720,232.558139534884,0,881,0,4,839,476.758045292014
34617,73,73055,81,"Tasa de exámenes médico legales por presunto delito sexual contra niños, niñas y adolescentes",2021,2,4,771,518.806744487678,0,422,0,4,349,1146.13180515759
34618,73,73055,81,"Tasa de exámenes médico legales por presunto delito sexual contra niños, niñas y adolescentes",2021,3,3,1022,293.542074363992,0,557,0,3,465,645.161290322581
34619,73,73055,81,"Tasa de exámenes médico legales por presunto delito sexual contra niños, niñas y adolescentes",2021,4,4,1101,363.30608537693,1,586,170.648464163823,3,515,582.52427184466
34620,73,73055,121,Tasa de exámenes médico legales por presunto delito sexual cuando la víctima está entre 18 y 28 años,2021,5,1,1799,55.5864369093941,0,909,0,1,890,112.359550561798
34621,73,73067,81,"Tasa de exámenes médico legales por presunto delito sexual contra niños, niñas y adolescentes",2021,3,4,2368,168.918918918919,1,1191,83.9630562552477,3,1177,254.885301614274
34622,73,73067,81,"Tasa de exámenes médico legales por presunto delito sexual contra niños, niñas y adolescentes",2021,4,10,2287,437.254044599913,2,1159,172.562553925798,8,1128,709.219858156028
34623,73,73067,121,Tasa de exámenes médico legales por presunto delito sexual cuando la víctima está entre 18 y 28 años,2021,5,1,3230,30.9597523219814,0,1737,0,1,1493,66.9792364367046
34624,73,73124,81,"Tasa de exámenes médico legales por presunto delito sexual contra niños, niñas y adolescentes",2021,2,3,1473,203.665987780041,1,782,127.877237851662,2,691,289.435600578871
34625,73,73124,81,"Tasa de exámenes médico legales por presunto delito sexual contra niños, niñas y adolescentes",2021,3,1,1792,55.8035714285714,0,940,0,1,852,117.370892018779
34626,73,73124,81,"Tasa de exámenes médico legales por presunto delito sexual contra niños, niñas y adolescentes",2021,4,8,1841,434.546442151005,0,955,0,8,886,902.93453724605
34627,73,73148,81,"Tasa de exámenes médico legales por presunto delito sexual contra niños, niñas y adolescentes",2021,2,2,663,301.659125188537,0,340,0,2,323,619.195046439629
34628,73,73148,81,"Tasa de exámenes médico legales por presunto delito sexual contra niños, niñas y adolescentes",2021,3,4,876,456.62100456621,1,454,220.264317180617,3,422,710.900473933649
34629,73,73148,81,"Tasa de exámenes médico legales por presunto delito sexual contra niños, niñas y adolescentes",2021,4,10,976,1024.59016393443,1,505,198.019801980198,9,471,1910.82802547771
34630,73,73148,121,Tasa de exámenes médico legales por presunto delito sexual cuando la víctima está entre 18 y 28 años,2021,5,4,1753,228.180262407302,1,891,112.233445566779,3,862,348.027842227378
34631,73,73152,81,"Tasa de exámenes médico legales por presunto delito sexual contra niños, niñas y adolescentes",2021,2,1,510,196.078431372549,1,266,375.93984962406,0,244,0
34632,73,73168,81,"Tasa de exámenes médico legales por presunto delito sexual contra niños, niñas y adolescentes",2021,2,1,4346,23.0096640589047,0,2270,0,1,2076,48.1695568400771
34633,73,73168,81,"Tasa de exámenes médico legales por presunto delito sexual contra niños, niñas y adolescentes",2021,3,17,5518,308.082638637187,4,2853,140.203294777427,13,2665,487.804878048781
34634,73,73168,81,"Tasa de exámenes médico legales por presunto delito sexual contra niños, niñas y adolescentes",2021,4,38,5651,672.44735445054,3,2924,102.599179206566,35,2727,1283.46167950128
34635,73,73168,121,Tasa de exámenes médico legales por presunto delito sexual cuando la víctima está entre 18 y 28 años,2021,5,9,8808,102.179836512262,0,4542,0,9,4266,210.970464135021
34636,73,73200,81,"Tasa de exámenes médico legales por presunto delito sexual contra niños, niñas y adolescentes",2021,3,1,772,129.533678756477,0,391,0,1,381,262.46719160105
34637,73,73200,81,"Tasa de exámenes médico legales por presunto delito sexual contra niños, niñas y adolescentes",2021,4,3,802,374.064837905237,0,414,0,3,388,773.19587628866
34638,73,73200,121,Tasa de exámenes médico legales por presunto delito sexual cuando la víctima está entre 18 y 28 años,2021,5,1,1263,79.1765637371338,0,652,0,1,611,163.66612111293
34639,73,73217,81,"Tasa de exámenes médico legales por presunto delito sexual contra niños, niñas y adolescentes",2021,3,6,2475,242.424242424242,0,1250,0,6,1225,489.795918367347
34640,73,73217,81,"Tasa de exámenes médico legales por presunto delito sexual contra niños, niñas y adolescentes",2021,4,13,2516,516.693163751987,0,1295,0,13,1221,1064.70106470106
34641,73,73217,121,Tasa de exámenes médico legales por presunto delito sexual cuando la víctima está entre 18 y 28 años,2021,5,3,3489,85.9845227858985,0,1835,0,3,1654,181.378476420798
34642,73,73226,81,"Tasa de exámenes médico legales por presunto delito sexual contra niños, niñas y adolescentes",2021,2,2,603,331.67495854063,0,300,0,2,303,660.06600660066
34643,73,73226,81,"Tasa de exámenes médico legales por presunto delito sexual contra niños, niñas y adolescentes",2021,3,5,818,611.246943765281,3,409,733.496332518338,2,409,488.997555012225
34644,73,73226,81,"Tasa de exámenes médico legales por presunto delito sexual contra niños, niñas y adolescentes",2021,4,4,829,482.509047044632,0,427,0,4,402,995.024875621891
34645,73,73226,121,Tasa de exámenes médico legales por presunto delito sexual cuando la víctima está entre 18 y 28 años,2021,5,1,1054,94.876660341556,0,548,0,1,506,197.628458498024
34646,73,73236,81,"Tasa de exámenes médico legales por presunto delito sexual contra niños, niñas y adolescentes",2021,3,3,749,400.534045393859,0,394,0,3,355,845.070422535211
34647,73,73236,81,"Tasa de exámenes médico legales por presunto delito sexual contra niños, niñas y adolescentes",2021,4,2,780,256.410256410256,0,418,0,2,362,552.486187845304
34648,73,73268,81,"Tasa de exámenes médico legales por presunto delito sexual contra niños, niñas y adolescentes",2021,2,3,4451,67.4005841383959,2,2288,87.4125874125874,1,2163,46.2320850670365
34649,73,73268,81,"Tasa de exámenes médico legales por presunto delito sexual contra niños, niñas y adolescentes",2021,3,13,5741,226.441386518028,2,2955,67.6818950930626,11,2786,394.831299353912
34650,73,73268,81,"Tasa de exámenes médico legales por presunto delito sexual contra niños, niñas y adolescentes",2021,4,28,6455,433.772269558482,2,3368,59.3824228028504,26,3087,842.241658568189
34651,73,73268,121,Tasa de exámenes médico legales por presunto delito sexual cuando la víctima está entre 18 y 28 años,2021,5,15,12490,120.096076861489,3,6529,45.9488436207689,12,5961,201.308505284348
34652,73,73270,81,"Tasa de exámenes médico legales por presunto delito sexual contra niños, niñas y adolescentes",2021,2,1,517,193.423597678917,1,248,403.225806451613,0,269,0
34653,73,73270,81,"Tasa de exámenes médico legales por presunto delito sexual contra niños, niñas y adolescentes",2021,3,4,703,568.990042674253,1,348,287.35632183908,3,355,845.070422535211
34654,73,73270,81,"Tasa de exámenes médico legales por presunto delito sexual contra niños, niñas y adolescentes",2021,4,1,726,137.741046831956,0,366,0,1,360,277.777777777778
34655,73,73275,81,"Tasa de exámenes médico legales por presunto delito sexual contra niños, niñas y adolescentes",2021,3,1,2463,40.6008932196508,0,1286,0,1,1177,84.9617672047579
34656,73,73275,81,"Tasa de exámenes médico legales por presunto delito sexual contra niños, niñas y adolescentes",2021,4,5,2592,192.901234567901,1,1359,73.5835172921266,4,1233,324.41200324412
34657,73,73283,81,"Tasa de exámenes médico legales por presunto delito sexual contra niños, niñas y adolescentes",2021,2,2,2188,91.4076782449726,1,1167,85.6898029134533,1,1021,97.9431929480901
34658,73,73283,81,"Tasa de exámenes médico legales por presunto delito sexual contra niños, niñas y adolescentes",2021,3,5,2928,170.765027322404,1,1519,65.832784726794,4,1409,283.88928317956
34659,73,73283,81,"Tasa de exámenes médico legales por presunto delito sexual contra niños, niñas y adolescentes",2021,4,10,3131,319.386777387416,1,1592,62.8140703517588,9,1539,584.795321637427
34660,73,73283,121,Tasa de exámenes médico legales por presunto delito sexual cuando la víctima está entre 18 y 28 años,2021,5,5,5089,98.2511298879937,0,2578,0,5,2511,199.123855037834
34661,73,73319,81,"Tasa de exámenes médico legales por presunto delito sexual contra niños, niñas y adolescentes",2021,2,4,2142,186.741363211951,0,1111,0,4,1031,387.972841901067
34662,73,73319,81,"Tasa de exámenes médico legales por presunto delito sexual contra niños, niñas y adolescentes",2021,3,10,2844,351.617440225035,2,1456,137.362637362637,8,1388,576.368876080692
34663,73,73319,81,"Tasa de exámenes médico legales por presunto delito sexual contra niños, niñas y adolescentes",2021,4,7,3050,229.508196721311,1,1556,64.26735218509,6,1494,401.606425702811
34664,73,73319,121,Tasa de exámenes médico legales por presunto delito sexual cuando la víctima está entre 18 y 28 años,2021,5,3,4865,61.6649537512847,0,2502,0,3,2363,126.957257723233
34665,73,73347,81,"Tasa de exámenes médico legales por presunto delito sexual contra niños, niñas y adolescentes",2021,3,1,699,143.061516452074,0,368,0,1,331,302.114803625378
34666,73,73347,81,"Tasa de exámenes médico legales por presunto delito sexual contra niños, niñas y adolescentes",2021,4,2,737,271.370420624152,0,380,0,2,357,560.224089635854
34667,73,73349,81,"Tasa de exámenes médico legales por presunto delito sexual contra niños, niñas y adolescentes",2021,2,8,1397,572.655690765927,3,699,429.184549356223,5,698,716.332378223496
34668,73,73349,81,"Tasa de exámenes médico legales por presunto delito sexual contra niños, niñas y adolescentes",2021,3,6,1838,326.441784548422,0,934,0,6,904,663.716814159292
34669,73,73349,81,"Tasa de exámenes médico legales por presunto delito sexual contra niños, niñas y adolescentes",2021,4,5,2094,238.777459407832,0,1111,0,5,983,508.646998982706
34670,73,73349,121,Tasa de exámenes médico legales por presunto delito sexual cuando la víctima está entre 18 y 28 años,2021,5,1,3892,25.693730729702,0,2131,0,1,1761,56.785917092561
34671,73,73001,81,"Tasa de exámenes médico legales por presunto delito sexual contra niños, niñas y adolescentes",2021,2,35,32191,108.726041440154,14,16435,85.1840584119258,21,15756,133.282559025133
34672,73,73001,81,"Tasa de exámenes médico legales por presunto delito sexual contra niños, niñas y adolescentes",2021,3,88,41884,210.104097029892,15,21325,70.3399765533412,73,20559,355.075635974512
34673,73,73001,81,"Tasa de exámenes médico legales por presunto delito sexual contra niños, niñas y adolescentes",2021,4,170,48208,352.638566213077,15,24465,61.3120784794605,155,23743,652.823990228699
34674,73,73001,121,Tasa de exámenes médico legales por presunto delito sexual cuando la víctima está entre 18 y 28 años,2021,5,57,100070,56.9601279104627,6,50321,11.923451441744,51,49749,102.514623409516
34675,73,73352,81,"Tasa de exámenes médico legales por presunto delito sexual contra niños, niñas y adolescentes",2021,2,2,846,236.406619385343,0,461,0,2,385,519.480519480519
34676,73,73352,81,"Tasa de exámenes médico legales por presunto delito sexual contra niños, niñas y adolescentes",2021,3,4,1102,362.976406533575,2,581,344.234079173838,2,521,383.877159309021
34677,73,73352,81,"Tasa de exámenes médico legales por presunto delito sexual contra niños, niñas y adolescentes",2021,4,7,1131,618.921308576481,1,584,171.232876712329,6,547,1096.89213893967
34678,73,73352,121,Tasa de exámenes médico legales por presunto delito sexual cuando la víctima está entre 18 y 28 años,2021,5,1,1721,58.1057524694945,0,871,0,1,850,117.647058823529
34679,73,73408,81,"Tasa de exámenes médico legales por presunto delito sexual contra niños, niñas y adolescentes",2021,2,1,1267,78.9265982636148,0,674,0,1,593,168.634064080944
34680,73,73408,81,"Tasa de exámenes médico legales por presunto delito sexual contra niños, niñas y adolescentes",2021,3,3,1595,188.087774294671,0,829,0,3,766,391.644908616188
34681,73,73408,81,"Tasa de exámenes médico legales por presunto delito sexual contra niños, niñas y adolescentes",2021,4,5,1656,301.932367149759,2,837,238.9486260454,3,819,366.300366300366
34682,73,73408,121,Tasa de exámenes médico legales por presunto delito sexual cuando la víctima está entre 18 y 28 años,2021,5,1,2953,33.8638672536404,0,1481,0,1,1472,67.9347826086957
34683,73,73411,81,"Tasa de exámenes médico legales por presunto delito sexual contra niños, niñas y adolescentes",2021,2,4,2286,174.978127734033,0,1173,0,4,1113,359.389038634322
34684,73,73411,81,"Tasa de exámenes médico legales por presunto delito sexual contra niños, niñas y adolescentes",2021,3,7,3163,221.308883970914,1,1638,61.0500610500611,6,1525,393.44262295082
34685,73,73411,81,"Tasa de exámenes médico legales por presunto delito sexual contra niños, niñas y adolescentes",2021,4,10,3447,290.107339715695,0,1773,0,10,1674,597.371565113501
34686,73,73411,121,Tasa de exámenes médico legales por presunto delito sexual cuando la víctima está entre 18 y 28 años,2021,5,6,5322,112.739571589628,1,2619,38.1825124093165,5,2703,184.979652238254
34687,73,73449,81,"Tasa de exámenes médico legales por presunto delito sexual contra niños, niñas y adolescentes",2021,2,7,2747,254.823443756826,2,1385,144.404332129964,5,1362,367.107195301028
34688,73,73449,81,"Tasa de exámenes médico legales por presunto delito sexual contra niños, niñas y adolescentes",2021,3,19,3310,574.018126888218,6,1699,353.148911124191,13,1611,806.952203600248
34689,73,73449,81,"Tasa de exámenes médico legales por presunto delito sexual contra niños, niñas y adolescentes",2021,4,25,3405,734.214390602056,0,1794,0,25,1611,1551.83116076971
34690,73,73449,121,Tasa de exámenes médico legales por presunto delito sexual cuando la víctima está entre 18 y 28 años,2021,5,15,6963,215.4243860405,1,3599,27.7854959711031,14,3364,416.171224732461
34691,73,73461,81,"Tasa de exámenes médico legales por presunto delito sexual contra niños, niñas y adolescentes",2021,4,5,472,1059.32203389831,0,235,0,5,237,2109.70464135021
34692,73,73483,81,"Tasa de exámenes médico legales por presunto delito sexual contra niños, niñas y adolescentes",2021,3,5,1253,399.042298483639,0,633,0,5,620,806.451612903226
34693,73,73483,81,"Tasa de exámenes médico legales por presunto delito sexual contra niños, niñas y adolescentes",2021,4,4,1392,287.35632183908,0,729,0,4,663,603.318250377074
34694,73,73483,121,Tasa de exámenes médico legales por presunto delito sexual cuando la víctima está entre 18 y 28 años,2021,5,2,2092,95.6022944550669,0,1085,0,2,1007,198.609731876862
34695,73,73504,81,"Tasa de exámenes médico legales por presunto delito sexual contra niños, niñas y adolescentes",2021,3,9,3740,240.641711229947,2,1937,103.252452245741,7,1803,388.241819190239
34696,73,73504,81,"Tasa de exámenes médico legales por presunto delito sexual contra niños, niñas y adolescentes",2021,4,22,3838,573.215216258468,0,2031,0,22,1807,1217.4875484228
34697,73,73520,81,"Tasa de exámenes médico legales por presunto delito sexual contra niños, niñas y adolescentes",2021,2,1,831,120.336943441637,0,411,0,1,420,238.095238095238
34698,73,73520,81,"Tasa de exámenes médico legales por presunto delito sexual contra niños, niñas y adolescentes",2021,3,4,1041,384.245917387128,1,513,194.931773879142,3,528,568.181818181818
34699,73,73520,81,"Tasa de exámenes médico legales por presunto delito sexual contra niños, niñas y adolescentes",2021,4,2,1027,194.741966893866,1,519,192.678227360308,1,508,196.850393700787
34700,73,73547,81,"Tasa de exámenes médico legales por presunto delito sexual contra niños, niñas y adolescentes",2021,4,1,676,147.92899408284,0,371,0,1,305,327.868852459016
34701,73,73555,81,"Tasa de exámenes médico legales por presunto delito sexual contra niños, niñas y adolescentes",2021,2,5,2841,175.994368180218,0,1463,0,5,1378,362.844702467344
34702,73,73555,81,"Tasa de exámenes médico legales por presunto delito sexual contra niños, niñas y adolescentes",2021,3,11,3342,329.144225014961,3,1745,171.919770773639,8,1597,500.93926111459
34703,73,73555,81,"Tasa de exámenes médico legales por presunto delito sexual contra niños, niñas y adolescentes",2021,4,19,3170,599.369085173502,1,1678,59.5947556615018,18,1492,1206.43431635389
34704,73,73555,121,Tasa de exámenes médico legales por presunto delito sexual cuando la víctima está entre 18 y 28 años,2021,5,3,4763,62.9855133319337,0,2477,0,3,2286,131.233595800525
34705,73,73563,81,"Tasa de exámenes médico legales por presunto delito sexual contra niños, niñas y adolescentes",2021,3,2,799,250.312891113892,0,402,0,2,397,503.778337531486
34706,73,73563,81,"Tasa de exámenes médico legales por presunto delito sexual contra niños, niñas y adolescentes",2021,4,2,811,246.609124537608,0,416,0,2,395,506.329113924051
34707,73,73563,121,Tasa de exámenes médico legales por presunto delito sexual cuando la víctima está entre 18 y 28 años,2021,5,1,1217,82.1692686935086,0,645,0,1,572,174.825174825175
34708,73,73585,81,"Tasa de exámenes médico legales por presunto delito sexual contra niños, niñas y adolescentes",2021,2,1,1654,60.459492140266,1,823,121.506682867558,0,831,0
34709,73,73585,81,"Tasa de exámenes médico legales por presunto delito sexual contra niños, niñas y adolescentes",2021,3,10,2044,489.236790606654,3,1047,286.532951289398,7,997,702.106318956871
34710,73,73585,81,"Tasa de exámenes médico legales por presunto delito sexual contra niños, niñas y adolescentes",2021,4,22,2070,1062.80193236715,3,1076,278.810408921933,19,994,1911.46881287726
34711,73,73585,121,Tasa de exámenes médico legales por presunto delito sexual cuando la víctima está entre 18 y 28 años,2021,5,4,3394,117.855038302887,1,1682,59.4530321046373,3,1712,175.233644859813
34712,73,73616,81,"Tasa de exámenes médico legales por presunto delito sexual contra niños, niñas y adolescentes",2021,2,1,2638,37.9075056861259,1,1348,74.1839762611276,0,1290,0
34713,73,73616,81,"Tasa de exámenes médico legales por presunto delito sexual contra niños, niñas y adolescentes",2021,3,7,3028,231.175693527081,0,1560,0,7,1468,476.839237057221
34714,73,73616,81,"Tasa de exámenes médico legales por presunto delito sexual contra niños, niñas y adolescentes",2021,4,9,2758,326.323422770123,1,1449,69.0131124913734,8,1309,611.153552330023
34715,73,73616,121,Tasa de exámenes médico legales por presunto delito sexual cuando la víctima está entre 18 y 28 años,2021,5,3,4114,72.9217306757414,1,2173,46.0193281178095,2,1941,103.039670273055
34716,73,73622,81,"Tasa de exámenes médico legales por presunto delito sexual contra niños, niñas y adolescentes",2021,3,3,625,480,1,329,303.951367781155,2,296,675.675675675676
34717,73,73622,81,"Tasa de exámenes médico legales por presunto delito sexual contra niños, niñas y adolescentes",2021,4,5,651,768.049155145929,0,344,0,5,307,1628.66449511401
34718,73,73622,121,Tasa de exámenes médico legales por presunto delito sexual cuando la víctima está entre 18 y 28 años,2021,5,2,967,206.825232678387,0,496,0,2,471,424.628450106157
34719,73,73624,81,"Tasa de exámenes médico legales por presunto delito sexual contra niños, niñas y adolescentes",2021,2,3,1761,170.357751277683,1,879,113.765642775882,2,882,226.757369614512
34720,73,73624,81,"Tasa de exámenes médico legales por presunto delito sexual contra niños, niñas y adolescentes",2021,3,5,2362,211.685012701101,1,1194,83.7520938023451,4,1168,342.465753424658
34721,73,73624,81,"Tasa de exámenes médico legales por presunto delito sexual contra niños, niñas y adolescentes",2021,4,23,2493,922.583233052547,0,1282,0,23,1211,1899.25681255161
34722,73,73624,121,Tasa de exámenes médico legales por presunto delito sexual cuando la víctima está entre 18 y 28 años,2021,5,3,3682,81.4774579033134,0,1939,0,3,1743,172.117039586919
34723,73,73671,81,"Tasa de exámenes médico legales por presunto delito sexual contra niños, niñas y adolescentes",2021,4,3,1412,212.464589235128,0,745,0,3,667,449.775112443778
34724,73,73671,121,Tasa de exámenes médico legales por presunto delito sexual cuando la víctima está entre 18 y 28 años,2021,5,1,2243,44.5831475702185,0,1137,0,1,1106,90.4159132007233
34725,73,73675,81,"Tasa de exámenes médico legales por presunto delito sexual contra niños, niñas y adolescentes",2021,3,5,1446,345.781466113416,1,735,136.054421768707,4,711,562.587904360056
34726,73,73675,81,"Tasa de exámenes médico legales por presunto delito sexual contra niños, niñas y adolescentes",2021,4,7,1493,468.854655056932,0,771,0,7,722,969.529085872576
34727,73,73675,121,Tasa de exámenes médico legales por presunto delito sexual cuando la víctima está entre 18 y 28 años,2021,5,1,2062,48.4966052376334,0,1098,0,1,964,103.734439834025
34728,73,73678,81,"Tasa de exámenes médico legales por presunto delito sexual contra niños, niñas y adolescentes",2021,2,4,843,474.495848161329,2,424,471.698113207547,2,419,477.326968973747
34729,73,73678,81,"Tasa de exámenes médico legales por presunto delito sexual contra niños, niñas y adolescentes",2021,3,7,1181,592.718035563082,1,614,162.866449511401,6,567,1058.20105820106
34730,73,73678,81,"Tasa de exámenes médico legales por presunto delito sexual contra niños, niñas y adolescentes",2021,4,10,1292,773.993808049536,1,682,146.627565982405,9,610,1475.40983606557
34731,73,73443,81,"Tasa de exámenes médico legales por presunto delito sexual contra niños, niñas y adolescentes",2021,2,4,2609,153.315446531238,0,1326,0,4,1283,311.769290724864
34732,73,73443,81,"Tasa de exámenes médico legales por presunto delito sexual contra niños, niñas y adolescentes",2021,3,5,3384,147.754137115839,1,1721,58.1057524694945,4,1663,240.529164161155
34733,73,73443,81,"Tasa de exámenes médico legales por presunto delito sexual contra niños, niñas y adolescentes",2021,4,9,3564,252.525252525253,1,1815,55.0964187327824,8,1749,457.404230989137
34734,73,73443,121,Tasa de exámenes médico legales por presunto delito sexual cuando la víctima está entre 18 y 28 años,2021,5,4,6186,64.6621403168445,0,3072,0,4,3114,128.452151573539
34735,73,73686,81,"Tasa de exámenes médico legales por presunto delito sexual contra niños, niñas y adolescentes",2021,2,1,439,227.790432801822,1,230,434.782608695652,0,209,0
34736,73,73686,81,"Tasa de exámenes médico legales por presunto delito sexual contra niños, niñas y adolescentes",2021,4,6,628,955.414012738853,0,337,0,6,291,2061.85567010309
34737,73,73770,81,"Tasa de exámenes médico legales por presunto delito sexual contra niños, niñas y adolescentes",2021,4,5,311,1607.71704180064,0,157,0,5,154,3246.75324675325
34738,73,73770,121,Tasa de exámenes médico legales por presunto delito sexual cuando la víctima está entre 18 y 28 años,2021,5,1,550,181.818181818182,0,290,0,1,260,384.615384615385
34739,73,73854,81,"Tasa de exámenes médico legales por presunto delito sexual contra niños, niñas y adolescentes",2021,2,1,362,276.243093922652,0,168,0,1,194,515.463917525773
34740,73,73854,81,"Tasa de exámenes médico legales por presunto delito sexual contra niños, niñas y adolescentes",2021,3,2,509,392.927308447937,0,246,0,2,263,760.456273764259
34741,73,73854,81,"Tasa de exámenes médico legales por presunto delito sexual contra niños, niñas y adolescentes",2021,4,2,538,371.747211895911,0,266,0,2,272,735.294117647059
34742,73,73854,121,Tasa de exámenes médico legales por presunto delito sexual cuando la víctima está entre 18 y 28 años,2021,5,1,758,131.926121372032,0,379,0,1,379,263.852242744063
34743,73,73861,81,"Tasa de exámenes médico legales por presunto delito sexual contra niños, niñas y adolescentes",2021,3,2,1187,168.49199663016,0,639,0,2,548,364.963503649635
34744,73,73861,81,"Tasa de exámenes médico legales por presunto delito sexual contra niños, niñas y adolescentes",2021,4,5,1218,410.509031198686,0,674,0,5,544,919.117647058824
34745,73,73870,81,"Tasa de exámenes médico legales por presunto delito sexual contra niños, niñas y adolescentes",2021,3,1,958,104.384133611691,0,493,0,1,465,215.05376344086
34746,73,73870,81,"Tasa de exámenes médico legales por presunto delito sexual contra niños, niñas y adolescentes",2021,4,2,931,214.822771213749,1,475,210.526315789474,1,456,219.298245614035
34747,73,73873,81,"Tasa de exámenes médico legales por presunto delito sexual contra niños, niñas y adolescentes",2021,2,1,374,267.379679144385,0,187,0,1,187,534.75935828877
34748,73,73873,81,"Tasa de exámenes médico legales por presunto delito sexual contra niños, niñas y adolescentes",2021,3,2,449,445.43429844098,0,226,0,2,223,896.860986547085
34749,73,73873,81,"Tasa de exámenes médico legales por presunto delito sexual contra niños, niñas y adolescentes",2021,4,4,436,917.431192660551,0,223,0,4,213,1877.93427230047
34750,76,76020,81,"Tasa de exámenes médico legales por presunto delito sexual contra niños, niñas y adolescentes",2021,3,1,1408,71.0227272727273,0,723,0,1,685,145.985401459854
34751,76,76020,81,"Tasa de exámenes médico legales por presunto delito sexual contra niños, niñas y adolescentes",2021,4,5,1467,340.831629175187,0,739,0,5,728,686.813186813187
34752,76,76020,121,Tasa de exámenes médico legales por presunto delito sexual cuando la víctima está entre 18 y 28 años,2021,5,1,2296,43.5540069686411,0,1141,0,1,1155,86.5800865800866
34753,76,76036,81,"Tasa de exámenes médico legales por presunto delito sexual contra niños, niñas y adolescentes",2021,2,2,1664,120.192307692308,0,841,0,2,823,243.013365735115
34754,76,76036,81,"Tasa de exámenes médico legales por presunto delito sexual contra niños, niñas y adolescentes",2021,3,1,2092,47.8011472275335,0,1074,0,1,1018,98.2318271119843
34755,76,76036,121,Tasa de exámenes médico legales por presunto delito sexual cuando la víctima está entre 18 y 28 años,2021,5,1,3605,27.7392510402219,0,1770,0,1,1835,54.4959128065395
34756,76,76041,81,"Tasa de exámenes médico legales por presunto delito sexual contra niños, niñas y adolescentes",2021,4,1,1839,54.3773790103317,0,937,0,1,902,110.864745011086
34757,76,76054,81,"Tasa de exámenes médico legales por presunto delito sexual contra niños, niñas y adolescentes",2021,3,1,565,176.991150442478,0,282,0,1,283,353.356890459364
34758,76,76054,81,"Tasa de exámenes médico legales por presunto delito sexual contra niños, niñas y adolescentes",2021,4,3,585,512.820512820513,0,298,0,3,287,1045.29616724739
34759,76,76054,121,Tasa de exámenes médico legales por presunto delito sexual cuando la víctima está entre 18 y 28 años,2021,5,1,785,127.388535031847,0,420,0,1,365,273.972602739726
34760,76,76100,81,"Tasa de exámenes médico legales por presunto delito sexual contra niños, niñas y adolescentes",2021,2,1,1370,72.992700729927,1,671,149.03129657228,0,699,0
34761,76,76100,81,"Tasa de exámenes médico legales por presunto delito sexual contra niños, niñas y adolescentes",2021,3,3,1688,177.725118483412,1,826,121.065375302663,2,862,232.018561484919
34762,76,76100,81,"Tasa de exámenes médico legales por presunto delito sexual contra niños, niñas y adolescentes",2021,4,7,1662,421.179302045728,1,837,119.4743130227,6,825,727.272727272727
34763,76,76100,121,Tasa de exámenes médico legales por presunto delito sexual cuando la víctima está entre 18 y 28 años,2021,5,1,2335,42.8265524625268,0,1218,0,1,1117,89.5255147717099
34764,76,76109,81,"Tasa de exámenes médico legales por presunto delito sexual contra niños, niñas y adolescentes",2021,2,7,36881,18.9799625823595,1,18578,5.3827107331252,6,18303,32.7815112276676
34765,76,76109,81,"Tasa de exámenes médico legales por presunto delito sexual contra niños, niñas y adolescentes",2021,3,16,42683,37.4856500246,3,21550,13.9211136890951,13,21133,61.515165854351
34766,76,76109,81,"Tasa de exámenes médico legales por presunto delito sexual contra niños, niñas y adolescentes",2021,4,30,38778,77.3634535045645,6,19525,30.729833546735,24,19253,124.655897782164
34767,76,76109,121,Tasa de exámenes médico legales por presunto delito sexual cuando la víctima está entre 18 y 28 años,2021,5,17,57133,29.7551327604012,1,27309,3.66179647735179,16,29824,53.6480686695279
34768,76,76113,81,"Tasa de exámenes médico legales por presunto delito sexual contra niños, niñas y adolescentes",2021,2,1,1690,59.1715976331361,1,871,114.810562571757,0,819,0
34769,76,76113,81,"Tasa de exámenes médico legales por presunto delito sexual contra niños, niñas y adolescentes",2021,3,1,2252,44.404973357016,0,1148,0,1,1104,90.5797101449275
34770,76,76113,81,"Tasa de exámenes médico legales por presunto delito sexual contra niños, niñas y adolescentes",2021,4,5,2422,206.440957886045,0,1235,0,5,1187,421.2299915754
34771,76,76113,121,Tasa de exámenes médico legales por presunto delito sexual cuando la víctima está entre 18 y 28 años,2021,5,1,3900,25.6410256410256,0,1999,0,1,1901,52.6038926880589
34772,76,76122,81,"Tasa de exámenes médico legales por presunto delito sexual contra niños, niñas y adolescentes",2021,2,2,1907,104.87676979549,0,1000,0,2,907,220.507166482911
34773,76,76122,81,"Tasa de exámenes médico legales por presunto delito sexual contra niños, niñas y adolescentes",2021,3,9,2553,352.526439482961,0,1307,0,9,1246,722.3113964687
34774,76,76122,81,"Tasa de exámenes médico legales por presunto delito sexual contra niños, niñas y adolescentes",2021,4,4,2755,145.19056261343,0,1359,0,4,1396,286.532951289398
34775,76,76001,81,"Tasa de exámenes médico legales por presunto delito sexual contra niños, niñas y adolescentes",2021,2,121,157492,76.829299265994507,21,80061,26.2299996252857,100,77431,129.147240769201
34776,76,76001,81,"Tasa de exámenes médico legales por presunto delito sexual contra niños, niñas y adolescentes",2021,3,200,189650,105.457421566043,33,95689,34.4867226117945,167,93961,177.733314885963
34777,76,76001,81,"Tasa de exámenes médico legales por presunto delito sexual contra niños, niñas y adolescentes",2021,4,338,197542,171.102854076601,35,98039,35.7000785401728,303,99503,304.513431755826
34778,76,76001,121,Tasa de exámenes médico legales por presunto delito sexual cuando la víctima está entre 18 y 28 años,2021,5,86,398086,21.6033721356692,8,192823,4.14888265404023,78,205263,38.0000292307917
34779,76,76001,81,"Tasa de exámenes médico legales por presunto delito sexual contra niños, niñas y adolescentes",2021,1,1,30788,3.24801870858776,0,15692,0,1,15096,6.62427133015368
34780,76,76126,81,"Tasa de exámenes médico legales por presunto delito sexual contra niños, niñas y adolescentes",2021,2,2,1319,151.630022744503,0,658,0,2,661,302.571860816944
34781,76,76126,81,"Tasa de exámenes médico legales por presunto delito sexual contra niños, niñas y adolescentes",2021,3,3,1739,172.512938470385,1,877,114.025085518814,2,862,232.018561484919
34782,76,76126,81,"Tasa de exámenes médico legales por presunto delito sexual contra niños, niñas y adolescentes",2021,4,5,1822,274.423710208562,1,923,108.342361863489,4,899,444.938820912125
34783,76,76126,121,Tasa de exámenes médico legales por presunto delito sexual cuando la víctima está entre 18 y 28 años,2021,5,1,2966,33.7154416722859,0,1453,0,1,1513,66.0938532716457
34784,76,76130,81,"Tasa de exámenes médico legales por presunto delito sexual contra niños, niñas y adolescentes",2021,2,6,8040,74.6268656716418,2,4167,47.9961603071754,4,3873,103.279111799639
34785,76,76130,81,"Tasa de exámenes médico legales por presunto delito sexual contra niños, niñas y adolescentes",2021,3,12,9578,125.287116308206,3,4939,60.7410406964973,9,4639,194.007329165768
34786,76,76130,81,"Tasa de exámenes médico legales por presunto delito sexual contra niños, niñas y adolescentes",2021,4,12,9472,126.689189189189,2,4836,41.3564929693962,10,4636,215.703192407248
34787,76,76130,121,Tasa de exámenes médico legales por presunto delito sexual cuando la víctima está entre 18 y 28 años,2021,5,3,16529,18.1499183253675,0,8155,0,3,8374,35.8251731550036
34788,76,76147,81,"Tasa de exámenes médico legales por presunto delito sexual contra niños, niñas y adolescentes",2021,2,5,9018,55.4446662231093,1,4511,22.1680336954112,4,4507,88.7508320390504
34789,76,76147,81,"Tasa de exámenes médico legales por presunto delito sexual contra niños, niñas y adolescentes",2021,3,13,11739,110.741971207087,2,5873,34.0541460922867,11,5866,187.521309239686
34790,76,76147,81,"Tasa de exámenes médico legales por presunto delito sexual contra niños, niñas y adolescentes",2021,4,23,12634,182.04844071553,2,6334,31.5756236185665,21,6300,333.333333333333
34791,76,76147,121,Tasa de exámenes médico legales por presunto delito sexual cuando la víctima está entre 18 y 28 años,2021,5,12,22673,52.9263882150576,0,11274,0,12,11399,105.272392315115
34792,76,76233,81,"Tasa de exámenes médico legales por presunto delito sexual contra niños, niñas y adolescentes",2021,2,4,3949,101.291466193973,0,2012,0,4,1937,206.504904491482
34793,76,76233,81,"Tasa de exámenes médico legales por presunto delito sexual contra niños, niñas y adolescentes",2021,3,9,4926,182.704019488429,2,2508,79.7448165869219,7,2418,289.495450785773
34794,76,76233,81,"Tasa de exámenes médico legales por presunto delito sexual contra niños, niñas y adolescentes",2021,4,11,4943,222.53692089824,1,2520,39.6825396825397,10,2423,412.711514651259
34795,76,76233,121,Tasa de exámenes médico legales por presunto delito sexual cuando la víctima está entre 18 y 28 años,2021,5,2,7829,25.5460467492656,0,3966,0,2,3863,51.7732332384157
34796,76,76243,81,"Tasa de exámenes médico legales por presunto delito sexual contra niños, niñas y adolescentes",2021,3,1,940,106.382978723404,1,478,209.205020920502,0,462,0
34797,76,76243,81,"Tasa de exámenes médico legales por presunto delito sexual contra niños, niñas y adolescentes",2021,4,2,943,212.089077412513,0,506,0,2,437,457.66590389016
34798,76,76246,81,"Tasa de exámenes médico legales por presunto delito sexual contra niños, niñas y adolescentes",2021,3,1,679,147.275405007364,0,349,0,1,330,303.030303030303
34799,76,76246,81,"Tasa de exámenes médico legales por presunto delito sexual contra niños, niñas y adolescentes",2021,4,1,657,152.20700152207,0,363,0,1,294,340.136054421769
34800,76,76248,81,"Tasa de exámenes médico legales por presunto delito sexual contra niños, niñas y adolescentes",2021,2,2,4325,46.242774566474,1,2196,45.5373406193078,1,2129,46.9704086425552
34801,76,76248,81,"Tasa de exámenes médico legales por presunto delito sexual contra niños, niñas y adolescentes",2021,3,4,5393,74.1702206564065,0,2715,0,4,2678,149.365197908887
34802,76,76248,81,"Tasa de exámenes médico legales por presunto delito sexual contra niños, niñas y adolescentes",2021,4,9,5540,162.454873646209,0,2735,0,9,2805,320.855614973262
34803,76,76248,121,Tasa de exámenes médico legales por presunto delito sexual cuando la víctima está entre 18 y 28 años,2021,5,3,9630,31.1526479750779,0,4595,0,3,5035,59.5829195630586
34804,76,76250,81,"Tasa de exámenes médico legales por presunto delito sexual contra niños, niñas y adolescentes",2021,3,1,990,101.010101010101,0,512,0,1,478,209.205020920502
34805,76,76250,81,"Tasa de exámenes médico legales por presunto delito sexual contra niños, niñas y adolescentes",2021,4,1,948,105.485232067511,0,485,0,1,463,215.982721382289
34806,76,76275,81,"Tasa de exámenes médico legales por presunto delito sexual contra niños, niñas y adolescentes",2021,2,1,4620,21.6450216450216,0,2421,0,1,2199,45.475216007276
34807,76,76275,81,"Tasa de exámenes médico legales por presunto delito sexual contra niños, niñas y adolescentes",2021,4,6,6096,98.4251968503937,1,3071,32.5626831650928,5,3025,165.289256198347
34808,76,76275,121,Tasa de exámenes médico legales por presunto delito sexual cuando la víctima está entre 18 y 28 años,2021,5,3,10355,28.9715113471753,0,5044,0,3,5311,56.4865373752589
34809,76,76306,81,"Tasa de exámenes médico legales por presunto delito sexual contra niños, niñas y adolescentes",2021,2,1,1602,62.4219725343321,0,835,0,1,767,130.378096479791
34810,76,76306,81,"Tasa de exámenes médico legales por presunto delito sexual contra niños, niñas y adolescentes",2021,3,2,2147,93.1532370749884,1,1113,89.8472596585804,1,1034,96.7117988394584
34811,76,76306,81,"Tasa de exámenes médico legales por presunto delito sexual contra niños, niñas y adolescentes",2021,4,2,2286,87.4890638670166,0,1164,0,2,1122,178.25311942959
34812,76,76306,121,Tasa de exámenes médico legales por presunto delito sexual cuando la víctima está entre 18 y 28 años,2021,5,1,3739,26.7451190157796,0,1824,0,1,1915,52.2193211488251
34813,76,76318,81,"Tasa de exámenes médico legales por presunto delito sexual contra niños, niñas y adolescentes",2021,2,2,2614,76.5110941086458,1,1316,75.9878419452888,1,1298,77.0416024653313
34814,76,76318,81,"Tasa de exámenes médico legales por presunto delito sexual contra niños, niñas y adolescentes",2021,3,3,3285,91.324200913242,0,1686,0,3,1599,187.617260787993
34815,76,76318,81,"Tasa de exámenes médico legales por presunto delito sexual contra niños, niñas y adolescentes",2021,4,7,3366,207.961972667855,1,1732,57.7367205542725,6,1634,367.197062423501
34816,76,76318,121,Tasa de exámenes médico legales por presunto delito sexual cuando la víctima está entre 18 y 28 años,2021,5,1,5669,17.6397953783736,0,2763,0,1,2906,34.4115622849277
34817,76,76111,81,"Tasa de exámenes médico legales por presunto delito sexual contra niños, niñas y adolescentes",2021,2,11,9311,118.13983460423199,2,4676,42.7715996578272,9,4635,194.174757281553
34818,76,76111,81,"Tasa de exámenes médico legales por presunto delito sexual contra niños, niñas y adolescentes",2021,3,18,11484,156.739811912226,6,5752,104.311543810848,12,5732,209.351011863224
34819,76,76111,81,"Tasa de exámenes médico legales por presunto delito sexual contra niños, niñas y adolescentes",2021,4,19,11719,162.129874562676,3,5909,50.7700118463361,16,5810,275.387263339071
34820,76,76364,81,"Tasa de exámenes médico legales por presunto delito sexual contra niños, niñas y adolescentes",2021,2,5,12493,40.0224125510286,2,6422,31.1429461227032,3,6071,49.415252841377
34821,76,76364,81,"Tasa de exámenes médico legales por presunto delito sexual contra niños, niñas y adolescentes",2021,3,14,15646,89.4797392304742,2,8022,24.931438544004,12,7624,157.397691500525
34822,76,76364,81,"Tasa de exámenes médico legales por presunto delito sexual contra niños, niñas y adolescentes",2021,4,30,16170,185.528756957328,1,8199,12.1966093426028,29,7971,363.818843306988
34823,76,76364,121,Tasa de exámenes médico legales por presunto delito sexual cuando la víctima está entre 18 y 28 años,2021,5,8,29055,27.5339872655309,1,14563,6.8667170225915,7,14492,48.30251173061
34824,76,76377,81,"Tasa de exámenes médico legales por presunto delito sexual contra niños, niñas y adolescentes",2021,3,1,1372,72.8862973760933,0,712,0,1,660,151.515151515152
34825,76,76377,81,"Tasa de exámenes médico legales por presunto delito sexual contra niños, niñas y adolescentes",2021,4,2,1472,135.869565217391,0,733,0,2,739,270.63599458728
34826,76,76377,121,Tasa de exámenes médico legales por presunto delito sexual cuando la víctima está entre 18 y 28 años,2021,5,1,2364,42.3011844331641,0,1191,0,1,1173,85.2514919011083
34827,76,76400,81,"Tasa de exámenes médico legales por presunto delito sexual contra niños, niñas y adolescentes",2021,2,5,2476,201.938610662359,2,1233,162.20600162206,3,1243,241.351568785197
34828,76,76400,81,"Tasa de exámenes médico legales por presunto delito sexual contra niños, niñas y adolescentes",2021,3,8,3269,244.723156928724,2,1654,120.918984280532,6,1615,371.517027863777
34829,76,76400,81,"Tasa de exámenes médico legales por presunto delito sexual contra niños, niñas y adolescentes",2021,4,5,3427,145.900204260286,0,1727,0,5,1700,294.117647058824
34830,76,76400,121,Tasa de exámenes médico legales por presunto delito sexual cuando la víctima está entre 18 y 28 años,2021,5,1,5626,17.7746178457163,0,2685,0,1,2941,34.0020401224073
34831,76,76403,81,"Tasa de exámenes médico legales por presunto delito sexual contra niños, niñas y adolescentes",2021,2,1,765,130.718954248366,0,366,0,1,399,250.62656641604
34832,76,76403,81,"Tasa de exámenes médico legales por presunto delito sexual contra niños, niñas y adolescentes",2021,3,1,1021,97.9431929480901,0,494,0,1,527,189.753320683112
34833,76,76403,81,"Tasa de exámenes médico legales por presunto delito sexual contra niños, niñas y adolescentes",2021,4,1,1070,93.4579439252337,0,529,0,1,541,184.842883548983
34834,76,76497,81,"Tasa de exámenes médico legales por presunto delito sexual contra niños, niñas y adolescentes",2021,3,1,1203,83.1255195344971,0,625,0,1,578,173.010380622837
34835,76,76520,81,"Tasa de exámenes médico legales por presunto delito sexual contra niños, niñas y adolescentes",2021,2,13,25549,50.8826177149791,1,13007,7.68816790958715,12,12542,95.6785201722213
34836,76,76520,81,"Tasa de exámenes médico legales por presunto delito sexual contra niños, niñas y adolescentes",2021,3,28,30899,90.6178193469044,5,15682,31.8836883050631,23,15217,151.146743773411
34837,76,76520,81,"Tasa de exámenes médico legales por presunto delito sexual contra niños, niñas y adolescentes",2021,4,39,31617,123.351361609261,6,15912,37.7073906485671,33,15705,210.124164278892
34838,76,76520,121,Tasa de exámenes médico legales por presunto delito sexual cuando la víctima está entre 18 y 28 años,2021,5,8,59809,13.3759133240817,2,29614,6.75356250422098,6,30195,19.8708395429707
34839,76,76563,81,"Tasa de exámenes médico legales por presunto delito sexual contra niños, niñas y adolescentes",2021,3,1,5016,19.9362041467305,0,2502,0,1,2514,39.7772474144789
34840,76,76563,81,"Tasa de exámenes médico legales por presunto delito sexual contra niños, niñas y adolescentes",2021,4,6,5362,111.898545318911,0,2631,0,6,2731,219.699743683632
34841,76,76563,121,Tasa de exámenes médico legales por presunto delito sexual cuando la víctima está entre 18 y 28 años,2021,5,1,8646,11.5660421003932,0,4153,0,1,4493,22.2568439795237
34842,76,76606,81,"Tasa de exámenes médico legales por presunto delito sexual contra niños, niñas y adolescentes",2021,2,4,1220,327.868852459016,1,620,161.290322580645,3,600,500
34843,76,76606,81,"Tasa de exámenes médico legales por presunto delito sexual contra niños, niñas y adolescentes",2021,3,8,1524,524.9343832021,1,780,128.205128205128,7,744,940.860215053764
34844,76,76606,81,"Tasa de exámenes médico legales por presunto delito sexual contra niños, niñas y adolescentes",2021,4,5,1532,326.370757180157,0,792,0,5,740,675.675675675676
34845,76,76616,81,"Tasa de exámenes médico legales por presunto delito sexual contra niños, niñas y adolescentes",2021,3,3,1566,191.570881226054,0,811,0,3,755,397.350993377483
34846,76,76616,81,"Tasa de exámenes médico legales por presunto delito sexual contra niños, niñas y adolescentes",2021,4,1,1559,64.143681847338,0,800,0,1,759,131.752305665349
34847,76,76622,81,"Tasa de exámenes médico legales por presunto delito sexual contra niños, niñas y adolescentes",2021,2,4,2505,159.680638722555,1,1286,77.7604976671851,3,1219,246.103363412633
34848,76,76622,81,"Tasa de exámenes médico legales por presunto delito sexual contra niños, niñas y adolescentes",2021,3,9,3361,267.777447188337,1,1716,58.2750582750583,8,1645,486.322188449848
34849,76,76622,81,"Tasa de exámenes médico legales por presunto delito sexual contra niños, niñas y adolescentes",2021,4,10,3574,279.798545047566,0,1807,0,10,1767,565.930956423316
34850,76,76622,121,Tasa de exámenes médico legales por presunto delito sexual cuando la víctima está entre 18 y 28 años,2021,5,2,5836,34.2700479780672,0,2866,0,2,2970,67.3400673400674
34851,76,76670,81,"Tasa de exámenes médico legales por presunto delito sexual contra niños, niñas y adolescentes",2021,3,1,1699,58.8581518540318,0,889,0,1,810,123.456790123457
34852,76,76670,81,"Tasa de exámenes médico legales por presunto delito sexual contra niños, niñas y adolescentes",2021,4,1,1736,57.6036866359447,0,879,0,1,857,116.686114352392
34853,76,76736,81,"Tasa de exámenes médico legales por presunto delito sexual contra niños, niñas y adolescentes",2021,2,4,2658,150.489089541008,1,1368,73.0994152046784,3,1290,232.558139534884
34854,76,76736,81,"Tasa de exámenes médico legales por presunto delito sexual contra niños, niñas y adolescentes",2021,3,6,3663,163.800163800164,4,1879,212.879191059074,2,1784,112.107623318386
34855,76,76736,81,"Tasa de exámenes médico legales por presunto delito sexual contra niños, niñas y adolescentes",2021,4,5,3950,126.582278481013,0,2019,0,5,1931,258.933195235629
34856,76,76736,121,Tasa de exámenes médico legales por presunto delito sexual cuando la víctima está entre 18 y 28 años,2021,5,1,6303,15.8654608916389,0,3152,0,1,3151,31.7359568390987
34857,76,76823,81,"Tasa de exámenes médico legales por presunto delito sexual contra niños, niñas y adolescentes",2021,2,1,1075,93.0232558139535,0,538,0,1,537,186.219739292365
34858,76,76823,81,"Tasa de exámenes médico legales por presunto delito sexual contra niños, niñas y adolescentes",2021,3,3,1489,201.477501678979,1,746,134.048257372654,2,743,269.179004037685
34859,76,76823,81,"Tasa de exámenes médico legales por presunto delito sexual contra niños, niñas y adolescentes",2021,4,3,1531,195.950359242325,0,767,0,3,764,392.670157068063
34860,76,76828,81,"Tasa de exámenes médico legales por presunto delito sexual contra niños, niñas y adolescentes",2021,3,2,2037,98.1836033382425,1,1049,95.3288846520496,1,988,101.214574898785
34861,76,76828,81,"Tasa de exámenes médico legales por presunto delito sexual contra niños, niñas y adolescentes",2021,4,6,2077,288.878189696678,1,1084,92.2509225092251,5,993,503.524672708963
34862,76,76834,81,"Tasa de exámenes médico legales por presunto delito sexual contra niños, niñas y adolescentes",2021,2,9,15779,57.0378350972812,2,8052,24.8385494287134,7,7727,90.591432638799
34863,76,76834,81,"Tasa de exámenes médico legales por presunto delito sexual contra niños, niñas y adolescentes",2021,3,17,20336,83.5955940204563,1,10315,9.69461948618517,16,10021,159.664704121345
34864,76,76834,81,"Tasa de exámenes médico legales por presunto delito sexual contra niños, niñas y adolescentes",2021,4,22,21493,102.358907551296,1,10846,9.21998893601328,21,10647,197.23865877712
34865,76,76834,121,Tasa de exámenes médico legales por presunto delito sexual cuando la víctima está entre 18 y 28 años,2021,5,9,37655,23.901208338866,0,18544,0,9,19111,47.0932970540526
34866,76,76845,81,"Tasa de exámenes médico legales por presunto delito sexual contra niños, niñas y adolescentes",2021,3,1,535,186.915887850467,0,288,0,1,247,404.858299595142
34867,76,76845,81,"Tasa de exámenes médico legales por presunto delito sexual contra niños, niñas y adolescentes",2021,4,3,551,544.464609800363,0,299,0,3,252,1190.47619047619
34868,76,76845,121,Tasa de exámenes médico legales por presunto delito sexual cuando la víctima está entre 18 y 28 años,2021,5,1,813,123.0012300123,0,424,0,1,389,257.06940874036
34869,76,76863,81,"Tasa de exámenes médico legales por presunto delito sexual contra niños, niñas y adolescentes",2021,3,2,653,306.278713629403,0,325,0,2,328,609.756097560976
34870,76,76863,81,"Tasa de exámenes médico legales por presunto delito sexual contra niños, niñas y adolescentes",2021,4,1,660,151.515151515152,0,327,0,1,333,300.3003003003
34871,76,76869,81,"Tasa de exámenes médico legales por presunto delito sexual contra niños, niñas y adolescentes",2021,2,2,938,213.219616204691,0,502,0,2,436,458.715596330275
34872,76,76869,81,"Tasa de exámenes médico legales por presunto delito sexual contra niños, niñas y adolescentes",2021,3,4,1182,338.409475465313,1,610,163.934426229508,3,572,524.475524475525
34873,76,76869,81,"Tasa de exámenes médico legales por presunto delito sexual contra niños, niñas y adolescentes",2021,4,8,1205,663.900414937759,0,608,0,8,597,1340.03350083752
34874,76,76869,121,Tasa de exámenes médico legales por presunto delito sexual cuando la víctima está entre 18 y 28 años,2021,5,1,2001,49.9750124937531,0,997,0,1,1004,99.601593625498
34875,76,76890,81,"Tasa de exámenes médico legales por presunto delito sexual contra niños, niñas y adolescentes",2021,4,5,1600,312.5,0,796,0,5,804,621.890547263682
34876,76,76890,121,Tasa de exámenes médico legales por presunto delito sexual cuando la víctima está entre 18 y 28 años,2021,5,1,2655,37.6647834274953,0,1358,0,1,1297,77.1010023130301
34877,76,76892,81,"Tasa de exámenes médico legales por presunto delito sexual contra niños, niñas y adolescentes",2021,2,7,8389,83.4426034092264,0,4366,0,7,4023,173.999502858563
34878,76,76892,81,"Tasa de exámenes médico legales por presunto delito sexual contra niños, niñas y adolescentes",2021,3,16,10475,152.744630071599,1,5299,18.8714851858841,15,5176,289.799072642968
34879,76,76892,81,"Tasa de exámenes médico legales por presunto delito sexual contra niños, niñas y adolescentes",2021,4,25,10904,229.27366104182,3,5355,56.0224089635854,22,5549,396.467832041809
34880,76,76892,121,Tasa de exámenes médico legales por presunto delito sexual cuando la víctima está entre 18 y 28 años,2021,5,7,19925,35.1317440401506,1,9730,10.2774922918808,6,10195,58.8523786169691
34881,76,76895,81,"Tasa de exámenes médico legales por presunto delito sexual contra niños, niñas y adolescentes",2021,2,1,3199,31.2597686777118,0,1589,0,1,1610,62.111801242236
34882,76,76895,81,"Tasa de exámenes médico legales por presunto delito sexual contra niños, niñas y adolescentes",2021,3,3,4136,72.5338491295938,0,2054,0,3,2082,144.092219020173
34883,76,76895,81,"Tasa de exámenes médico legales por presunto delito sexual contra niños, niñas y adolescentes",2021,4,5,4360,114.678899082569,1,2161,46.2748727441,4,2199,181.900864029104
34884,76,76895,121,Tasa de exámenes médico legales por presunto delito sexual cuando la víctima está entre 18 y 28 años,2021,5,3,7242,41.4250207125104,0,3543,0,3,3699,81.10300081103
34885,97,97161,81,"Tasa de exámenes médico legales por presunto delito sexual contra niños, niñas y adolescentes",2021,3,2,598,334.448160535117,0,298,0,2,300,666.666666666667
34886,97,97161,81,"Tasa de exámenes médico legales por presunto delito sexual contra niños, niñas y adolescentes",2021,4,2,633,315.955766192733,0,324,0,2,309,647.249190938511
34887,97,97001,81,"Tasa de exámenes médico legales por presunto delito sexual contra niños, niñas y adolescentes",2021,2,4,4550,87.9120879120879,1,2327,42.9737859905458,3,2223,134.952766531714
34888,97,97001,81,"Tasa de exámenes médico legales por presunto delito sexual contra niños, niñas y adolescentes",2021,3,10,5853,170.852554245686,3,2926,102.529049897471,7,2927,239.152716091561
34889,97,97001,81,"Tasa de exámenes médico legales por presunto delito sexual contra niños, niñas y adolescentes",2021,4,22,5594,393.27851269217,0,2811,0,22,2783,790.513833992095
34890,97,97001,121,Tasa de exámenes médico legales por presunto delito sexual cuando la víctima está entre 18 y 28 años,2021,5,7,6917,101.199942171462,0,3794,0,7,3123,224.143451809158
34891,97,97666,81,"Tasa de exámenes médico legales por presunto delito sexual contra niños, niñas y adolescentes",2021,3,5,394,1269.03553299492,1,201,497.512437810945,4,193,2072.53886010363
34892,97,97666,81,"Tasa de exámenes médico legales por presunto delito sexual contra niños, niñas y adolescentes",2021,4,1,449,222.71714922049,0,243,0,1,206,485.436893203883
34893,99,99001,81,"Tasa de exámenes médico legales por presunto delito sexual contra niños, niñas y adolescentes",2021,2,3,2111,142.112742775936,1,1093,91.4913083257091,2,1018,196.463654223969
34894,99,99001,81,"Tasa de exámenes médico legales por presunto delito sexual contra niños, niñas y adolescentes",2021,3,2,2332,85.7632933104631,0,1198,0,2,1134,176.36684303351
34895,99,99001,81,"Tasa de exámenes médico legales por presunto delito sexual contra niños, niñas y adolescentes",2021,4,10,2232,448.028673835125,0,1146,0,10,1086,920.810313075507
34896,99,99001,121,Tasa de exámenes médico legales por presunto delito sexual cuando la víctima está entre 18 y 28 años,2021,5,1,4386,22.7998176014592,0,2321,0,1,2065,48.4261501210654
